Location_Code,Total_Pop,Male,Female,Male_Rate,Female_Rate
E01011954,2283,1083,1200,0.4743758212877792,0.5256241787122208
E01011969,1344,664,680,0.49404761904761907,0.5059523809523809
E01011970,1070,520,550,0.48598130841121495,0.514018691588785
E01011971,1323,636,687,0.48072562358276644,0.5192743764172335
E01033465,1955,971,984,0.4966751918158568,0.5033248081841433
E01033467,2264,1040,1224,0.45936395759717313,0.5406360424028268
E01011952,1604,743,861,0.463216957605985,0.536783042394015
E01011953,1966,950,1016,0.4832146490335707,0.5167853509664293
E01011991,1620,799,821,0.49320987654320986,0.5067901234567901
E01011992,1895,916,979,0.48337730870712403,0.516622691292876
E01011993,1736,883,853,0.5086405529953917,0.4913594470046083
E01011994,1457,708,749,0.48592999313658203,0.514070006863418
E01011955,1299,614,685,0.472671285604311,0.527328714395689
E01011957,1245,615,630,0.4939759036144578,0.5060240963855421
E01032540,999,454,545,0.4544544544544545,0.5455455455455456
E01032541,2161,988,1173,0.45719574271170754,0.5428042572882924
E01033466,2297,1062,1235,0.46234218545929473,0.5376578145407053
E01011951,1201,596,605,0.4962531223980017,0.5037468776019983
E01011964,1330,668,662,0.5022556390977444,0.49774436090225566
E01011967,1487,710,777,0.47747141896435774,0.5225285810356423
E01011999,1843,887,956,0.4812805208898535,0.5187194791101465
E01012000,1263,633,630,0.501187648456057,0.498812351543943
E01011950,1034,528,506,0.5106382978723404,0.48936170212765956
E01011986,1258,610,648,0.4848966613672496,0.5151033386327504
E01011987,1354,654,700,0.48301329394387,0.51698670605613
E01012001,2160,1037,1123,0.48009259259259257,0.5199074074074074
E01011949,1821,886,935,0.4865458539264141,0.513454146073586
E01011980,1669,814,855,0.487717195925704,0.5122828040742959
E01011981,1766,858,908,0.48584371460928655,0.5141562853907135
E01011984,1216,590,626,0.48519736842105265,0.5148026315789473
E01011985,1265,623,642,0.4924901185770751,0.5075098814229249
E01011988,1792,856,936,0.47767857142857145,0.5223214285714286
E01011989,1895,907,988,0.47862796833773086,0.5213720316622691
E01011990,1822,882,940,0.4840834248079034,0.5159165751920965
E01011995,1292,621,671,0.4806501547987616,0.5193498452012384
E01011996,1382,664,718,0.4804630969609262,0.5195369030390738
E01011997,1910,928,982,0.48586387434554973,0.5141361256544502
E01011998,2167,1047,1120,0.4831564374711583,0.5168435625288417
E01011961,1397,682,715,0.4881889763779528,0.5118110236220472
E01011962,1427,665,762,0.46601261387526277,0.5339873861247372
E01011977,1717,786,931,0.45777518928363425,0.5422248107163657
E01011978,1635,772,863,0.47217125382263,0.5278287461773701
E01011979,1498,684,814,0.45660881174899864,0.5433911882510013
E01011959,2856,1441,1415,0.5045518207282913,0.4954481792717087
E01011960,1285,619,666,0.48171206225680935,0.5182879377431907
E01011963,1395,671,724,0.48100358422939066,0.5189964157706093
E01011968,1939,908,1031,0.46828261990716863,0.5317173800928313
E01011982,1689,839,850,0.49674363528715215,0.5032563647128478
E01012003,1654,826,828,0.49939540507859737,0.5006045949214026
E01012005,1870,916,954,0.4898395721925134,0.5101604278074866
E01011965,1615,790,825,0.4891640866873065,0.5108359133126935
E01011966,1303,637,666,0.488871834228703,0.511128165771297
E01011974,1505,786,719,0.5222591362126245,0.4777408637873754
E01011975,1095,528,567,0.4821917808219178,0.5178082191780822
E01011983,1679,828,851,0.4931506849315068,0.5068493150684932
E01012002,1392,688,704,0.4942528735632184,0.5057471264367817
E01035188,1941,974,967,0.5018031942297785,0.4981968057702215
E01012068,1835,1075,760,0.5858310626702997,0.4141689373297003
E01012092,1926,1084,842,0.5628245067497404,0.4371754932502596
E01012093,2016,1181,835,0.5858134920634921,0.41418650793650796
E01035189,1320,786,534,0.5954545454545455,0.40454545454545454
E01035190,1725,920,805,0.5333333333333333,0.4666666666666667
E01035191,1778,931,847,0.5236220472440944,0.4763779527559055
E01035192,1264,697,567,0.5514240506329114,0.4485759493670886
E01012058,1662,894,768,0.5379061371841155,0.4620938628158845
E01012059,1602,839,763,0.5237203495630461,0.4762796504369538
E01012060,1620,766,854,0.4728395061728395,0.5271604938271605
E01012061,1228,558,670,0.4543973941368078,0.5456026058631922
E01012036,1544,852,692,0.5518134715025906,0.4481865284974093
E01012037,1493,792,701,0.5304755525787006,0.4695244474212994
E01012038,1472,762,710,0.5176630434782609,0.48233695652173914
E01012039,1494,886,608,0.5930388219544847,0.4069611780455154
E01012040,1397,757,640,0.5418754473872585,0.4581245526127416
E01012041,1105,571,534,0.5167420814479639,0.4832579185520362
E01012074,1519,700,819,0.4608294930875576,0.5391705069124424
E01012075,1569,731,838,0.46590184831102616,0.5340981516889739
E01012076,1384,632,752,0.45664739884393063,0.5433526011560693
E01012077,1476,712,764,0.4823848238482385,0.5176151761517616
E01012088,1733,842,891,0.48586266589728794,0.514137334102712
E01012078,1504,788,716,0.523936170212766,0.47606382978723405
E01012079,1442,712,730,0.49375866851595007,0.5062413314840499
E01012080,1206,603,603,0.5,0.5
E01012081,1754,846,908,0.4823261117445838,0.5176738882554162
E01012026,2092,1049,1043,0.501434034416826,0.498565965583174
E01012027,1957,938,1019,0.4793050587634134,0.5206949412365867
E01033469,2218,1051,1167,0.4738503155996393,0.5261496844003607
E01012015,1439,695,744,0.4829742876997915,0.5170257123002084
E01012016,1784,839,945,0.4702914798206278,0.5297085201793722
E01012017,1502,746,756,0.4966711051930759,0.5033288948069241
E01012089,1576,755,821,0.47906091370558374,0.5209390862944162
E01012090,1522,755,767,0.49605781865965837,0.5039421813403416
E01012091,1970,932,1038,0.4730964467005076,0.5269035532994923
E01012011,1973,889,1084,0.45058286872782566,0.5494171312721744
E01012012,1767,863,904,0.488398415393322,0.511601584606678
E01012013,1480,718,762,0.4851351351351351,0.5148648648648648
E01012014,1615,754,861,0.46687306501547987,0.5331269349845201
E01012053,1754,852,902,0.48574686431014824,0.5142531356898518
E01012054,1747,880,867,0.5037206639954207,0.4962793360045793
E01012055,1931,976,955,0.5054375970999482,0.49456240290005177
E01012056,2375,1175,1200,0.49473684210526314,0.5052631578947369
E01012057,1948,964,984,0.4948665297741273,0.5051334702258727
E01012082,1508,676,832,0.4482758620689655,0.5517241379310345
E01012083,1623,766,857,0.47196549599507087,0.5280345040049291
E01012084,1655,761,894,0.4598187311178248,0.5401812688821752
E01012085,1600,749,851,0.468125,0.531875
E01012018,1581,846,735,0.5351043643263758,0.4648956356736243
E01012019,1178,551,627,0.46774193548387094,0.532258064516129
E01012020,1495,709,786,0.474247491638796,0.525752508361204
E01012021,1346,609,737,0.4524517087667162,0.5475482912332839
E01012007,1423,662,761,0.4652143359100492,0.5347856640899508
E01012008,1390,675,715,0.4856115107913669,0.5143884892086331
E01012009,1956,958,998,0.4897750511247444,0.5102249488752556
E01012010,1467,739,728,0.5037491479209271,0.49625085207907293
E01012046,2030,970,1060,0.47783251231527096,0.5221674876847291
E01012047,1607,758,849,0.4716863721219664,0.5283136278780336
E01012048,1791,872,919,0.4868788386376326,0.5131211613623674
E01012049,1253,620,633,0.4948124501197127,0.5051875498802874
E01012050,1413,646,767,0.45718329794762913,0.5428167020523709
E01012051,1253,577,676,0.4604948124501197,0.5395051875498803
E01012052,1222,575,647,0.4705400981996727,0.5294599018003273
E01012022,2846,1371,1475,0.4817287420941673,0.5182712579058327
E01012023,1451,685,766,0.4720882150241213,0.5279117849758787
E01012024,1572,751,821,0.477735368956743,0.522264631043257
E01012025,1223,614,609,0.5020441537203598,0.49795584627964024
E01012065,1900,925,975,0.4868421052631579,0.5131578947368421
E01012066,1871,923,948,0.49331908070550506,0.5066809192944949
E01012067,1566,764,802,0.4878671775223499,0.51213282247765
E01012042,1345,678,667,0.504089219330855,0.49591078066914496
E01012043,1295,622,673,0.4803088803088803,0.5196911196911197
E01012044,1547,722,825,0.4667097608274079,0.5332902391725921
E01012045,1469,685,784,0.46630360789652825,0.5336963921034718
E01032552,1644,773,871,0.4701946472019465,0.5298053527980535
E01035193,1686,793,893,0.47034400948991695,0.529655990510083
E01035194,1249,611,638,0.489191353082466,0.510808646917534
E01012030,1402,649,753,0.4629101283880171,0.5370898716119828
E01012031,1463,690,773,0.47163362952836635,0.5283663704716336
E01012032,1678,814,864,0.48510131108462456,0.5148986889153755
E01012033,1209,552,657,0.456575682382134,0.543424317617866
E01012034,1389,656,733,0.4722822174226062,0.5277177825773938
E01012035,1199,548,651,0.457047539616347,0.5429524603836531
E01012062,1814,881,933,0.4856670341786108,0.5143329658213892
E01012063,1388,650,738,0.46829971181556196,0.531700288184438
E01012071,1377,692,685,0.5025417574437182,0.4974582425562818
E01012073,1396,671,725,0.4806590257879656,0.5193409742120344
E01032593,2566,1265,1301,0.4929851909586906,0.5070148090413095
E01035195,1624,790,834,0.48645320197044334,0.5135467980295566
E01035196,1244,641,603,0.5152733118971061,0.4847266881028939
E01012100,1446,767,679,0.5304287690179806,0.46957123098201936
E01012101,1549,806,743,0.5203357004519045,0.47966429954809553
E01012102,2073,977,1096,0.47129763627592863,0.5287023637240714
E01012184,1402,650,752,0.463623395149786,0.536376604850214
E01012105,1381,671,710,0.48587979724837077,0.5141202027516293
E01012142,1603,760,843,0.4741110417966313,0.5258889582033687
E01012143,1522,712,810,0.46780551905387646,0.5321944809461235
E01012144,1364,696,668,0.5102639296187683,0.4897360703812317
E01012106,1333,669,664,0.5018754688672168,0.4981245311327832
E01012107,1357,663,694,0.4885777450257922,0.5114222549742078
E01032560,1132,542,590,0.4787985865724382,0.5212014134275619
E01032561,1494,698,796,0.46720214190093706,0.5327978580990629
E01012176,1419,685,734,0.48273431994362226,0.5172656800563777
E01012177,1369,660,709,0.4821037253469686,0.5178962746530315
E01012178,1368,686,682,0.5014619883040936,0.49853801169590645
E01012179,2134,1031,1103,0.4831302717900656,0.5168697282099344
E01012180,1624,824,800,0.5073891625615764,0.49261083743842365
E01012185,1368,656,712,0.47953216374269003,0.52046783625731
E01012186,1597,783,814,0.49029430181590483,0.5097056981840952
E01012127,1094,502,592,0.45886654478976235,0.5411334552102377
E01012128,1368,654,714,0.4780701754385965,0.5219298245614035
E01012129,2437,1175,1262,0.4821501846532622,0.5178498153467378
E01012130,1199,596,603,0.4970809007506255,0.5029190992493745
E01012131,1375,655,720,0.4763636363636364,0.5236363636363637
E01012138,2938,1449,1489,0.4931926480599047,0.5068073519400953
E01012139,1746,863,883,0.49427262313860254,0.5057273768613975
E01012140,1244,592,652,0.4758842443729904,0.5241157556270096
E01012141,1038,516,522,0.49710982658959535,0.5028901734104047
E01012154,1122,531,591,0.4732620320855615,0.5267379679144385
E01012155,1803,873,930,0.4841930116472546,0.5158069883527454
E01012156,1604,774,830,0.4825436408977556,0.5174563591022444
E01012157,1592,747,845,0.4692211055276382,0.5307788944723618
E01012158,1503,714,789,0.4750499001996008,0.5249500998003992
E01012159,1361,700,661,0.5143277002204262,0.4856722997795738
E01012160,1532,724,808,0.4725848563968668,0.5274151436031331
E01012161,1478,684,794,0.462787550744249,0.5372124492557511
E01012113,1441,675,766,0.46842470506592643,0.5315752949340735
E01012114,1404,671,733,0.4779202279202279,0.5220797720797721
E01012175,1394,662,732,0.4748923959827834,0.5251076040172167
E01033471,2149,1048,1101,0.48766868310842254,0.5123313168915775
E01012095,1221,607,614,0.49713349713349714,0.5028665028665029
E01012097,1108,545,563,0.4918772563176895,0.5081227436823105
E01012098,1572,759,813,0.48282442748091603,0.517175572519084
E01012099,1496,736,760,0.4919786096256685,0.5080213903743316
E01012108,1381,622,759,0.4503982621288921,0.5496017378711079
E01012109,1315,622,693,0.47300380228136885,0.5269961977186312
E01012110,1294,628,666,0.4853168469860896,0.5146831530139103
E01012111,1286,608,678,0.4727838258164852,0.5272161741835147
E01012171,1425,646,779,0.4533333333333333,0.5466666666666666
E01012172,1270,608,662,0.47874015748031495,0.521259842519685
E01012162,1328,657,671,0.4947289156626506,0.5052710843373494
E01012163,2425,1203,1222,0.4960824742268041,0.5039175257731959
E01012164,1542,718,824,0.4656290531776913,0.5343709468223087
E01012165,2412,1178,1234,0.48839137645107794,0.511608623548922
E01012096,1445,739,706,0.5114186851211072,0.4885813148788927
E01012136,1403,701,702,0.49964362081254454,0.5003563791874555
E01033473,2237,1072,1165,0.47921323200715243,0.5207867679928475
E01012112,1415,675,740,0.47703180212014135,0.5229681978798587
E01012145,1423,670,753,0.4708362614195362,0.5291637385804638
E01012147,1763,877,886,0.497447532614861,0.5025524673851389
E01012149,1139,560,579,0.4916593503072871,0.5083406496927129
E01012132,1861,921,940,0.4948952176249328,0.5051047823750672
E01012134,1357,675,682,0.4974207811348563,0.5025792188651437
E01012137,1369,697,672,0.5091307523739956,0.49086924762600437
E01012181,1593,770,823,0.48336472065285624,0.5166352793471437
E01012117,2051,965,1086,0.4705021940516821,0.5294978059483179
E01012118,1345,616,729,0.4579925650557621,0.5420074349442379
E01012119,2061,1013,1048,0.49150897622513345,0.5084910237748665
E01012121,1278,634,644,0.49608763693270735,0.5039123630672926
E01032548,1636,809,827,0.4944987775061125,0.5055012224938875
E01032549,2522,1203,1319,0.47700237906423476,0.5229976209357653
E01033472,2407,1165,1242,0.48400498545907766,0.5159950145409223
E01012120,1254,574,680,0.45773524720893144,0.5422647527910686
E01012124,1556,760,796,0.4884318766066838,0.5115681233933161
E01012182,1321,645,676,0.4882664647993944,0.5117335352006056
E01012183,1443,707,736,0.48995148995148996,0.51004851004851
E01012148,1409,699,710,0.49609652235628104,0.5039034776437189
E01012150,1570,705,865,0.44904458598726116,0.5509554140127388
E01012151,1417,667,750,0.47071277346506707,0.529287226534933
E01012152,1769,879,890,0.4968908988128886,0.5031091011871114
E01032594,1437,678,759,0.4718162839248434,0.5281837160751566
E01012146,1143,568,575,0.4969378827646544,0.5030621172353456
E01012167,2116,1024,1092,0.4839319470699433,0.5160680529300568
E01012168,2021,970,1051,0.47996041563582387,0.5200395843641762
E01012170,1260,585,675,0.4642857142857143,0.5357142857142857
E01012173,1098,539,559,0.49089253187613846,0.5091074681238615
E01012174,1113,515,598,0.46271338724168914,0.5372866127583109
E01033470,1862,927,935,0.49785177228786254,0.5021482277121375
E01012242,1399,681,718,0.4867762687634024,0.5132237312365976
E01012243,1502,724,778,0.48202396804260983,0.5179760319573902
E01012244,1351,664,687,0.4914877868245744,0.5085122131754256
E01012246,1278,635,643,0.4968701095461659,0.5031298904538342
E01012296,1183,577,606,0.48774302620456467,0.5122569737954353
E01012297,2454,1218,1236,0.4963325183374083,0.5036674816625917
E01012197,1779,878,901,0.49353569421023047,0.5064643057897695
E01012256,1203,587,616,0.48794679966749793,0.5120532003325021
E01012257,1392,665,727,0.47772988505747127,0.5222701149425287
E01012275,1567,745,822,0.47543075941289087,0.5245692405871091
E01012276,1701,835,866,0.49088771310993534,0.5091122868900647
E01012277,1686,805,881,0.4774614472123369,0.5225385527876631
E01012196,1529,753,776,0.4924787442773054,0.5075212557226946
E01012198,1344,669,675,0.49776785714285715,0.5022321428571429
E01012214,1545,729,816,0.47184466019417476,0.5281553398058253
E01012215,1217,592,625,0.4864420706655711,0.5135579293344289
E01012216,1193,565,628,0.47359597652975693,0.5264040234702431
E01012245,1538,731,807,0.4752925877763329,0.5247074122236671
E01012278,1184,588,596,0.4966216216216216,0.5033783783783784
E01012279,1664,813,851,0.4885817307692308,0.5114182692307693
E01012280,1526,747,779,0.4895150720838794,0.5104849279161205
E01012281,1264,594,670,0.4699367088607595,0.5300632911392406
E01012255,1317,630,687,0.4783599088838269,0.5216400911161732
E01012269,1605,792,813,0.4934579439252336,0.5065420560747663
E01012294,1334,661,673,0.4955022488755622,0.5044977511244377
E01012295,1407,692,715,0.4918265813788202,0.5081734186211798
E01033476,1936,973,963,0.5025826446280992,0.49741735537190085
E01033480,2937,1457,1480,0.4960844399046646,0.5039155600953353
E01012210,1494,706,788,0.4725568942436412,0.5274431057563588
E01012211,1777,873,904,0.4912774338773213,0.5087225661226786
E01012212,1504,729,775,0.48470744680851063,0.5152925531914894
E01012213,1291,570,721,0.4415182029434547,0.5584817970565453
E01012192,1494,711,783,0.4759036144578313,0.5240963855421686
E01012193,1549,766,783,0.4945125887669464,0.5054874112330536
E01012260,1611,791,820,0.4909993792675357,0.5090006207324643
E01012261,1364,674,690,0.4941348973607038,0.5058651026392962
E01012247,1154,574,580,0.49740034662045063,0.5025996533795494
E01012249,1582,774,808,0.4892541087231353,0.5107458912768648
E01012271,1441,674,767,0.4677307425399028,0.5322692574600971
E01012272,1042,489,553,0.4692898272552783,0.5307101727447217
E01012273,1519,712,807,0.4687294272547729,0.5312705727452272
E01012274,1286,600,686,0.4665629860031104,0.5334370139968896
E01012248,1251,607,644,0.48521183053557154,0.5147881694644284
E01012250,1930,921,1009,0.4772020725388601,0.5227979274611398
E01032542,1852,895,957,0.48326133909287255,0.5167386609071274
E01032543,2169,1014,1155,0.46749654218533887,0.5325034578146611
E01032544,2044,978,1066,0.47847358121330724,0.5215264187866928
E01012194,1480,695,785,0.46959459459459457,0.5304054054054054
E01012195,1557,749,808,0.481053307642903,0.518946692357097
E01012258,2189,1558,631,0.7117405207857469,0.2882594792142531
E01012259,1567,786,781,0.5015954052329291,0.49840459476707083
E01012268,2126,1037,1089,0.48777046095954846,0.5122295390404515
E01012187,1241,609,632,0.49073327961321517,0.5092667203867849
E01012188,1117,537,580,0.4807520143240824,0.5192479856759177
E01012189,1292,619,673,0.4791021671826625,0.5208978328173375
E01012205,1381,658,723,0.47646632874728456,0.5235336712527154
E01012219,1765,891,874,0.5048158640226629,0.4951841359773371
E01012251,1544,733,811,0.47474093264248707,0.5252590673575129
E01012252,1597,723,874,0.45272385723231057,0.5472761427676894
E01012253,1199,585,614,0.48790658882402,0.51209341117598
E01012254,1347,711,636,0.5278396436525612,0.47216035634743875
E01012204,1304,622,682,0.47699386503067487,0.5230061349693251
E01012206,1307,603,704,0.4613618974751339,0.5386381025248661
E01012207,1911,925,986,0.4840397697540555,0.5159602302459445
E01012208,1568,760,808,0.4846938775510204,0.5153061224489796
E01012190,1401,657,744,0.4689507494646681,0.5310492505353319
E01012191,1558,701,857,0.44993581514762515,0.5500641848523748
E01012224,1692,817,875,0.48286052009456265,0.5171394799054374
E01012225,1477,712,765,0.4820582261340555,0.5179417738659445
E01012226,1323,653,670,0.4935752078609221,0.5064247921390779
E01012209,1658,795,863,0.4794933655006031,0.5205066344993968
E01012217,1344,679,665,0.5052083333333334,0.4947916666666667
E01012218,1542,739,803,0.4792477302204929,0.5207522697795072
E01012223,1502,729,773,0.48535286284953394,0.5146471371504661
E01012286,1082,524,558,0.48428835489833644,0.5157116451016636
E01012287,1807,927,880,0.51300498063088,0.4869950193691201
E01012288,1238,637,601,0.5145395799676898,0.48546042003231016
E01012289,1238,631,607,0.5096930533117933,0.4903069466882068
E01012238,1563,740,823,0.473448496481126,0.5265515035188739
E01012239,2478,1225,1253,0.4943502824858757,0.5056497175141242
E01012240,1690,793,897,0.46923076923076923,0.5307692307692308
E01012241,1416,678,738,0.4788135593220339,0.5211864406779662
E01012290,1894,880,1014,0.46462513199577615,0.5353748680042238
E01012291,1856,892,964,0.48060344827586204,0.5193965517241379
E01012292,2048,961,1087,0.46923828125,0.53076171875
E01012282,1143,540,603,0.47244094488188976,0.5275590551181102
E01012283,1216,589,627,0.484375,0.515625
E01012284,1433,656,777,0.4577808792742498,0.5422191207257502
E01012285,1246,611,635,0.49036918138041735,0.5096308186195827
E01012199,1319,639,680,0.4844579226686884,0.5155420773313116
E01012200,1976,977,999,0.4944331983805668,0.5055668016194332
E01012201,2112,1027,1085,0.4862689393939394,0.5137310606060606
E01012202,1638,826,812,0.5042735042735043,0.49572649572649574
E01012203,1903,951,952,0.4997372569626905,0.5002627430373096
E01012270,1358,631,727,0.4646539027982327,0.5353460972017673
E01012228,1318,649,669,0.49241274658573597,0.507587253414264
E01012230,1641,815,826,0.49664838513101767,0.5033516148689823
E01012233,1774,859,915,0.4842164599774521,0.5157835400225479
E01012236,1237,602,635,0.486661277283751,0.513338722716249
E01012237,1297,650,647,0.5011565150346955,0.49884348496530456
E01012235,2383,1264,1119,0.5304238355014688,0.4695761644985313
E01012298,1315,644,671,0.4897338403041825,0.5102661596958175
E01012299,1281,628,653,0.49024199843871974,0.5097580015612803
E01012300,1443,651,792,0.45114345114345117,0.5488565488565489
E01012301,1251,627,624,0.5011990407673861,0.4988009592326139
E01012302,1237,600,637,0.4850444624090542,0.5149555375909458
E01012303,2105,1021,1084,0.4850356294536817,0.5149643705463183
E01012267,1728,927,801,0.5364583333333334,0.4635416666666667
E01035197,1601,881,720,0.5502810743285447,0.4497189256714553
E01035198,1574,773,801,0.49110546378653114,0.5088945362134689
E01035199,1199,715,484,0.5963302752293578,0.4036697247706422
E01012262,2629,1361,1268,0.5176873335869152,0.48231266641308485
E01035200,2081,1126,955,0.5410860163382989,0.4589139836617011
E01035201,1702,854,848,0.5017626321974148,0.4982373678025852
E01035202,1957,972,985,0.4966785896780787,0.5033214103219213
E01012227,1475,697,778,0.4725423728813559,0.5274576271186441
E01033474,2727,1295,1432,0.4748808214154749,0.5251191785845252
E01033479,1789,853,936,0.47680268306316376,0.5231973169368362
E01035203,1679,841,838,0.5008933889219773,0.4991066110780226
E01012231,1842,907,935,0.49239956568946797,0.507600434310532
E01012232,1359,662,697,0.48712288447387786,0.5128771155261221
E01012234,1548,770,778,0.4974160206718346,0.5025839793281653
E01033475,1905,945,960,0.49606299212598426,0.5039370078740157
E01035204,2481,1254,1227,0.5054413542926239,0.49455864570737607
E01012334,2705,1325,1380,0.4898336414048059,0.5101663585951941
E01012335,1547,734,813,0.4744667097608274,0.5255332902391726
E01012366,1982,966,1016,0.4873864783047427,0.5126135216952573
E01033481,1762,880,882,0.49943246311010214,0.5005675368898979
E01033482,1660,840,820,0.5060240963855421,0.4939759036144578
E01012323,1441,718,723,0.49826509368494104,0.501734906315059
E01012324,1330,639,691,0.48045112781954885,0.5195488721804511
E01032545,1730,813,917,0.4699421965317919,0.5300578034682081
E01032546,1738,838,900,0.48216340621403914,0.5178365937859609
E01012328,1508,721,787,0.4781167108753316,0.5218832891246684
E01012329,1699,839,860,0.49381989405532667,0.5061801059446733
E01012330,1072,534,538,0.498134328358209,0.5018656716417911
E01012331,1145,564,581,0.4925764192139738,0.5074235807860262
E01012349,1435,740,695,0.5156794425087108,0.4843205574912892
E01012350,1392,683,709,0.4906609195402299,0.5093390804597702
E01012351,1341,677,664,0.5048471290082028,0.49515287099179717
E01012352,1450,711,739,0.4903448275862069,0.5096551724137931
E01012325,1393,705,688,0.5061019382627423,0.4938980617372577
E01012326,1106,549,557,0.49638336347197104,0.5036166365280289
E01012332,1419,660,759,0.46511627906976744,0.5348837209302325
E01012333,1631,756,875,0.463519313304721,0.5364806866952789
E01012309,1937,946,991,0.48838409912235414,0.5116159008776459
E01012310,2155,1032,1123,0.4788863109048724,0.5211136890951276
E01012311,1469,696,773,0.47379169503063306,0.5262083049693669
E01012312,1392,663,729,0.47629310344827586,0.5237068965517241
E01012313,1401,666,735,0.4753747323340471,0.5246252676659529
E01012314,1376,645,731,0.46875,0.53125
E01012307,2227,1096,1131,0.4921418949259093,0.5078581050740907
E01012327,1647,746,901,0.45294474802671525,0.5470552519732848
E01012342,2694,1270,1424,0.47141796585003715,0.5285820341499629
E01035183,1507,753,754,0.4996682149966821,0.5003317850033179
E01035184,1328,660,668,0.49698795180722893,0.5030120481927711
E01012315,1638,798,840,0.48717948717948717,0.5128205128205128
E01012360,1749,839,910,0.47970268724985704,0.5202973127501429
E01035185,1533,774,759,0.5048923679060665,0.49510763209393344
E01035186,1114,536,578,0.48114901256732495,0.518850987432675
E01012336,1608,746,862,0.4639303482587065,0.5360696517412935
E01012337,1829,885,944,0.4838709677419355,0.5161290322580645
E01012347,1687,797,890,0.4724362774155305,0.5275637225844695
E01012348,2130,1034,1096,0.48544600938967136,0.5145539906103287
E01012361,1891,911,980,0.48175568482284503,0.518244315177155
E01012304,1046,555,491,0.5305927342256214,0.4694072657743786
E01012305,1078,552,526,0.5120593692022264,0.48794063079777367
E01012306,1444,657,787,0.4549861495844875,0.5450138504155124
E01012340,2276,1127,1149,0.4951669595782074,0.5048330404217927
E01012341,1662,778,884,0.4681107099879663,0.5318892900120337
E01012317,1316,655,661,0.49772036474164133,0.5022796352583586
E01012318,2343,1088,1255,0.46436192915066155,0.5356380708493385
E01012319,2695,1333,1362,0.4946196660482375,0.5053803339517625
E01012356,1600,842,758,0.52625,0.47375
E01012357,1308,648,660,0.4954128440366973,0.5045871559633027
E01012358,1586,782,804,0.4930643127364439,0.5069356872635561
E01012359,1791,820,971,0.45784477945281965,0.5421552205471803
E01012338,2149,1048,1101,0.48766868310842254,0.5123313168915775
E01012339,1938,957,981,0.4938080495356037,0.5061919504643962
E01012344,1434,697,737,0.4860529986052999,0.5139470013947002
E01012345,1561,738,823,0.4727738629083921,0.5272261370916079
E01012346,2287,1146,1141,0.5010931351114998,0.4989068648885002
E01012353,1457,731,726,0.5017158544955388,0.4982841455044612
E01012354,1526,853,673,0.5589777195281782,0.44102228047182174
E01012355,1414,746,668,0.5275813295615276,0.4724186704384724
E01012362,1215,610,605,0.5020576131687243,0.49794238683127573
E01012363,1243,615,628,0.49477071600965405,0.505229283990346
E01012364,1351,646,705,0.47816432272390824,0.5218356772760918
E01012365,1181,577,604,0.48856900931414055,0.5114309906858594
E01035187,2098,1082,1016,0.5157292659675882,0.48427073403241183
E01020613,1330,681,649,0.51203007518797,0.48796992481203005
E01020614,1401,651,750,0.46466809421841543,0.5353319057815846
E01020622,1532,771,761,0.5032637075718016,0.49673629242819844
E01020623,1458,739,719,0.5068587105624143,0.49314128943758573
E01020606,1353,697,656,0.5151515151515151,0.48484848484848486
E01020615,1687,803,884,0.4759928867812685,0.5240071132187315
E01020616,1625,772,853,0.47507692307692306,0.5249230769230769
E01020617,2455,1202,1253,0.4896130346232179,0.5103869653767821
E01020596,1583,748,835,0.47252053063802907,0.527479469361971
E01020597,1391,688,703,0.49460819554277496,0.505391804457225
E01020598,1676,788,888,0.4701670644391408,0.5298329355608592
E01020611,1809,882,927,0.48756218905472637,0.5124378109452736
E01020612,1501,723,778,0.4816788807461692,0.5183211192538307
E01020592,1504,695,809,0.4621010638297872,0.5378989361702128
E01020593,1212,613,599,0.5057755775577558,0.49422442244224424
E01020599,1709,833,876,0.4874195435927443,0.5125804564072557
E01020601,1384,653,731,0.4718208092485549,0.528179190751445
E01020602,1877,891,986,0.4746936600958977,0.5253063399041022
E01020618,1928,977,951,0.5067427385892116,0.4932572614107884
E01020594,1515,732,783,0.48316831683168315,0.5168316831683168
E01020595,1669,792,877,0.4745356500898742,0.5254643499101258
E01020600,1435,683,752,0.4759581881533101,0.5240418118466899
E01020603,1638,810,828,0.4945054945054945,0.5054945054945055
E01020605,1642,811,831,0.4939098660170524,0.5060901339829477
E01020590,1260,636,624,0.5047619047619047,0.49523809523809526
E01020591,1426,666,760,0.4670406732117812,0.5329593267882188
E01020608,1900,914,986,0.48105263157894734,0.5189473684210526
E01020609,1302,626,676,0.4807987711213518,0.5192012288786483
E01020610,1386,668,718,0.481962481962482,0.5180375180375181
E01020604,1397,670,727,0.47959914101646384,0.5204008589835362
E01020607,1852,937,915,0.505939524838013,0.49406047516198703
E01020619,1578,752,826,0.47655259822560203,0.523447401774398
E01020620,1556,780,776,0.5012853470437018,0.4987146529562982
E01020621,2042,979,1063,0.4794319294809011,0.5205680705190989
E01020634,1595,754,841,0.4727272727272727,0.5272727272727272
E01020635,1287,638,649,0.49572649572649574,0.5042735042735043
E01020636,1724,851,873,0.49361948955916474,0.5063805104408353
E01020654,1849,884,965,0.4780962682531098,0.5219037317468902
E01020676,1482,732,750,0.4939271255060729,0.5060728744939271
E01020627,1492,724,768,0.48525469168900803,0.514745308310992
E01020628,1804,886,918,0.4911308203991131,0.508869179600887
E01020629,1823,876,947,0.4805266044980801,0.51947339550192
E01020655,1956,944,1012,0.48261758691206547,0.5173824130879345
E01020656,1419,702,717,0.49471458773784355,0.5052854122621564
E01020657,1462,708,754,0.4842681258549932,0.5157318741450069
E01020661,1822,915,907,0.5021953896816685,0.4978046103183315
E01020662,1735,866,869,0.49913544668587895,0.500864553314121
E01020663,1791,900,891,0.5025125628140703,0.49748743718592964
E01020674,1565,787,778,0.5028753993610223,0.4971246006389776
E01020678,1279,630,649,0.49257232212666147,0.5074276778733385
E01020626,1460,725,735,0.4965753424657534,0.5034246575342466
E01020638,1585,777,808,0.49022082018927443,0.5097791798107255
E01020639,1678,801,877,0.47735399284862934,0.5226460071513707
E01020653,1465,689,776,0.47030716723549487,0.5296928327645051
E01020677,1495,696,799,0.46555183946488293,0.534448160535117
E01020647,2055,957,1098,0.4656934306569343,0.5343065693430656
E01020648,2669,1365,1304,0.5114275009366804,0.4885724990633196
E01020649,1643,824,819,0.5015216068167986,0.4984783931832015
E01020673,1528,767,761,0.5019633507853403,0.4980366492146597
E01020675,1707,817,890,0.4786174575278266,0.5213825424721734
E01020624,1705,872,833,0.5114369501466276,0.48856304985337246
E01020625,1649,826,823,0.5009096422073984,0.4990903577926016
E01020670,1544,722,822,0.4676165803108808,0.5323834196891192
E01020671,1253,627,626,0.5003990422984836,0.49960095770151636
E01020672,1675,863,812,0.515223880597015,0.4847761194029851
E01020632,1693,873,820,0.5156526875369167,0.48434731246308327
E01020640,2222,1100,1122,0.49504950495049505,0.504950495049505
E01020641,2169,1076,1093,0.49608114338404796,0.503918856615952
E01020642,1355,654,701,0.4826568265682657,0.5173431734317343
E01020643,2034,1006,1028,0.4945919370698132,0.5054080629301868
E01020667,1546,746,800,0.48253557567917205,0.517464424320828
E01020650,2390,1142,1248,0.47782426778242676,0.5221757322175732
E01020651,1703,816,887,0.47915443335290664,0.5208455666470934
E01020652,2043,992,1051,0.4855604503181596,0.5144395496818405
E01020668,1434,714,720,0.497907949790795,0.502092050209205
E01020669,1434,696,738,0.48535564853556484,0.5146443514644351
E01020630,1349,650,699,0.48183839881393625,0.5181616011860638
E01020631,1589,773,816,0.48646947765890497,0.513530522341095
E01020637,1643,821,822,0.4996956786366403,0.5003043213633597
E01020645,1533,706,827,0.46053489889106325,0.5394651011089368
E01034489,1238,618,620,0.4991922455573506,0.5008077544426495
E01034490,1551,787,764,0.5074145712443585,0.49258542875564154
E01034491,1283,628,655,0.48947778643803586,0.5105222135619641
E01020633,1624,808,816,0.4975369458128079,0.5024630541871922
E01020664,1593,733,860,0.4601381042059008,0.5398618957940992
E01020665,1390,672,718,0.48345323741007196,0.516546762589928
E01020666,1388,683,705,0.4920749279538905,0.5079250720461095
E01020646,1623,789,834,0.48613678373382624,0.5138632162661737
E01020658,1871,861,1010,0.46018172100481025,0.5398182789951897
E01020659,1380,671,709,0.486231884057971,0.513768115942029
E01020660,1580,753,827,0.47658227848101264,0.5234177215189874
E01020709,2617,1594,1023,0.6090943828811617,0.39090561711883837
E01020717,1524,726,798,0.4763779527559055,0.5236220472440944
E01020718,1304,618,686,0.47392638036809814,0.5260736196319018
E01020719,1188,580,608,0.4882154882154882,0.5117845117845118
E01020721,1089,530,559,0.4866850321395776,0.5133149678604224
E01020708,1223,590,633,0.48242027800490594,0.517579721995094
E01020710,1689,833,856,0.4931912374185909,0.5068087625814092
E01020711,1880,938,942,0.498936170212766,0.5010638297872341
E01020720,1403,641,762,0.4568781183178902,0.5431218816821097
E01020679,1541,740,801,0.48020765736534715,0.5197923426346528
E01020680,1647,837,810,0.5081967213114754,0.4918032786885246
E01020681,1493,719,774,0.4815807099799062,0.5184192900200938
E01020714,1462,705,757,0.48221614227086185,0.5177838577291382
E01020716,1682,815,867,0.4845422116527943,0.5154577883472057
E01020725,1517,734,783,0.4838497033618985,0.5161502966381015
E01020726,1128,550,578,0.4875886524822695,0.5124113475177305
E01020727,1195,540,655,0.45188284518828453,0.5481171548117155
E01020729,2207,1109,1098,0.5024920706841867,0.49750792931581334
E01020730,1630,784,846,0.48098159509202454,0.5190184049079755
E01020731,1452,731,721,0.5034435261707989,0.4965564738292011
E01020682,1803,881,922,0.48863006100942874,0.5113699389905713
E01020683,1588,775,813,0.4880352644836272,0.5119647355163728
E01020690,1267,602,665,0.47513812154696133,0.5248618784530387
E01020691,1318,610,708,0.4628224582701062,0.5371775417298937
E01020692,1449,704,745,0.4858523119392685,0.5141476880607315
E01020693,1346,682,664,0.5066864784546805,0.4933135215453195
E01020722,1964,990,974,0.5040733197556008,0.4959266802443992
E01020723,1704,832,872,0.48826291079812206,0.5117370892018779
E01020724,1732,802,930,0.4630484988452656,0.5369515011547344
E01020703,2569,1221,1348,0.4752822109770339,0.5247177890229662
E01033195,1552,708,844,0.45618556701030927,0.5438144329896907
E01033197,2085,1249,836,0.5990407673860911,0.40095923261390887
E01034493,6464,3119,3345,0.48251856435643564,0.5174814356435643
E01020702,2743,1334,1409,0.4863288370397375,0.5136711629602625
E01020704,1849,945,904,0.5110870740941049,0.4889129259058951
E01020712,1777,886,891,0.4985931344963421,0.5014068655036579
E01034496,1612,798,814,0.49503722084367247,0.5049627791563276
E01034497,1547,759,788,0.4906270200387847,0.5093729799612152
E01034498,1978,949,1029,0.47977755308392317,0.5202224469160769
E01034499,1794,926,868,0.5161649944258639,0.483835005574136
E01020705,1676,816,860,0.48687350835322196,0.513126491646778
E01020706,1812,880,932,0.4856512141280353,0.5143487858719646
E01034494,1527,779,748,0.510150622134905,0.48984937786509497
E01034495,1464,740,724,0.505464480874317,0.49453551912568305
E01020685,1610,777,833,0.4826086956521739,0.5173913043478261
E01020686,1429,709,720,0.49615115465360393,0.5038488453463961
E01020687,1281,616,665,0.4808743169398907,0.5191256830601093
E01020688,1420,681,739,0.4795774647887324,0.5204225352112676
E01020689,1577,766,811,0.48573240329740014,0.5142675967025999
E01020694,1459,712,747,0.4880054832076765,0.5119945167923236
E01020696,1224,624,600,0.5098039215686274,0.49019607843137253
E01020697,1539,718,821,0.4665367121507472,0.5334632878492528
E01020732,2363,1136,1227,0.4807448159119763,0.5192551840880237
E01020695,2116,1010,1106,0.4773156899810964,0.5226843100189036
E01020698,1552,772,780,0.49742268041237114,0.5025773195876289
E01020699,1431,686,745,0.47938504542278126,0.5206149545772187
E01020700,1534,753,781,0.4908735332464146,0.5091264667535854
E01020701,1329,658,671,0.49510910458991725,0.5048908954100828
E01020750,1080,515,565,0.47685185185185186,0.5231481481481481
E01020786,1524,780,744,0.5118110236220472,0.4881889763779528
E01020787,1800,853,947,0.4738888888888889,0.5261111111111111
E01033163,2007,989,1018,0.4927752864972596,0.5072247135027405
E01034492,2145,1039,1106,0.48438228438228437,0.5156177156177156
E01020740,1397,690,707,0.49391553328561205,0.506084466714388
E01020741,1107,566,541,0.5112917795844625,0.48870822041553746
E01020742,1706,866,840,0.5076201641266119,0.492379835873388
E01020782,1251,593,658,0.47402078337330134,0.5259792166266987
E01020783,1224,584,640,0.477124183006536,0.5228758169934641
E01020784,1487,735,752,0.49428379287155344,0.5057162071284466
E01020743,1776,866,910,0.48761261261261263,0.5123873873873874
E01020747,1236,586,650,0.4741100323624595,0.5258899676375405
E01020748,1215,582,633,0.47901234567901235,0.5209876543209877
E01020749,1320,597,723,0.45227272727272727,0.5477272727272727
E01020773,1491,737,754,0.494299128101945,0.505700871898055
E01020775,1619,761,858,0.47004323656578134,0.5299567634342186
E01020776,1734,841,893,0.48500576701268744,0.5149942329873126
E01033161,1501,772,729,0.5143237841439041,0.48567621585609594
E01033198,1271,617,654,0.4854445318646735,0.5145554681353265
E01033205,1406,728,678,0.5177809388335705,0.4822190611664296
E01033206,1470,687,783,0.4673469387755102,0.5326530612244897
E01020751,1643,833,810,0.5069993913572732,0.4930006086427267
E01020752,1124,560,564,0.498220640569395,0.501779359430605
E01020754,1360,654,706,0.4808823529411765,0.5191176470588236
E01020756,1635,811,824,0.4960244648318043,0.5039755351681957
E01020745,1279,614,665,0.4800625488663018,0.5199374511336982
E01020753,1879,872,1007,0.4640766365087813,0.5359233634912187
E01020757,1243,601,642,0.4835076427996782,0.5164923572003218
E01020758,1398,655,743,0.4685264663805436,0.5314735336194564
E01020759,1558,723,835,0.46405648267008986,0.5359435173299102
E01020765,1654,810,844,0.48972188633615477,0.5102781136638452
E01020760,1979,970,1009,0.4901465386558868,0.5098534613441131
E01020761,1579,749,830,0.4743508549715009,0.525649145028499
E01020762,1385,654,731,0.47220216606498194,0.527797833935018
E01020763,1823,909,914,0.4986286341195831,0.5013713658804169
E01020764,1110,534,576,0.4810810810810811,0.518918918918919
E01020766,1358,623,735,0.4587628865979381,0.5412371134020618
E01020767,1625,796,829,0.4898461538461538,0.5101538461538462
E01020768,1456,704,752,0.4835164835164835,0.5164835164835165
E01020733,1131,535,596,0.47303271441202477,0.5269672855879752
E01020734,1205,561,644,0.46556016597510375,0.5344398340248963
E01020735,1461,700,761,0.4791238877481177,0.5208761122518822
E01020770,1112,542,570,0.48741007194244607,0.512589928057554
E01020771,1041,504,537,0.484149855907781,0.515850144092219
E01020780,1278,599,679,0.46870109546165883,0.5312989045383412
E01020746,1072,521,551,0.48600746268656714,0.5139925373134329
E01020769,1169,561,608,0.4798973481608212,0.5201026518391788
E01020777,1494,719,775,0.48125836680053546,0.5187416331994645
E01020778,1189,594,595,0.49957947855340623,0.5004205214465938
E01020779,1532,761,771,0.49673629242819844,0.5032637075718016
E01020737,1437,674,763,0.46903270702853167,0.5309672929714684
E01020739,1150,585,565,0.508695652173913,0.49130434782608695
E01020744,1166,577,589,0.49485420240137223,0.5051457975986278
E01034500,2190,1052,1138,0.480365296803653,0.5196347031963471
E01020788,1364,697,667,0.5109970674486803,0.48900293255131966
E01020789,1699,846,853,0.49793996468510887,0.5020600353148911
E01020790,1372,672,700,0.4897959183673469,0.5102040816326531
E01020791,1256,607,649,0.48328025477707004,0.51671974522293
E01020792,1495,742,753,0.4963210702341137,0.5036789297658862
E01020772,2028,1004,1024,0.49506903353057197,0.504930966469428
E01020793,1636,785,851,0.4798288508557457,0.5201711491442543
E01020794,1922,941,981,0.48959417273673256,0.5104058272632674
E01020795,1775,890,885,0.5014084507042254,0.49859154929577465
E01020817,1201,591,610,0.492089925062448,0.507910074937552
E01020818,1407,691,716,0.49111584932480457,0.5088841506751954
E01020819,1012,485,527,0.4792490118577075,0.5207509881422925
E01020837,1538,767,771,0.4986996098829649,0.5013003901170351
E01020843,1534,752,782,0.49022164276401564,0.5097783572359843
E01020809,1388,676,712,0.48703170028818443,0.5129682997118156
E01020810,1182,548,634,0.46362098138747887,0.5363790186125211
E01020811,1205,568,637,0.4713692946058091,0.5286307053941909
E01020812,1448,729,719,0.5034530386740331,0.4965469613259669
E01020827,1776,852,924,0.4797297297297297,0.5202702702702703
E01020806,1417,702,715,0.4954128440366973,0.5045871559633027
E01020807,1225,656,569,0.5355102040816326,0.46448979591836737
E01020820,1933,920,1013,0.47594412829798244,0.5240558717020176
E01034501,1909,892,1017,0.4672603457307491,0.532739654269251
E01034502,1398,689,709,0.4928469241773963,0.5071530758226037
E01020797,2425,1240,1185,0.511340206185567,0.488659793814433
E01020798,1489,681,808,0.45735392881128273,0.5426460711887172
E01020799,1471,732,739,0.49762066621346024,0.5023793337865398
E01020808,1328,667,661,0.5022590361445783,0.4977409638554217
E01020821,2146,1074,1072,0.5004659832246039,0.4995340167753961
E01020822,2106,1044,1062,0.49572649572649574,0.5042735042735043
E01020823,1773,900,873,0.5076142131979695,0.49238578680203043
E01020835,1468,719,749,0.48978201634877383,0.5102179836512262
E01034503,1618,792,826,0.4894932014833127,0.5105067985166872
E01034504,1389,677,712,0.48740100791936647,0.5125989920806335
E01020805,1908,929,979,0.4868972746331237,0.5131027253668763
E01034505,1474,745,729,0.505427408412483,0.494572591587517
E01034506,1154,604,550,0.5233968804159446,0.47660311958405543
E01034507,1238,607,631,0.4903069466882068,0.5096930533117933
E01034508,1548,764,784,0.4935400516795866,0.5064599483204134
E01020796,1259,591,668,0.4694201747418586,0.5305798252581414
E01020828,1611,786,825,0.48789571694599626,0.5121042830540037
E01020829,2303,1165,1138,0.5058619192357794,0.49413808076422056
E01020830,1856,900,956,0.4849137931034483,0.5150862068965517
E01020801,1439,727,712,0.5052119527449618,0.4947880472550382
E01020802,1817,926,891,0.5096312603192075,0.49036873968079253
E01020838,1720,883,837,0.5133720930232558,0.4866279069767442
E01020839,1514,738,776,0.48745046235138706,0.512549537648613
E01020840,2162,1062,1100,0.49121184088806663,0.5087881591119334
E01020841,1768,856,912,0.4841628959276018,0.5158371040723982
E01020813,1196,594,602,0.49665551839464883,0.5033444816053512
E01020814,1316,648,668,0.49240121580547114,0.5075987841945289
E01020815,1269,608,661,0.4791174152876281,0.5208825847123719
E01020848,1161,574,587,0.49440137812230833,0.5055986218776917
E01020850,2432,1208,1224,0.4967105263157895,0.5032894736842105
E01020851,1342,671,671,0.5,0.5
E01020816,1321,606,715,0.4587433762301287,0.5412566237698713
E01020844,1547,743,804,0.48028442146089206,0.519715578539108
E01020847,1457,693,764,0.4756348661633493,0.5243651338366506
E01020849,1281,634,647,0.49492583918813426,0.5050741608118657
E01020825,1733,844,889,0.4870167339873053,0.5129832660126947
E01020831,1347,607,740,0.4506310319227914,0.5493689680772086
E01020833,1216,619,597,0.509046052631579,0.4909539473684211
E01020834,1244,588,656,0.47266881028938906,0.5273311897106109
E01020824,1453,680,773,0.4679972470750172,0.5320027529249828
E01020826,1500,737,763,0.49133333333333334,0.5086666666666667
E01020832,1448,684,764,0.4723756906077348,0.5276243093922652
E01020845,1354,642,712,0.4741506646971935,0.5258493353028065
E01020846,1217,604,613,0.49630238290879214,0.5036976170912079
E01020856,1507,740,767,0.49104180491041804,0.508958195089582
E01020858,1039,514,525,0.49470644850818096,0.5052935514918191
E01020859,1202,584,618,0.4858569051580699,0.5141430948419301
E01020860,1059,502,557,0.4740321057601511,0.5259678942398489
E01020861,1146,567,579,0.49476439790575916,0.5052356020942408
E01020862,2345,1146,1199,0.4886993603411514,0.5113006396588486
E01020864,2107,1054,1053,0.5002373042240151,0.4997626957759848
E01020867,2163,1019,1144,0.47110494683310217,0.5288950531668978
E01020889,1466,762,704,0.519781718963165,0.48021828103683495
E01020890,1672,811,861,0.48504784688995217,0.5149521531100478
E01020891,1584,797,787,0.5031565656565656,0.49684343434343436
E01020905,1469,700,769,0.4765146358066712,0.5234853641933288
E01020906,1637,799,838,0.48808796579108127,0.5119120342089187
E01020876,1731,835,896,0.4823801270941652,0.5176198729058348
E01020878,1787,893,894,0.49972020145495244,0.5002797985450476
E01020887,2006,1004,1002,0.5004985044865404,0.4995014955134596
E01020892,1062,513,549,0.4830508474576271,0.5169491525423728
E01020894,1201,577,624,0.4804329725228976,0.5195670274771024
E01020898,1575,711,864,0.4514285714285714,0.5485714285714286
E01020877,1515,716,799,0.4726072607260726,0.5273927392739274
E01020879,2178,1060,1118,0.4866850321395776,0.5133149678604224
E01020893,1914,946,968,0.4942528735632184,0.5057471264367817
E01020899,1334,643,691,0.48200899550224885,0.5179910044977512
E01020903,1090,512,578,0.46972477064220186,0.5302752293577981
E01020904,1750,884,866,0.5051428571428571,0.4948571428571429
E01020873,1364,672,692,0.49266862170087977,0.5073313782991202
E01020875,1364,700,664,0.5131964809384164,0.4868035190615836
E01020900,1682,831,851,0.4940546967895363,0.5059453032104637
E01020901,1396,702,694,0.502865329512894,0.497134670487106
E01020902,1427,733,694,0.5136650315346881,0.4863349684653118
E01020868,2118,1036,1082,0.48914069877242683,0.5108593012275732
E01020869,1359,646,713,0.4753495217071376,0.5246504782928624
E01020874,1625,806,819,0.496,0.504
E01020880,1582,838,744,0.5297092288242731,0.47029077117572693
E01020881,1497,714,783,0.47695390781563124,0.5230460921843687
E01020870,1302,634,668,0.4869431643625192,0.5130568356374808
E01020871,1379,650,729,0.4713560551124003,0.5286439448875997
E01020872,1734,837,897,0.4826989619377163,0.5173010380622838
E01020883,1591,781,810,0.4908862350722816,0.5091137649277184
E01020886,1199,593,606,0.4945788156797331,0.5054211843202668
E01020882,1448,700,748,0.48342541436464087,0.5165745856353591
E01020888,1890,941,949,0.4978835978835979,0.5021164021164021
E01020895,1500,692,808,0.4613333333333333,0.5386666666666666
E01020896,1348,650,698,0.4821958456973294,0.5178041543026706
E01034509,1710,863,847,0.5046783625730994,0.4953216374269006
E01034510,1189,586,603,0.4928511354079058,0.5071488645920942
E01020884,1298,604,694,0.46533127889060094,0.5346687211093991
E01020885,1174,549,625,0.4676320272572402,0.5323679727427598
E01020907,1546,738,808,0.47736093143596375,0.5226390685640362
E01020908,1357,628,729,0.4627855563743552,0.5372144436256449
E01020909,1666,809,857,0.48559423769507803,0.514405762304922
E01020852,1657,758,899,0.45745322872661437,0.5425467712733857
E01020853,1785,830,955,0.4649859943977591,0.5350140056022409
E01020854,2583,1422,1161,0.5505226480836237,0.44947735191637633
E01020855,1146,521,625,0.45462478184991273,0.5453752181500873
E01020857,1460,729,731,0.49931506849315066,0.5006849315068493
E01020863,1320,660,660,0.5,0.5
E01034511,2191,1059,1132,0.4833409402099498,0.5166590597900502
E01027356,2229,1067,1162,0.47868999551368324,0.5213100044863167
E01027357,1289,616,673,0.4778898370830101,0.5221101629169899
E01027366,1512,746,766,0.4933862433862434,0.5066137566137566
E01027367,1664,878,786,0.5276442307692307,0.4723557692307692
E01027358,1948,932,1016,0.4784394250513347,0.5215605749486653
E01027359,2262,1101,1161,0.48673740053050396,0.513262599469496
E01033715,1056,499,557,0.4725378787878788,0.5274621212121212
E01033717,1538,765,773,0.49739921976592977,0.5026007802340702
E01027361,1638,776,862,0.47374847374847373,0.5262515262515263
E01027362,1806,864,942,0.47840531561461797,0.521594684385382
E01027363,1268,607,661,0.47870662460567825,0.5212933753943217
E01027364,1758,848,910,0.48236632536973834,0.5176336746302617
E01027370,2046,980,1066,0.4789833822091887,0.5210166177908113
E01027371,1787,883,904,0.4941242305540011,0.5058757694459989
E01027372,2335,1126,1209,0.48222698072805137,0.5177730192719486
E01027365,2434,1176,1258,0.48315529991783074,0.5168447000821693
E01027368,1672,830,842,0.4964114832535885,0.5035885167464115
E01027369,1483,732,751,0.4935940660822657,0.5064059339177344
E01027373,2012,1003,1009,0.4985089463220676,0.5014910536779325
E01027376,1665,771,894,0.46306306306306305,0.5369369369369369
E01027377,1550,715,835,0.4612903225806452,0.5387096774193548
E01027385,1267,577,690,0.4554064719810576,0.5445935280189423
E01027387,1714,810,904,0.4725787631271879,0.5274212368728122
E01027388,1445,716,729,0.4955017301038062,0.5044982698961937
E01027389,1557,748,809,0.48041104688503533,0.5195889531149647
E01027378,1116,558,558,0.5,0.5
E01027379,1612,787,825,0.4882133995037221,0.5117866004962779
E01027380,1297,630,667,0.48573631457208943,0.5142636854279106
E01027382,1641,797,844,0.48567946374162096,0.514320536258379
E01027386,1366,669,697,0.48975109809663253,0.5102489019033675
E01027374,1962,940,1022,0.47910295616717635,0.5208970438328236
E01027375,1824,928,896,0.5087719298245614,0.49122807017543857
E01027381,1888,941,947,0.4984110169491525,0.5015889830508474
E01027383,1106,541,565,0.4891500904159132,0.5108499095840868
E01027384,1313,621,692,0.472962680883473,0.5270373191165271
E01027390,1929,899,1030,0.46604458268532917,0.5339554173146708
E01027392,1854,913,941,0.4924487594390507,0.5075512405609492
E01027393,1494,722,772,0.48326639892904955,0.5167336010709505
E01027416,1595,755,840,0.47335423197492166,0.5266457680250783
E01027424,1907,940,967,0.4929208180388044,0.5070791819611956
E01027414,1382,692,690,0.5007235890014472,0.4992764109985528
E01027415,1557,800,757,0.5138086062941555,0.4861913937058446
E01027431,1573,767,806,0.48760330578512395,0.512396694214876
E01027442,1536,766,770,0.4986979166666667,0.5013020833333334
E01035631,1567,767,800,0.4894703254626675,0.5105296745373324
E01035632,1762,872,890,0.4948921679909194,0.5051078320090806
E01027391,1476,741,735,0.5020325203252033,0.49796747967479676
E01027422,1664,829,835,0.49819711538461536,0.5018028846153846
E01027423,1400,674,726,0.48142857142857143,0.5185714285714286
E01027429,1761,837,924,0.4752981260647359,0.524701873935264
E01027430,1521,713,808,0.46877054569362264,0.5312294543063774
E01027426,2127,1021,1106,0.4800188058298072,0.5199811941701927
E01027427,1840,935,905,0.5081521739130435,0.49184782608695654
E01027428,1417,701,716,0.4947071277346507,0.5052928722653494
E01035633,1375,669,706,0.48654545454545456,0.5134545454545455
E01035634,1042,540,502,0.5182341650671785,0.4817658349328215
E01035635,1607,791,816,0.492221530802738,0.507778469197262
E01027437,1611,774,837,0.48044692737430167,0.5195530726256983
E01027438,1362,657,705,0.48237885462555063,0.5176211453744494
E01027439,1844,889,955,0.4821041214750542,0.5178958785249458
E01027440,1452,710,742,0.4889807162534435,0.5110192837465565
E01027398,2180,1048,1132,0.48073394495412847,0.5192660550458715
E01027409,1496,711,785,0.4752673796791444,0.5247326203208557
E01027411,1346,595,751,0.44205052005943535,0.5579494799405647
E01027412,2048,1025,1023,0.50048828125,0.49951171875
E01027413,2190,1070,1120,0.4885844748858447,0.5114155251141552
E01027417,1467,701,766,0.4778459441036128,0.5221540558963872
E01027418,1768,867,901,0.49038461538461536,0.5096153846153846
E01027419,1490,710,780,0.47651006711409394,0.5234899328859061
E01027420,1302,629,673,0.48310291858678955,0.5168970814132104
E01027421,1352,644,708,0.47633136094674555,0.5236686390532544
E01027394,1025,514,511,0.5014634146341463,0.49853658536585366
E01027406,1187,583,604,0.4911541701769166,0.5088458298230834
E01027407,1194,591,603,0.4949748743718593,0.5050251256281407
E01027408,1358,653,705,0.4808541973490427,0.5191458026509573
E01027410,1504,743,761,0.4940159574468085,0.5059840425531915
E01027432,1491,769,722,0.5157612340710932,0.4842387659289068
E01027433,2578,1255,1323,0.48681148176881306,0.5131885182311869
E01027434,1290,629,661,0.4875968992248062,0.5124031007751938
E01027435,1338,689,649,0.5149476831091181,0.4850523168908819
E01027436,1458,724,734,0.49657064471879286,0.5034293552812071
E01027443,1613,776,837,0.4810911345319281,0.5189088654680719
E01027444,2617,1915,702,0.7317539166985098,0.26824608330149025
E01027445,1655,801,854,0.48398791540785496,0.516012084592145
E01027446,1312,642,670,0.4893292682926829,0.510670731707317
E01027451,1686,835,851,0.49525504151838673,0.5047449584816133
E01027474,1866,917,949,0.49142550911039656,0.5085744908896034
E01027475,1390,696,694,0.5007194244604316,0.49928057553956834
E01027457,1713,819,894,0.47810858143607704,0.521891418563923
E01027462,1963,924,1039,0.4707080998471727,0.5292919001528273
E01027463,1772,874,898,0.4932279909706546,0.5067720090293454
E01027447,1738,869,869,0.5,0.5
E01027450,1680,818,862,0.4869047619047619,0.513095238095238
E01027473,2680,1331,1349,0.4966417910447761,0.5033582089552239
E01035629,1747,893,854,0.5111619919862621,0.48883800801373783
E01035630,1631,770,861,0.4721030042918455,0.5278969957081545
E01027452,1311,627,684,0.4782608695652174,0.5217391304347826
E01027453,1454,631,823,0.4339752407152682,0.5660247592847317
E01027461,1295,604,691,0.4664092664092664,0.5335907335907336
E01033718,1970,927,1043,0.47055837563451774,0.5294416243654823
E01027455,1428,706,722,0.4943977591036415,0.5056022408963585
E01027456,1223,591,632,0.4832379394930499,0.5167620605069502
E01027458,2381,1144,1237,0.48047039059218816,0.5195296094078119
E01027460,1603,752,851,0.46912039925140364,0.5308796007485964
E01027464,1302,621,681,0.4769585253456221,0.5230414746543779
E01027465,1446,689,757,0.47648686030428766,0.5235131396957123
E01027466,1317,588,729,0.44646924829157175,0.5535307517084282
E01033714,2956,1419,1537,0.4800405953991881,0.5199594046008119
E01027449,1532,747,785,0.48759791122715407,0.512402088772846
E01027468,1302,641,661,0.4923195084485407,0.5076804915514593
E01027469,1339,655,684,0.48917102315160566,0.5108289768483943
E01027471,2008,996,1012,0.4960159362549801,0.5039840637450199
E01027472,1744,971,773,0.5567660550458715,0.44323394495412843
E01027479,2183,1079,1104,0.49427393495190103,0.5057260650480989
E01027480,1224,621,603,0.5073529411764706,0.49264705882352944
E01027503,1578,783,795,0.49619771863117873,0.5038022813688213
E01027511,1080,544,536,0.5037037037037037,0.4962962962962963
E01027484,2068,1000,1068,0.4835589941972921,0.5164410058027079
E01027485,1456,705,751,0.4842032967032967,0.5157967032967034
E01027486,1085,554,531,0.5105990783410138,0.4894009216589862
E01027487,1108,554,554,0.5,0.5
E01027512,1002,519,483,0.5179640718562875,0.4820359281437126
E01027483,1317,630,687,0.4783599088838269,0.5216400911161732
E01027496,1155,540,615,0.4675324675324675,0.5324675324675324
E01027508,1128,530,598,0.4698581560283688,0.5301418439716312
E01027513,1978,991,987,0.5010111223458038,0.49898887765419614
E01027476,2266,1109,1157,0.4894086496028244,0.5105913503971756
E01027489,1477,737,740,0.4989844278943805,0.5010155721056195
E01027490,1721,787,934,0.45729227193492156,0.5427077280650784
E01027491,1490,731,759,0.4906040268456376,0.5093959731543625
E01027492,1678,816,862,0.4862932061978546,0.5137067938021455
E01027493,1566,751,815,0.47956577266922096,0.520434227330779
E01027494,2445,1182,1263,0.4834355828220859,0.5165644171779141
E01027497,2469,1194,1275,0.4835965978128797,0.5164034021871203
E01027498,2667,1277,1390,0.4788151481064867,0.5211848518935133
E01027499,1889,917,972,0.48544203282159876,0.5145579671784013
E01027500,1631,784,847,0.48068669527896996,0.51931330472103
E01035636,2081,1019,1062,0.48966842864007687,0.5103315713599231
E01027477,1193,608,585,0.509639564124057,0.490360435875943
E01027478,1070,511,559,0.47757009345794393,0.5224299065420561
E01027488,2375,1176,1199,0.49515789473684213,0.5048421052631579
E01027495,1123,547,576,0.4870881567230632,0.5129118432769367
E01027505,1365,674,691,0.4937728937728938,0.5062271062271062
E01027510,1149,562,587,0.48912097476066146,0.5108790252393386
E01027541,1711,826,885,0.4827586206896552,0.5172413793103449
E01027542,1715,801,914,0.46705539358600584,0.5329446064139942
E01027543,1298,621,677,0.47842835130970723,0.5215716486902927
E01027544,1226,598,628,0.48776508972267535,0.5122349102773246
E01027528,1342,674,668,0.5022354694485842,0.4977645305514158
E01027529,1068,531,537,0.49719101123595505,0.5028089887640449
E01027539,1487,710,777,0.47747141896435774,0.5225285810356423
E01027545,1738,829,909,0.4769850402761795,0.5230149597238205
E01027546,1506,756,750,0.50199203187251,0.49800796812749004
E01027533,1688,868,820,0.514218009478673,0.48578199052132703
E01027540,1879,936,943,0.4981373070782331,0.5018626929217669
E01027549,2861,1424,1437,0.4977280671094023,0.5022719328905977
E01033716,2283,1118,1165,0.489706526500219,0.5102934734997809
E01027530,1362,639,723,0.46916299559471364,0.5308370044052864
E01027531,1648,803,845,0.48725728155339804,0.5127427184466019
E01027534,1769,877,892,0.49576031656302993,0.50423968343697
E01027535,1324,647,677,0.48867069486404835,0.5113293051359517
E01027553,1594,768,826,0.48180677540777916,0.5181932245922208
E01027554,1308,619,689,0.47324159021406725,0.5267584097859327
E01027515,1482,713,769,0.48110661268556004,0.5188933873144399
E01027517,1828,872,956,0.47702407002188185,0.5229759299781181
E01027518,1417,673,744,0.47494707127734653,0.5250529287226535
E01027519,1341,639,702,0.47651006711409394,0.5234899328859061
E01027550,1242,611,631,0.4919484702093398,0.5080515297906603
E01027551,1535,727,808,0.4736156351791531,0.5263843648208469
E01027552,1252,634,618,0.5063897763578274,0.4936102236421725
E01027514,1664,793,871,0.4765625,0.5234375
E01027516,1083,496,587,0.4579870729455217,0.5420129270544783
E01027520,1455,702,753,0.4824742268041237,0.5175257731958763
E01027521,1832,882,950,0.4814410480349345,0.5185589519650655
E01027522,1326,617,709,0.46530920060331826,0.5346907993966817
E01027523,1119,549,570,0.4906166219839142,0.5093833780160858
E01027524,2031,951,1080,0.46824224519940916,0.5317577548005908
E01027525,1745,864,881,0.4951289398280802,0.5048710601719197
E01027526,1128,541,587,0.4796099290780142,0.5203900709219859
E01027527,1278,604,674,0.4726134585289515,0.5273865414710485
E01027532,2033,975,1058,0.4795868175110674,0.5204131824889326
E01027536,1287,605,682,0.4700854700854701,0.5299145299145299
E01027537,1320,620,700,0.4696969696969697,0.5303030303030303
E01027538,1607,796,811,0.4953329184816428,0.5046670815183572
E01027395,1885,939,946,0.4981432360742706,0.5018567639257294
E01027396,1240,589,651,0.475,0.525
E01027397,1373,677,696,0.49308084486525855,0.5069191551347414
E01027399,1394,672,722,0.48206599713055953,0.5179340028694405
E01027400,1294,646,648,0.4992272024729521,0.500772797527048
E01027401,1398,693,705,0.4957081545064378,0.5042918454935622
E01027402,1249,634,615,0.5076060848678943,0.4923939151321057
E01027403,1108,543,565,0.490072202166065,0.509927797833935
E01027404,2252,1119,1133,0.4968916518650089,0.5031083481349912
E01027405,1357,657,700,0.48415622697126015,0.5158437730287398
E01027481,1548,712,836,0.4599483204134367,0.5400516795865633
E01027482,1547,733,814,0.4738202973497091,0.5261797026502909
E01027504,1882,926,956,0.4920297555791711,0.5079702444208289
E01027507,1389,681,708,0.490280777537797,0.509719222462203
E01027509,1305,632,673,0.4842911877394636,0.5157088122605364
E01035637,1089,514,575,0.4719926538108356,0.5280073461891643
E01008309,1785,849,936,0.4756302521008403,0.5243697478991597
E01008352,1441,722,719,0.5010409437890354,0.4989590562109646
E01008357,1526,737,789,0.4829619921363041,0.5170380078636959
E01008358,1707,801,906,0.46924428822495606,0.5307557117750439
E01033550,2055,1007,1048,0.49002433090024333,0.5099756690997567
E01033551,1828,896,932,0.49015317286652077,0.5098468271334792
E01008336,1330,635,695,0.4774436090225564,0.5225563909774437
E01008337,1305,626,679,0.4796934865900383,0.5203065134099617
E01008338,1130,555,575,0.4911504424778761,0.5088495575221239
E01008339,1842,930,912,0.504885993485342,0.495114006514658
E01008340,1751,845,906,0.48258138206739004,0.5174186179326099
E01008341,1413,698,715,0.49398443029016276,0.5060155697098372
E01008342,1332,638,694,0.47897897897897895,0.521021021021021
E01008293,1376,729,647,0.529796511627907,0.470203488372093
E01008456,1521,708,813,0.46548323471400394,0.534516765285996
E01008457,1590,764,826,0.48050314465408805,0.519496855345912
E01008458,2133,1057,1076,0.4955461790904829,0.5044538209095171
E01008459,1871,842,1029,0.450026723677178,0.549973276322822
E01008460,1401,647,754,0.46181299072091364,0.5381870092790864
E01008351,1393,667,726,0.47882268485283563,0.5211773151471644
E01008354,1619,808,811,0.4990735021618283,0.5009264978381717
E01008418,1959,948,1011,0.48392036753445633,0.5160796324655437
E01008420,1305,649,656,0.49731800766283524,0.5026819923371647
E01008422,1559,776,783,0.49775497113534317,0.5022450288646568
E01008424,1501,738,763,0.491672218520986,0.508327781479014
E01008353,1526,727,799,0.4764089121887287,0.5235910878112713
E01008355,1533,739,794,0.482061317677756,0.5179386823222439
E01008356,1327,690,637,0.5199698568198945,0.4800301431801055
E01008378,1415,669,746,0.472791519434629,0.5272084805653711
E01008419,1427,716,711,0.5017519271198319,0.4982480728801682
E01008421,1515,749,766,0.49438943894389437,0.5056105610561056
E01008423,1304,644,660,0.4938650306748466,0.5061349693251533
E01008317,1408,677,731,0.48082386363636365,0.5191761363636364
E01008319,1789,893,896,0.4991615427613192,0.5008384572386808
E01008320,1586,786,800,0.49558638083228246,0.5044136191677175
E01008321,1708,842,866,0.4929742388758782,0.5070257611241218
E01008322,1542,808,734,0.5239948119325551,0.47600518806744485
E01008323,1661,839,822,0.5051173991571343,0.4948826008428657
E01008295,1796,841,955,0.4682628062360802,0.5317371937639198
E01008374,1500,737,763,0.49133333333333334,0.5086666666666667
E01008375,1455,688,767,0.47285223367697593,0.5271477663230241
E01008376,1159,586,573,0.5056082830025884,0.4943917169974116
E01008377,2301,1095,1206,0.4758800521512386,0.5241199478487614
E01008379,1689,817,872,0.4837181764357608,0.5162818235642392
E01008380,1901,894,1007,0.4702788006312467,0.5297211993687533
E01008296,1337,635,702,0.474943904263276,0.525056095736724
E01008297,1958,973,985,0.4969356486210419,0.5030643513789581
E01008298,1937,907,1030,0.4682498709344347,0.5317501290655653
E01008299,1391,678,713,0.4874191229331416,0.5125808770668584
E01008314,1079,514,565,0.4763670064874884,0.5236329935125116
E01008315,1505,724,781,0.48106312292358805,0.518936877076412
E01008316,1506,748,758,0.49667994687915007,0.5033200531208499
E01008318,1318,644,674,0.48861911987860396,0.511380880121396
E01008363,1585,760,825,0.4794952681388013,0.5205047318611987
E01008365,1584,768,816,0.48484848484848486,0.5151515151515151
E01008366,2124,1115,1009,0.5249529190207156,0.4750470809792844
E01008369,2000,1046,954,0.523,0.477
E01008371,1413,669,744,0.4734607218683652,0.5265392781316348
E01008372,1804,843,961,0.4672949002217295,0.5327050997782705
E01008373,2164,994,1170,0.45933456561922364,0.5406654343807763
E01008400,1733,805,928,0.4645124062319677,0.5354875937680323
E01008401,1506,706,800,0.46879150066401065,0.5312084993359893
E01008402,1429,703,726,0.4919524142757173,0.5080475857242828
E01008403,1583,780,803,0.49273531269741,0.50726468730259
E01008404,1552,777,775,0.5006443298969072,0.4993556701030928
E01008405,1558,762,796,0.4890885750962773,0.5109114249037228
E01008443,1385,671,714,0.4844765342960289,0.5155234657039711
E01008324,1257,587,670,0.4669848846459825,0.5330151153540175
E01008325,1488,695,793,0.46706989247311825,0.5329301075268817
E01008326,1394,647,747,0.46413199426111906,0.5358680057388809
E01008327,1236,583,653,0.4716828478964401,0.5283171521035599
E01008328,1209,586,623,0.48469809760132343,0.5153019023986766
E01008329,1462,711,751,0.48632010943912446,0.5136798905608755
E01008330,1431,672,759,0.469601677148847,0.5303983228511531
E01008300,2050,1006,1044,0.49073170731707316,0.5092682926829268
E01008450,1768,826,942,0.4671945701357466,0.5328054298642534
E01008451,1895,862,1033,0.45488126649076516,0.5451187335092348
E01008452,1460,723,737,0.4952054794520548,0.5047945205479452
E01008367,2144,1100,1044,0.5130597014925373,0.4869402985074627
E01008368,1737,850,887,0.48934945308002303,0.510650546919977
E01008370,1860,869,991,0.46720430107526884,0.5327956989247312
E01008409,1531,790,741,0.5160026126714565,0.4839973873285434
E01008411,1701,819,882,0.48148148148148145,0.5185185185185185
E01008303,1750,934,816,0.5337142857142857,0.4662857142857143
E01008359,1410,746,664,0.5290780141843971,0.47092198581560285
E01008360,1523,786,737,0.5160866710439921,0.48391332895600786
E01008361,1502,778,724,0.5179760319573902,0.48202396804260983
E01008362,1533,780,753,0.5088062622309197,0.4911937377690802
E01008364,1457,783,674,0.5374056280027454,0.4625943719972546
E01008343,1643,779,864,0.47413268411442483,0.5258673158855751
E01008344,1498,735,763,0.49065420560747663,0.5093457943925234
E01008345,1563,744,819,0.4760076775431862,0.5239923224568138
E01008346,1044,509,535,0.4875478927203065,0.5124521072796935
E01008347,1486,725,761,0.4878869448183042,0.5121130551816958
E01008348,1197,581,616,0.4853801169590643,0.5146198830409356
E01008349,1742,877,865,0.5034443168771527,0.4965556831228473
E01008350,1631,784,847,0.48068669527896996,0.51931330472103
E01008430,1265,618,647,0.48853754940711464,0.5114624505928854
E01008431,1534,779,755,0.5078226857887875,0.4921773142112125
E01008433,1372,692,680,0.5043731778425656,0.4956268221574344
E01008434,1417,726,691,0.5123500352858151,0.4876499647141849
E01008435,1587,739,848,0.465658475110271,0.5343415248897291
E01008436,1572,830,742,0.5279898218829516,0.4720101781170484
E01008381,1439,717,722,0.4982626824183461,0.501737317581654
E01008382,1260,605,655,0.4801587301587302,0.5198412698412699
E01008383,1462,675,787,0.46169630642954856,0.5383036935704515
E01008384,1357,664,693,0.48931466470154755,0.5106853352984525
E01008385,1378,698,680,0.5065312046444121,0.4934687953555878
E01008386,1286,611,675,0.4751166407465008,0.5248833592534993
E01008387,1269,613,656,0.4830575256107171,0.5169424743892829
E01008396,2330,1287,1043,0.5523605150214592,0.4476394849785408
E01008398,1836,987,849,0.5375816993464052,0.4624183006535948
E01008449,1872,1074,798,0.5737179487179487,0.42628205128205127
E01008453,1892,949,943,0.5015856236786469,0.49841437632135305
E01008455,1736,883,853,0.5086405529953917,0.4913594470046083
E01033556,2631,1445,1186,0.5492208285822882,0.4507791714177119
E01008415,1280,593,687,0.46328125,0.53671875
E01008416,1722,855,867,0.4965156794425087,0.5034843205574913
E01033547,2685,1266,1419,0.47150837988826816,0.5284916201117319
E01008288,1350,671,679,0.49703703703703705,0.502962962962963
E01008289,1741,811,930,0.4658242389431361,0.5341757610568638
E01008290,1694,858,836,0.5064935064935064,0.4935064935064935
E01008291,2099,994,1105,0.47355883754168654,0.5264411624583135
E01008292,1287,620,667,0.48174048174048173,0.5182595182595182
E01008388,1817,870,947,0.47881122729774356,0.5211887727022565
E01008389,1673,751,922,0.44889420203227737,0.5511057979677226
E01008426,1583,734,849,0.4636765634870499,0.5363234365129501
E01008429,1546,711,835,0.45989650711513586,0.5401034928848641
E01008390,1968,972,996,0.49390243902439024,0.5060975609756098
E01008425,1401,750,651,0.5353319057815846,0.46466809421841543
E01008427,1336,637,699,0.47679640718562877,0.5232035928143712
E01008428,1482,689,793,0.4649122807017544,0.5350877192982456
E01008441,1815,821,994,0.45234159779614325,0.5476584022038568
E01008442,1312,624,688,0.47560975609756095,0.524390243902439
E01008444,1599,784,815,0.4903064415259537,0.5096935584740463
E01008445,2103,988,1115,0.46980504041844984,0.5301949595815502
E01008446,1350,640,710,0.4740740740740741,0.5259259259259259
E01008447,1300,593,707,0.45615384615384613,0.5438461538461539
E01008448,1374,668,706,0.4861717612809316,0.5138282387190685
E01008306,2362,1109,1253,0.4695173581710415,0.5304826418289585
E01008307,1354,640,714,0.4726735598227474,0.5273264401772526
E01035613,1422,718,704,0.5049226441631505,0.49507735583684953
E01035614,1763,878,885,0.49801474758933634,0.5019852524106636
E01035615,1542,750,792,0.48638132295719844,0.5136186770428015
E01035616,1493,756,737,0.506363027461487,0.4936369725385131
E01008294,1357,644,713,0.4745762711864407,0.5254237288135594
E01008311,2220,1116,1104,0.5027027027027027,0.4972972972972973
E01008312,1164,583,581,0.5008591065292096,0.4991408934707904
E01008313,1188,575,613,0.484006734006734,0.515993265993266
E01008407,3263,1602,1661,0.49095923996322405,0.509040760036776
E01008410,2517,1217,1300,0.4835121176003178,0.5164878823996821
E01008412,1520,738,782,0.4855263157894737,0.5144736842105263
E01008413,1364,720,644,0.5278592375366569,0.47214076246334313
E01008302,1629,852,777,0.5230202578268877,0.47697974217311234
E01008391,1623,768,855,0.4731977818853974,0.5268022181146026
E01008392,1823,892,931,0.48930334613274823,0.5106966538672518
E01008432,1432,700,732,0.4888268156424581,0.5111731843575419
E01008397,2794,1503,1291,0.5379384395132427,0.46206156048675734
E01033543,1821,975,846,0.5354200988467874,0.4645799011532125
E01033545,2061,1168,893,0.5667151868025231,0.43328481319747697
E01035617,3573,1722,1851,0.4819479429051218,0.5180520570948782
E01008406,3961,1905,2056,0.4809391567785913,0.5190608432214088
E01033548,1471,769,702,0.5227736233854521,0.4772263766145479
E01033553,2986,1535,1451,0.5140656396517079,0.485934360348292
E01008333,1953,1053,900,0.5391705069124424,0.4608294930875576
E01008334,2301,1217,1084,0.5289004780530204,0.47109952194697957
E01008335,2132,1109,1023,0.5201688555347092,0.4798311444652908
E01035618,1589,799,790,0.5028319697923223,0.4971680302076778
E01035619,1632,802,830,0.49142156862745096,0.508578431372549
E01008399,2042,1058,984,0.5181194906953966,0.48188050930460335
E01008439,1746,990,756,0.5670103092783505,0.4329896907216495
E01035620,1740,915,825,0.5258620689655172,0.47413793103448276
E01035621,2000,982,1018,0.491,0.509
E01008301,1624,875,749,0.5387931034482759,0.46120689655172414
E01008305,2437,1211,1226,0.4969224456298728,0.5030775543701272
E01035622,1211,646,565,0.5334434351775392,0.4665565648224608
E01035623,1186,643,543,0.5421585160202361,0.45784148397976393
E01008331,1893,963,930,0.508716323296355,0.49128367670364503
E01008437,1715,897,818,0.5230320699708455,0.4769679300291545
E01008438,1928,1036,892,0.5373443983402489,0.46265560165975106
E01008547,1401,693,708,0.49464668094218417,0.5053533190578159
E01008548,1798,882,916,0.4905450500556173,0.5094549499443827
E01008549,1537,758,779,0.49316851008458035,0.5068314899154196
E01008551,1428,715,713,0.5007002801120448,0.4992997198879552
E01008478,1463,702,761,0.47983595352016406,0.5201640464798359
E01008480,1504,712,792,0.4734042553191489,0.526595744680851
E01008504,1505,718,787,0.4770764119601329,0.5229235880398672
E01008578,1322,641,681,0.4848714069591528,0.5151285930408472
E01008583,1472,723,749,0.49116847826086957,0.5088315217391305
E01008520,1399,687,712,0.4910650464617584,0.5089349535382416
E01008523,1301,631,670,0.48501152959262106,0.5149884704073789
E01008546,1597,774,823,0.48465873512836566,0.5153412648716343
E01008550,1616,771,845,0.4771039603960396,0.5228960396039604
E01008577,1909,905,1004,0.47407019381875326,0.5259298061812467
E01008579,1368,626,742,0.45760233918128657,0.5423976608187134
E01008580,1277,595,682,0.4659357870007831,0.5340642129992169
E01008581,1816,860,956,0.473568281938326,0.526431718061674
E01008582,1353,647,706,0.4781966001478197,0.5218033998521804
E01008517,1581,771,810,0.4876660341555977,0.5123339658444023
E01008519,1221,560,661,0.45864045864045866,0.5413595413595413
E01008521,1430,656,774,0.45874125874125876,0.5412587412587413
E01008522,1541,750,791,0.48669695003244645,0.5133030499675535
E01008584,1623,844,779,0.5200246457178065,0.47997535428219346
E01008585,1529,743,786,0.48593852190974496,0.514061478090255
E01008587,1374,664,710,0.48326055312954874,0.5167394468704513
E01008588,1589,777,812,0.4889867841409692,0.5110132158590308
E01008589,1458,696,762,0.4773662551440329,0.522633744855967
E01008518,1568,792,776,0.5051020408163265,0.49489795918367346
E01008564,1426,706,720,0.4950911640953717,0.5049088359046283
E01008567,1486,688,798,0.4629878869448183,0.5370121130551817
E01035625,1820,887,933,0.48736263736263735,0.5126373626373626
E01035626,1871,915,956,0.4890432923570283,0.5109567076429716
E01008475,1593,781,812,0.49026993094789706,0.5097300690521029
E01008476,1778,850,928,0.4780652418447694,0.5219347581552306
E01008477,1810,840,970,0.46408839779005523,0.5359116022099447
E01008479,1516,736,780,0.48548812664907653,0.5145118733509235
E01008552,1596,788,808,0.49373433583959897,0.506265664160401
E01008553,1732,828,904,0.4780600461893764,0.5219399538106235
E01008554,1646,793,853,0.48177399756986633,0.5182260024301336
E01008555,1703,796,907,0.4674104521432766,0.5325895478567234
E01008586,1510,725,785,0.48013245033112584,0.5198675496688742
E01008495,1752,836,916,0.4771689497716895,0.5228310502283106
E01008496,1490,702,788,0.47114093959731546,0.5288590604026846
E01008497,1471,737,734,0.5010197144799456,0.4989802855200544
E01008498,1519,718,801,0.4726793943383805,0.5273206056616195
E01008568,1499,710,789,0.47364909939959976,0.5263509006004002
E01008569,1454,691,763,0.4752407152682256,0.5247592847317745
E01008570,1290,634,656,0.49147286821705427,0.5085271317829457
E01032647,2884,1436,1448,0.49791955617198336,0.5020804438280166
E01032648,1534,752,782,0.49022164276401564,0.5097783572359843
E01008500,1519,759,760,0.49967083607636603,0.500329163923634
E01008505,1778,904,874,0.5084364454443194,0.4915635545556805
E01008506,1375,614,761,0.4465454545454545,0.5534545454545454
E01008507,1695,818,877,0.4825958702064897,0.5174041297935104
E01008493,1518,750,768,0.49407114624505927,0.5059288537549407
E01008494,1605,766,839,0.47725856697819313,0.5227414330218069
E01008556,2041,954,1087,0.46741793238608526,0.5325820676139148
E01008557,1627,804,823,0.4941610325752919,0.505838967424708
E01008470,1438,690,748,0.47983310152990266,0.5201668984700973
E01008499,1653,789,864,0.47731397459165154,0.5226860254083484
E01008502,1559,741,818,0.47530468248877483,0.5246953175112251
E01008516,2014,970,1044,0.4816285998013903,0.5183714001986097
E01008488,1445,678,767,0.4692041522491349,0.5307958477508651
E01008489,1874,863,1011,0.4605122732123799,0.53948772678762
E01008490,1542,763,779,0.49481193255512324,0.5051880674448768
E01008491,1543,725,818,0.4698639014906027,0.5301360985093972
E01008558,1453,690,763,0.4748795595320027,0.5251204404679972
E01008560,1591,757,834,0.47580138277812695,0.524198617221873
E01008561,1643,807,836,0.49117468046256846,0.5088253195374315
E01008562,1468,700,768,0.4768392370572207,0.5231607629427792
E01008525,1500,724,776,0.4826666666666667,0.5173333333333333
E01008527,1389,687,702,0.4946004319654428,0.5053995680345572
E01008559,1496,724,772,0.4839572192513369,0.516042780748663
E01008563,1396,672,724,0.4813753581661891,0.5186246418338109
E01008469,1858,921,937,0.49569429494079653,0.5043057050592035
E01008472,1437,686,751,0.47738343771746694,0.5226165622825331
E01008473,1258,629,629,0.5,0.5
E01008503,1988,957,1031,0.4813883299798793,0.5186116700201208
E01035627,1660,821,839,0.49457831325301205,0.505421686746988
E01035628,1694,843,851,0.49763872491145217,0.5023612750885478
E01008471,1545,750,795,0.4854368932038835,0.5145631067961165
E01008474,1553,736,817,0.4739214423696072,0.5260785576303928
E01008513,2237,1073,1164,0.47966025927581585,0.5203397407241842
E01008514,1823,854,969,0.4684585847504114,0.5315414152495886
E01032649,1099,547,552,0.49772520473157417,0.5022747952684259
E01032650,1048,517,531,0.4933206106870229,0.5066793893129771
E01008486,1375,666,709,0.4843636363636364,0.5156363636363637
E01008487,1488,726,762,0.4879032258064516,0.5120967741935484
E01008526,1440,681,759,0.47291666666666665,0.5270833333333333
E01008530,1534,722,812,0.4706649282920469,0.529335071707953
E01008461,1393,652,741,0.4680545585068198,0.5319454414931802
E01008466,1376,671,705,0.4876453488372093,0.5123546511627907
E01008467,1359,654,705,0.48123620309050774,0.5187637969094923
E01008468,1475,714,761,0.48406779661016947,0.5159322033898305
E01008483,1453,709,744,0.4879559532002753,0.5120440467997247
E01008524,1842,968,874,0.5255157437567861,0.4744842562432139
E01008528,1344,671,673,0.4992559523809524,0.5007440476190477
E01008529,1500,713,787,0.47533333333333333,0.5246666666666666
E01008481,1431,631,800,0.44095038434661077,0.5590496156533893
E01008482,1669,797,872,0.4775314559616537,0.5224685440383463
E01008484,1456,696,760,0.47802197802197804,0.521978021978022
E01008485,1482,683,799,0.460863697705803,0.5391363022941971
E01008492,1707,830,877,0.4862331575864089,0.513766842413591
E01008462,1548,732,816,0.4728682170542636,0.5271317829457365
E01008463,1285,634,651,0.4933852140077821,0.5066147859922179
E01008464,1294,627,667,0.4845440494590417,0.5154559505409583
E01008465,1386,641,745,0.4624819624819625,0.5375180375180375
E01008531,1304,654,650,0.5015337423312883,0.49846625766871167
E01008532,1667,789,878,0.47330533893221355,0.5266946610677864
E01008534,1240,631,609,0.5088709677419355,0.49112903225806454
E01008538,2542,1236,1306,0.48623131392604246,0.5137686860739575
E01008508,1581,762,819,0.4819734345351044,0.5180265654648957
E01008509,1697,859,838,0.5061873895109016,0.4938126104890984
E01008510,1523,757,766,0.4970453053184504,0.5029546946815495
E01008512,1607,812,795,0.5052893590541382,0.49471064094586187
E01008539,1551,776,775,0.5003223726627982,0.4996776273372018
E01008540,1728,850,878,0.49189814814814814,0.5081018518518519
E01008541,1500,728,772,0.48533333333333334,0.5146666666666667
E01008544,1548,825,723,0.5329457364341085,0.46705426356589147
E01008545,1239,609,630,0.4915254237288136,0.5084745762711864
E01008511,1651,860,791,0.5208964264082374,0.4791035735917626
E01008542,1675,787,888,0.4698507462686567,0.5301492537313433
E01008543,2513,1274,1239,0.5069637883008357,0.49303621169916434
E01008571,1804,881,923,0.4883592017738359,0.511640798226164
E01008572,1595,828,767,0.5191222570532915,0.4808777429467085
E01008573,1608,814,794,0.5062189054726368,0.4937810945273632
E01008574,1933,956,977,0.49456802897051216,0.5054319710294879
E01008576,2039,1002,1037,0.491417361451692,0.508582638548308
E01008533,1483,685,798,0.4619015509103169,0.5380984490896831
E01008535,1454,683,771,0.46973865199449794,0.5302613480055021
E01008536,1427,726,701,0.508759635599159,0.4912403644008409
E01008537,1166,564,602,0.483704974271012,0.516295025728988
E01008575,1337,650,687,0.48616305160807777,0.5138369483919222
E01008595,1414,739,675,0.5226308345120226,0.47736916548797736
E01008596,1416,709,707,0.5007062146892656,0.4992937853107345
E01008597,2333,1179,1154,0.5053579082726104,0.49464209172738965
E01008598,1471,748,723,0.5084976206662135,0.49150237933378654
E01008599,1445,693,752,0.4795847750865052,0.5204152249134948
E01008664,1214,662,552,0.5453047775947282,0.4546952224052718
E01008665,1254,655,599,0.5223285486443381,0.47767145135566186
E01008666,1849,955,894,0.5164954029204976,0.48350459707950244
E01008667,1705,883,822,0.5178885630498534,0.48211143695014663
E01008668,1396,714,682,0.5114613180515759,0.4885386819484241
E01008673,1137,551,586,0.484608619173263,0.5153913808267371
E01008675,1236,598,638,0.48381877022653724,0.5161812297734628
E01008676,1167,577,590,0.4944301628106255,0.5055698371893744
E01008677,1303,671,632,0.5149654643131235,0.48503453568687643
E01008678,1111,541,570,0.48694869486948694,0.513051305130513
E01008647,1443,716,727,0.4961884961884962,0.5038115038115039
E01008648,1332,647,685,0.48573573573573575,0.5142642642642643
E01008649,1538,740,798,0.4811443433029909,0.5188556566970091
E01008651,1881,840,1041,0.44657097288676234,0.5534290271132376
E01008679,1210,586,624,0.484297520661157,0.515702479338843
E01008680,1437,697,740,0.4850382741823243,0.5149617258176757
E01008682,1152,556,596,0.4826388888888889,0.5173611111111112
E01008683,1226,606,620,0.49429037520391517,0.5057096247960848
E01008635,1353,621,732,0.458980044345898,0.541019955654102
E01008650,1306,638,668,0.4885145482388974,0.5114854517611026
E01008674,1186,572,614,0.4822934232715008,0.5177065767284992
E01008681,1399,655,744,0.4681915654038599,0.5318084345961401
E01008600,1224,627,597,0.5122549019607843,0.4877450980392157
E01008604,1599,747,852,0.46716697936210133,0.5328330206378987
E01008660,1332,676,656,0.5075075075075075,0.4924924924924925
E01008661,1082,535,547,0.4944547134935305,0.5055452865064695
E01008633,1429,686,743,0.4800559832050385,0.5199440167949615
E01008634,1223,551,672,0.45053147996729354,0.5494685200327064
E01008636,1381,669,712,0.4844315713251267,0.5155684286748733
E01008637,1402,700,702,0.4992867332382311,0.5007132667617689
E01008639,2395,1154,1241,0.48183716075156574,0.5181628392484342
E01008652,1232,610,622,0.49512987012987014,0.5048701298701299
E01008653,1236,585,651,0.4733009708737864,0.5266990291262136
E01008654,1101,595,506,0.5404178019981835,0.45958219800181654
E01008655,1827,873,954,0.47783251231527096,0.5221674876847291
E01008657,1261,631,630,0.500396510705789,0.49960348929421095
E01008638,1248,645,603,0.5168269230769231,0.4831730769230769
E01008640,2626,1317,1309,0.5015232292460016,0.4984767707539985
E01008641,1044,529,515,0.5067049808429118,0.4932950191570881
E01008642,1835,901,934,0.49100817438692096,0.508991825613079
E01008590,1393,681,712,0.48887293610911703,0.511127063890883
E01008591,1239,620,619,0.5004035512510089,0.4995964487489911
E01008592,1209,609,600,0.5037220843672456,0.49627791563275436
E01008594,1777,855,922,0.4811480022509848,0.5188519977490152
E01008601,1539,725,814,0.4710851202079272,0.5289148797920727
E01008669,1446,705,741,0.487551867219917,0.5124481327800829
E01008671,1048,560,488,0.5343511450381679,0.46564885496183206
E01008672,1315,650,665,0.49429657794676807,0.5057034220532319
E01008622,1665,797,868,0.4786786786786787,0.5213213213213214
E01008625,1379,657,722,0.47643219724437996,0.52356780275562
E01034512,1470,701,769,0.47687074829931975,0.5231292517006803
E01034513,1531,725,806,0.47354670150228606,0.5264532984977139
E01008602,1421,669,752,0.4707952146375792,0.5292047853624209
E01008603,1351,708,643,0.5240562546262029,0.4759437453737972
E01008608,1139,532,607,0.46707638279192276,0.5329236172080772
E01008670,1480,719,761,0.4858108108108108,0.5141891891891892
E01008643,1734,841,893,0.48500576701268744,0.5149942329873126
E01008644,1552,744,808,0.4793814432989691,0.520618556701031
E01008645,2705,1321,1384,0.48835489833641405,0.5116451016635859
E01008646,1316,635,681,0.4825227963525836,0.5174772036474165
E01008656,1420,674,746,0.47464788732394364,0.5253521126760563
E01008658,1462,675,787,0.46169630642954856,0.5383036935704515
E01008593,1349,614,735,0.4551519644180875,0.5448480355819125
E01008605,1126,540,586,0.47957371225577267,0.5204262877442274
E01008606,1751,867,884,0.49514563106796117,0.5048543689320388
E01008607,1470,624,846,0.42448979591836733,0.5755102040816327
E01008609,1506,669,837,0.4442231075697211,0.5557768924302788
E01008631,1328,623,705,0.4691265060240964,0.5308734939759037
E01008632,1218,556,662,0.45648604269293924,0.5435139573070608
E01008659,1467,726,741,0.4948875255623722,0.5051124744376279
E01008662,1182,575,607,0.48646362098138746,0.5135363790186125
E01008663,1375,618,757,0.44945454545454544,0.5505454545454546
E01008624,1313,635,678,0.4836252856054836,0.5163747143945163
E01008684,1025,485,540,0.47317073170731705,0.526829268292683
E01008685,1792,857,935,0.47823660714285715,0.5217633928571429
E01008686,1663,804,859,0.4834636199639206,0.5165363800360794
E01008687,1797,836,961,0.46521981079577074,0.5347801892042293
E01008688,1334,600,734,0.4497751124437781,0.5502248875562219
E01008689,1431,664,767,0.4640111809923131,0.5359888190076869
E01008690,1359,658,701,0.4841795437821928,0.5158204562178073
E01008691,1138,579,559,0.5087873462214412,0.4912126537785589
E01008692,1348,640,708,0.47477744807121663,0.5252225519287834
E01008627,1190,585,605,0.49159663865546216,0.5084033613445378
E01008628,1388,644,744,0.46397694524495675,0.5360230547550432
E01008629,1344,639,705,0.47544642857142855,0.5245535714285714
E01008630,1438,688,750,0.47844228094575797,0.521557719054242
E01008610,1494,695,799,0.46519410977242304,0.534805890227577
E01008611,1351,678,673,0.5018504811250926,0.4981495188749075
E01008612,1442,708,734,0.4909847434119279,0.5090152565880721
E01008613,1491,734,757,0.4922870556673374,0.5077129443326627
E01008616,1460,693,767,0.47465753424657536,0.5253424657534247
E01008618,1307,658,649,0.5034429992348891,0.49655700076511095
E01008619,1585,734,851,0.4630914826498423,0.5369085173501578
E01008621,1440,695,745,0.4826388888888889,0.5173611111111112
E01008614,1684,801,883,0.47565320665083133,0.5243467933491687
E01008615,1384,639,745,0.46170520231213874,0.5382947976878613
E01008617,1382,689,693,0.49855282199710566,0.5014471780028944
E01008620,1446,683,763,0.4723374827109267,0.5276625172890733
E01008713,1523,771,752,0.5062376887721602,0.4937623112278398
E01008722,1399,663,736,0.4739099356683345,0.5260900643316655
E01008724,1143,546,597,0.4776902887139108,0.5223097112860893
E01008726,1413,676,737,0.47841472045293704,0.521585279547063
E01008723,1424,700,724,0.49157303370786515,0.5084269662921348
E01008725,1340,661,679,0.49328358208955225,0.5067164179104477
E01008727,1459,681,778,0.46675805346127486,0.5332419465387251
E01008728,1341,648,693,0.48322147651006714,0.5167785234899329
E01008792,1258,605,653,0.4809220985691574,0.5190779014308426
E01008698,1430,674,756,0.47132867132867134,0.5286713286713287
E01008837,1234,578,656,0.4683954619124797,0.5316045380875203
E01008838,1470,722,748,0.49115646258503404,0.508843537414966
E01008839,1357,629,728,0.46352247605011054,0.5364775239498895
E01008840,1375,648,727,0.4712727272727273,0.5287272727272727
E01008841,1408,683,725,0.4850852272727273,0.5149147727272727
E01008712,1807,847,960,0.46873270614277807,0.5312672938572219
E01008817,1229,593,636,0.4825061025223759,0.5174938974776241
E01008819,1391,643,748,0.46225736879942486,0.5377426312005751
E01008821,1515,694,821,0.45808580858085807,0.5419141914191419
E01008822,1517,737,780,0.4858272907053395,0.5141727092946605
E01008842,1382,665,717,0.48118668596237335,0.5188133140376266
E01008708,1413,680,733,0.48124557678697805,0.5187544232130219
E01008709,1180,595,585,0.5042372881355932,0.4957627118644068
E01008711,1460,741,719,0.5075342465753425,0.49246575342465754
E01034514,3222,1595,1627,0.49503414028553694,0.5049658597144631
E01008786,1432,698,734,0.48743016759776536,0.5125698324022346
E01008787,1417,689,728,0.48623853211009177,0.5137614678899083
E01008788,1424,702,722,0.49297752808988765,0.5070224719101124
E01008789,1302,660,642,0.5069124423963134,0.4930875576036866
E01008790,1401,704,697,0.502498215560314,0.49750178443968596
E01008791,1586,806,780,0.5081967213114754,0.4918032786885246
E01008855,1394,709,685,0.5086083213773315,0.4913916786226686
E01008856,1261,609,652,0.4829500396510706,0.5170499603489295
E01008876,1648,830,818,0.5036407766990292,0.4963592233009709
E01008877,1576,778,798,0.4936548223350254,0.5063451776649747
E01008693,1406,698,708,0.49644381223328593,0.5035561877667141
E01008694,1395,673,722,0.4824372759856631,0.5175627240143369
E01008695,1412,663,749,0.4695467422096317,0.5304532577903682
E01008696,1214,614,600,0.5057660626029654,0.4942339373970346
E01008697,1395,649,746,0.4652329749103943,0.5347670250896057
E01008699,1391,626,765,0.45003594536304814,0.5499640546369519
E01008853,1396,631,765,0.4520057306590258,0.5479942693409742
E01008854,1217,610,607,0.5012325390304027,0.4987674609695974
E01008857,1327,627,700,0.4724943481537302,0.5275056518462697
E01008858,1263,577,686,0.4568487727632621,0.5431512272367379
E01008859,1397,668,729,0.47816750178954903,0.521832498210451
E01008860,1282,616,666,0.48049921996879874,0.5195007800312013
E01008878,1475,690,785,0.46779661016949153,0.5322033898305085
E01008873,1190,587,603,0.49327731092436977,0.5067226890756302
E01008874,1737,793,944,0.4565342544617156,0.5434657455382844
E01008875,1435,675,760,0.47038327526132406,0.5296167247386759
E01008879,1255,621,634,0.49482071713147413,0.5051792828685259
E01008880,1076,532,544,0.4944237918215613,0.5055762081784386
E01008701,1637,768,869,0.4691508857666463,0.5308491142333537
E01008704,1489,737,752,0.4949630624580255,0.5050369375419744
E01008706,1455,750,705,0.5154639175257731,0.4845360824742268
E01008707,1257,645,612,0.513126491646778,0.48687350835322196
E01008756,1502,734,768,0.48868175765645805,0.511318242343542
E01008762,1659,750,909,0.45207956600361665,0.5479204339963833
E01008812,1715,805,910,0.46938775510204084,0.5306122448979592
E01033076,2477,1202,1275,0.48526443278159065,0.5147355672184094
E01008700,1959,922,1037,0.4706482899438489,0.5293517100561511
E01008703,2189,1254,935,0.5728643216080402,0.4271356783919598
E01008705,1070,538,532,0.502803738317757,0.497196261682243
E01008831,1857,973,884,0.5239633817985999,0.4760366182014001
E01008834,1470,787,683,0.535374149659864,0.46462585034013604
E01008810,1589,752,837,0.473253618628068,0.5267463813719321
E01008811,1549,749,800,0.4835377663008393,0.5164622336991608
E01008813,1602,740,862,0.46192259675405745,0.5380774032459426
E01008814,1478,714,764,0.48308525033829497,0.516914749661705
E01008757,1310,630,680,0.48091603053435117,0.5190839694656488
E01008758,1392,686,706,0.492816091954023,0.507183908045977
E01008759,1436,696,740,0.48467966573816157,0.5153203342618384
E01008761,1363,642,721,0.471019809244314,0.528980190755686
E01008702,1157,559,598,0.48314606741573035,0.5168539325842697
E01008735,1897,1003,894,0.5287295730100158,0.47127042698998417
E01008736,1016,485,531,0.47736220472440943,0.5226377952755905
E01008737,1228,614,614,0.5,0.5
E01008738,1050,497,553,0.47333333333333333,0.5266666666666666
E01008836,1310,729,581,0.5564885496183206,0.4435114503816794
E01008845,1390,688,702,0.4949640287769784,0.5050359712230216
E01008846,1235,573,662,0.46396761133603237,0.5360323886639676
E01008847,1352,666,686,0.492603550295858,0.507396449704142
E01008851,1556,742,814,0.4768637532133676,0.5231362467866324
E01034515,1512,770,742,0.5092592592592593,0.49074074074074076
E01034516,1608,801,807,0.498134328358209,0.5018656716417911
E01008760,1432,701,731,0.4895251396648045,0.5104748603351955
E01008830,1365,724,641,0.5304029304029304,0.4695970695970696
E01008832,1465,708,757,0.4832764505119454,0.5167235494880547
E01008833,1330,648,682,0.48721804511278194,0.512781954887218
E01008843,1208,600,608,0.4966887417218543,0.5033112582781457
E01008844,1440,709,731,0.49236111111111114,0.5076388888888889
E01008848,1301,614,687,0.4719446579554189,0.528055342044581
E01008849,1407,659,748,0.4683724235963042,0.5316275764036958
E01008852,1132,557,575,0.4920494699646643,0.5079505300353356
E01008867,1545,792,753,0.512621359223301,0.487378640776699
E01008868,1096,541,555,0.4936131386861314,0.5063868613138686
E01008869,1220,584,636,0.4786885245901639,0.521311475409836
E01008870,1328,662,666,0.49849397590361444,0.5015060240963856
E01008871,1380,666,714,0.4826086956521739,0.5173913043478261
E01008872,1654,805,849,0.4866989117291415,0.5133010882708585
E01008730,1649,759,890,0.46027895694360216,0.5397210430563978
E01008732,1934,901,1033,0.4658738366080662,0.5341261633919339
E01008733,1577,795,782,0.5041217501585289,0.49587824984147116
E01008734,1294,624,670,0.482225656877898,0.517774343122102
E01034517,2245,1030,1215,0.45879732739420936,0.5412026726057907
E01008740,1432,735,697,0.513268156424581,0.486731843575419
E01008781,1424,683,741,0.47963483146067415,0.5203651685393258
E01008782,1380,684,696,0.4956521739130435,0.5043478260869565
E01008783,1372,668,704,0.4868804664723032,0.5131195335276968
E01008784,1496,730,766,0.4879679144385027,0.5120320855614974
E01008785,1324,634,690,0.4788519637462236,0.5211480362537765
E01008835,1550,766,784,0.4941935483870968,0.5058064516129033
E01008823,1427,665,762,0.46601261387526277,0.5339873861247372
E01008824,1401,716,685,0.5110635260528195,0.4889364739471806
E01008825,1499,694,805,0.4629753168779186,0.5370246831220814
E01008826,1378,655,723,0.4753265602322206,0.5246734397677794
E01008827,1167,564,603,0.4832904884318766,0.5167095115681234
E01008828,1532,696,836,0.45430809399477806,0.5456919060052219
E01008829,1282,644,638,0.5023400936037441,0.49765990639625585
E01008739,1494,743,751,0.49732262382864795,0.5026773761713521
E01008741,1403,689,714,0.49109052031361367,0.5089094796863863
E01008779,1336,639,697,0.4782934131736527,0.5217065868263473
E01008780,1941,919,1022,0.4734672849046883,0.5265327150953117
E01008799,1624,787,837,0.48460591133004927,0.5153940886699507
E01008861,1439,702,737,0.48783877692842254,0.5121612230715775
E01008862,1288,633,655,0.49145962732919257,0.5085403726708074
E01008863,1532,756,776,0.4934725848563969,0.5065274151436031
E01008864,1209,601,608,0.49710504549214224,0.5028949545078577
E01008865,1327,621,706,0.46797287113790503,0.5320271288620949
E01008866,1369,656,713,0.47918188458729,0.5208181154127101
E01008773,1278,572,706,0.4475743348982786,0.5524256651017214
E01008776,1234,564,670,0.45705024311183146,0.5429497568881686
E01008777,1398,685,713,0.4899856938483548,0.5100143061516452
E01008778,1322,616,706,0.4659606656580938,0.5340393343419062
E01008809,1564,719,845,0.45971867007672634,0.5402813299232737
E01008803,1460,713,747,0.48835616438356166,0.5116438356164383
E01008804,1613,767,846,0.4755114693118413,0.5244885306881587
E01008805,1330,635,695,0.4774436090225564,0.5225563909774437
E01033077,2287,1095,1192,0.47879317883690425,0.5212068211630958
E01008763,1435,674,761,0.4696864111498258,0.5303135888501742
E01008764,1461,691,770,0.4729637234770705,0.5270362765229295
E01008766,2952,1446,1506,0.4898373983739837,0.5101626016260162
E01008768,1984,973,1011,0.4904233870967742,0.5095766129032258
E01008769,1664,803,861,0.48257211538461536,0.5174278846153846
E01008772,1359,639,720,0.47019867549668876,0.5298013245033113
E01008774,1303,624,679,0.47889485801995396,0.5211051419800461
E01008775,1370,656,714,0.47883211678832116,0.5211678832116788
E01008802,1342,652,690,0.4858420268256334,0.5141579731743666
E01008808,1509,750,759,0.4970178926441352,0.5029821073558648
E01008793,1620,757,863,0.46728395061728395,0.532716049382716
E01008795,1731,842,889,0.48642403235124204,0.5135759676487579
E01008800,1523,755,768,0.49573210768220616,0.5042678923177938
E01008801,1527,763,764,0.4996725605762934,0.5003274394237066
E01034518,1730,850,880,0.4913294797687861,0.5086705202312138
E01034519,1558,782,776,0.5019255455712451,0.4980744544287548
E01008765,1530,732,798,0.47843137254901963,0.5215686274509804
E01008767,1353,624,729,0.4611973392461197,0.5388026607538803
E01008770,1248,617,631,0.49439102564102566,0.5056089743589743
E01008771,1471,736,735,0.5003399048266486,0.49966009517335147
E01008720,1323,667,656,0.5041572184429327,0.4958427815570673
E01008721,1555,761,794,0.48938906752411576,0.5106109324758843
E01008796,1897,935,962,0.4928835002635741,0.5071164997364259
E01032483,1635,787,848,0.4813455657492355,0.5186544342507645
E01032484,1255,601,654,0.4788844621513944,0.5211155378486055
E01008750,2017,1003,1014,0.49727317798710957,0.5027268220128904
E01008751,1467,707,760,0.48193592365371507,0.5180640763462849
E01008752,2005,990,1015,0.4937655860349127,0.5062344139650873
E01008753,1286,622,664,0.48367029548989116,0.5163297045101088
E01008755,1272,656,616,0.5157232704402516,0.48427672955974843
E01008714,1547,726,821,0.46929541047188106,0.5307045895281189
E01008715,1341,633,708,0.4720357941834452,0.5279642058165548
E01008716,1463,722,741,0.4935064935064935,0.5064935064935064
E01008717,1568,720,848,0.45918367346938777,0.5408163265306123
E01008749,1268,588,680,0.4637223974763407,0.5362776025236593
E01008754,1352,634,718,0.46893491124260356,0.5310650887573964
E01008718,1740,836,904,0.4804597701149425,0.5195402298850574
E01008719,1188,559,629,0.47053872053872053,0.5294612794612794
E01008742,1515,735,780,0.48514851485148514,0.5148514851485149
E01008747,1714,823,891,0.48016336056009334,0.5198366394399067
E01008748,1452,710,742,0.4889807162534435,0.5110192837465565
E01008743,1571,734,837,0.4672183322724379,0.5327816677275621
E01008744,2057,1019,1038,0.49538162372386974,0.5046183762761303
E01008745,1609,772,837,0.4798011187072716,0.5201988812927284
E01008746,2134,1056,1078,0.4948453608247423,0.5051546391752577
E01008246,1385,676,709,0.488086642599278,0.511913357400722
E01008247,1538,734,804,0.47724317295188556,0.5227568270481144
E01008248,2676,1374,1302,0.5134529147982063,0.48654708520179374
E01008249,1504,703,801,0.46742021276595747,0.5325797872340425
E01008250,1425,702,723,0.4926315789473684,0.5073684210526316
E01008195,1986,961,1025,0.4838872104733132,0.5161127895266868
E01008197,1710,811,899,0.47426900584795323,0.5257309941520468
E01008198,1647,809,838,0.4911961141469338,0.5088038858530661
E01008199,1317,635,682,0.48215641609719057,0.5178435839028094
E01008200,1371,663,708,0.48358862144420134,0.5164113785557987
E01008245,1319,635,684,0.48142532221379836,0.5185746777862017
E01008214,1776,807,969,0.4543918918918919,0.5456081081081081
E01008215,1532,770,762,0.5026109660574413,0.49738903394255873
E01008243,1507,769,738,0.5102853351028533,0.48971466489714666
E01008244,1853,914,939,0.4932541824069077,0.5067458175930922
E01008178,1596,779,817,0.4880952380952381,0.5119047619047619
E01008180,1352,625,727,0.46227810650887574,0.5377218934911243
E01008182,1714,803,911,0.4684947491248541,0.5315052508751459
E01008277,1527,737,790,0.48264571054354943,0.5173542894564506
E01008280,1848,897,951,0.48538961038961037,0.5146103896103896
E01008177,1278,611,667,0.4780907668231612,0.5219092331768388
E01008179,1137,555,582,0.48812664907651715,0.5118733509234829
E01008181,1540,750,790,0.487012987012987,0.512987012987013
E01008276,1396,693,703,0.49641833810888253,0.5035816618911175
E01008279,1359,675,684,0.4966887417218543,0.5033112582781457
E01008209,1924,900,1024,0.4677754677754678,0.5322245322245323
E01008210,1377,651,726,0.47276688453159044,0.5272331154684096
E01008258,2286,1206,1080,0.5275590551181102,0.47244094488188976
E01008259,2018,1079,939,0.5346878097125867,0.4653121902874133
E01008167,1545,793,752,0.5132686084142395,0.4867313915857605
E01008170,1763,939,824,0.5326148610323312,0.46738513896766876
E01008257,1460,691,769,0.47328767123287674,0.5267123287671233
E01035610,2739,1425,1314,0.52026286966046,0.47973713033953996
E01008262,1569,817,752,0.5207138304652645,0.4792861695347355
E01008263,1388,661,727,0.4762247838616715,0.5237752161383286
E01008264,1443,733,710,0.507969507969508,0.49203049203049204
E01008265,1331,673,658,0.5056348610067618,0.49436513899323814
E01008266,1290,633,657,0.4906976744186046,0.5093023255813953
E01008251,1755,908,847,0.5173789173789174,0.4826210826210826
E01008252,1654,911,743,0.5507859733978234,0.4492140266021765
E01008253,1467,760,707,0.5180640763462849,0.48193592365371507
E01008254,1488,772,716,0.5188172043010753,0.48118279569892475
E01008255,2126,1016,1110,0.477892756349953,0.522107243650047
E01008165,1506,711,795,0.4721115537848606,0.5278884462151394
E01008201,1603,778,825,0.48533998752339363,0.5146600124766063
E01008202,1694,794,900,0.46871310507674147,0.5312868949232585
E01008204,1510,705,805,0.46688741721854304,0.5331125827814569
E01008212,1254,630,624,0.5023923444976076,0.49760765550239233
E01008213,1476,689,787,0.46680216802168023,0.5331978319783198
E01008216,1384,654,730,0.4725433526011561,0.5274566473988439
E01008228,1119,540,579,0.48257372654155495,0.517426273458445
E01008206,1631,817,814,0.5009196811771919,0.49908031882280807
E01008207,1329,645,684,0.4853273137697517,0.5146726862302483
E01008208,1619,793,826,0.4898085237801112,0.5101914762198888
E01008211,1641,812,829,0.4948202315661182,0.5051797684338818
E01008283,1206,593,613,0.4917081260364842,0.5082918739635157
E01008284,1347,669,678,0.49665924276169265,0.5033407572383074
E01008286,1349,634,715,0.4699777613046701,0.5300222386953298
E01008287,1875,944,931,0.5034666666666666,0.4965333333333333
E01008231,1509,704,805,0.4665341285619616,0.5334658714380385
E01008240,1488,708,780,0.47580645161290325,0.5241935483870968
E01008241,1568,738,830,0.47066326530612246,0.5293367346938775
E01008242,1609,776,833,0.48228713486637664,0.5177128651336234
E01008281,1567,708,859,0.4518187619655393,0.5481812380344607
E01008282,1405,653,752,0.4647686832740214,0.5352313167259787
E01008219,1634,803,831,0.49143206854345167,0.5085679314565483
E01008235,1338,651,687,0.48654708520179374,0.5134529147982063
E01008236,1429,690,739,0.4828551434569629,0.5171448565430371
E01008237,1562,778,784,0.4980793854033291,0.5019206145966709
E01008238,1445,715,730,0.49480968858131485,0.5051903114186851
E01008267,1486,728,758,0.4899057873485868,0.5100942126514132
E01008269,1462,693,769,0.4740082079343365,0.5259917920656635
E01008270,1278,609,669,0.4765258215962441,0.5234741784037559
E01008271,1335,647,688,0.4846441947565543,0.5153558052434457
E01008275,1404,667,737,0.47507122507122507,0.5249287749287749
E01008229,1235,586,649,0.4744939271255061,0.5255060728744939
E01008230,1353,651,702,0.4811529933481153,0.5188470066518847
E01008232,1376,660,716,0.4796511627906977,0.5203488372093024
E01008233,1210,608,602,0.5024793388429752,0.4975206611570248
E01008285,1376,650,726,0.47238372093023256,0.5276162790697675
E01008256,1628,776,852,0.47665847665847666,0.5233415233415234
E01008260,1490,739,751,0.4959731543624161,0.5040268456375839
E01008261,1378,671,707,0.4869375907111756,0.5130624092888244
E01008268,1388,687,701,0.49495677233429397,0.5050432276657061
E01008272,1609,775,834,0.48166563082660035,0.5183343691733996
E01008273,1413,681,732,0.4819532908704883,0.5180467091295117
E01008274,1352,627,725,0.46375739644970415,0.5362426035502958
E01008193,1283,604,679,0.47077162899454406,0.5292283710054559
E01008194,1361,651,710,0.47832476120499634,0.5216752387950037
E01008234,2063,1027,1036,0.49781871061560834,0.5021812893843917
E01008239,1529,758,771,0.49574885546108566,0.5042511445389143
E01008218,1530,713,817,0.46601307189542485,0.5339869281045752
E01008220,1230,604,626,0.49105691056910566,0.5089430894308943
E01008221,1825,874,951,0.4789041095890411,0.5210958904109589
E01008225,1559,746,813,0.47851186658114175,0.5214881334188582
E01008227,1725,846,879,0.49043478260869566,0.5095652173913043
E01008184,1338,638,700,0.476831091180867,0.523168908819133
E01008185,1394,682,712,0.48923959827833574,0.5107604017216643
E01008188,1323,634,689,0.47921390778533635,0.5207860922146637
E01008278,1514,745,769,0.49207397622192867,0.5079260237780714
E01008189,1210,594,616,0.4909090909090909,0.509090909090909
E01008190,1352,654,698,0.48372781065088755,0.5162721893491125
E01008191,1388,700,688,0.5043227665706052,0.4956772334293948
E01008192,1382,668,714,0.4833574529667149,0.516642547033285
E01008217,1459,717,742,0.4914324880054832,0.5085675119945168
E01008222,1620,765,855,0.4722222222222222,0.5277777777777778
E01008223,1852,886,966,0.47840172786177104,0.521598272138229
E01008224,2657,1301,1356,0.489649981181784,0.5103500188182161
E01008226,1795,897,898,0.49972144846796657,0.5002785515320334
E01008172,1725,804,921,0.46608695652173915,0.5339130434782609
E01008173,1502,693,809,0.4613848202396804,0.5386151797603196
E01008174,2142,1048,1094,0.4892623716153128,0.5107376283846872
E01008175,1432,699,733,0.48812849162011174,0.5118715083798883
E01008176,1473,709,764,0.4813306177868296,0.5186693822131704
E01008162,2244,1211,1033,0.5396613190730838,0.4603386809269162
E01008164,1506,781,725,0.5185922974767596,0.4814077025232404
E01008166,1625,974,651,0.5993846153846154,0.4006153846153846
E01035611,1098,642,456,0.5846994535519126,0.41530054644808745
E01035612,1216,563,653,0.4629934210526316,0.5370065789473685
E01008163,2055,1073,982,0.5221411192214112,0.4778588807785888
E01008203,1608,827,781,0.5143034825870647,0.48569651741293535
E01008205,1463,673,790,0.4600136705399863,0.5399863294600137
E01008183,1441,671,770,0.46564885496183206,0.5343511450381679
E01008186,1778,890,888,0.500562429696288,0.49943757030371205
E01008196,2115,1044,1071,0.49361702127659574,0.5063829787234042
E01035624,1557,751,806,0.48233782915863843,0.5176621708413616
E01012392,2908,1486,1422,0.5110041265474553,0.4889958734525447
E01012393,2884,1436,1448,0.49791955617198336,0.5020804438280166
E01012395,1598,805,793,0.5037546933667084,0.49624530663329164
E01012411,1309,620,689,0.47364400305576776,0.5263559969442322
E01012374,2707,1349,1358,0.49833764314739565,0.5016623568526044
E01012375,1501,766,735,0.5103264490339774,0.48967355096602266
E01012376,2789,1403,1386,0.5030476873431338,0.49695231265686624
E01012421,1181,582,599,0.4928027095681626,0.5071972904318375
E01012423,1274,617,657,0.48430141287284145,0.5156985871271585
E01012368,2016,967,1049,0.47966269841269843,0.5203373015873016
E01012410,1082,536,546,0.4953789279112754,0.5046210720887245
E01012412,1776,914,862,0.5146396396396397,0.48536036036036034
E01012413,1449,703,746,0.48516218081435475,0.5148378191856453
E01012414,1125,573,552,0.5093333333333333,0.49066666666666664
E01012377,1727,843,884,0.4881297046902142,0.5118702953097858
E01012390,1590,764,826,0.48050314465408805,0.519496855345912
E01012419,1107,507,600,0.45799457994579945,0.5420054200542005
E01012420,1425,630,795,0.4421052631578947,0.5578947368421052
E01012422,1463,667,796,0.4559125085440875,0.5440874914559125
E01012369,1785,890,895,0.49859943977591037,0.5014005602240896
E01012394,1916,919,997,0.47964509394572025,0.5203549060542797
E01012425,1556,761,795,0.4890745501285347,0.5109254498714653
E01012426,1344,663,681,0.49330357142857145,0.5066964285714286
E01012427,1802,897,905,0.49778024417314093,0.5022197558268591
E01012378,1521,762,759,0.5009861932938856,0.4990138067061144
E01012379,1654,820,834,0.4957678355501814,0.5042321644498187
E01012380,1445,681,764,0.471280276816609,0.528719723183391
E01012388,1780,873,907,0.4904494382022472,0.5095505617977528
E01012442,1492,675,817,0.4524128686327078,0.5475871313672922
E01012367,1855,918,937,0.4948787061994609,0.505121293800539
E01012370,1841,923,918,0.5013579576317219,0.4986420423682781
E01012424,1916,967,949,0.5046972860125261,0.4953027139874739
E01012441,2268,1159,1109,0.5110229276895943,0.48897707231040566
E01012389,1696,824,872,0.4858490566037736,0.5141509433962265
E01012391,2142,1029,1113,0.4803921568627451,0.5196078431372549
E01012401,1794,873,921,0.4866220735785953,0.5133779264214047
E01012443,1475,735,740,0.49830508474576274,0.5016949152542373
E01012385,2088,1077,1011,0.5158045977011494,0.48419540229885055
E01012386,2658,1349,1309,0.5075244544770504,0.4924755455229496
E01012387,1067,539,528,0.5051546391752577,0.4948453608247423
E01012434,1424,676,748,0.4747191011235955,0.5252808988764045
E01012435,2078,1031,1047,0.49615014436958615,0.5038498556304138
E01012381,1728,868,860,0.5023148148148148,0.4976851851851852
E01012382,1613,755,858,0.4680719156850589,0.5319280843149411
E01012384,1574,768,806,0.48792884371029227,0.5120711562897078
E01012444,1514,731,783,0.48282694848084545,0.5171730515191546
E01012445,1242,617,625,0.4967793880837359,0.5032206119162641
E01012398,1154,578,576,0.5008665511265165,0.49913344887348354
E01012400,1199,574,625,0.4787322768974145,0.5212677231025855
E01012402,1518,691,827,0.4552042160737813,0.5447957839262187
E01012404,1371,687,684,0.5010940919037199,0.4989059080962801
E01012405,2083,1028,1055,0.49351896303408543,0.5064810369659145
E01012416,1837,929,908,0.5057158410451824,0.49428415895481764
E01012417,1195,608,587,0.5087866108786611,0.49121338912133894
E01012429,1375,641,734,0.4661818181818182,0.5338181818181819
E01012430,1585,819,766,0.5167192429022082,0.4832807570977918
E01012431,2109,1100,1009,0.5215742057847321,0.4784257942152679
E01035382,1270,680,590,0.5354330708661418,0.4645669291338583
E01035383,1280,625,655,0.48828125,0.51171875
E01012383,1531,733,798,0.47877204441541477,0.5212279555845852
E01012396,1405,712,693,0.5067615658362989,0.49323843416370106
E01012397,1617,721,896,0.4458874458874459,0.5541125541125541
E01012399,1333,623,710,0.4673668417104276,0.5326331582895724
E01012403,1825,880,945,0.4821917808219178,0.5178082191780822
E01012408,1805,842,963,0.4664819944598338,0.5335180055401662
E01012432,1318,621,697,0.47116843702579664,0.5288315629742033
E01012433,1577,763,814,0.4838300570703868,0.5161699429296132
E01012436,1246,605,641,0.485553772070626,0.514446227929374
E01012438,1122,520,602,0.46345811051693403,0.5365418894830659
E01012440,1189,571,618,0.4802354920100925,0.5197645079899075
E01012406,1394,664,730,0.4763271162123386,0.5236728837876614
E01012407,1681,838,843,0.49851279000594884,0.5014872099940512
E01012409,1317,626,691,0.4753227031131359,0.524677296886864
E01012437,1270,580,690,0.4566929133858268,0.5433070866141733
E01012439,1440,661,779,0.45902777777777776,0.5409722222222222
E01012371,1208,599,609,0.4958609271523179,0.5041390728476821
E01012372,1108,536,572,0.48375451263537905,0.516245487364621
E01012373,1215,587,628,0.4831275720164609,0.516872427983539
E01012415,1307,656,651,0.5019127773527161,0.49808722264728383
E01012418,1413,684,729,0.4840764331210191,0.5159235668789809
E01012471,2208,1567,641,0.7096920289855072,0.29030797101449274
E01012472,1864,897,967,0.4812231759656652,0.5187768240343348
E01012476,1619,809,810,0.4996911673872761,0.5003088326127239
E01012477,1613,803,810,0.49783013019218847,0.5021698698078115
E01012473,1586,750,836,0.4728877679697352,0.5271122320302648
E01012474,1410,640,770,0.45390070921985815,0.5460992907801419
E01012475,1488,719,769,0.4831989247311828,0.5168010752688172
E01012554,1999,981,1018,0.49074537268634316,0.5092546273136568
E01012467,1180,574,606,0.4864406779661017,0.5135593220338983
E01012468,2414,1152,1262,0.4772162386081193,0.5227837613918807
E01012469,1466,698,768,0.4761255115961801,0.5238744884038199
E01012470,1159,572,587,0.49352890422778256,0.5064710957722174
E01012460,1439,707,732,0.49131341209173035,0.5086865879082696
E01012462,1224,599,625,0.48937908496732024,0.5106209150326797
E01012463,1061,510,551,0.4806786050895382,0.5193213949104618
E01012464,1366,668,698,0.4890190336749634,0.5109809663250366
E01012459,1520,753,767,0.4953947368421053,0.5046052631578948
E01012461,1247,606,641,0.4859663191659984,0.5140336808340016
E01012465,1199,637,562,0.5312760633861552,0.46872393661384487
E01012466,1555,744,811,0.47845659163987136,0.5215434083601286
E01012526,1722,883,839,0.5127758420441347,0.48722415795586527
E01012534,1484,724,760,0.48787061994609165,0.5121293800539084
E01012535,1798,859,939,0.4777530589543938,0.5222469410456062
E01012537,1563,745,818,0.47664747280870123,0.5233525271912988
E01012539,1505,739,766,0.49102990033222593,0.5089700996677741
E01012538,1339,640,699,0.47796863330843914,0.5220313666915609
E01012540,1328,658,670,0.4954819277108434,0.5045180722891566
E01012541,1210,601,609,0.49669421487603305,0.503305785123967
E01012542,1382,685,697,0.4956584659913169,0.5043415340086831
E01012543,1325,630,695,0.47547169811320755,0.5245283018867924
E01012544,1462,711,751,0.48632010943912446,0.5136798905608755
E01012521,1561,754,807,0.48302370275464446,0.5169762972453555
E01012522,1392,690,702,0.4956896551724138,0.5043103448275862
E01012533,1496,722,774,0.48262032085561496,0.517379679144385
E01012536,1523,755,768,0.49573210768220616,0.5042678923177938
E01012545,1638,766,872,0.46764346764346765,0.5323565323565324
E01012546,1601,764,837,0.4772017489069332,0.5227982510930669
E01012561,1473,720,753,0.48879837067209775,0.5112016293279023
E01012562,2252,1135,1117,0.5039964476021315,0.4960035523978686
E01035384,1263,631,632,0.4996041171813143,0.5003958828186856
E01035385,1600,797,803,0.498125,0.501875
E01035386,1551,788,763,0.5080593165699548,0.49194068343004516
E01035387,1505,738,767,0.49036544850498337,0.5096345514950166
E01035388,1595,774,821,0.4852664576802508,0.5147335423197492
E01012563,1725,878,847,0.5089855072463768,0.4910144927536232
E01012564,1304,629,675,0.48236196319018404,0.5176380368098159
E01012566,2078,1040,1038,0.5004812319538018,0.49951876804619827
E01012569,1786,880,906,0.49272116461366183,0.5072788353863382
E01012570,1149,578,571,0.5030461270670148,0.4969538729329852
E01035389,1532,724,808,0.4725848563968668,0.5274151436031331
E01035390,1494,752,742,0.5033467202141901,0.4966532797858099
E01012481,1541,734,807,0.4763140817650876,0.5236859182349124
E01012482,1643,820,823,0.4990870359099209,0.5009129640900791
E01012520,1629,852,777,0.5230202578268877,0.47697974217311234
E01012523,1405,692,713,0.4925266903914591,0.507473309608541
E01012524,1489,728,761,0.4889187374076561,0.5110812625923439
E01012525,1504,731,773,0.48603723404255317,0.5139627659574468
E01012478,2210,1120,1090,0.5067873303167421,0.49321266968325794
E01012547,1638,802,836,0.4896214896214896,0.5103785103785103
E01012548,1782,904,878,0.5072951739618407,0.49270482603815935
E01012549,1757,842,915,0.479225953329539,0.520774046670461
E01012550,1646,810,836,0.49210206561360875,0.5078979343863913
E01012453,1858,889,969,0.47847147470398277,0.5215285252960172
E01012454,2606,1317,1289,0.5053722179585571,0.4946277820414428
E01012455,2029,994,1035,0.4898965007392804,0.5101034992607195
E01012457,1702,879,823,0.5164512338425382,0.4835487661574618
E01012551,1532,762,770,0.49738903394255873,0.5026109660574413
E01012552,1400,685,715,0.48928571428571427,0.5107142857142857
E01012553,1248,606,642,0.4855769230769231,0.5144230769230769
E01012555,1323,664,659,0.5018896447467877,0.4981103552532124
E01012556,1434,708,726,0.49372384937238495,0.5062761506276151
E01012491,1396,704,692,0.504297994269341,0.49570200573065903
E01012492,1379,679,700,0.49238578680203043,0.5076142131979695
E01012493,1672,815,857,0.4874401913875598,0.5125598086124402
E01012494,1921,947,974,0.49297241020301924,0.5070275897969807
E01012500,1382,679,703,0.4913169319826339,0.5086830680173662
E01012495,1597,823,774,0.5153412648716343,0.48465873512836566
E01012496,1388,683,705,0.4920749279538905,0.5079250720461095
E01012497,1220,568,652,0.46557377049180326,0.5344262295081967
E01012498,1530,739,791,0.4830065359477124,0.5169934640522876
E01012499,1819,872,947,0.4793842770753161,0.5206157229246839
E01012501,1374,691,683,0.5029112081513828,0.49708879184861715
E01012479,1664,845,819,0.5078125,0.4921875
E01012480,2270,1182,1088,0.520704845814978,0.479295154185022
E01012510,2233,1151,1082,0.515450067174205,0.4845499328257949
E01012511,1604,783,821,0.48815461346633415,0.5118453865336658
E01033299,2407,1189,1218,0.4939759036144578,0.5060240963855421
E01033303,1111,553,558,0.4977497749774977,0.5022502250225023
E01012458,2654,1353,1301,0.5097965335342879,0.4902034664657121
E01012483,1630,819,811,0.5024539877300613,0.49754601226993866
E01012509,2234,1085,1149,0.4856759176365264,0.5143240823634736
E01012512,1504,739,765,0.4913563829787234,0.5086436170212766
E01033300,1596,940,656,0.5889724310776943,0.41102756892230574
E01033302,1619,875,744,0.5404570722668314,0.4595429277331686
E01012527,1486,723,763,0.48654104979811574,0.5134589502018843
E01012528,1173,562,611,0.47911338448422847,0.5208866155157715
E01012529,1409,699,710,0.49609652235628104,0.5039034776437189
E01012530,1337,648,689,0.4846671652954376,0.5153328347045625
E01012531,1501,703,798,0.46835443037974683,0.5316455696202531
E01012532,1319,628,691,0.4761182714177407,0.5238817285822593
E01012505,1403,689,714,0.49109052031361367,0.5089094796863863
E01012506,1599,798,801,0.49906191369606,0.50093808630394
E01012507,1838,953,885,0.5184983677910773,0.4815016322089227
E01012508,1698,834,864,0.4911660777385159,0.508833922261484
E01035391,1727,856,871,0.4956572090330052,0.5043427909669947
E01035392,1401,688,713,0.49107780157030695,0.5089221984296931
E01012513,1998,926,1072,0.46346346346346345,0.5365365365365365
E01012514,1860,883,977,0.4747311827956989,0.5252688172043011
E01012515,1537,739,798,0.4808067664281067,0.5191932335718933
E01012516,1336,636,700,0.47604790419161674,0.5239520958083832
E01012517,2321,1145,1176,0.4933218440327445,0.5066781559672555
E01012518,2125,1004,1121,0.47247058823529414,0.5275294117647059
E01012519,1484,734,750,0.4946091644204852,0.5053908355795148
E01012485,1549,727,822,0.4693350548741123,0.5306649451258877
E01012486,1451,731,720,0.503790489317712,0.4962095106822881
E01012487,1513,740,773,0.48909451421017847,0.5109054857898215
E01012489,1853,884,969,0.47706422018348627,0.5229357798165137
E01012490,1420,688,732,0.48450704225352115,0.5154929577464789
E01012450,1400,654,746,0.46714285714285714,0.5328571428571428
E01012451,1512,725,787,0.4794973544973545,0.5205026455026455
E01012557,1518,755,763,0.497364953886693,0.502635046113307
E01012558,1697,830,867,0.4890984089569829,0.5109015910430171
E01012559,1553,763,790,0.49130714745653575,0.5086928525434643
E01012560,1469,714,755,0.4860449285228046,0.5139550714771953
E01012448,1628,969,659,0.5952088452088452,0.4047911547911548
E01012488,1857,920,937,0.49542272482498656,0.5045772751750135
E01012502,1568,774,794,0.49362244897959184,0.5063775510204082
E01012503,1794,876,918,0.4882943143812709,0.5117056856187291
E01012446,1315,653,662,0.49657794676806083,0.5034220532319391
E01012447,1361,666,695,0.4893460690668626,0.5106539309331374
E01012449,1395,663,732,0.4752688172043011,0.524731182795699
E01012452,1744,840,904,0.481651376146789,0.518348623853211
E01012607,1602,809,793,0.5049937578027466,0.4950062421972534
E01012608,2286,1094,1192,0.4785651793525809,0.5214348206474191
E01012633,1701,847,854,0.49794238683127573,0.5020576131687243
E01012634,1616,788,828,0.4876237623762376,0.5123762376237624
E01012635,1881,951,930,0.5055821371610846,0.4944178628389155
E01012636,1737,839,898,0.4830166954519286,0.5169833045480714
E01012581,1358,658,700,0.4845360824742268,0.5154639175257731
E01012582,1667,830,837,0.4979004199160168,0.5020995800839833
E01012583,2015,999,1016,0.4957816377171216,0.5042183622828784
E01012587,2347,1144,1203,0.4874307626757563,0.5125692373242438
E01012588,2213,1089,1124,0.4920921825576141,0.5079078174423859
E01012574,1476,725,751,0.4911924119241192,0.5088075880758808
E01012577,2041,997,1044,0.48848603625673687,0.5115139637432631
E01012578,2006,1000,1006,0.4985044865403789,0.5014955134596212
E01012605,2356,1165,1191,0.49448217317487264,0.5055178268251274
E01012606,1758,889,869,0.5056882821387941,0.4943117178612059
E01012579,1784,899,885,0.5039237668161435,0.4960762331838565
E01012580,2206,1083,1123,0.4909338168631006,0.5090661831368993
E01012642,1908,931,977,0.4879454926624738,0.5120545073375262
E01012645,2122,1053,1069,0.49622997172478794,0.5037700282752121
E01012585,1812,908,904,0.5011037527593819,0.4988962472406181
E01012586,1720,894,826,0.5197674418604651,0.48023255813953486
E01012656,1834,936,898,0.5103598691384951,0.48964013086150493
E01012657,2120,1070,1050,0.5047169811320755,0.49528301886792453
E01012658,1921,967,954,0.5033836543466944,0.4966163456533056
E01012629,1300,671,629,0.5161538461538462,0.48384615384615387
E01012631,1447,679,768,0.4692467173462336,0.5307532826537664
E01012643,1653,815,838,0.49304295220810646,0.5069570477918935
E01012644,2467,1265,1202,0.5127685447912445,0.48723145520875555
E01012655,2204,1252,952,0.5680580762250453,0.4319419237749546
E01012571,1766,902,864,0.5107587768969423,0.48924122310305773
E01012572,1458,684,774,0.4691358024691358,0.5308641975308642
E01012573,1762,827,935,0.46935300794551643,0.5306469920544835
E01012575,1295,625,670,0.4826254826254826,0.5173745173745173
E01012630,2294,1210,1084,0.5274629468177855,0.47253705318221445
E01012576,1816,1018,798,0.5605726872246696,0.43942731277533037
E01012637,1740,811,929,0.46609195402298853,0.5339080459770115
E01012638,1639,790,849,0.4820012202562538,0.5179987797437462
E01012639,2036,998,1038,0.4901768172888016,0.5098231827111984
E01012640,1999,1016,983,0.5082541270635318,0.4917458729364682
E01012641,1853,906,947,0.48893685914732865,0.5110631408526713
E01012595,2176,1060,1116,0.48713235294117646,0.5128676470588235
E01012596,2057,987,1070,0.4798249878463782,0.5201750121536218
E01012622,1596,809,787,0.5068922305764411,0.4931077694235589
E01012623,1403,672,731,0.4789736279401283,0.5210263720598717
E01012624,1451,709,742,0.48862853204686424,0.5113714679531358
E01012625,1810,872,938,0.481767955801105,0.518232044198895
E01012584,1609,814,795,0.5059042883778745,0.49409571162212557
E01012609,1552,753,799,0.485180412371134,0.5148195876288659
E01012610,1269,619,650,0.48778565799842394,0.512214342001576
E01012611,1074,529,545,0.4925512104283054,0.5074487895716946
E01012612,1378,677,701,0.49129172714078373,0.5087082728592163
E01012613,1857,931,926,0.5013462574044157,0.49865374259558426
E01012600,1332,626,706,0.46996996996997,0.53003003003003
E01012601,1550,757,793,0.48838709677419356,0.5116129032258064
E01012602,1577,794,783,0.5034876347495244,0.4965123652504756
E01012603,1734,853,881,0.49192618223760093,0.5080738177623991
E01012604,1655,829,826,0.5009063444108761,0.4990936555891239
E01012632,2220,1104,1116,0.4972972972972973,0.5027027027027027
E01012594,1396,660,736,0.47277936962750716,0.5272206303724928
E01012618,1522,728,794,0.4783180026281209,0.5216819973718791
E01012619,1396,678,718,0.48567335243553006,0.5143266475644699
E01012620,1462,714,748,0.4883720930232558,0.5116279069767442
E01012621,1499,700,799,0.466977985323549,0.5330220146764509
E01012593,1609,807,802,0.5015537600994406,0.49844623990055936
E01012597,1659,837,822,0.5045207956600362,0.49547920433996384
E01012598,2936,1504,1432,0.5122615803814714,0.4877384196185286
E01012599,1307,636,671,0.486610558530987,0.513389441469013
E01012589,1373,666,707,0.4850691915513474,0.5149308084486526
E01012590,1312,640,672,0.4878048780487805,0.5121951219512195
E01012591,1543,767,776,0.4970836033700583,0.5029163966299417
E01012648,1197,606,591,0.506265664160401,0.49373433583959897
E01012652,1423,709,714,0.4982431482782853,0.5017568517217147
E01012617,1332,652,680,0.4894894894894895,0.5105105105105106
E01012646,1633,784,849,0.4800979791794244,0.5199020208205756
E01012647,1546,787,759,0.5090556274256145,0.4909443725743855
E01012650,1459,700,759,0.47978067169294036,0.5202193283070596
E01012649,1538,742,796,0.48244473342002603,0.517555266579974
E01012651,1518,713,805,0.4696969696969697,0.5303030303030303
E01012653,1554,754,800,0.4851994851994852,0.5148005148005148
E01012654,1732,912,820,0.5265588914549654,0.47344110854503463
E01012614,1662,839,823,0.5048134777376655,0.49518652226233456
E01012615,1375,671,704,0.488,0.512
E01012616,1971,994,977,0.504312531709792,0.495687468290208
E01012659,1353,651,702,0.4811529933481153,0.5188470066518847
E01012660,1116,575,541,0.5152329749103942,0.48476702508960573
E01012661,1488,720,768,0.4838709677419355,0.5161290322580645
E01012592,1923,939,984,0.48829953198127923,0.5117004680187207
E01012628,1158,578,580,0.4991364421416235,0.5008635578583766
E01032485,1902,941,961,0.49474237644584645,0.5052576235541535
E01032486,1334,662,672,0.4962518740629685,0.5037481259370314
E01012663,1542,756,786,0.490272373540856,0.5097276264591439
E01012664,1593,766,827,0.48085373509102325,0.5191462649089768
E01012665,1648,767,881,0.4654126213592233,0.5345873786407767
E01012716,1383,686,697,0.4960231381055676,0.5039768618944324
E01012719,1453,687,766,0.4728148657949071,0.5271851342050929
E01012662,1412,662,750,0.4688385269121813,0.5311614730878187
E01012703,1450,669,781,0.4613793103448276,0.5386206896551724
E01012704,2013,991,1022,0.49230004967709884,0.5076999503229012
E01012706,1557,733,824,0.4707771355170199,0.5292228644829801
E01012717,1573,773,800,0.49141767323585506,0.5085823267641449
E01012666,1396,698,698,0.5,0.5
E01012667,1467,730,737,0.49761417859577367,0.5023858214042263
E01012668,1583,763,820,0.4819962097283639,0.5180037902716361
E01012669,1764,910,854,0.5158730158730159,0.48412698412698413
E01012718,1586,773,813,0.48738965952080704,0.512610340479193
E01012690,1653,808,845,0.48880822746521474,0.5111917725347852
E01012691,1844,888,956,0.48156182212581344,0.5184381778741866
E01012692,1617,797,820,0.49288806431663573,0.5071119356833642
E01012705,1519,727,792,0.47860434496379195,0.521395655036208
E01012723,1369,659,710,0.4813732651570489,0.5186267348429511
E01012693,1553,763,790,0.49130714745653575,0.5086928525434643
E01012711,1417,696,721,0.4911785462244178,0.5088214537755822
E01012747,1535,762,773,0.49641693811074916,0.5035830618892508
E01012750,1747,863,884,0.4939896966227819,0.5060103033772181
E01012681,1633,1052,581,0.6442131047152481,0.355786895284752
E01012683,1402,782,620,0.557774607703281,0.442225392296719
E01012748,1737,921,816,0.5302245250431779,0.4697754749568221
E01012749,1717,889,828,0.5177635410599883,0.48223645894001166
E01012707,1247,624,623,0.5004009623095429,0.4995990376904571
E01012720,1679,777,902,0.46277546158427635,0.5372245384157236
E01012721,1681,822,859,0.48899464604402143,0.5110053539559786
E01012724,1473,759,714,0.515274949083503,0.4847250509164969
E01012678,1085,539,546,0.4967741935483871,0.5032258064516129
E01012679,1422,701,721,0.4929676511954993,0.5070323488045007
E01012680,1696,846,850,0.4988207547169811,0.5011792452830188
E01012682,1482,790,692,0.5330634278002699,0.4669365721997301
E01012684,1419,709,710,0.4996476391825229,0.5003523608174771
E01012676,1384,667,717,0.4819364161849711,0.5180635838150289
E01012677,1404,680,724,0.4843304843304843,0.5156695156695157
E01012708,1282,611,671,0.4765990639625585,0.5234009360374415
E01012709,1525,712,813,0.4668852459016393,0.5331147540983606
E01012710,1232,565,667,0.4586038961038961,0.5413961038961039
E01012722,1159,575,584,0.49611734253666956,0.5038826574633305
E01012673,1333,697,636,0.522880720180045,0.477119279819955
E01012675,1624,817,807,0.5030788177339901,0.49692118226600984
E01012735,1262,676,586,0.5356576862123613,0.4643423137876387
E01012736,1538,852,686,0.5539661898569571,0.4460338101430429
E01012737,1314,737,577,0.560882800608828,0.439117199391172
E01012670,1491,752,739,0.5043594902749833,0.4956405097250168
E01012733,1030,498,532,0.48349514563106794,0.516504854368932
E01012734,1383,702,681,0.5075921908893709,0.4924078091106291
E01012738,1365,690,675,0.5054945054945055,0.4945054945054945
E01012739,1382,664,718,0.4804630969609262,0.5195369030390738
E01012742,1139,538,601,0.4723441615452151,0.5276558384547849
E01012712,1679,841,838,0.5008933889219773,0.4991066110780226
E01012713,1834,872,962,0.47546346782988,0.52453653217012
E01012715,1463,672,791,0.45933014354066987,0.5406698564593302
E01012740,1505,721,784,0.4790697674418605,0.5209302325581395
E01012741,1376,692,684,0.502906976744186,0.49709302325581395
E01012671,1445,764,681,0.528719723183391,0.471280276816609
E01012672,1558,827,731,0.5308087291399229,0.469191270860077
E01012674,1740,877,863,0.5040229885057471,0.4959770114942529
E01012751,1570,878,692,0.5592356687898089,0.4407643312101911
E01012686,1457,692,765,0.47494852436513385,0.5250514756348662
E01012687,1290,609,681,0.4720930232558139,0.5279069767441861
E01012688,1082,507,575,0.4685767097966728,0.5314232902033271
E01012689,1365,683,682,0.5003663003663004,0.49963369963369964
E01012714,1881,920,961,0.4891015417331207,0.5108984582668793
E01012695,1406,659,747,0.46870554765291605,0.531294452347084
E01012743,1670,828,842,0.49580838323353293,0.5041916167664671
E01012744,1606,781,825,0.4863013698630137,0.5136986301369864
E01012745,1636,778,858,0.47555012224938875,0.5244498777506112
E01012746,1680,803,877,0.4779761904761905,0.5220238095238096
E01012685,1360,624,736,0.4588235294117647,0.5411764705882353
E01012694,1335,647,688,0.4846441947565543,0.5153558052434457
E01012696,1516,716,800,0.47229551451187335,0.5277044854881267
E01012697,1260,604,656,0.4793650793650794,0.5206349206349207
E01012698,1625,780,845,0.48,0.52
E01012726,1703,848,855,0.49794480328831475,0.5020551967116853
E01012728,1483,741,742,0.4996628455832771,0.5003371544167229
E01012752,1342,677,665,0.5044709388971684,0.49552906110283157
E01012753,1153,577,576,0.5004336513443192,0.49956634865568084
E01012754,1227,625,602,0.5093724531377343,0.4906275468622657
E01012755,1441,724,717,0.5024288688410826,0.49757113115891743
E01012701,1467,721,746,0.49147920927062033,0.5085207907293797
E01012729,1590,773,817,0.4861635220125786,0.5138364779874214
E01012730,1935,926,1009,0.4785529715762274,0.5214470284237727
E01012731,1543,710,833,0.46014257939079717,0.5398574206092028
E01012732,1771,820,951,0.46301524562394125,0.5369847543760587
E01012699,1661,832,829,0.5009030704394943,0.4990969295605057
E01012700,1779,833,946,0.4682405845980888,0.5317594154019112
E01012702,1410,652,758,0.4624113475177305,0.5375886524822695
E01012725,1417,662,755,0.4671841919548342,0.5328158080451658
E01012727,1585,760,825,0.4794952681388013,0.5205047318611987
E01018411,2394,1188,1206,0.49624060150375937,0.5037593984962406
E01018412,1601,791,810,0.49406620861961276,0.5059337913803873
E01034663,2213,1087,1126,0.49118843199277,0.50881156800723
E01034664,1401,713,688,0.5089221984296931,0.49107780157030695
E01018413,1537,752,785,0.4892648015614834,0.5107351984385166
E01018414,1575,757,818,0.48063492063492064,0.5193650793650794
E01018415,1739,807,932,0.4640598044853364,0.5359401955146637
E01018416,1818,867,951,0.4768976897689769,0.523102310231023
E01018424,1673,817,856,0.488344291691572,0.511655708308428
E01018425,1669,831,838,0.4979029358897543,0.5020970641102457
E01018426,1493,735,758,0.49229738780977894,0.5077026121902211
E01018427,1214,578,636,0.47611202635914335,0.5238879736408567
E01018419,2358,1169,1189,0.4957591178965225,0.5042408821034775
E01018420,1910,919,991,0.481151832460733,0.518848167539267
E01018421,1276,618,658,0.4843260188087774,0.5156739811912225
E01018422,1350,659,691,0.48814814814814816,0.5118518518518519
E01018423,1482,714,768,0.4817813765182186,0.5182186234817814
E01018395,1950,987,963,0.5061538461538462,0.4938461538461538
E01018396,1456,689,767,0.4732142857142857,0.5267857142857143
E01018400,2527,1222,1305,0.48357736446379107,0.5164226355362089
E01018401,1657,809,848,0.48823174411587206,0.5117682558841279
E01018398,1446,716,730,0.4951590594744122,0.5048409405255878
E01018399,1762,883,879,0.5011350737797957,0.4988649262202043
E01018402,1872,942,930,0.5032051282051282,0.4967948717948718
E01018403,2436,1207,1229,0.4954844006568144,0.5045155993431856
E01018397,2040,1009,1031,0.4946078431372549,0.5053921568627451
E01018408,1855,893,962,0.4814016172506739,0.5185983827493261
E01018409,1932,914,1018,0.4730848861283644,0.5269151138716356
E01018410,1854,904,950,0.48759439050701187,0.5124056094929881
E01018404,1449,730,719,0.5037957211870255,0.49620427881297446
E01018405,1330,661,669,0.49699248120300754,0.5030075187969925
E01018406,1400,712,688,0.5085714285714286,0.49142857142857144
E01018407,1519,755,764,0.4970375246872943,0.5029624753127058
E01018436,1654,793,861,0.47944377267230953,0.5205562273276905
E01018437,1562,753,809,0.4820742637644046,0.5179257362355953
E01018438,1288,598,690,0.4642857142857143,0.5357142857142857
E01018439,2063,986,1077,0.4779447406689287,0.5220552593310712
E01018440,2624,1307,1317,0.49809451219512196,0.5019054878048781
E01018441,2066,1047,1019,0.5067763794772507,0.49322362052274926
E01018443,2166,1055,1111,0.487072945521699,0.512927054478301
E01034665,1302,627,675,0.4815668202764977,0.5184331797235023
E01034666,1610,769,841,0.47763975155279503,0.522360248447205
E01018432,1349,677,672,0.5018532246108228,0.4981467753891772
E01018433,1426,683,743,0.4789621318373071,0.5210378681626928
E01018434,1360,655,705,0.48161764705882354,0.5183823529411765
E01018435,1455,720,735,0.4948453608247423,0.5051546391752577
E01018417,1640,797,843,0.48597560975609755,0.5140243902439025
E01018418,1494,715,779,0.4785809906291834,0.5214190093708166
E01018428,1289,640,649,0.4965089216446858,0.5034910783553141
E01018429,1532,748,784,0.48825065274151436,0.5117493472584856
E01018430,1300,640,660,0.49230769230769234,0.5076923076923077
E01018431,1237,608,629,0.49151172190784154,0.5084882780921585
E01034667,1342,672,670,0.5007451564828614,0.4992548435171386
E01034668,1707,856,851,0.5014645577035736,0.4985354422964265
E01018387,1884,933,951,0.49522292993630573,0.5047770700636943
E01018388,1699,837,862,0.492642731018246,0.5073572689817539
E01018389,1699,800,899,0.47086521483225424,0.5291347851677457
E01018390,1599,796,803,0.4978111319574734,0.5021888680425266
E01018386,2189,1060,1129,0.4842393787117405,0.5157606212882595
E01018391,2489,1192,1297,0.4789071916432302,0.5210928083567697
E01018392,1829,877,952,0.47949699289229086,0.5205030071077091
E01018472,1337,659,678,0.49289454001495886,0.5071054599850411
E01018473,1571,809,762,0.5149586250795671,0.48504137492043287
E01018474,1758,866,892,0.4926052332195677,0.5073947667804323
E01018475,1666,853,813,0.5120048019207684,0.4879951980792317
E01018463,1441,725,716,0.5031228313671062,0.49687716863289383
E01018476,1578,744,834,0.4714828897338403,0.5285171102661597
E01018477,1725,843,882,0.48869565217391303,0.5113043478260869
E01018478,1752,895,857,0.5108447488584474,0.4891552511415525
E01018479,2356,1182,1174,0.50169779286927,0.49830220713073003
E01018459,1433,678,755,0.47313328681088623,0.5268667131891137
E01018460,1403,684,719,0.48752672843905914,0.5124732715609408
E01018461,1500,731,769,0.48733333333333334,0.5126666666666667
E01018466,2333,1159,1174,0.4967852550364338,0.5032147449635662
E01034669,1301,677,624,0.5203689469638739,0.4796310530361261
E01034670,1521,802,719,0.5272846811308349,0.472715318869165
E01018482,1375,672,703,0.48872727272727273,0.5112727272727273
E01018483,1375,710,665,0.5163636363636364,0.48363636363636364
E01018484,2246,1096,1150,0.4879786286731968,0.5120213713268033
E01018485,1563,780,783,0.4990403071017274,0.5009596928982726
E01018499,1478,748,730,0.5060893098782138,0.4939106901217862
E01018500,1147,567,580,0.4943330427201395,0.5056669572798606
E01018501,1516,773,743,0.5098944591029023,0.4901055408970976
E01018502,1426,603,823,0.4228611500701262,0.5771388499298737
E01018462,1926,970,956,0.5036344755970924,0.4963655244029076
E01018464,1552,793,759,0.5109536082474226,0.4890463917525773
E01018496,1613,826,787,0.5120892746435214,0.4879107253564786
E01018497,1214,640,574,0.5271828665568369,0.4728171334431631
E01018498,1675,783,892,0.46746268656716417,0.5325373134328358
E01018468,1503,732,771,0.4870259481037924,0.5129740518962076
E01018469,1747,845,902,0.48368631940469375,0.5163136805953062
E01018470,1939,950,989,0.48994326972666324,0.5100567302733368
E01018471,1388,686,702,0.4942363112391931,0.5057636887608069
E01034671,1258,618,640,0.4912559618441971,0.5087440381558028
E01034672,1023,489,534,0.4780058651026393,0.5219941348973607
E01034673,1291,656,635,0.5081332300542215,0.4918667699457785
E01018486,1587,924,663,0.5822306238185255,0.41776937618147447
E01018487,1753,961,792,0.5482030804335425,0.4517969195664575
E01018488,1614,814,800,0.5043370508054523,0.49566294919454773
E01018489,1632,1018,614,0.6237745098039216,0.3762254901960784
E01018510,1703,813,890,0.4773928361714621,0.5226071638285379
E01018511,1406,698,708,0.49644381223328593,0.5035561877667141
E01018512,1703,819,884,0.48091603053435117,0.5190839694656488
E01018513,1544,767,777,0.49676165803108807,0.5032383419689119
E01018445,1939,1001,938,0.516245487364621,0.48375451263537905
E01018446,1479,679,800,0.45909398242055444,0.5409060175794456
E01018447,1966,1052,914,0.5350966429298067,0.4649033570701933
E01018448,1682,857,825,0.509512485136742,0.49048751486325803
E01018490,1755,884,871,0.5037037037037037,0.4962962962962963
E01018491,1623,753,870,0.46395563770794823,0.5360443622920518
E01018492,1064,516,548,0.4849624060150376,0.5150375939849624
E01018505,1257,629,628,0.5003977724741447,0.4996022275258552
E01018506,1299,644,655,0.49576597382602,0.5042340261739799
E01018507,1316,657,659,0.4992401215805471,0.5007598784194529
E01018451,1306,618,688,0.47320061255742724,0.5267993874425727
E01018454,1560,776,784,0.49743589743589745,0.5025641025641026
E01018455,1334,641,693,0.48050974512743627,0.5194902548725637
E01018456,1298,591,707,0.45531587057010786,0.5446841294298922
E01018457,1469,679,790,0.4622191967324711,0.537780803267529
E01018493,1346,640,706,0.475482912332838,0.524517087667162
E01018494,2714,1328,1386,0.48931466470154755,0.5106853352984525
E01018495,1541,745,796,0.4834523036988968,0.5165476963011032
E01018508,1440,715,725,0.4965277777777778,0.5034722222222222
E01018509,1181,555,626,0.46994072819644367,0.5300592718035563
E01018452,1095,526,569,0.480365296803653,0.5196347031963471
E01018503,1720,796,924,0.4627906976744186,0.5372093023255814
E01018504,1652,785,867,0.475181598062954,0.524818401937046
E01033372,1161,572,589,0.4926787252368648,0.5073212747631353
E01033373,1456,770,686,0.5288461538461539,0.47115384615384615
E01018449,1747,846,901,0.4842587292501431,0.5157412707498569
E01018450,2667,1330,1337,0.49868766404199477,0.5013123359580053
E01018458,2287,1129,1158,0.49365981635330125,0.5063401836466987
E01018481,2023,1000,1023,0.49431537320810676,0.5056846267918932
E01018514,2110,1027,1083,0.4867298578199052,0.5132701421800948
E01018585,1372,669,703,0.48760932944606417,0.5123906705539358
E01018586,1963,1004,959,0.5114620478858889,0.48853795211411105
E01018587,1608,793,815,0.4931592039800995,0.5068407960199005
E01018661,1202,610,592,0.5074875207986689,0.4925124792013311
E01018657,1140,538,602,0.47192982456140353,0.5280701754385965
E01018662,1201,569,632,0.47377185678601164,0.5262281432139884
E01018663,1571,741,830,0.4716740929344367,0.5283259070655634
E01018664,1375,676,699,0.49163636363636365,0.5083636363636364
E01018665,1148,537,611,0.46777003484320556,0.5322299651567944
E01018655,1571,726,845,0.4621260343730108,0.5378739656269892
E01018658,1181,560,621,0.4741744284504657,0.5258255715495342
E01018659,1218,584,634,0.4794745484400657,0.5205254515599343
E01034658,2460,1182,1278,0.48048780487804876,0.5195121951219512
E01018582,2373,1193,1180,0.5027391487568479,0.4972608512431521
E01018592,1778,881,897,0.4955005624296963,0.5044994375703037
E01018593,1781,885,896,0.49691184727681076,0.5030881527231892
E01018594,1770,917,853,0.5180790960451978,0.48192090395480225
E01018595,1702,853,849,0.5011750881316098,0.4988249118683901
E01018596,2049,1010,1039,0.49292337725719865,0.5070766227428014
E01018583,1871,892,979,0.4767504008551577,0.5232495991448424
E01018584,1948,992,956,0.5092402464065708,0.49075975359342916
E01018612,1378,692,686,0.502177068214804,0.49782293178519593
E01018613,1584,738,846,0.4659090909090909,0.5340909090909091
E01018600,1708,840,868,0.4918032786885246,0.5081967213114754
E01018601,1822,858,964,0.47091108671789245,0.5290889132821076
E01018602,1780,902,878,0.5067415730337078,0.49325842696629213
E01018652,1552,762,790,0.49097938144329895,0.509020618556701
E01018598,1918,992,926,0.5172054223149114,0.48279457768508866
E01018599,1147,541,606,0.47166521360069746,0.5283347863993025
E01018648,2379,1193,1186,0.5014712063892391,0.4985287936107608
E01018649,1390,654,736,0.47050359712230216,0.5294964028776978
E01018650,1730,849,881,0.4907514450867052,0.5092485549132948
E01018651,1557,641,916,0.41168914579319205,0.588310854206808
E01018654,2427,1224,1203,0.5043263288009888,0.4956736711990111
E01018588,1522,727,795,0.4776609724047306,0.5223390275952694
E01018589,1614,800,814,0.49566294919454773,0.5043370508054523
E01018590,1970,960,1010,0.4873096446700508,0.5126903553299492
E01018653,2186,1047,1139,0.47895699908508693,0.5210430009149131
E01018605,1097,520,577,0.4740200546946217,0.5259799453053783
E01018609,1718,807,911,0.46973224679860304,0.530267753201397
E01018610,1952,945,1007,0.48411885245901637,0.5158811475409836
E01018611,1660,819,841,0.49337349397590363,0.5066265060240964
E01018666,1804,910,894,0.5044345898004434,0.4955654101995565
E01018667,1627,741,886,0.45543945912722805,0.544560540872772
E01018668,1835,867,968,0.47247956403269753,0.5275204359673025
E01018603,1336,648,688,0.48502994011976047,0.5149700598802395
E01018604,1383,663,720,0.4793926247288503,0.5206073752711496
E01018606,1474,655,819,0.4443690637720488,0.5556309362279511
E01018607,1278,625,653,0.4890453834115806,0.5109546165884195
E01018608,1358,679,679,0.5,0.5
E01018572,1784,846,938,0.4742152466367713,0.5257847533632287
E01018573,1485,709,776,0.47744107744107744,0.5225589225589226
E01018574,1998,927,1071,0.46396396396396394,0.536036036036036
E01018580,1783,863,920,0.48401570386988224,0.5159842961301178
E01018581,1528,726,802,0.47513089005235604,0.524869109947644
E01018575,1320,653,667,0.4946969696969697,0.5053030303030303
E01018576,1794,884,910,0.4927536231884058,0.5072463768115942
E01018577,2358,1150,1208,0.48770144189991516,0.5122985581000848
E01018578,1222,601,621,0.4918166939443535,0.5081833060556464
E01018579,1249,590,659,0.4723779023218575,0.5276220976781425
E01018641,1582,779,803,0.49241466498103664,0.5075853350189633
E01018642,1307,642,665,0.4912012241775057,0.5087987758224942
E01018643,2007,993,1014,0.4947683109118087,0.5052316890881914
E01018644,1357,649,708,0.4782608695652174,0.5217391304347826
E01018614,1798,874,924,0.4860956618464961,0.5139043381535039
E01018618,1522,686,836,0.4507227332457293,0.5492772667542707
E01018619,1519,737,782,0.48518762343647137,0.5148123765635286
E01018620,1468,672,796,0.45776566757493187,0.5422343324250681
E01018621,1358,654,704,0.48159057437407954,0.5184094256259205
E01018628,1550,759,791,0.4896774193548387,0.5103225806451613
E01018629,1891,903,988,0.4775251189846642,0.5224748810153358
E01018630,1287,616,671,0.47863247863247865,0.5213675213675214
E01018631,1341,697,644,0.5197613721103654,0.4802386278896346
E01034659,1272,617,655,0.485062893081761,0.514937106918239
E01034660,1079,550,529,0.5097312326227988,0.4902687673772011
E01018615,1216,609,607,0.5008223684210527,0.49917763157894735
E01018616,1535,722,813,0.4703583061889251,0.529641693811075
E01018617,1353,675,678,0.49889135254988914,0.5011086474501109
E01018632,1729,858,871,0.49624060150375937,0.5037593984962406
E01018633,1492,721,771,0.4832439678284182,0.5167560321715817
E01018622,1316,651,665,0.4946808510638298,0.5053191489361702
E01018623,1438,699,739,0.4860917941585535,0.5139082058414465
E01018624,1982,1033,949,0.5211907164480323,0.4788092835519677
E01018625,1435,717,718,0.49965156794425086,0.5003484320557491
E01018627,1696,892,804,0.5259433962264151,0.4740566037735849
E01018635,1181,584,597,0.4944961896697714,0.5055038103302286
E01018636,1370,644,726,0.47007299270072994,0.5299270072992701
E01018634,1837,933,904,0.50789330430049,0.49210669569951004
E01018645,1765,843,922,0.4776203966005666,0.5223796033994335
E01018646,1740,809,931,0.4649425287356322,0.5350574712643679
E01018647,1520,750,770,0.4934210526315789,0.506578947368421
E01018591,2368,1154,1214,0.4873310810810811,0.512668918918919
E01018669,2540,1256,1284,0.494488188976378,0.5055118110236221
E01018670,2326,1143,1183,0.49140154772141015,0.5085984522785899
E01034661,1035,520,515,0.5024154589371981,0.4975845410628019
E01034662,1919,946,973,0.49296508598228245,0.5070349140177176
E01018637,1848,873,975,0.4724025974025974,0.5275974025974026
E01018638,1536,717,819,0.466796875,0.533203125
E01018639,1566,765,801,0.4885057471264368,0.5114942528735632
E01018640,1258,621,637,0.49364069952305245,0.5063593004769475
E01034674,1553,788,765,0.5074050225370251,0.49259497746297487
E01034675,2058,921,1137,0.44752186588921283,0.5524781341107872
E01034676,1079,534,545,0.494902687673772,0.505097312326228
E01034677,1371,695,676,0.5069292487235595,0.49307075127644057
E01034678,1345,654,691,0.4862453531598513,0.5137546468401487
E01018515,2338,1200,1138,0.5132591958939264,0.48674080410607357
E01018516,1570,774,796,0.4929936305732484,0.5070063694267516
E01033375,2061,999,1062,0.4847161572052402,0.5152838427947598
E01033376,1158,567,591,0.4896373056994819,0.5103626943005182
E01033378,1510,749,761,0.4960264900662252,0.5039735099337749
E01018308,2014,969,1045,0.4811320754716981,0.5188679245283019
E01018336,1214,592,622,0.4876441515650741,0.5123558484349259
E01018337,1285,647,638,0.5035019455252918,0.4964980544747082
E01018338,1757,846,911,0.4815025611838361,0.518497438816164
E01018358,1316,604,712,0.45896656534954405,0.541033434650456
E01018359,1073,552,521,0.5144454799627214,0.48555452003727867
E01018360,2771,1617,1154,0.5835438469866474,0.4164561530133526
E01018366,1477,715,762,0.48408937034529453,0.5159106296547055
E01018367,2112,1009,1103,0.4777462121212121,0.5222537878787878
E01018364,1565,742,823,0.4741214057507987,0.5258785942492012
E01018365,1983,914,1069,0.46091780131114474,0.5390821986888553
E01018378,1259,571,688,0.45353455123113584,0.5464654487688642
E01018379,1370,669,701,0.48832116788321167,0.5116788321167883
E01018380,1132,542,590,0.4787985865724382,0.5212014134275619
E01018362,1541,770,771,0.49967553536664505,0.500324464633355
E01018363,1012,475,537,0.46936758893280633,0.5306324110671937
E01018374,1778,871,907,0.4898762654668167,0.5101237345331834
E01018375,1783,930,853,0.5215928210880538,0.4784071789119462
E01018376,1759,833,926,0.47356452529846504,0.526435474701535
E01018377,2128,1036,1092,0.4868421052631579,0.5131578947368421
E01018309,1623,769,854,0.4738139248305607,0.5261860751694393
E01018310,1680,793,887,0.4720238095238095,0.5279761904761905
E01018311,1421,650,771,0.4574243490499648,0.5425756509500352
E01018312,1519,737,782,0.48518762343647137,0.5148123765635286
E01018313,1414,682,732,0.4823196605374823,0.5176803394625177
E01018314,1688,800,888,0.47393364928909953,0.5260663507109005
E01018315,1217,602,615,0.49465899753492193,0.5053410024650781
E01018316,1450,695,755,0.4793103448275862,0.5206896551724138
E01018317,1572,803,769,0.5108142493638677,0.4891857506361323
E01018349,1771,837,934,0.47261434217955955,0.5273856578204404
E01018350,2182,1058,1124,0.4848762603116407,0.5151237396883593
E01018368,1531,720,811,0.47028086218158066,0.5297191378184193
E01018370,1641,801,840,0.48811700182815354,0.5118829981718465
E01018345,1327,649,678,0.48907309721175585,0.5109269027882442
E01018346,1480,727,753,0.4912162162162162,0.5087837837837837
E01018347,1382,650,732,0.4703328509406657,0.5296671490593343
E01018383,1478,699,779,0.472936400541272,0.527063599458728
E01018384,1453,703,750,0.48382656572608396,0.516173434273916
E01018343,1528,761,767,0.4980366492146597,0.5019633507853403
E01018361,1432,707,725,0.4937150837988827,0.5062849162011173
E01032930,2150,1080,1070,0.5023255813953489,0.49767441860465117
E01032931,1106,613,493,0.554249547920434,0.445750452079566
E01035373,1230,598,632,0.4861788617886179,0.5138211382113821
E01035374,1122,573,549,0.5106951871657754,0.4893048128342246
E01018328,1523,722,801,0.47406434668417596,0.525935653315824
E01018330,1366,627,739,0.45900439238653,0.54099560761347
E01018331,1612,785,827,0.4869727047146402,0.5130272952853598
E01035375,1324,580,744,0.4380664652567976,0.5619335347432024
E01035376,1547,836,711,0.5404007756948933,0.45959922430510664
E01035377,1659,792,867,0.47739602169981915,0.5226039783001808
E01035378,1214,591,623,0.4868204283360791,0.5131795716639209
E01018319,2213,1111,1102,0.5020334387708992,0.49796656122910077
E01018344,1828,910,918,0.49781181619256015,0.5021881838074398
E01018381,1241,629,612,0.5068493150684932,0.4931506849315068
E01018382,1632,788,844,0.48284313725490197,0.5171568627450981
E01018323,1505,729,776,0.48438538205980064,0.5156146179401994
E01018324,1377,687,690,0.4989106753812636,0.5010893246187363
E01018325,1461,733,728,0.5017111567419575,0.49828884325804246
E01018385,2000,961,1039,0.4805,0.5195
E01018320,1472,697,775,0.4735054347826087,0.5264945652173914
E01018321,1277,612,665,0.4792482380579483,0.5207517619420516
E01018322,1106,522,584,0.4719710669077758,0.5280289330922242
E01035379,1384,683,701,0.4934971098265896,0.5065028901734104
E01035380,1618,758,860,0.4684796044499382,0.5315203955500618
E01035381,1443,707,736,0.48995148995148996,0.51004851004851
E01018332,1062,530,532,0.4990583804143126,0.5009416195856874
E01018333,1545,743,802,0.4809061488673139,0.5190938511326861
E01018334,1622,770,852,0.4747225647348952,0.5252774352651048
E01018340,1650,763,887,0.4624242424242424,0.5375757575757576
E01018341,1109,553,556,0.49864743011722273,0.5013525698827773
E01018342,1828,907,921,0.4961706783369803,0.5038293216630197
E01018351,1472,737,735,0.5006793478260869,0.499320652173913
E01018352,1906,957,949,0.5020986358866737,0.49790136411332636
E01018353,1512,737,775,0.48743386243386244,0.5125661375661376
E01018354,1627,765,862,0.47019053472649047,0.5298094652735095
E01018335,2193,1082,1111,0.49338805289557686,0.5066119471044231
E01018369,1697,790,907,0.4655274012964054,0.5344725987035945
E01018371,2131,1041,1090,0.48850305021116847,0.5114969497888315
E01018372,2168,1058,1110,0.48800738007380073,0.5119926199261993
E01018339,2625,1233,1392,0.4697142857142857,0.5302857142857142
E01018355,1358,625,733,0.46023564064801176,0.5397643593519882
E01018356,1657,790,867,0.4767652383826192,0.5232347616173808
E01018357,1931,949,982,0.49145520455722425,0.5085447954427758
E01018373,2203,1113,1090,0.5052201543349978,0.49477984566500227
E01018534,2480,1227,1253,0.494758064516129,0.505241935483871
E01018535,1665,764,901,0.45885885885885885,0.5411411411411411
E01018536,1720,828,892,0.4813953488372093,0.5186046511627908
E01018537,2046,984,1062,0.4809384164222874,0.5190615835777126
E01018518,1563,753,810,0.4817658349328215,0.5182341650671785
E01018569,1315,636,679,0.48365019011406846,0.5163498098859316
E01018570,1399,683,716,0.4882058613295211,0.511794138670479
E01018571,1349,642,707,0.4759080800593032,0.5240919199406968
E01018546,1561,746,815,0.47789878283151827,0.5221012171684818
E01018547,1316,626,690,0.4756838905775076,0.5243161094224924
E01018548,2107,1014,1093,0.4812529663028002,0.5187470336971998
E01018549,1451,744,707,0.512749827705031,0.487250172294969
E01018532,1884,901,983,0.47823779193205945,0.5217622080679406
E01018533,1460,718,742,0.4917808219178082,0.5082191780821917
E01018544,1425,695,730,0.48771929824561405,0.512280701754386
E01018545,1867,882,985,0.4724156400642742,0.5275843599357257
E01018519,1412,714,698,0.5056657223796034,0.4943342776203966
E01018520,1977,1011,966,0.511380880121396,0.48861911987860396
E01018525,1782,837,945,0.4696969696969697,0.5303030303030303
E01035365,1247,638,609,0.5116279069767442,0.4883720930232558
E01035366,2034,1025,1009,0.5039331366764995,0.4960668633235005
E01035367,1332,638,694,0.47897897897897895,0.521021021021021
E01035368,1234,586,648,0.47487844408427876,0.5251215559157212
E01018523,1363,666,697,0.4886280264123258,0.5113719735876743
E01018524,1503,709,794,0.4717232202262142,0.5282767797737857
E01018541,1373,685,688,0.4989075018208303,0.5010924981791697
E01018542,1339,611,728,0.4563106796116505,0.5436893203883495
E01018543,1291,611,680,0.47327652982184354,0.5267234701781565
E01018528,1718,819,899,0.4767171129220023,0.5232828870779976
E01018529,1355,660,695,0.4870848708487085,0.5129151291512916
E01018530,1452,723,729,0.49793388429752067,0.5020661157024794
E01018531,1568,768,800,0.4897959183673469,0.5102040816326531
E01018560,1134,551,583,0.4858906525573192,0.5141093474426808
E01018561,1191,614,577,0.5155331654072208,0.48446683459277917
E01018562,1393,674,719,0.4838478104809763,0.5161521895190236
E01018522,1461,691,770,0.4729637234770705,0.5270362765229295
E01018538,1209,608,601,0.5028949545078577,0.49710504549214224
E01018539,1195,560,635,0.4686192468619247,0.5313807531380753
E01018540,1435,693,742,0.48292682926829267,0.5170731707317073
E01018521,1371,641,730,0.4675419401896426,0.5324580598103574
E01018550,1120,520,600,0.4642857142857143,0.5357142857142857
E01018551,1583,770,813,0.48641819330385344,0.5135818066961465
E01018552,2669,1233,1436,0.46197077557137506,0.538029224428625
E01018553,1815,862,953,0.474931129476584,0.525068870523416
E01018556,1419,682,737,0.4806201550387597,0.5193798449612403
E01018557,1409,661,748,0.4691270404542229,0.5308729595457772
E01018558,1151,587,564,0.5099913119026933,0.4900086880973067
E01018559,1112,561,551,0.5044964028776978,0.49550359712230213
E01018565,1601,799,802,0.4990630855715178,0.5009369144284822
E01018566,1270,605,665,0.4763779527559055,0.5236220472440944
E01018567,1436,717,719,0.49930362116991645,0.5006963788300836
E01018568,1490,754,736,0.5060402684563758,0.49395973154362416
E01018526,1603,750,853,0.4678727386150967,0.5321272613849033
E01018527,1591,762,829,0.47894406033940917,0.5210559396605908
E01018554,2176,1060,1116,0.48713235294117646,0.5128676470588235
E01018555,1108,552,556,0.4981949458483754,0.5018050541516246
E01018685,1322,624,698,0.4720121028744327,0.5279878971255674
E01018686,1482,706,776,0.47638326585695007,0.5236167341430499
E01018687,1305,626,679,0.4796934865900383,0.5203065134099617
E01018688,1555,787,768,0.5061093247588424,0.49389067524115754
E01018689,1390,642,748,0.4618705035971223,0.5381294964028777
E01018690,2123,1035,1088,0.4875176636834668,0.5124823363165332
E01018675,2048,1020,1028,0.498046875,0.501953125
E01018708,2147,1066,1081,0.49650675360968793,0.503493246390312
E01018721,2252,1083,1169,0.4809058614564831,0.5190941385435168
E01018671,1225,613,612,0.5004081632653061,0.4995918367346939
E01018672,1749,866,883,0.49514008004574045,0.5048599199542596
E01018673,1169,554,615,0.4739093242087254,0.5260906757912746
E01018674,1559,789,770,0.5060936497754971,0.4939063502245029
E01018684,2320,1159,1161,0.4995689655172414,0.5004310344827586
E01018695,2001,943,1058,0.47126436781609193,0.5287356321839081
E01018696,1482,702,780,0.47368421052631576,0.5263157894736842
E01018697,1790,861,929,0.4810055865921788,0.5189944134078213
E01018698,2005,968,1037,0.4827930174563591,0.517206982543641
E01018704,1389,676,713,0.4866810655147588,0.5133189344852411
E01018705,1471,718,753,0.48810333106730114,0.5118966689326988
E01018706,1916,908,1008,0.47390396659707723,0.5260960334029228
E01018718,1850,933,917,0.5043243243243243,0.49567567567567566
E01018722,2636,1294,1342,0.49089529590288317,0.5091047040971168
E01018714,1978,962,1016,0.4863498483316481,0.5136501516683518
E01018715,1670,877,793,0.5251497005988024,0.4748502994011976
E01035369,1151,552,599,0.4795829713292789,0.5204170286707211
E01035370,1629,804,825,0.49355432780847147,0.5064456721915286
E01035371,1170,580,590,0.49572649572649574,0.5042735042735043
E01035372,1558,762,796,0.4890885750962773,0.5109114249037228
E01018726,1530,751,779,0.49084967320261436,0.5091503267973856
E01018727,1756,862,894,0.4908883826879271,0.5091116173120729
E01018728,1620,791,829,0.4882716049382716,0.5117283950617284
E01018729,1675,816,859,0.4871641791044776,0.5128358208955224
E01018709,1463,735,728,0.5023923444976076,0.49760765550239233
E01018710,1419,712,707,0.5017618040873855,0.49823819591261453
E01018711,1471,744,727,0.5057783820530252,0.49422161794697483
E01018712,1492,750,742,0.5026809651474531,0.4973190348525469
E01018699,1541,745,796,0.4834523036988968,0.5165476963011032
E01018701,1436,660,776,0.4596100278551532,0.5403899721448467
E01018716,1553,778,775,0.5009658725048294,0.4990341274951706
E01018717,1720,875,845,0.5087209302325582,0.49127906976744184
E01018719,1471,738,733,0.5016995241332427,0.4983004758667573
E01018720,1752,874,878,0.4988584474885845,0.5011415525114156
E01018691,1632,810,822,0.4963235294117647,0.5036764705882353
E01018693,2042,1013,1029,0.4960822722820764,0.5039177277179236
E01018694,2211,1070,1141,0.4839439167797377,0.5160560832202623
E01018700,1862,916,946,0.49194414607948445,0.5080558539205156
E01018702,1475,718,757,0.48677966101694914,0.5132203389830509
E01018703,1973,989,984,0.5012671059300557,0.49873289406994425
E01018676,1856,907,949,0.4886853448275862,0.5113146551724138
E01018677,1658,823,835,0.49638118214716526,0.5036188178528347
E01018678,1267,616,651,0.4861878453038674,0.5138121546961326
E01018679,2195,1090,1105,0.49658314350797267,0.5034168564920274
E01018692,1953,971,982,0.4971838197644649,0.5028161802355351
E01018680,1703,831,872,0.4879624192601292,0.5120375807398708
E01018681,1658,808,850,0.4873341375150784,0.5126658624849216
E01018682,1306,655,651,0.501531393568147,0.498468606431853
E01018683,1782,858,924,0.48148148148148145,0.5185185185185185
E01018733,1388,660,728,0.4755043227665706,0.5244956772334294
E01018734,1239,586,653,0.47296206618240516,0.5270379338175948
E01018748,1431,714,717,0.4989517819706499,0.5010482180293501
E01018749,2501,1270,1231,0.507796881247501,0.492203118752499
E01018736,1750,875,875,0.5,0.5
E01018737,2166,1073,1093,0.4953831948291782,0.5046168051708217
E01018743,1333,674,659,0.5056264066016504,0.4943735933983496
E01018744,1680,824,856,0.49047619047619045,0.5095238095238095
E01018732,1319,656,663,0.4973464746019712,0.5026535253980288
E01018745,1569,763,806,0.4862970044614404,0.5137029955385596
E01018746,1891,931,960,0.4923320994182972,0.5076679005817029
E01018747,1708,864,844,0.5058548009367682,0.49414519906323184
E01018730,1461,688,773,0.47091033538672145,0.5290896646132786
E01018738,1844,845,999,0.4582429501084599,0.5417570498915402
E01018739,2032,994,1038,0.4891732283464567,0.5108267716535433
E01018741,1179,601,578,0.5097540288379983,0.4902459711620017
E01018731,1974,961,1013,0.4868287740628166,0.5131712259371833
E01018735,1218,617,601,0.506568144499179,0.493431855500821
E01018740,1505,693,812,0.4604651162790698,0.5395348837209303
E01018742,2363,1187,1176,0.502327549724926,0.49767245027507406
E01018707,1751,851,900,0.48600799543118217,0.5139920045688178
E01018723,1446,706,740,0.48824343015214383,0.5117565698478561
E01018724,1766,847,919,0.4796149490373726,0.5203850509626274
E01018725,1471,748,723,0.5084976206662135,0.49150237933378654
E01019126,1622,785,837,0.4839704069050555,0.5160295930949446
E01019127,1539,734,805,0.47693307342430147,0.5230669265756985
E01019132,1803,896,907,0.49694952856350527,0.5030504714364947
E01019134,1360,646,714,0.475,0.525
E01019135,1583,752,831,0.4750473783954517,0.5249526216045484
E01019136,2037,986,1051,0.4840451644575356,0.5159548355424645
E01019137,1033,481,552,0.46563407550822844,0.5343659244917716
E01019083,1813,881,932,0.4859349145063431,0.5140650854936569
E01019107,1541,780,761,0.5061648280337443,0.4938351719662557
E01019130,1780,889,891,0.499438202247191,0.500561797752809
E01019131,1866,912,954,0.4887459807073955,0.5112540192926045
E01019081,1850,897,953,0.48486486486486485,0.5151351351351351
E01019082,1490,729,761,0.489261744966443,0.5107382550335571
E01019102,1606,802,804,0.49937733499377335,0.5006226650062267
E01019128,1639,813,826,0.4960341671751068,0.5039658328248933
E01019133,1525,783,742,0.5134426229508197,0.48655737704918034
E01019093,1557,751,806,0.48233782915863843,0.5176621708413616
E01019094,2131,1045,1086,0.4903801032379165,0.5096198967620835
E01019096,2142,1049,1093,0.48972922502334265,0.5102707749766573
E01019114,1440,717,723,0.4979166666666667,0.5020833333333333
E01019115,1554,789,765,0.5077220077220077,0.4922779922779923
E01019095,1385,659,726,0.47581227436823104,0.524187725631769
E01019097,1812,871,941,0.4806843267108168,0.5193156732891833
E01019098,1636,774,862,0.4731051344743276,0.5268948655256723
E01019099,1716,821,895,0.4784382284382284,0.5215617715617715
E01019084,1604,789,815,0.4918952618453865,0.5081047381546134
E01019085,1944,914,1030,0.47016460905349794,0.529835390946502
E01019086,1060,540,520,0.5094339622641509,0.49056603773584906
E01019088,1839,877,962,0.476889613920609,0.523110386079391
E01019091,1747,856,891,0.4899828277046365,0.5100171722953635
E01019078,1435,718,717,0.5003484320557491,0.49965156794425086
E01019079,1387,684,703,0.4931506849315068,0.5068493150684932
E01019080,1918,938,980,0.48905109489051096,0.5109489051094891
E01019087,1580,741,839,0.4689873417721519,0.5310126582278482
E01019090,1412,711,701,0.5035410764872521,0.4964589235127479
E01019116,1134,578,556,0.5097001763668431,0.49029982363315694
E01019118,1274,642,632,0.5039246467817896,0.49607535321821034
E01019122,1357,700,657,0.5158437730287398,0.48415622697126015
E01019123,1789,874,915,0.48854108440469535,0.5114589155953047
E01019124,1971,978,993,0.4961948249619482,0.5038051750380518
E01019125,1444,709,735,0.4909972299168975,0.5090027700831025
E01019111,1872,905,967,0.48344017094017094,0.5165598290598291
E01019112,1684,827,857,0.4910926365795725,0.5089073634204275
E01019113,1676,801,875,0.4779236276849642,0.5220763723150358
E01019120,1541,759,782,0.4925373134328358,0.5074626865671642
E01019121,1838,961,877,0.5228509249183896,0.4771490750816104
E01019108,1533,707,826,0.4611872146118721,0.5388127853881278
E01019109,1735,834,901,0.4806916426512968,0.5193083573487032
E01019110,1585,746,839,0.47066246056782335,0.5293375394321767
E01019117,1353,687,666,0.5077605321507761,0.49223946784922396
E01019119,1463,737,726,0.5037593984962406,0.49624060150375937
E01019089,1617,781,836,0.48299319727891155,0.5170068027210885
E01019100,2064,1048,1016,0.5077519379844961,0.49224806201550386
E01019101,1436,712,724,0.4958217270194986,0.5041782729805014
E01019129,2120,1032,1088,0.4867924528301887,0.5132075471698113
E01019092,1409,710,699,0.5039034776437189,0.49609652235628104
E01019104,1359,612,747,0.4503311258278146,0.5496688741721855
E01019106,1400,685,715,0.48928571428571427,0.5107142857142857
E01034068,2111,1054,1057,0.4992894362861203,0.5007105637138797
E01019144,1390,713,677,0.5129496402877698,0.4870503597122302
E01019145,1985,1010,975,0.5088161209068011,0.491183879093199
E01019146,1304,635,669,0.4869631901840491,0.5130368098159509
E01019147,1503,738,765,0.49101796407185627,0.5089820359281437
E01019148,1318,655,663,0.4969650986342944,0.5030349013657056
E01019149,1444,714,730,0.49445983379501385,0.5055401662049861
E01019150,1501,736,765,0.49033977348434377,0.5096602265156562
E01019151,1468,709,759,0.4829700272479564,0.5170299727520435
E01019152,1335,658,677,0.49288389513108616,0.5071161048689139
E01019153,1005,491,514,0.48855721393034823,0.5114427860696518
E01019154,1289,611,678,0.474010861132661,0.525989138867339
E01019155,1342,634,708,0.47242921013412814,0.5275707898658718
E01019162,1547,733,814,0.4738202973497091,0.5261797026502909
E01019163,1251,630,621,0.5035971223021583,0.49640287769784175
E01019156,1389,696,693,0.5010799136069114,0.49892008639308855
E01019159,1181,580,601,0.4911092294665538,0.5088907705334462
E01019164,1523,745,778,0.4891661195009849,0.5108338804990151
E01019165,1415,701,714,0.49540636042402825,0.5045936395759717
E01019166,1247,611,636,0.48997594226142743,0.5100240577385726
E01019167,1362,641,721,0.47063142437591776,0.5293685756240822
E01019168,1313,663,650,0.504950495049505,0.49504950495049505
E01019169,1382,693,689,0.5014471780028944,0.49855282199710566
E01019170,1230,636,594,0.5170731707317073,0.48292682926829267
E01019171,1181,593,588,0.502116850127011,0.497883149872989
E01019161,2141,1058,1083,0.49416160672582904,0.5058383932741709
E01019176,1807,880,927,0.4869950193691201,0.51300498063088
E01019177,1446,704,742,0.48686030428769017,0.5131396957123098
E01019178,1527,749,778,0.4905042567125082,0.5094957432874918
E01019179,1180,602,578,0.5101694915254237,0.48983050847457626
E01019160,1363,687,676,0.504035216434336,0.495964783565664
E01019172,1266,642,624,0.5071090047393365,0.4928909952606635
E01019173,1134,578,556,0.5097001763668431,0.49029982363315694
E01019175,1473,676,797,0.4589273591310251,0.5410726408689749
E01034069,2021,981,1040,0.48540326571004455,0.5145967342899554
E01019141,1189,633,556,0.5323801513877208,0.46761984861227923
E01019142,1350,671,679,0.49703703703703705,0.502962962962963
E01019143,1452,741,711,0.5103305785123967,0.4896694214876033
E01019157,1307,669,638,0.5118592195868401,0.4881407804131599
E01019158,1110,549,561,0.4945945945945946,0.5054054054054054
E01019180,1688,835,853,0.4946682464454976,0.5053317535545023
E01019182,1408,722,686,0.5127840909090909,0.4872159090909091
E01019184,1343,679,664,0.505584512285927,0.49441548771407295
E01033160,2246,1087,1159,0.4839715048975957,0.5160284951024042
E01019138,1154,567,587,0.4913344887348354,0.5086655112651647
E01019139,1059,585,474,0.5524079320113314,0.4475920679886686
E01019185,1350,677,673,0.5014814814814815,0.4985185185185185
E01019186,1202,599,603,0.4983361064891847,0.5016638935108153
E01019187,1282,630,652,0.4914196567862715,0.5085803432137286
E01019226,1151,577,574,0.5013032145960035,0.49869678540399653
E01019227,1412,703,709,0.4978753541076487,0.5021246458923513
E01019228,1606,803,803,0.5,0.5
E01019229,1839,951,888,0.5171288743882545,0.4828711256117455
E01019200,1602,777,825,0.4850187265917603,0.5149812734082397
E01019201,1395,668,727,0.47885304659498207,0.5211469534050179
E01019202,1548,742,806,0.479328165374677,0.520671834625323
E01019225,1941,993,948,0.5115919629057187,0.4884080370942813
E01019188,1555,769,786,0.4945337620578778,0.5054662379421222
E01019189,1367,682,685,0.49890270665691294,0.5010972933430871
E01019190,1668,808,860,0.4844124700239808,0.5155875299760192
E01019191,1452,700,752,0.4820936639118457,0.5179063360881543
E01019244,1447,676,771,0.4671734623358673,0.5328265376641327
E01019196,1785,857,928,0.4801120448179272,0.5198879551820729
E01019238,1497,737,760,0.4923179692718771,0.5076820307281229
E01019240,2231,1121,1110,0.5024652622142537,0.4975347377857463
E01019241,1895,927,968,0.48918205804749343,0.5108179419525066
E01019243,1407,654,753,0.464818763326226,0.535181236673774
E01019251,2184,1037,1147,0.4748168498168498,0.5251831501831502
E01019192,1367,665,702,0.4864667154352597,0.5135332845647403
E01019195,1366,643,723,0.4707174231332357,0.5292825768667643
E01019203,2207,1081,1126,0.48980516538287266,0.5101948346171273
E01019254,1313,654,659,0.49809596344249807,0.5019040365575019
E01019255,1306,637,669,0.4877488514548239,0.5122511485451761
E01019204,1022,560,462,0.547945205479452,0.4520547945205479
E01019206,1672,890,782,0.5322966507177034,0.4677033492822967
E01019234,1361,669,692,0.49155033063923587,0.5084496693607642
E01019235,1370,677,693,0.49416058394160584,0.5058394160583941
E01019237,1363,663,700,0.48642699926632427,0.5135730007336757
E01019242,1235,601,634,0.48663967611336034,0.5133603238866397
E01019219,2158,1050,1108,0.4865616311399444,0.5134383688600556
E01019224,1965,959,1006,0.48804071246819336,0.5119592875318066
E01019239,1465,744,721,0.5078498293515359,0.49215017064846417
E01019249,1571,762,809,0.48504137492043287,0.5149586250795671
E01019250,1642,800,842,0.48721071863581,0.51278928136419
E01019205,1601,814,787,0.5084322298563397,0.4915677701436602
E01019207,1311,620,691,0.47292143401983217,0.5270785659801678
E01019215,1495,753,742,0.5036789297658862,0.4963210702341137
E01019218,1513,729,784,0.48182419035029744,0.5181758096497026
E01019233,1292,618,674,0.47832817337461303,0.521671826625387
E01019193,2004,951,1053,0.4745508982035928,0.5254491017964071
E01019194,2159,1026,1133,0.47522000926354796,0.5247799907364521
E01019230,1558,734,824,0.4711168164313222,0.5288831835686778
E01019231,1715,833,882,0.4857142857142857,0.5142857142857142
E01019232,1406,684,722,0.4864864864864865,0.5135135135135135
E01019252,1315,646,669,0.49125475285171105,0.508745247148289
E01019209,1363,679,684,0.49816581071166544,0.5018341892883346
E01019211,1521,767,754,0.5042735042735043,0.49572649572649574
E01019216,1733,838,895,0.4835545297172533,0.5164454702827467
E01019217,1565,809,756,0.5169329073482428,0.4830670926517572
E01019220,1519,760,759,0.500329163923634,0.49967083607636603
E01019236,1634,829,805,0.50734394124847,0.49265605875153
E01019197,2116,1031,1085,0.4872400756143667,0.5127599243856332
E01019198,1324,629,695,0.47507552870090636,0.5249244712990937
E01019199,1049,493,556,0.4699714013346044,0.5300285986653956
E01019221,1772,853,919,0.4813769751693002,0.5186230248306998
E01019222,1725,843,882,0.48869565217391303,0.5113043478260869
E01019245,1541,758,783,0.4918883841661259,0.5081116158338741
E01019208,1453,695,758,0.4783207157604955,0.5216792842395045
E01019210,1344,643,701,0.47842261904761907,0.5215773809523809
E01019246,1210,580,630,0.4793388429752066,0.5206611570247934
E01019247,1373,686,687,0.4996358339402768,0.5003641660597232
E01019248,1164,557,607,0.47852233676975947,0.5214776632302406
E01019212,1696,817,879,0.48172169811320753,0.5182783018867925
E01019223,1370,682,688,0.4978102189781022,0.5021897810218978
E01019253,1694,793,901,0.46812278630460447,0.5318772136953955
E01034070,1109,535,574,0.4824165915238954,0.5175834084761046
E01034071,1570,796,774,0.5070063694267516,0.4929936305732484
E01034072,1230,601,629,0.4886178861788618,0.5113821138211382
E01034073,1405,668,737,0.47544483985765124,0.5245551601423487
E01034074,1804,889,915,0.4927937915742794,0.5072062084257206
E01019269,1528,777,751,0.5085078534031413,0.49149214659685864
E01019270,1304,640,664,0.49079754601226994,0.50920245398773
E01034075,2358,1168,1190,0.4953350296861747,0.5046649703138253
E01019260,1416,712,704,0.5028248587570622,0.4971751412429379
E01019280,1448,818,630,0.5649171270718232,0.4350828729281768
E01019281,1118,557,561,0.49821109123434704,0.501788908765653
E01019282,1202,608,594,0.5058236272878536,0.49417637271214643
E01019261,1657,835,822,0.5039227519613759,0.496077248038624
E01019262,1598,803,795,0.5025031289111389,0.4974968710888611
E01019284,1154,551,603,0.47746967071057195,0.5225303292894281
E01019285,1365,664,701,0.48644688644688644,0.5135531135531135
E01019286,1318,637,681,0.48330804248861914,0.5166919575113809
E01019287,1082,551,531,0.5092421441774492,0.4907578558225508
E01019288,1338,680,658,0.5082212257100149,0.49177877428998507
E01019256,1375,696,679,0.5061818181818182,0.4938181818181818
E01019264,1765,874,891,0.4951841359773371,0.5048158640226629
E01019265,1263,630,633,0.498812351543943,0.501187648456057
E01019266,1369,655,714,0.4784514243973703,0.5215485756026297
E01019267,1214,569,645,0.4686985172981878,0.5313014827018122
E01019277,1193,583,610,0.4886839899413244,0.5113160100586757
E01019278,1370,681,689,0.49708029197080295,0.502919708029197
E01034076,2029,1030,999,0.507639231148349,0.4923607688516511
E01019291,1436,697,739,0.4853760445682451,0.5146239554317549
E01019292,1058,536,522,0.5066162570888468,0.4933837429111531
E01019294,1405,673,732,0.4790035587188612,0.5209964412811388
E01019295,1453,695,758,0.4783207157604955,0.5216792842395045
E01019296,1390,679,711,0.48848920863309353,0.5115107913669065
E01019301,1577,781,796,0.49524413443246673,0.5047558655675333
E01019302,1506,741,765,0.49203187250996017,0.5079681274900398
E01019271,1286,610,676,0.47433903576982894,0.5256609642301711
E01019272,1406,688,718,0.48933143669985774,0.5106685633001422
E01019273,1504,746,758,0.49601063829787234,0.5039893617021277
E01019274,1435,734,701,0.5114982578397212,0.48850174216027875
E01019275,2032,983,1049,0.483759842519685,0.5162401574803149
E01019257,1358,685,673,0.5044182621502209,0.4955817378497791
E01019258,1442,728,714,0.5048543689320388,0.49514563106796117
E01019279,1330,668,662,0.5022556390977444,0.49774436090225566
E01019300,1638,833,805,0.5085470085470085,0.49145299145299143
E01019303,1495,732,763,0.48963210702341137,0.5103678929765886
E01019304,1112,561,551,0.5044964028776978,0.49550359712230213
E01019259,1238,612,626,0.49434571890145396,0.505654281098546
E01019283,1549,917,632,0.591994835377663,0.408005164622337
E01019289,1279,642,637,0.5019546520719312,0.4980453479280688
E01019290,1052,522,530,0.49619771863117873,0.5038022813688213
E01019293,1275,618,657,0.48470588235294115,0.5152941176470588
E01019298,1461,726,735,0.49691991786447637,0.5030800821355236
E01019299,1899,920,979,0.48446550816219064,0.5155344918378094
E01019305,2026,991,1035,0.4891411648568608,0.5108588351431392
E01019314,1359,669,690,0.4922737306843267,0.5077262693156733
E01019320,1455,757,698,0.5202749140893471,0.47972508591065294
E01019321,1597,780,817,0.4884157795867251,0.5115842204132749
E01019315,1888,944,944,0.5,0.5
E01019316,1344,678,666,0.5044642857142857,0.4955357142857143
E01019322,1606,794,812,0.4943960149439601,0.5056039850560399
E01019338,1414,725,689,0.5127298444130127,0.4872701555869873
E01019327,1810,846,964,0.46740331491712706,0.532596685082873
E01019332,1325,623,702,0.470188679245283,0.5298113207547169
E01019333,1381,709,672,0.5133960897900073,0.4866039102099928
E01019335,1483,748,735,0.5043830074173972,0.49561699258260283
E01019336,1731,885,846,0.511265164644714,0.48873483535528595
E01019312,1623,812,811,0.5003080714725816,0.49969192852741834
E01019326,2159,1062,1097,0.491894395553497,0.508105604446503
E01019328,1427,686,741,0.48072880168185006,0.5192711983181499
E01019329,1103,540,563,0.48957388939256574,0.5104261106074343
E01019330,1490,732,758,0.4912751677852349,0.508724832214765
E01019331,1739,839,900,0.4824611845888442,0.5175388154111559
E01019334,1335,653,682,0.4891385767790262,0.5108614232209738
E01019308,1262,608,654,0.48177496038034867,0.5182250396196514
E01019311,1480,729,751,0.4925675675675676,0.5074324324324324
E01019313,1394,700,694,0.5021520803443329,0.49784791965566716
E01019339,1363,695,668,0.5099046221570066,0.4900953778429934
E01019306,1230,604,626,0.49105691056910566,0.5089430894308943
E01019307,2003,966,1037,0.4822765851223165,0.5177234148776835
E01019310,1459,735,724,0.5037697052775874,0.4962302947224126
E01019319,1635,822,813,0.5027522935779817,0.4972477064220184
E01019323,1231,605,626,0.49147034930950445,0.5085296506904955
E01019324,1331,663,668,0.49812171299774605,0.5018782870022539
E01019337,1329,654,675,0.49209932279909707,0.5079006772009029
E01019309,2357,1197,1160,0.5078489605430632,0.4921510394569368
E01019317,1325,663,662,0.5003773584905661,0.499622641509434
E01019318,1276,634,642,0.49686520376175547,0.5031347962382445
E01019325,1403,709,694,0.5053456878118318,0.4946543121881682
E01019340,1361,683,678,0.5018368846436444,0.4981631153563556
E01019374,1576,813,763,0.5158629441624365,0.48413705583756345
E01019375,1409,685,724,0.48616039744499645,0.5138396025550035
E01019376,1292,653,639,0.5054179566563467,0.49458204334365324
E01019395,1847,893,954,0.48348673524634544,0.5165132647536546
E01019387,2199,1071,1128,0.4870395634379263,0.5129604365620737
E01019396,1954,960,994,0.49129989764585463,0.5087001023541453
E01019397,1762,871,891,0.49432463110102154,0.5056753688989785
E01034077,2103,1014,1089,0.48216833095577744,0.5178316690442225
E01019346,1874,914,960,0.48772678762006405,0.512273212379936
E01019359,2616,1244,1372,0.47553516819571867,0.5244648318042814
E01019365,2111,1061,1050,0.5026054002842255,0.4973945997157745
E01019370,2277,1078,1199,0.47342995169082125,0.5265700483091788
E01019360,2061,1038,1023,0.5036390101892285,0.4963609898107715
E01019363,1906,949,957,0.49790136411332636,0.5020986358866737
E01019364,2061,1001,1060,0.48568655992236776,0.5143134400776322
E01019371,2292,1108,1184,0.48342059336823734,0.5165794066317626
E01019358,1780,843,937,0.47359550561797753,0.5264044943820225
E01019362,1846,875,971,0.4739978331527627,0.5260021668472372
E01019366,1709,848,861,0.4961966062024576,0.5038033937975425
E01019394,2317,1170,1147,0.5049633146309883,0.49503668536901163
E01019361,1792,880,912,0.49107142857142855,0.5089285714285714
E01019368,2217,1083,1134,0.4884979702300406,0.5115020297699594
E01019369,1934,929,1005,0.48035160289555323,0.5196483971044468
E01034078,1219,608,611,0.49876948318293685,0.5012305168170632
E01034079,1773,866,907,0.4884376762549351,0.5115623237450648
E01019356,1395,686,709,0.4917562724014337,0.5082437275985663
E01019381,2165,1081,1084,0.49930715935334874,0.5006928406466513
E01019386,1706,852,854,0.49941383352872215,0.5005861664712778
E01019344,1031,516,515,0.5004849660523764,0.49951503394762364
E01019345,1226,618,608,0.5040783034257749,0.49592169657422513
E01019350,1546,778,768,0.5032341526520052,0.49676584734799484
E01019351,1750,915,835,0.5228571428571429,0.47714285714285715
E01019372,1099,492,607,0.44767970882620567,0.5523202911737943
E01019373,1450,742,708,0.5117241379310344,0.4882758620689655
E01019384,2394,1240,1154,0.5179615705931495,0.48203842940685043
E01019385,1386,676,710,0.48773448773448774,0.5122655122655123
E01019348,1198,589,609,0.49165275459098495,0.508347245409015
E01019352,2191,1049,1142,0.478776814240073,0.521223185759927
E01019377,1892,923,969,0.48784355179704014,0.5121564482029598
E01019383,2155,1059,1096,0.491415313225058,0.508584686774942
E01019343,1492,723,769,0.48458445040214476,0.5154155495978552
E01019347,1751,843,908,0.4814391776127927,0.5185608223872074
E01019382,2225,1082,1143,0.48629213483146067,0.5137078651685393
E01034080,2502,1164,1338,0.46522781774580335,0.5347721822541966
E01019388,1937,957,980,0.4940629839958699,0.5059370160041301
E01019389,2336,1132,1204,0.4845890410958904,0.5154109589041096
E01019390,1981,986,995,0.4977284199899041,0.5022715800100959
E01019392,1852,953,899,0.5145788336933045,0.48542116630669546
E01019349,1891,904,987,0.4780539397144368,0.5219460602855632
E01019353,1523,729,794,0.47866053841103084,0.5213394615889692
E01019354,1329,641,688,0.4823175319789315,0.5176824680210684
E01019355,1424,635,789,0.44592696629213485,0.5540730337078652
E01019357,1774,867,907,0.4887260428410372,0.5112739571589628
E01019378,1541,752,789,0.4879948085658663,0.5120051914341337
E01019379,1481,718,763,0.48480756245779877,0.5151924375422012
E01019380,1183,564,619,0.47675401521555366,0.5232459847844463
E01019391,1743,850,893,0.4876649454962708,0.5123350545037292
E01019393,1972,981,991,0.4974645030425964,0.5025354969574036
E01024859,1472,703,769,0.47758152173913043,0.5224184782608695
E01024861,1241,599,642,0.48267526188557613,0.5173247381144238
E01024862,1482,745,737,0.5026990553306343,0.4973009446693657
E01024891,1986,947,1039,0.4768378650553877,0.5231621349446123
E01024892,1588,746,842,0.46977329974811083,0.5302267002518891
E01024894,1344,674,670,0.5014880952380952,0.49851190476190477
E01024893,1860,921,939,0.49516129032258066,0.5048387096774194
E01024896,1409,700,709,0.49680624556423,0.5031937544357701
E01024897,1552,757,795,0.4877577319587629,0.5122422680412371
E01024898,1880,954,926,0.5074468085106383,0.4925531914893617
E01024856,2085,1065,1020,0.5107913669064749,0.4892086330935252
E01024875,1925,1001,924,0.52,0.48
E01024876,1909,1017,892,0.532739654269251,0.4672603457307491
E01024877,2054,1091,963,0.5311587147030185,0.4688412852969815
E01024878,2005,1034,971,0.5157107231920199,0.48428927680798006
E01024895,1841,965,876,0.5241716458446496,0.47582835415535035
E01024883,1561,756,805,0.484304932735426,0.515695067264574
E01024884,1660,813,847,0.48975903614457833,0.5102409638554217
E01024885,1623,818,805,0.5040049291435613,0.4959950708564387
E01024886,1536,757,779,0.4928385416666667,0.5071614583333334
E01024889,1266,636,630,0.5023696682464455,0.4976303317535545
E01024890,1679,771,908,0.4592019058963669,0.5407980941036331
E01024879,1619,809,810,0.4996911673872761,0.5003088326127239
E01024880,1446,685,761,0.47372060857538034,0.5262793914246197
E01024912,1345,642,703,0.47732342007434947,0.5226765799256505
E01024913,1272,630,642,0.49528301886792453,0.5047169811320755
E01024914,1392,689,703,0.4949712643678161,0.5050287356321839
E01024881,1409,697,712,0.49467707594038324,0.5053229240596168
E01024882,1435,730,705,0.5087108013937283,0.4912891986062718
E01024902,1961,945,1016,0.4818969913309536,0.5181030086690463
E01024911,1841,899,942,0.48832156436719176,0.5116784356328082
E01024855,1440,701,739,0.48680555555555555,0.5131944444444444
E01024857,1556,718,838,0.461439588688946,0.538560411311054
E01024858,1714,858,856,0.5005834305717619,0.49941656942823803
E01024864,1598,784,814,0.490613266583229,0.509386733416771
E01024863,1555,745,810,0.4790996784565916,0.5209003215434084
E01024865,1403,671,732,0.4782608695652174,0.5217391304347826
E01024866,1709,829,880,0.48507899356348744,0.5149210064365126
E01024867,1361,651,710,0.47832476120499634,0.5216752387950037
E01024860,1368,687,681,0.5021929824561403,0.49780701754385964
E01024868,1164,581,583,0.4991408934707904,0.5008591065292096
E01024869,1394,685,709,0.4913916786226686,0.5086083213773315
E01024870,1149,554,595,0.4821583986074848,0.5178416013925152
E01024872,1590,750,840,0.4716981132075472,0.5283018867924528
E01024899,1681,812,869,0.4830458060678168,0.5169541939321832
E01024900,1726,835,891,0.48377752027809967,0.5162224797219004
E01024907,1382,712,670,0.5151953690303908,0.48480463096960924
E01024908,1548,791,757,0.5109819121447028,0.48901808785529716
E01024909,1690,886,804,0.5242603550295858,0.4757396449704142
E01024874,1028,506,522,0.49221789883268485,0.5077821011673151
E01024887,1544,761,783,0.49287564766839376,0.5071243523316062
E01024888,1891,944,947,0.4992067689053411,0.5007932310946589
E01024901,1729,842,887,0.4869866975130133,0.5130133024869867
E01024871,1286,635,651,0.4937791601866252,0.5062208398133748
E01024873,1357,662,695,0.48784082535003687,0.5121591746499632
E01024903,1279,595,684,0.4652071931196247,0.5347928068803753
E01024904,1848,905,943,0.4897186147186147,0.5102813852813853
E01024905,1269,637,632,0.5019700551615445,0.4980299448384555
E01024906,2261,1136,1125,0.5024325519681557,0.49756744803184433
E01024910,1445,724,721,0.501038062283737,0.49896193771626296
E01024951,1178,561,617,0.4762308998302207,0.5237691001697793
E01024952,1220,606,614,0.4967213114754098,0.5032786885245901
E01024953,1382,700,682,0.5065123010130246,0.4934876989869754
E01024954,1549,762,787,0.4919302775984506,0.5080697224015494
E01024921,1995,973,1022,0.48771929824561405,0.512280701754386
E01024978,1290,602,688,0.4666666666666667,0.5333333333333333
E01024979,1349,664,685,0.4922164566345441,0.507783543365456
E01024980,1335,638,697,0.4779026217228464,0.5220973782771535
E01024946,1217,595,622,0.48890714872637636,0.5110928512736237
E01024947,1305,659,646,0.5049808429118774,0.4950191570881226
E01024955,1374,687,687,0.5,0.5
E01024956,1917,967,950,0.504434011476265,0.495565988523735
E01024957,2599,1256,1343,0.48326279338207,0.51673720661793
E01024958,1323,658,665,0.4973544973544973,0.5026455026455027
E01024948,1691,849,842,0.5020697811945595,0.4979302188054406
E01024950,1345,672,673,0.4996282527881041,0.5003717472118959
E01024977,2691,1296,1395,0.4816053511705686,0.5183946488294314
E01034337,1842,902,940,0.48968512486427795,0.510314875135722
E01034338,1276,663,613,0.5195924764890282,0.48040752351097177
E01024967,1210,593,617,0.4900826446280992,0.5099173553719009
E01024968,2194,1072,1122,0.4886052871467639,0.5113947128532361
E01024969,1403,654,749,0.466143977191732,0.533856022808268
E01024970,1348,678,670,0.5029673590504451,0.4970326409495549
E01024971,1362,653,709,0.47944199706314244,0.5205580029368576
E01024972,1198,599,599,0.5,0.5
E01024930,1459,718,741,0.49211788896504455,0.5078821110349554
E01024931,1408,687,721,0.48792613636363635,0.5120738636363636
E01024933,1315,629,686,0.4783269961977186,0.5216730038022813
E01024937,1513,731,782,0.48314606741573035,0.5168539325842697
E01034339,2291,1142,1149,0.4984722828459188,0.5015277171540812
E01024964,1563,781,782,0.4996801023672425,0.5003198976327575
E01024974,1596,782,814,0.4899749373433584,0.5100250626566416
E01024975,3085,2428,657,0.787034035656402,0.21296596434359805
E01024976,1639,782,857,0.47712019524100063,0.5228798047589994
E01024920,1899,895,1004,0.47130068457082674,0.5286993154291733
E01024934,1682,819,863,0.4869203329369798,0.5130796670630202
E01024935,1350,631,719,0.4674074074074074,0.5325925925925926
E01034340,1694,821,873,0.4846517119244392,0.5153482880755608
E01034341,1627,790,837,0.4855562384757222,0.5144437615242778
E01034342,1698,856,842,0.5041224970553593,0.4958775029446408
E01034343,1379,671,708,0.4865844815083394,0.5134155184916607
E01024925,1737,846,891,0.48704663212435234,0.5129533678756477
E01024926,2438,1199,1239,0.4917965545529122,0.5082034454470877
E01024927,1617,817,800,0.505256648113791,0.49474335188620905
E01024928,1449,709,740,0.4893029675638371,0.5106970324361628
E01024936,1655,825,830,0.4984894259818731,0.5015105740181269
E01024938,2110,1044,1066,0.4947867298578199,0.5052132701421801
E01024939,2328,1152,1176,0.4948453608247423,0.5051546391752577
E01024940,1693,854,839,0.5044300059066745,0.49556999409332547
E01024941,1890,934,956,0.49417989417989416,0.5058201058201058
E01024923,1287,620,667,0.48174048174048173,0.5182595182595182
E01024924,1436,716,720,0.4986072423398329,0.5013927576601671
E01024963,1509,730,779,0.48376408217362493,0.5162359178263751
E01024965,1429,727,702,0.5087473757872638,0.4912526242127362
E01024966,1901,926,975,0.48711204629142557,0.5128879537085744
E01024942,1581,802,779,0.5072738772928527,0.4927261227071474
E01024943,2377,1175,1202,0.4943205721497686,0.5056794278502313
E01024944,2198,1072,1126,0.48771610555050043,0.5122838944494995
E01034344,1723,860,863,0.4991294254207777,0.5008705745792222
E01034345,1257,585,672,0.46539379474940334,0.5346062052505967
E01024922,1417,698,719,0.49258997882851097,0.507410021171489
E01024959,2000,947,1053,0.4735,0.5265
E01024960,1786,877,909,0.4910414333706607,0.5089585666293394
E01024961,1581,769,812,0.4864010120177103,0.5135989879822896
E01024962,1516,765,751,0.5046174142480211,0.4953825857519789
E01024915,2716,1302,1414,0.4793814432989691,0.520618556701031
E01024916,1717,832,885,0.48456610366919045,0.5154338963308096
E01024917,1727,849,878,0.4916039374638101,0.50839606253619
E01024918,1744,871,873,0.4994266055045872,0.5005733944954128
E01024973,2122,1058,1064,0.49858623939679547,0.5014137606032045
E01024993,1622,784,838,0.4833538840937115,0.5166461159062885
E01025026,1422,713,709,0.5014064697609001,0.49859353023909986
E01025027,1844,954,890,0.517353579175705,0.482646420824295
E01025028,1623,781,842,0.48120764017252005,0.51879235982748
E01025031,2000,984,1016,0.492,0.508
E01025007,1992,987,1005,0.4954819277108434,0.5045180722891566
E01025008,1120,572,548,0.5107142857142857,0.48928571428571427
E01025009,1554,760,794,0.48906048906048905,0.510939510939511
E01025011,1537,741,796,0.48210800260247233,0.5178919973975277
E01025012,2759,1368,1391,0.4958318231243204,0.5041681768756796
E01025013,1715,853,862,0.49737609329446064,0.5026239067055394
E01025019,1899,906,993,0.47709320695102686,0.5229067930489731
E01024998,1730,833,897,0.4815028901734104,0.5184971098265896
E01025010,1680,1039,641,0.618452380952381,0.381547619047619
E01025014,1751,901,850,0.5145631067961165,0.4854368932038835
E01025015,1510,735,775,0.4867549668874172,0.5132450331125827
E01025004,1328,651,677,0.49021084337349397,0.509789156626506
E01025006,1228,597,631,0.48615635179153094,0.5138436482084691
E01025023,1265,614,651,0.4853754940711462,0.5146245059288538
E01025024,2191,1037,1154,0.4732998630762209,0.5267001369237791
E01025025,1560,768,792,0.49230769230769234,0.5076923076923077
E01025001,2135,1046,1089,0.4899297423887588,0.5100702576112413
E01025002,1409,678,731,0.48119233498935415,0.5188076650106459
E01025005,1427,676,751,0.47372109320252276,0.5262789067974772
E01025016,2334,1136,1198,0.48671808054841476,0.5132819194515853
E01025018,1220,572,648,0.46885245901639344,0.5311475409836065
E01024984,1434,697,737,0.4860529986052999,0.5139470013947002
E01024985,1410,674,736,0.47801418439716314,0.5219858156028369
E01024986,1610,840,770,0.5217391304347826,0.4782608695652174
E01024987,1337,701,636,0.5243081525804039,0.47569184741959614
E01024988,1573,773,800,0.49141767323585506,0.5085823267641449
E01024989,1496,716,780,0.4786096256684492,0.5213903743315508
E01024996,1189,633,556,0.5323801513877208,0.46761984861227923
E01024997,1427,658,769,0.4611072179397337,0.5388927820602663
E01024999,1450,694,756,0.4786206896551724,0.5213793103448275
E01025000,1223,607,616,0.4963205233033524,0.5036794766966476
E01025029,2592,1259,1333,0.48572530864197533,0.5142746913580247
E01025030,2074,1029,1045,0.4961427193828351,0.503857280617165
E01024981,1335,637,698,0.4771535580524345,0.5228464419475656
E01024982,1351,640,711,0.47372316802368614,0.5262768319763138
E01024983,1442,705,737,0.48890429958391124,0.5110957004160888
E01024994,1559,734,825,0.4708146247594612,0.5291853752405388
E01024995,1370,630,740,0.45985401459854014,0.5401459854014599
E01025003,1711,822,889,0.4804208065458796,0.5195791934541204
E01025017,1445,670,775,0.46366782006920415,0.5363321799307958
E01024990,1425,661,764,0.463859649122807,0.536140350877193
E01024991,1053,503,550,0.47768281101614435,0.5223171889838556
E01024992,1393,661,732,0.4745154343144293,0.5254845656855707
E01025020,1403,677,726,0.48253741981468284,0.5174625801853172
E01025021,1340,634,706,0.47313432835820896,0.5268656716417911
E01025022,1870,911,959,0.48716577540106953,0.5128342245989305
E01025060,1452,671,781,0.4621212121212121,0.5378787878787878
E01025061,1596,758,838,0.474937343358396,0.525062656641604
E01025062,1693,862,831,0.5091553455404607,0.4908446544595393
E01025063,1494,727,767,0.4866131191432396,0.5133868808567604
E01025064,1570,766,804,0.4878980891719745,0.5121019108280255
E01025065,1648,811,837,0.49211165048543687,0.5078883495145631
E01025066,1563,773,790,0.4945617402431222,0.5054382597568778
E01025032,1439,668,771,0.4642112578179291,0.5357887421820708
E01025033,2251,1104,1147,0.49044868947134607,0.5095513105286539
E01025034,1757,876,881,0.4985771200910643,0.5014228799089356
E01025048,1468,726,742,0.494550408719346,0.5054495912806539
E01025049,1504,733,771,0.48736702127659576,0.5126329787234043
E01025050,1533,757,776,0.4938030006523157,0.5061969993476843
E01025053,1531,757,774,0.49444807315480077,0.5055519268451992
E01025070,1208,588,620,0.4867549668874172,0.5132450331125827
E01025071,1317,685,632,0.5201214882308276,0.47987851176917234
E01025072,1509,755,754,0.5003313452617627,0.49966865473823724
E01025073,1298,665,633,0.512326656394453,0.487673343605547
E01025074,1325,643,682,0.4852830188679245,0.5147169811320754
E01025051,1647,817,830,0.49605343047966,0.50394656952034
E01025052,1519,738,781,0.4858459512837393,0.5141540487162607
E01025057,1642,782,860,0.4762484774665043,0.5237515225334958
E01025058,1432,674,758,0.47067039106145253,0.5293296089385475
E01025059,1814,865,949,0.4768467475192944,0.5231532524807057
E01025067,1488,736,752,0.4946236559139785,0.5053763440860215
E01025068,1563,801,762,0.5124760076775432,0.4875239923224568
E01025069,1403,701,702,0.49964362081254454,0.5003563791874555
E01025044,1223,582,641,0.4758789860997547,0.5241210139002453
E01025045,1228,584,644,0.4755700325732899,0.5244299674267101
E01025046,1280,622,658,0.4859375,0.5140625
E01025081,1608,808,800,0.5024875621890548,0.4975124378109453
E01025041,1710,852,858,0.4982456140350877,0.5017543859649123
E01025042,2392,1198,1194,0.5008361204013378,0.4991638795986622
E01025082,1704,830,874,0.48708920187793425,0.5129107981220657
E01025083,2133,1074,1059,0.5035161744022504,0.4964838255977497
E01025084,1751,894,857,0.5105653912050258,0.4894346087949743
E01034335,1701,849,852,0.4991181657848324,0.5008818342151675
E01034336,2025,992,1033,0.48987654320987656,0.5101234567901235
E01025055,1447,722,725,0.49896337249481687,0.5010366275051832
E01025075,1742,877,865,0.5034443168771527,0.4965556831228473
E01025076,1256,609,647,0.48487261146496813,0.5151273885350318
E01025077,1424,659,765,0.4627808988764045,0.5372191011235955
E01025078,1420,712,708,0.5014084507042254,0.49859154929577465
E01025035,1404,694,710,0.4943019943019943,0.5056980056980057
E01025036,1718,910,808,0.529685681024447,0.470314318975553
E01025037,1585,764,821,0.48201892744479496,0.5179810725552051
E01025038,1310,615,695,0.46946564885496184,0.5305343511450382
E01025039,1182,593,589,0.5016920473773265,0.4983079526226734
E01025040,1438,719,719,0.5,0.5
E01025054,1566,780,786,0.49808429118773945,0.5019157088122606
E01025056,1287,633,654,0.49184149184149184,0.5081585081585082
E01025079,1575,758,817,0.4812698412698413,0.5187301587301587
E01025080,1463,711,752,0.4859876965140123,0.5140123034859877
E01025088,1049,504,545,0.4804575786463298,0.5195424213536701
E01025096,1621,784,837,0.4836520666255398,0.5163479333744602
E01025097,1507,738,769,0.48971466489714666,0.5102853351028533
E01025098,1343,657,686,0.4892032762472077,0.5107967237527923
E01025148,2098,1017,1081,0.48474737845567206,0.5152526215443279
E01025168,1055,522,533,0.4947867298578199,0.5052132701421801
E01025169,1270,612,658,0.4818897637795276,0.5181102362204725
E01025130,2280,1139,1141,0.49956140350877193,0.500438596491228
E01025132,1395,709,686,0.5082437275985663,0.4917562724014337
E01025166,1183,548,635,0.463229078613694,0.536770921386306
E01025167,1137,560,577,0.4925241864555849,0.5074758135444152
E01025089,1433,701,732,0.4891835310537334,0.5108164689462665
E01025090,1594,770,824,0.48306148055207027,0.5169385194479298
E01025158,1416,663,753,0.4682203389830508,0.5317796610169492
E01025159,1352,650,702,0.4807692307692308,0.5192307692307693
E01025160,1445,717,728,0.4961937716262976,0.5038062283737024
E01025085,1444,704,740,0.48753462603878117,0.5124653739612188
E01025086,1342,599,743,0.4463487332339791,0.5536512667660208
E01025087,1294,608,686,0.46986089644513135,0.5301391035548686
E01025161,1078,512,566,0.4749536178107607,0.5250463821892394
E01025108,1494,729,765,0.4879518072289157,0.5120481927710844
E01025109,1392,648,744,0.46551724137931033,0.5344827586206896
E01025131,1545,753,792,0.487378640776699,0.512621359223301
E01025133,1593,762,831,0.4783427495291902,0.5216572504708098
E01025112,1568,768,800,0.4897959183673469,0.5102040816326531
E01025136,1542,717,825,0.4649805447470817,0.5350194552529183
E01025138,1373,672,701,0.48943918426802624,0.5105608157319738
E01025139,1566,840,726,0.5363984674329502,0.46360153256704983
E01025140,1417,664,753,0.46859562455892734,0.5314043754410727
E01025111,1812,881,931,0.48620309050772625,0.5137969094922737
E01025113,1517,719,798,0.47396176664469347,0.5260382333553065
E01025118,1076,530,546,0.49256505576208176,0.5074349442379182
E01025119,1373,646,727,0.47050254916241807,0.5294974508375819
E01025110,1531,823,708,0.5375571521881124,0.46244284781188766
E01025116,1348,646,702,0.4792284866468843,0.5207715133531158
E01025117,1451,768,683,0.5292901447277739,0.47070985527222603
E01025120,1414,687,727,0.48585572842998587,0.5141442715700142
E01025170,1610,750,860,0.4658385093167702,0.5341614906832298
E01025171,1938,911,1027,0.47007223942208465,0.5299277605779154
E01025172,1404,647,757,0.46082621082621084,0.5391737891737892
E01025173,1639,788,851,0.4807809640024405,0.5192190359975595
E01025149,2181,1032,1149,0.4731774415405777,0.5268225584594223
E01025150,1560,745,815,0.4775641025641026,0.5224358974358975
E01025151,1649,860,789,0.5215281989084294,0.47847180109157067
E01025152,1550,751,799,0.48451612903225805,0.515483870967742
E01025154,1342,650,692,0.4843517138599106,0.5156482861400894
E01025091,1661,822,839,0.4948826008428657,0.5051173991571343
E01025092,1283,628,655,0.48947778643803586,0.5105222135619641
E01025095,2977,1692,1285,0.5683574067853544,0.4316425932146456
E01025126,2120,1030,1090,0.4858490566037736,0.5141509433962265
E01025093,2206,1205,1001,0.5462375339981868,0.45376246600181325
E01025094,1378,746,632,0.5413642960812772,0.45863570391872277
E01025099,1966,1020,946,0.5188199389623601,0.4811800610376399
E01033071,1674,868,806,0.5185185185185185,0.48148148148148145
E01033073,1862,969,893,0.5204081632653061,0.47959183673469385
E01025128,1325,646,679,0.48754716981132074,0.5124528301886793
E01025147,1478,743,735,0.5027063599458728,0.4972936400541272
E01034763,2303,1116,1187,0.48458532349109856,0.5154146765089014
E01025114,1521,742,779,0.4878369493754109,0.5121630506245891
E01025115,1504,717,787,0.4767287234042553,0.5232712765957447
E01025121,2040,997,1043,0.4887254901960784,0.5112745098039215
E01025122,1666,814,852,0.4885954381752701,0.5114045618247299
E01025123,2634,1278,1356,0.48519362186788156,0.5148063781321185
E01025124,1563,748,815,0.47856685860524634,0.5214331413947537
E01033072,2492,1213,1279,0.48675762439807385,0.5132423756019262
E01025100,2432,1206,1226,0.49588815789473684,0.5041118421052632
E01025101,1373,673,700,0.4901675163874727,0.5098324836125273
E01025102,1556,731,825,0.4697943444730077,0.5302056555269923
E01025103,1250,628,622,0.5024,0.4976
E01025144,1772,733,1039,0.4136568848758465,0.5863431151241535
E01025146,1962,957,1005,0.4877675840978593,0.5122324159021406
E01025127,1377,676,701,0.49092229484386346,0.5090777051561365
E01025141,1364,652,712,0.4780058651026393,0.5219941348973607
E01025143,1413,671,742,0.4748761500353857,0.5251238499646143
E01025145,1465,724,741,0.49419795221843005,0.50580204778157
E01025105,5747,2826,2921,0.4917348181659997,0.5082651818340004
E01025106,2085,1009,1076,0.4839328537170264,0.5160671462829736
E01025107,1591,809,782,0.5084852294154619,0.491514770584538
E01025142,1481,709,772,0.4787305874409183,0.5212694125590817
E01025137,1415,693,722,0.48975265017667846,0.5102473498233215
E01025153,1261,639,622,0.5067406819984139,0.49325931800158607
E01025155,1289,623,666,0.48332040341349886,0.5166795965865012
E01025156,1418,663,755,0.4675599435825106,0.5324400564174894
E01025157,1215,556,659,0.4576131687242798,0.5423868312757202
E01025162,1413,665,748,0.4706298655343241,0.5293701344656758
E01025163,1318,622,696,0.47192716236722304,0.5280728376327769
E01025164,1408,665,743,0.47230113636363635,0.5276988636363636
E01025165,1454,707,747,0.4862448418156809,0.5137551581843192
E01025191,1286,651,635,0.5062208398133748,0.4937791601866252
E01025192,1554,766,788,0.4929214929214929,0.5070785070785071
E01025193,1349,645,704,0.4781319495922906,0.5218680504077094
E01025194,1369,678,691,0.4952520087655223,0.5047479912344777
E01025195,1240,621,619,0.5008064516129033,0.4991935483870968
E01025196,1577,812,765,0.5149017121116043,0.4850982878883957
E01025197,1269,630,639,0.49645390070921985,0.5035460992907801
E01025198,1525,736,789,0.48262295081967216,0.5173770491803279
E01025199,1825,895,930,0.4904109589041096,0.5095890410958904
E01025200,1516,757,759,0.49934036939313986,0.5006596306068601
E01025201,1450,693,757,0.47793103448275864,0.5220689655172414
E01025202,1402,693,709,0.4942938659058488,0.5057061340941512
E01025178,1848,886,962,0.47943722943722944,0.5205627705627706
E01025179,1494,728,766,0.48728246318607765,0.5127175368139224
E01025180,1855,908,947,0.4894878706199461,0.5105121293800539
E01025203,1736,872,864,0.5023041474654378,0.4976958525345622
E01025226,1555,799,756,0.5138263665594855,0.48617363344051445
E01025227,1968,988,980,0.5020325203252033,0.49796747967479676
E01025228,1898,907,991,0.4778714436248683,0.5221285563751317
E01025174,1458,699,759,0.4794238683127572,0.5205761316872428
E01025175,1490,724,766,0.48590604026845635,0.5140939597315436
E01025176,1983,958,1025,0.4831064044377206,0.5168935955622794
E01025177,1644,819,825,0.4981751824817518,0.5018248175182481
E01025204,1714,839,875,0.4894982497082847,0.5105017502917153
E01025211,1585,754,831,0.4757097791798107,0.5242902208201893
E01025181,1804,863,941,0.47838137472283815,0.5216186252771619
E01025182,1892,962,930,0.5084566596194503,0.4915433403805497
E01025183,1955,969,986,0.4956521739130435,0.5043478260869565
E01025184,2056,1037,1019,0.5043774319066148,0.49562256809338523
E01025188,2302,1171,1131,0.5086880973066898,0.49131190269331015
E01025189,1780,905,875,0.5084269662921348,0.49157303370786515
E01025210,1970,985,985,0.5,0.5
E01025217,1646,822,824,0.4993924665856622,0.5006075334143378
E01025218,1368,718,650,0.5248538011695907,0.47514619883040937
E01025219,1400,716,684,0.5114285714285715,0.48857142857142855
E01025224,2535,1251,1284,0.493491124260355,0.506508875739645
E01025225,1825,889,936,0.48712328767123286,0.5128767123287671
E01025229,2903,1488,1415,0.5125732001377885,0.4874267998622115
E01025230,2256,1122,1134,0.4973404255319149,0.5026595744680851
E01025187,1513,736,777,0.48645076007931265,0.5135492399206874
E01025190,1724,837,887,0.48549883990719256,0.5145011600928074
E01025209,1708,856,852,0.5011709601873536,0.49882903981264637
E01025216,2365,1129,1236,0.4773784355179704,0.5226215644820296
E01025185,2163,1118,1045,0.5168747110494684,0.4831252889505317
E01025186,2011,1024,987,0.5091994032819492,0.4908005967180507
E01025212,1599,800,799,0.5003126954346466,0.4996873045653533
E01025213,1534,734,800,0.4784876140808344,0.5215123859191656
E01025214,1491,736,755,0.4936284372904091,0.5063715627095908
E01025215,1598,828,770,0.5181476846057572,0.4818523153942428
E01025205,1241,605,636,0.48751007252215955,0.5124899274778405
E01025206,1208,589,619,0.48758278145695366,0.5124172185430463
E01025207,1189,593,596,0.4987384356602187,0.5012615643397813
E01025208,1220,595,625,0.48770491803278687,0.5122950819672131
E01025220,1535,717,818,0.4671009771986971,0.532899022801303
E01025221,1477,711,766,0.4813811780636425,0.5186188219363574
E01025222,1479,709,770,0.4793779580797836,0.5206220419202163
E01025223,1417,686,731,0.48412138320395204,0.515878616796048
E01025278,2801,1376,1425,0.491253123884327,0.5087468761156729
E01025279,2476,1229,1247,0.49636510500807757,0.5036348949919225
E01025282,1890,973,917,0.5148148148148148,0.48518518518518516
E01025257,1491,736,755,0.4936284372904091,0.5063715627095908
E01025277,2466,1177,1289,0.4772911597729116,0.5227088402270884
E01025281,2136,1071,1065,0.5014044943820225,0.49859550561797755
E01034346,1119,551,568,0.4924039320822163,0.5075960679177838
E01034347,2536,1219,1317,0.4806782334384858,0.5193217665615142
E01025256,1442,706,736,0.4895977808599168,0.5104022191400832
E01025258,1485,721,764,0.4855218855218855,0.5144781144781144
E01025259,2840,1396,1444,0.4915492957746479,0.5084507042253521
E01025299,1504,736,768,0.48936170212765956,0.5106382978723404
E01025301,1091,534,557,0.4894592117323556,0.5105407882676444
E01025302,1187,575,612,0.4844144903117102,0.5155855096882898
E01025253,1772,869,903,0.4904063205417607,0.5095936794582393
E01025254,1145,556,589,0.485589519650655,0.514410480349345
E01025255,1478,744,734,0.503382949932341,0.496617050067659
E01025300,1145,518,627,0.4524017467248908,0.5475982532751091
E01025303,1319,649,670,0.4920394238059136,0.5079605761940864
E01025260,1544,727,817,0.47085492227979275,0.5291450777202072
E01025262,1407,689,718,0.4896943852167733,0.5103056147832267
E01025263,1426,680,746,0.47685834502103785,0.5231416549789621
E01025264,1398,696,702,0.4978540772532189,0.5021459227467812
E01025239,1405,668,737,0.47544483985765124,0.5245551601423487
E01025241,1645,800,845,0.48632218844984804,0.513677811550152
E01025242,1696,818,878,0.482311320754717,0.5176886792452831
E01025243,2145,1099,1046,0.5123543123543124,0.48764568764568766
E01025251,1480,730,750,0.49324324324324326,0.5067567567567568
E01025234,1546,747,799,0.4831824062095731,0.5168175937904269
E01025235,1785,886,899,0.49635854341736696,0.503641456582633
E01025237,1545,729,816,0.47184466019417476,0.5281553398058253
E01025238,1481,705,776,0.47602970965563807,0.5239702903443619
E01025245,2731,1302,1429,0.47674844379348225,0.5232515562065178
E01025252,1456,723,733,0.4965659340659341,0.5034340659340659
E01025233,1277,628,649,0.4917776037588097,0.5082223962411903
E01025240,1584,760,824,0.4797979797979798,0.5202020202020202
E01025261,1449,691,758,0.47688060731538995,0.52311939268461
E01025266,1145,552,593,0.4820960698689956,0.5179039301310043
E01025309,1222,611,611,0.5,0.5
E01025236,1575,746,829,0.47365079365079366,0.5263492063492063
E01025283,1761,827,934,0.4696195343554798,0.5303804656445201
E01025284,1691,842,849,0.4979302188054406,0.5020697811945595
E01025285,1420,701,719,0.4936619718309859,0.5063380281690141
E01025286,1871,915,956,0.4890432923570283,0.5109567076429716
E01025287,1957,982,975,0.5017884517118038,0.4982115482881962
E01025270,1647,811,836,0.49241044323011535,0.5075895567698846
E01025272,2707,1283,1424,0.47395640930919836,0.5260435906908016
E01025273,1277,657,620,0.514487079091621,0.485512920908379
E01025288,1744,944,800,0.5412844036697247,0.45871559633027525
E01025246,1764,904,860,0.5124716553287982,0.4875283446712018
E01025274,1934,1055,879,0.545501551189245,0.4544984488107549
E01025275,1646,883,763,0.5364520048602673,0.46354799513973266
E01025294,1811,958,853,0.5289895085588073,0.4710104914411927
E01025276,1710,894,816,0.5228070175438596,0.47719298245614034
E01025308,1693,852,841,0.503248670998228,0.496751329001772
E01025310,1575,784,791,0.49777777777777776,0.5022222222222222
E01025311,1219,595,624,0.48810500410172275,0.5118949958982772
E01025312,1594,805,789,0.5050188205771644,0.49498117942283565
E01025313,1972,1003,969,0.5086206896551724,0.49137931034482757
E01025314,2675,1301,1374,0.4863551401869159,0.5136448598130842
E01025231,1399,675,724,0.48248749106504646,0.5175125089349535
E01025232,1533,812,721,0.5296803652968036,0.4703196347031963
E01025265,1397,691,706,0.49463135289906945,0.5053686471009305
E01025267,1355,640,715,0.47232472324723246,0.5276752767527675
E01025268,1812,895,917,0.4939293598233996,0.5060706401766004
E01025269,1792,849,943,0.47377232142857145,0.5262276785714286
E01025271,1523,741,782,0.4865397242284964,0.5134602757715037
E01025295,2758,1641,1117,0.5949963741841915,0.40500362581580857
E01025296,2036,988,1048,0.48526522593320237,0.5147347740667977
E01025297,2385,1202,1183,0.5039832285115304,0.4960167714884696
E01025298,1803,880,923,0.48807542983915697,0.511924570160843
E01025244,1753,892,861,0.5088419851682829,0.49115801483171706
E01025292,2432,1170,1262,0.4810855263157895,0.5189144736842105
E01025293,2189,1165,1024,0.5322064869803563,0.46779351301964367
E01025247,1704,869,835,0.5099765258215962,0.49002347417840375
E01025248,1353,633,720,0.4678492239467849,0.532150776053215
E01025249,1036,529,507,0.5106177606177607,0.4893822393822394
E01025250,1687,834,853,0.4943687018375815,0.5056312981624185
E01025304,1907,993,914,0.5207131620346094,0.4792868379653907
E01025305,1664,840,824,0.5048076923076923,0.4951923076923077
E01025289,1415,717,698,0.5067137809187279,0.49328621908127207
E01025290,1780,969,811,0.5443820224719101,0.4556179775280899
E01025291,1347,700,647,0.5196733481811433,0.4803266518188567
E01025306,1916,1049,867,0.5474947807933194,0.4525052192066806
E01033223,1588,824,764,0.5188916876574308,0.4811083123425693
E01033224,1131,601,530,0.5313881520778072,0.46861184792219274
E01033226,1207,612,595,0.5070422535211268,0.49295774647887325
E01025315,1680,843,837,0.5017857142857143,0.4982142857142857
E01025320,1316,674,642,0.5121580547112462,0.4878419452887538
E01025331,1439,736,703,0.5114662960389159,0.4885337039610841
E01025348,1586,759,827,0.478562421185372,0.521437578814628
E01025349,1392,690,702,0.4956896551724138,0.5043103448275862
E01025334,2080,989,1091,0.4754807692307692,0.5245192307692308
E01025344,1304,628,676,0.4815950920245399,0.5184049079754601
E01025345,1511,775,736,0.5129053606882858,0.4870946393117141
E01025346,1482,745,737,0.5026990553306343,0.4973009446693657
E01025347,1783,858,925,0.4812114413909142,0.5187885586090858
E01025329,2269,1149,1120,0.5063904803878361,0.4936095196121639
E01025330,1528,714,814,0.46727748691099474,0.5327225130890052
E01025335,1310,646,664,0.49312977099236643,0.5068702290076336
E01025338,1541,786,755,0.5100584036340039,0.4899415963659961
E01025339,2331,1176,1155,0.5045045045045045,0.4954954954954955
E01025322,1413,707,706,0.5003538570417552,0.4996461429582449
E01025326,1688,813,875,0.4816350710900474,0.5183649289099526
E01025327,1289,637,652,0.49418153607447635,0.5058184639255237
E01025342,1530,750,780,0.49019607843137253,0.5098039215686274
E01025321,1327,644,683,0.4853051996985682,0.5146948003014318
E01025340,1417,709,708,0.5003528581510233,0.49964714184897674
E01025341,1237,627,610,0.5068714632174616,0.4931285367825384
E01025343,1583,770,813,0.48641819330385344,0.5135818066961465
E01025354,2246,1090,1156,0.4853072128227961,0.5146927871772039
E01025316,1654,801,853,0.48428053204353083,0.5157194679564692
E01025317,1072,512,560,0.47761194029850745,0.5223880597014925
E01025325,1522,719,803,0.4724047306176084,0.5275952693823915
E01025328,1494,728,766,0.48728246318607765,0.5127175368139224
E01025318,1153,567,586,0.49176062445793584,0.5082393755420642
E01025319,2052,1012,1040,0.49317738791423,0.50682261208577
E01025333,1294,613,681,0.47372488408037094,0.526275115919629
E01025350,1608,755,853,0.4695273631840796,0.5304726368159204
E01025351,2705,1309,1396,0.48391866913123843,0.5160813308687615
E01025323,1141,561,580,0.49167397020157755,0.5083260297984225
E01025324,1441,694,747,0.4816099930603747,0.5183900069396252
E01025336,1107,534,573,0.4823848238482385,0.5176151761517616
E01025337,1470,691,779,0.47006802721088436,0.5299319727891156
E01025352,1487,780,707,0.5245460659045057,0.4754539340954943
E01034764,2082,1014,1068,0.48703170028818443,0.5129682997118156
E01025355,2386,1154,1232,0.48365465213746855,0.5163453478625314
E01025361,2036,992,1044,0.48722986247544203,0.5127701375245579
E01025362,2039,997,1042,0.4889651790093183,0.5110348209906818
E01025393,1422,703,719,0.49437412095639943,0.5056258790436006
E01025363,1369,663,706,0.48429510591672753,0.5157048940832725
E01025364,1404,698,706,0.49715099715099714,0.5028490028490028
E01025366,1558,774,784,0.496790757381258,0.503209242618742
E01025395,1561,765,796,0.49007046764894296,0.509929532351057
E01025396,1326,663,663,0.5,0.5
E01025397,1741,877,864,0.5037334865020103,0.49626651349798967
E01025398,1384,679,705,0.49060693641618497,0.509393063583815
E01025367,1852,915,937,0.49406047516198703,0.505939524838013
E01025368,1693,839,854,0.49556999409332547,0.5044300059066745
E01025369,1324,658,666,0.49697885196374625,0.5030211480362538
E01025381,1590,769,821,0.48364779874213837,0.5163522012578616
E01025382,1752,848,904,0.4840182648401826,0.5159817351598174
E01025383,2924,1460,1464,0.4993160054719562,0.5006839945280438
E01025356,1495,743,752,0.49698996655518396,0.5030100334448161
E01025373,1648,793,855,0.4811893203883495,0.5188106796116505
E01025385,1229,588,641,0.47843775427176566,0.5215622457282343
E01025387,1883,938,945,0.49814126394052044,0.5018587360594795
E01033281,2696,1313,1383,0.4870178041543027,0.5129821958456974
E01025377,1563,764,799,0.4888035828534869,0.5111964171465131
E01025378,1559,778,781,0.4990378447722899,0.50096215522771
E01025379,1462,672,790,0.45964432284541723,0.5403556771545828
E01025380,1510,746,764,0.49403973509933774,0.5059602649006623
E01025357,1354,640,714,0.4726735598227474,0.5273264401772526
E01025358,2253,1100,1153,0.4882379050155348,0.5117620949844651
E01025365,1449,688,761,0.4748102139406487,0.5251897860593513
E01025384,1238,604,634,0.4878836833602585,0.5121163166397416
E01025359,1734,828,906,0.47750865051903113,0.5224913494809689
E01025360,1994,994,1000,0.49849548645937813,0.5015045135406219
E01025375,1600,803,797,0.501875,0.498125
E01025376,2470,1222,1248,0.49473684210526314,0.5052631578947369
E01025370,1279,636,643,0.49726348709929635,0.5027365129007036
E01025371,1411,709,702,0.5024805102763997,0.49751948972360027
E01025374,1454,699,755,0.48074277854195324,0.5192572214580468
E01025388,1464,703,761,0.4801912568306011,0.519808743169399
E01025389,1426,699,727,0.4901823281907433,0.5098176718092566
E01025390,1067,540,527,0.5060918462980318,0.4939081537019681
E01025391,1546,753,793,0.4870633893919793,0.5129366106080206
E01025392,1219,601,618,0.49302707136997537,0.5069729286300246
E01025394,1509,758,751,0.5023194168323393,0.49768058316766073
E01025424,1291,655,636,0.5073586367157242,0.49264136328427577
E01025425,1272,620,652,0.48742138364779874,0.5125786163522013
E01025426,1234,611,623,0.49513776337115073,0.5048622366288493
E01025466,1537,739,798,0.4808067664281067,0.5191932335718933
E01025413,1675,810,865,0.4835820895522388,0.5164179104477612
E01025414,1492,736,756,0.4932975871313673,0.5067024128686327
E01025456,1188,579,609,0.48737373737373735,0.5126262626262627
E01025458,1608,803,805,0.4993781094527363,0.5006218905472637
E01025408,1381,652,729,0.4721216509775525,0.5278783490224475
E01025409,1271,612,659,0.4815106215578285,0.5184893784421715
E01025410,1341,666,675,0.4966442953020134,0.5033557046979866
E01025467,1897,902,995,0.4754876120189773,0.5245123879810226
E01025403,2187,1072,1115,0.49016918152720623,0.5098308184727938
E01025457,1344,659,685,0.49032738095238093,0.5096726190476191
E01025463,1368,672,696,0.49122807017543857,0.5087719298245614
E01025464,1211,601,610,0.4962840627580512,0.5037159372419489
E01025465,1023,531,492,0.5190615835777126,0.4809384164222874
E01025411,2206,1094,1112,0.4959202175883953,0.5040797824116047
E01025448,1543,741,802,0.48023331173039535,0.5197666882696047
E01034348,1932,954,978,0.4937888198757764,0.5062111801242236
E01025412,1413,692,721,0.4897381457891012,0.5102618542108988
E01025427,1387,639,748,0.46070656092285506,0.5392934390771449
E01025428,1494,703,791,0.4705488621151272,0.5294511378848729
E01025429,1363,652,711,0.4783565663976522,0.5216434336023478
E01025404,1183,582,601,0.4919695688926458,0.5080304311073541
E01025405,1233,626,607,0.5077047850770479,0.49229521492295214
E01025406,1130,544,586,0.4814159292035398,0.5185840707964602
E01025407,1910,978,932,0.512041884816754,0.48795811518324606
E01025399,1406,691,715,0.4914651493598862,0.5085348506401138
E01025400,2111,1031,1080,0.4883941260066319,0.5116058739933681
E01025401,1585,785,800,0.4952681388012618,0.5047318611987381
E01025402,1951,963,988,0.4935930292157868,0.5064069707842133
E01025442,1027,521,506,0.50730282375852,0.49269717624148
E01025443,1275,609,666,0.4776470588235294,0.5223529411764706
E01025444,1252,614,638,0.4904153354632588,0.5095846645367412
E01025461,1949,995,954,0.5105182144689584,0.48948178553104155
E01025462,2026,986,1040,0.4866732477788746,0.5133267522211253
E01025439,1444,710,734,0.4916897506925208,0.5083102493074793
E01025453,1763,843,920,0.47816222348269993,0.5218377765173
E01025454,1302,648,654,0.4976958525345622,0.5023041474654378
E01025455,1608,770,838,0.47885572139303484,0.5211442786069652
E01025436,2303,1146,1157,0.4976118106817195,0.5023881893182806
E01025437,1952,952,1000,0.48770491803278687,0.5122950819672131
E01025438,1321,627,694,0.47464042392127176,0.5253595760787282
E01025440,1336,648,688,0.48502994011976047,0.5149700598802395
E01025441,1404,652,752,0.46438746438746437,0.5356125356125356
E01025417,1495,736,759,0.49230769230769234,0.5076923076923077
E01025418,1427,675,752,0.4730203223545901,0.52697967764541
E01025419,1554,744,810,0.47876447876447875,0.5212355212355212
E01034349,1699,831,868,0.4891112419070041,0.5108887580929958
E01034350,2190,1080,1110,0.4931506849315068,0.5068493150684932
E01025421,2424,1232,1192,0.5082508250825083,0.49174917491749176
E01025422,1399,657,742,0.46962115796997855,0.5303788420300214
E01025431,1975,977,998,0.49468354430379746,0.5053164556962025
E01025433,1559,784,775,0.5028864656831302,0.4971135343168698
E01025416,1513,750,763,0.495703899537343,0.5042961004626569
E01025451,1867,920,947,0.49276914836636315,0.5072308516336369
E01025452,1671,856,815,0.5122681029323758,0.48773189706762415
E01025415,1974,978,996,0.49544072948328266,0.5045592705167173
E01025423,1304,630,674,0.4831288343558282,0.5168711656441718
E01025435,1422,684,738,0.4810126582278481,0.5189873417721519
E01025446,1424,683,741,0.47963483146067415,0.5203651685393258
E01025434,1815,864,951,0.47603305785123967,0.5239669421487604
E01034351,2938,1451,1487,0.4938733832539142,0.5061266167460857
E01034352,1482,720,762,0.48582995951417,0.5141700404858299
E01034353,1443,738,705,0.5114345114345115,0.4885654885654886
E01025445,1597,731,866,0.4577332498434565,0.5422667501565435
E01025447,1143,523,620,0.4575678040244969,0.5424321959755031
E01025459,1695,808,887,0.4766961651917404,0.5233038348082596
E01025460,1901,937,964,0.49289847448711205,0.507101525512888
E01025496,1247,614,633,0.49238171611868486,0.5076182838813151
E01025497,1471,731,740,0.4969408565601632,0.5030591434398368
E01025498,1470,710,760,0.48299319727891155,0.5170068027210885
E01025530,1600,806,794,0.50375,0.49625
E01025532,1711,840,871,0.49094097019286964,0.5090590298071304
E01025533,1522,738,784,0.48488830486202367,0.5151116951379764
E01025507,1991,965,1026,0.48468106479156203,0.515318935208438
E01025508,1431,711,720,0.4968553459119497,0.5031446540880503
E01025509,1261,613,648,0.486122125297383,0.5138778747026169
E01025513,2160,1068,1092,0.49444444444444446,0.5055555555555555
E01025531,1127,566,561,0.5022182786157942,0.49778172138420584
E01025474,1287,627,660,0.48717948717948717,0.5128205128205128
E01025495,2185,1050,1135,0.4805491990846682,0.5194508009153318
E01025514,2434,1207,1227,0.4958915365653246,0.5041084634346754
E01025515,1596,803,793,0.5031328320802005,0.4968671679197995
E01025483,2414,1161,1253,0.48094449047224525,0.5190555095277548
E01025484,2150,1037,1113,0.4823255813953488,0.5176744186046511
E01025485,1648,816,832,0.49514563106796117,0.5048543689320388
E01025486,1633,798,835,0.488671157379057,0.511328842620943
E01025487,1775,854,921,0.4811267605633803,0.5188732394366197
E01025510,1305,631,674,0.4835249042145594,0.5164750957854406
E01025511,1113,540,573,0.48517520215633425,0.5148247978436657
E01025512,1192,564,628,0.47315436241610737,0.5268456375838926
E01025538,1488,727,761,0.4885752688172043,0.5114247311827957
E01025539,1404,666,738,0.47435897435897434,0.5256410256410257
E01025499,1343,646,697,0.4810126582278481,0.5189873417721519
E01025501,1096,502,594,0.458029197080292,0.541970802919708
E01025502,1545,743,802,0.4809061488673139,0.5190938511326861
E01025516,1459,733,726,0.5023989033584647,0.4976010966415353
E01025517,2196,1070,1126,0.4872495446265938,0.5127504553734062
E01025519,1176,576,600,0.4897959183673469,0.5102040816326531
E01025488,2840,1200,1640,0.4225352112676056,0.5774647887323944
E01025489,1366,657,709,0.48096632503660325,0.5190336749633968
E01025490,2690,986,1704,0.36654275092936806,0.633457249070632
E01025500,1687,747,940,0.44279786603438054,0.5572021339656195
E01025518,1556,683,873,0.4389460154241645,0.5610539845758354
E01025479,2158,1056,1102,0.4893419833178869,0.5106580166821131
E01025491,2614,1044,1570,0.39938791124713086,0.6006120887528692
E01025506,2025,985,1040,0.48641975308641977,0.5135802469135803
E01025468,1676,829,847,0.4946300715990454,0.5053699284009546
E01025469,1621,791,830,0.4879703886489821,0.5120296113510179
E01025470,1878,897,981,0.4776357827476038,0.5223642172523961
E01025522,1098,516,582,0.46994535519125685,0.5300546448087432
E01025471,1493,723,770,0.4842598794373744,0.5157401205626256
E01025480,1408,661,747,0.4694602272727273,0.5305397727272727
E01025481,1602,796,806,0.4968789013732834,0.5031210986267166
E01025482,1551,792,759,0.5106382978723404,0.48936170212765956
E01025520,1210,586,624,0.484297520661157,0.515702479338843
E01025521,1610,782,828,0.4857142857142857,0.5142857142857142
E01025523,1708,825,883,0.48302107728337235,0.5169789227166276
E01025524,1483,766,717,0.5165205664194201,0.48347943358057993
E01025525,1636,799,837,0.4883863080684597,0.5116136919315404
E01025526,1590,780,810,0.49056603773584906,0.5094339622641509
E01025472,1450,711,739,0.4903448275862069,0.5096551724137931
E01025473,1343,650,693,0.48399106478034254,0.5160089352196575
E01025475,1426,685,741,0.4803646563814867,0.5196353436185134
E01025476,1410,675,735,0.4787234042553192,0.5212765957446809
E01025477,1147,536,611,0.4673060156931125,0.5326939843068875
E01025478,1259,626,633,0.49722001588562353,0.5027799841143765
E01025492,1249,611,638,0.489191353082466,0.510808646917534
E01025527,1473,734,739,0.4983027834351663,0.5016972165648337
E01025528,1974,989,985,0.5010131712259371,0.4989868287740628
E01025529,1887,951,936,0.5039745627980922,0.4960254372019078
E01025493,1618,780,838,0.4820766378244747,0.5179233621755254
E01025494,1740,852,888,0.4896551724137931,0.5103448275862069
E01025503,1426,685,741,0.4803646563814867,0.5196353436185134
E01025504,1148,535,613,0.46602787456445993,0.5339721254355401
E01025505,1376,687,689,0.4992732558139535,0.5007267441860465
E01025534,1724,845,879,0.49013921113689096,0.509860788863109
E01025535,1631,820,811,0.5027590435315757,0.49724095646842426
E01025536,1452,689,763,0.47451790633608815,0.5254820936639119
E01025537,1537,749,788,0.48731294729993496,0.5126870527000651
E01025540,1227,606,621,0.4938875305623472,0.5061124694376528
E01025573,1328,627,701,0.47213855421686746,0.5278614457831325
E01025574,1420,673,747,0.47394366197183097,0.526056338028169
E01025581,1417,714,703,0.5038814396612562,0.49611856033874385
E01025582,1232,627,605,0.5089285714285714,0.49107142857142855
E01025583,1294,652,642,0.5038639876352395,0.49613601236476046
E01025584,1480,840,640,0.5675675675675675,0.43243243243243246
E01025605,1408,655,753,0.46519886363636365,0.5348011363636364
E01025606,1323,643,680,0.4860166288737717,0.5139833711262283
E01025607,1541,774,767,0.5022712524334848,0.49772874756651525
E01025608,1600,786,814,0.49125,0.50875
E01025590,1641,775,866,0.47227300426569163,0.5277269957343084
E01025591,1534,752,782,0.49022164276401564,0.5097783572359843
E01025592,1289,616,673,0.4778898370830101,0.5221101629169899
E01025593,1656,830,826,0.501207729468599,0.49879227053140096
E01025563,1115,538,577,0.48251121076233183,0.5174887892376682
E01025564,1822,898,924,0.49286498353457736,0.5071350164654226
E01025565,1704,827,877,0.48532863849765256,0.5146713615023474
E01025586,1485,728,757,0.49023569023569025,0.5097643097643098
E01025587,1643,800,843,0.48691418137553255,0.5130858186244674
E01025588,1339,657,682,0.49066467513069456,0.5093353248693054
E01025589,1190,572,618,0.48067226890756304,0.519327731092437
E01025557,1469,708,761,0.48196051735874745,0.5180394826412525
E01025575,1854,910,944,0.49083063646170444,0.5091693635382956
E01025578,1586,779,807,0.4911727616645649,0.5088272383354351
E01025579,1350,617,733,0.457037037037037,0.542962962962963
E01025580,1273,621,652,0.4878240377062058,0.5121759622937941
E01025547,2511,1286,1225,0.5121465551573079,0.48785344484269216
E01025549,2425,1177,1248,0.48536082474226805,0.514639175257732
E01025609,2335,1131,1204,0.4843683083511777,0.5156316916488223
E01025548,1667,814,853,0.48830233953209357,0.5116976604679064
E01025553,2749,1376,1373,0.5005456529647144,0.4994543470352856
E01025558,1610,777,833,0.4826086956521739,0.5173913043478261
E01025559,2048,971,1077,0.47412109375,0.52587890625
E01025560,1291,596,695,0.4616576297443842,0.5383423702556158
E01025554,1406,658,748,0.46799431009957326,0.5320056899004267
E01025556,1535,731,804,0.4762214983713355,0.5237785016286645
E01025570,1227,627,600,0.511002444987775,0.4889975550122249
E01025571,1383,671,712,0.485177151120752,0.514822848879248
E01025572,1313,641,672,0.4881949733434882,0.5118050266565118
E01025604,1417,674,743,0.4756527875793931,0.5243472124206069
E01025561,1557,763,794,0.4900449582530507,0.5099550417469493
E01025562,2527,1251,1276,0.4950534230312624,0.5049465769687377
E01025585,2628,1278,1350,0.4863013698630137,0.5136986301369864
E01025542,1778,839,939,0.4718785151856018,0.5281214848143982
E01025555,1357,639,718,0.470891672807664,0.529108327192336
E01025601,1417,668,749,0.47141848976711365,0.5285815102328864
E01025602,1620,779,841,0.4808641975308642,0.5191358024691358
E01025603,1400,666,734,0.4757142857142857,0.5242857142857142
E01025541,2430,1175,1255,0.4835390946502058,0.5164609053497943
E01025543,1710,819,891,0.4789473684210526,0.5210526315789473
E01025544,1375,646,729,0.4698181818181818,0.5301818181818182
E01025576,2407,1160,1247,0.4819277108433735,0.5180722891566265
E01025577,1421,700,721,0.49261083743842365,0.5073891625615764
E01025550,1506,735,771,0.48804780876494025,0.5119521912350598
E01025552,1214,588,626,0.4843492586490939,0.515650741350906
E01025594,1483,710,773,0.4787592717464599,0.5212407282535402
E01025595,1428,692,736,0.484593837535014,0.5154061624649859
E01025596,2105,1028,1077,0.4883610451306413,0.5116389548693586
E01025597,1060,503,557,0.47452830188679246,0.5254716981132076
E01025545,2452,1170,1282,0.47716150081566067,0.5228384991843393
E01025546,1586,770,816,0.4854981084489281,0.5145018915510718
E01025551,1203,567,636,0.4713216957605985,0.5286783042394015
E01025567,1653,795,858,0.4809437386569873,0.5190562613430127
E01025598,1423,672,751,0.47224174279690795,0.5277582572030921
E01025566,1966,978,988,0.49745676500508645,0.5025432349949135
E01025568,1895,922,973,0.48654353562005276,0.5134564643799472
E01025569,1911,929,982,0.4861329147043433,0.5138670852956567
E01025599,1031,500,531,0.48496605237633367,0.5150339476236664
E01025600,1494,740,754,0.49531459170013387,0.5046854082998661
E01004768,1595,806,789,0.5053291536050156,0.4946708463949843
E01004803,1620,781,839,0.4820987654320988,0.5179012345679013
E01004804,1468,713,755,0.48569482288828336,0.5143051771117166
E01004807,1377,700,677,0.5083514887436456,0.4916485112563544
E01004808,1618,792,826,0.4894932014833127,0.5105067985166872
E01004788,1356,659,697,0.4859882005899705,0.5140117994100295
E01004790,1418,674,744,0.47531734837799716,0.5246826516220028
E01004805,1565,760,805,0.48562300319488816,0.5143769968051118
E01004806,1517,711,806,0.46868820039551745,0.5313117996044825
E01004810,1557,752,805,0.4829800899165061,0.5170199100834939
E01004769,1503,727,776,0.48369926813040587,0.5163007318695941
E01004770,1521,736,785,0.4838921761998685,0.5161078238001315
E01004771,1685,829,856,0.4919881305637982,0.5080118694362018
E01004773,1965,975,990,0.4961832061068702,0.5038167938931297
E01004809,1723,806,917,0.4677887405687754,0.5322112594312246
E01004777,1723,809,914,0.46952988972722,0.53047011027278
E01004881,1482,701,781,0.47300944669365724,0.5269905533063428
E01004888,1281,650,631,0.507416081186573,0.492583918813427
E01004889,1432,678,754,0.473463687150838,0.526536312849162
E01004890,1381,683,698,0.4945691527878349,0.5054308472121651
E01004766,1658,856,802,0.5162846803377563,0.4837153196622437
E01004767,1887,959,928,0.5082140964493905,0.4917859035506094
E01004772,1846,855,991,0.46316359696641385,0.5368364030335862
E01004774,1765,873,892,0.49461756373937676,0.5053824362606232
E01004824,1884,937,947,0.4973460721868365,0.5026539278131635
E01004784,1193,608,585,0.509639564124057,0.490360435875943
E01004785,1523,743,780,0.48785292186474066,0.5121470781352594
E01004786,1450,681,769,0.4696551724137931,0.5303448275862069
E01004789,1452,682,770,0.4696969696969697,0.5303030303030303
E01004791,1323,624,699,0.47165532879818595,0.528344671201814
E01004792,1409,671,738,0.47622427253371186,0.5237757274662882
E01004779,1631,826,805,0.5064377682403434,0.49356223175965663
E01004781,2134,1067,1067,0.5,0.5
E01004882,1350,673,677,0.4985185185185185,0.5014814814814815
E01004883,1760,858,902,0.4875,0.5125
E01004884,1476,709,767,0.4803523035230352,0.5196476964769647
E01004864,1464,720,744,0.4918032786885246,0.5081967213114754
E01004867,1551,747,804,0.4816247582205029,0.5183752417794971
E01004921,1633,783,850,0.47948560930802203,0.5205143906919779
E01004924,1575,772,803,0.4901587301587302,0.5098412698412699
E01004925,1590,788,802,0.49559748427672956,0.5044025157232704
E01004778,1190,571,619,0.47983193277310926,0.5201680672268908
E01004780,2288,1143,1145,0.4995629370629371,0.5004370629370629
E01004782,1348,631,717,0.4681008902077151,0.5318991097922848
E01004783,1477,715,762,0.48408937034529453,0.5159106296547055
E01004802,1973,953,1020,0.4830207805372529,0.516979219462747
E01004926,1432,664,768,0.46368715083798884,0.5363128491620112
E01004927,2301,1115,1186,0.48457192524989134,0.5154280747501087
E01004929,2728,1329,1399,0.4871700879765396,0.5128299120234604
E01004820,1790,879,911,0.4910614525139665,0.5089385474860335
E01004825,1971,999,972,0.5068493150684932,0.4931506849315068
E01004826,1667,834,833,0.5002999400119976,0.4997000599880024
E01004865,1581,787,794,0.49778621125869704,0.502213788741303
E01004866,2038,1071,967,0.5255152109911678,0.4744847890088322
E01004840,1736,855,881,0.4925115207373272,0.5074884792626728
E01004841,1746,855,891,0.4896907216494845,0.5103092783505154
E01004842,1713,823,890,0.4804436660828955,0.5195563339171045
E01004919,1509,745,764,0.4937044400265076,0.5062955599734924
E01004920,1641,795,846,0.4844606946983547,0.5155393053016454
E01004787,1708,820,888,0.48009367681498827,0.5199063231850117
E01004793,1749,802,947,0.4585477415666095,0.5414522584333905
E01004794,2122,1062,1060,0.5004712535344015,0.49952874646559847
E01004795,1504,719,785,0.47805851063829785,0.5219414893617021
E01004797,1492,733,759,0.4912868632707775,0.5087131367292225
E01004775,2326,1150,1176,0.4944110060189166,0.5055889939810834
E01004885,1425,705,720,0.49473684210526314,0.5052631578947369
E01004886,1397,680,717,0.4867573371510379,0.513242662848962
E01004887,1327,617,710,0.46495855312735496,0.5350414468726451
E01004868,2163,1123,1040,0.5191863153028201,0.48081368469717983
E01004869,2188,1059,1129,0.4840036563071298,0.5159963436928702
E01004870,2015,1127,888,0.5593052109181141,0.44069478908188586
E01004871,1814,924,890,0.5093715545755237,0.4906284454244763
E01004922,2254,1101,1153,0.4884649511978705,0.5115350488021295
E01004822,1851,904,947,0.4883846569421934,0.5116153430578065
E01004823,2047,1036,1011,0.5061064973131412,0.49389350268685883
E01004848,2090,1102,988,0.5272727272727272,0.4727272727272727
E01033217,1228,659,569,0.5366449511400652,0.46335504885993484
E01033220,1314,719,595,0.5471841704718418,0.4528158295281583
E01004818,1722,943,779,0.5476190476190477,0.4523809523809524
E01004819,1518,773,745,0.5092226613965745,0.49077733860342554
E01004928,1378,665,713,0.4825834542815675,0.5174165457184325
E01004930,1514,738,776,0.48745046235138706,0.512549537648613
E01004931,1564,783,781,0.5006393861892583,0.4993606138107417
E01004932,1482,756,726,0.5101214574898786,0.4898785425101215
E01004834,1745,918,827,0.5260744985673352,0.47392550143266476
E01004838,2008,974,1034,0.4850597609561753,0.5149402390438247
E01004843,1558,750,808,0.4813863928112965,0.5186136071887034
E01004845,1872,916,956,0.4893162393162393,0.5106837606837606
E01004923,1675,837,838,0.49970149253731344,0.5002985074626866
E01004796,1576,802,774,0.5088832487309645,0.49111675126903553
E01004798,1613,756,857,0.46869187848729077,0.5313081215127092
E01004799,1271,623,648,0.4901652242328875,0.5098347757671126
E01004800,1295,649,646,0.5011583011583012,0.4988416988416988
E01004801,1674,799,875,0.477299880525687,0.522700119474313
E01004917,2298,1128,1170,0.4908616187989556,0.5091383812010444
E01004835,1461,730,731,0.4996577686516085,0.5003422313483915
E01004836,1746,846,900,0.4845360824742268,0.5154639175257731
E01004837,1561,792,769,0.507367072389494,0.4926329276105061
E01004844,1573,752,821,0.4780673871582963,0.5219326128417038
E01004897,1013,498,515,0.491609081934847,0.508390918065153
E01004827,1990,1013,977,0.5090452261306533,0.4909547738693467
E01004849,1794,864,930,0.4816053511705686,0.5183946488294314
E01004850,2293,1253,1040,0.546445704317488,0.453554295682512
E01004851,1691,849,842,0.5020697811945595,0.4979302188054406
E01004853,1575,800,775,0.5079365079365079,0.49206349206349204
E01004811,1845,889,956,0.48184281842818427,0.5181571815718157
E01004812,2402,1198,1204,0.4987510407993339,0.5012489592006661
E01004813,1748,842,906,0.4816933638443936,0.5183066361556065
E01004815,1786,890,896,0.49832026875699886,0.5016797312430011
E01004817,2064,1075,989,0.5208333333333334,0.4791666666666667
E01004828,2017,994,1023,0.4928111056023798,0.5071888943976203
E01004829,1458,717,741,0.49176954732510286,0.5082304526748971
E01004832,1641,803,838,0.4893357708714199,0.5106642291285801
E01004854,1658,813,845,0.49034981905910735,0.5096501809408926
E01004878,1697,838,859,0.4938126104890984,0.5061873895109016
E01004911,1539,753,786,0.48927875243664715,0.5107212475633528
E01004912,1435,697,738,0.4857142857142857,0.5142857142857142
E01004913,1955,964,991,0.4930946291560102,0.5069053708439898
E01004914,1170,564,606,0.48205128205128206,0.517948717948718
E01004915,1274,627,647,0.4921507064364207,0.5078492935635793
E01004916,1467,694,773,0.4730743012951602,0.5269256987048399
E01004918,1225,609,616,0.49714285714285716,0.5028571428571429
E01004846,1410,715,695,0.5070921985815603,0.4929078014184397
E01004847,2282,1069,1213,0.4684487291849255,0.5315512708150745
E01004852,1734,887,847,0.5115340253748558,0.4884659746251442
E01004877,2074,1002,1072,0.4831243972999036,0.5168756027000965
E01004879,1657,798,859,0.4815932407966204,0.5184067592033796
E01004830,1754,841,913,0.47947548460661343,0.5205245153933865
E01004831,1829,939,890,0.5133952979770366,0.48660470202296335
E01004833,1530,770,760,0.5032679738562091,0.49673202614379086
E01004839,2370,1157,1213,0.48818565400843883,0.5118143459915612
E01004814,1604,794,810,0.49501246882793015,0.5049875311720698
E01004855,1479,733,746,0.495605138607167,0.504394861392833
E01004856,1537,762,775,0.49577098243331164,0.5042290175666884
E01004857,1902,951,951,0.5,0.5
E01004891,1540,733,807,0.475974025974026,0.5240259740259741
E01004893,1524,796,728,0.5223097112860893,0.4776902887139108
E01004894,1925,956,969,0.49662337662337663,0.5033766233766234
E01004901,1764,886,878,0.5022675736961452,0.4977324263038549
E01033218,1571,760,811,0.48376830044557606,0.5162316995544239
E01033219,1421,706,715,0.4968332160450387,0.5031667839549613
E01004816,2939,1486,1453,0.505614154474311,0.494385845525689
E01004872,1694,810,884,0.4781582054309327,0.5218417945690673
E01004873,2021,973,1048,0.4814448292924295,0.5185551707075705
E01004875,1669,813,856,0.48711803475134813,0.5128819652486519
E01004880,1479,746,733,0.504394861392833,0.495605138607167
E01004892,1580,757,823,0.4791139240506329,0.5208860759493671
E01004896,1315,642,673,0.488212927756654,0.511787072243346
E01004899,1596,787,809,0.4931077694235589,0.5068922305764411
E01004900,1615,775,840,0.47987616099071206,0.5201238390092879
E01004776,1822,916,906,0.5027442371020856,0.4972557628979144
E01004895,1326,621,705,0.4683257918552036,0.5316742081447964
E01004936,2170,1089,1081,0.5018433179723503,0.4981566820276498
E01004938,1548,761,787,0.49160206718346255,0.5083979328165374
E01004939,1599,803,796,0.5021888680425266,0.4978111319574734
E01004858,1586,779,807,0.4911727616645649,0.5088272383354351
E01004859,1506,739,767,0.4907038512616202,0.5092961487383798
E01004860,1470,705,765,0.47959183673469385,0.5204081632653061
E01004902,1847,892,955,0.48294531672983215,0.5170546832701678
E01004906,1795,899,896,0.5008356545961002,0.4991643454038997
E01004861,1962,945,1017,0.481651376146789,0.518348623853211
E01004862,1436,704,732,0.49025069637883006,0.5097493036211699
E01004863,1586,788,798,0.4968474148802018,0.5031525851197982
E01004874,1755,850,905,0.4843304843304843,0.5156695156695157
E01004876,1966,978,988,0.49745676500508645,0.5025432349949135
E01004903,1445,711,734,0.49204152249134947,0.5079584775086505
E01004904,1678,828,850,0.4934445768772348,0.5065554231227652
E01004905,1596,784,812,0.49122807017543857,0.5087719298245614
E01004907,1310,614,696,0.4687022900763359,0.5312977099236641
E01004908,1297,624,673,0.4811102544333076,0.5188897455666923
E01004909,1397,651,746,0.4659985683607731,0.5340014316392269
E01004910,2051,1016,1035,0.4953681131155534,0.5046318868844466
E01004933,1314,665,649,0.5060882800608828,0.4939117199391172
E01004934,1442,714,728,0.49514563106796117,0.5048543689320388
E01004935,1838,889,949,0.4836779107725789,0.5163220892274211
E01004937,1637,837,800,0.5113011606597434,0.48869883934025654
E01004940,1431,702,729,0.49056603773584906,0.5094339622641509
E01005014,1465,740,725,0.5051194539249146,0.4948805460750853
E01005015,1494,678,816,0.4538152610441767,0.5461847389558233
E01005016,1494,740,754,0.49531459170013387,0.5046854082998661
E01005017,1835,896,939,0.488283378746594,0.511716621253406
E01005018,1534,729,805,0.47522816166883963,0.5247718383311604
E01005021,1218,687,531,0.5640394088669951,0.43596059113300495
E01005019,1502,718,784,0.4780292942743009,0.521970705725699
E01005023,1278,594,684,0.4647887323943662,0.5352112676056338
E01005046,1478,699,779,0.472936400541272,0.527063599458728
E01005048,1657,809,848,0.48823174411587206,0.5117682558841279
E01005020,1361,670,691,0.4922850844966936,0.5077149155033064
E01005022,1497,750,747,0.501002004008016,0.49899799599198397
E01005047,1474,703,771,0.4769335142469471,0.5230664857530529
E01005049,1645,810,835,0.49240121580547114,0.5075987841945289
E01005051,1524,752,772,0.49343832020997375,0.5065616797900262
E01004976,1546,743,803,0.48059508408796897,0.5194049159120311
E01004977,1708,817,891,0.4783372365339578,0.5216627634660421
E01004978,1857,935,922,0.5035002692514808,0.4964997307485191
E01004981,1472,721,751,0.4898097826086957,0.5101902173913043
E01004982,1488,714,774,0.4798387096774194,0.5201612903225806
E01004961,1450,698,752,0.48137931034482756,0.5186206896551724
E01004965,1238,634,604,0.5121163166397416,0.4878836833602585
E01004966,1816,872,944,0.4801762114537445,0.5198237885462555
E01004967,1191,583,608,0.489504617968094,0.5104953820319059
E01004963,1478,711,767,0.4810554803788904,0.5189445196211097
E01004968,1485,713,772,0.48013468013468014,0.5198653198653199
E01005050,2124,1001,1123,0.4712806026365348,0.5287193973634652
E01005052,1444,722,722,0.5,0.5
E01005053,1527,756,771,0.4950884086444008,0.5049115913555993
E01004954,1450,688,762,0.47448275862068967,0.5255172413793103
E01004955,1357,666,691,0.49078850405305824,0.5092114959469418
E01004956,1776,847,929,0.4769144144144144,0.5230855855855856
E01004957,1899,917,982,0.482885729331227,0.517114270668773
E01004960,1670,821,849,0.49161676646706587,0.5083832335329341
E01004958,1510,736,774,0.48741721854304637,0.5125827814569537
E01004959,1734,854,880,0.4925028835063437,0.5074971164936563
E01004979,1812,915,897,0.5049668874172185,0.49503311258278143
E01004980,1454,745,709,0.5123796423658872,0.48762035763411277
E01005024,2649,1359,1290,0.5130237825594564,0.4869762174405436
E01005026,2192,1115,1077,0.5086678832116789,0.49133211678832117
E01004947,1546,728,818,0.47089262613195343,0.5291073738680466
E01004948,1871,945,926,0.5050774986638161,0.4949225013361839
E01004962,2011,1005,1006,0.4997513674788662,0.5002486325211337
E01004964,1852,908,944,0.490280777537797,0.509719222462203
E01004949,1413,690,723,0.4883227176220807,0.5116772823779193
E01004950,1488,747,741,0.5020161290322581,0.49798387096774194
E01004951,1563,754,809,0.48240563019833654,0.5175943698016635
E01004952,1336,646,690,0.48353293413173654,0.5164670658682635
E01004953,1533,743,790,0.4846705805609915,0.5153294194390085
E01005025,1697,840,857,0.4949911608721273,0.5050088391278728
E01005027,1862,956,906,0.5134264232008593,0.4865735767991407
E01005028,2235,1092,1143,0.4885906040268456,0.5114093959731544
E01005029,1985,975,1010,0.491183879093199,0.5088161209068011
E01005000,1471,715,756,0.4860639021074099,0.5139360978925901
E01005001,1278,640,638,0.5007824726134585,0.49921752738654146
E01005005,1409,662,747,0.46983676366217175,0.5301632363378282
E01005006,2022,985,1037,0.48714144411473786,0.5128585558852621
E01005030,1787,879,908,0.4918858421936206,0.5081141578063794
E01005054,1571,761,810,0.48440483768300446,0.5155951623169955
E01005059,1786,875,911,0.4899216125419933,0.5100783874580067
E01005060,1734,854,880,0.4925028835063437,0.5074971164936563
E01004997,1550,758,792,0.4890322580645161,0.5109677419354839
E01004998,1656,809,847,0.4885265700483092,0.5114734299516909
E01004999,1477,707,770,0.4786729857819905,0.5213270142180095
E01005002,1507,744,763,0.4936960849369608,0.5063039150630392
E01005003,1485,719,766,0.4841750841750842,0.5158249158249159
E01004991,1382,661,721,0.47829232995658466,0.5217076700434153
E01004992,1427,697,730,0.48843728100911005,0.51156271899089
E01004993,1988,986,1002,0.4959758551307847,0.5040241448692153
E01004994,1383,683,700,0.4938539407086045,0.5061460592913956
E01004990,1586,753,833,0.47477931904161413,0.5252206809583859
E01004996,1511,772,739,0.5109199205823958,0.48908007941760423
E01005004,1579,793,786,0.5022165927802407,0.49778340721975933
E01005008,2172,1045,1127,0.48112338858195214,0.5188766114180479
E01005009,1766,924,842,0.5232163080407701,0.47678369195922987
E01004945,1534,745,789,0.48565840938722293,0.5143415906127771
E01005055,1448,718,730,0.4958563535911602,0.5041436464088398
E01005056,1272,632,640,0.4968553459119497,0.5031446540880503
E01005057,1618,775,843,0.4789864029666255,0.5210135970333746
E01005058,1347,664,683,0.4929472902746845,0.5070527097253155
E01004995,1501,732,769,0.4876748834110593,0.5123251165889408
E01005010,1605,770,835,0.4797507788161994,0.5202492211838006
E01005012,1756,855,901,0.4869020501138952,0.5130979498861048
E01005013,2622,1251,1371,0.477116704805492,0.522883295194508
E01004984,1393,691,702,0.49605168700646085,0.5039483129935391
E01004985,1462,746,716,0.5102599179206566,0.4897400820793434
E01004989,1421,700,721,0.49261083743842365,0.5073891625615764
E01005007,1509,731,778,0.48442677269715045,0.5155732273028496
E01005011,1430,724,706,0.5062937062937063,0.4937062937062937
E01004983,1355,691,664,0.5099630996309963,0.4900369003690037
E01004986,1627,784,843,0.48186846957590657,0.5181315304240934
E01004987,1310,638,672,0.4870229007633588,0.5129770992366413
E01004988,1387,675,712,0.48666186012977647,0.5133381398702235
E01004941,1869,885,984,0.47351524879614765,0.5264847512038523
E01004942,1700,786,914,0.4623529411764706,0.5376470588235294
E01004943,1837,883,954,0.48067501360914533,0.5193249863908547
E01004944,1517,752,765,0.4957152274225445,0.5042847725774555
E01004946,1679,757,922,0.4508636092912448,0.5491363907087552
E01004969,1509,769,740,0.5096090125911199,0.49039098740888004
E01004970,1626,798,828,0.4907749077490775,0.5092250922509225
E01004971,1480,765,715,0.5168918918918919,0.4831081081081081
E01005034,1789,913,876,0.5103409726103969,0.48965902738960315
E01004972,1494,725,769,0.48527443105756357,0.5147255689424364
E01004973,1544,771,773,0.4993523316062176,0.5006476683937824
E01004975,1498,731,767,0.48798397863818427,0.5120160213618158
E01005039,1575,743,832,0.47174603174603175,0.5282539682539683
E01005045,1619,780,839,0.4817788758492897,0.5182211241507103
E01004974,1411,700,711,0.4961020552799433,0.5038979447200567
E01005033,1675,824,851,0.4919402985074627,0.5080597014925373
E01005036,1982,1040,942,0.5247225025227044,0.47527749747729564
E01005037,1493,735,758,0.49229738780977894,0.5077026121902211
E01005031,1533,745,788,0.48597521200260924,0.5140247879973907
E01005032,1341,622,719,0.4638329604772558,0.5361670395227442
E01005035,1452,718,734,0.49449035812672176,0.5055096418732782
E01005038,1357,669,688,0.49299926308032427,0.5070007369196757
E01005040,1845,926,919,0.5018970189701897,0.4981029810298103
E01005041,1857,919,938,0.49488422186322023,0.5051157781367798
E01005042,1952,939,1013,0.48104508196721313,0.5189549180327869
E01005043,1947,969,978,0.49768875192604006,0.50231124807396
E01005044,1964,1007,957,0.5127291242362525,0.48727087576374745
E01005098,1631,768,863,0.47087676272225626,0.5291232372777437
E01005099,1943,850,1093,0.43746783324755534,0.5625321667524447
E01005100,1658,777,881,0.4686369119420989,0.5313630880579011
E01005102,1370,670,700,0.48905109489051096,0.5109489051094891
E01005103,1832,851,981,0.4645196506550218,0.5354803493449781
E01005101,1871,900,971,0.48102618920363444,0.5189738107963656
E01005135,1866,933,933,0.5,0.5
E01005136,1512,760,752,0.5026455026455027,0.4973544973544973
E01005138,2480,1186,1294,0.4782258064516129,0.521774193548387
E01034107,1412,686,726,0.48583569405099153,0.5141643059490085
E01034108,2074,1020,1054,0.4918032786885246,0.5081967213114754
E01005139,1966,919,1047,0.4674465920651068,0.5325534079348931
E01005141,1974,956,1018,0.48429584599797365,0.5157041540020263
E01005251,1678,815,863,0.4856972586412396,0.5143027413587604
E01005252,1929,950,979,0.4924831518921721,0.5075168481078279
E01033685,1586,807,779,0.5088272383354351,0.4911727616645649
E01033687,1341,672,669,0.5011185682326622,0.4988814317673378
E01005104,1975,1014,961,0.5134177215189873,0.48658227848101265
E01005160,1974,982,992,0.49746707193515705,0.502532928064843
E01005161,1815,876,939,0.4826446280991736,0.5173553719008265
E01005162,1897,964,933,0.5081707959936742,0.4918292040063258
E01005163,1786,893,893,0.5,0.5
E01005247,1421,672,749,0.4729064039408867,0.5270935960591133
E01005248,1329,623,706,0.4687735139202408,0.5312264860797592
E01005249,2199,1060,1139,0.48203728967712595,0.517962710322874
E01005250,2233,1028,1205,0.46036721898790867,0.5396327810120913
E01005253,1704,818,886,0.4800469483568075,0.5199530516431925
E01005254,1606,803,803,0.5,0.5
E01005164,2343,1196,1147,0.510456679470764,0.48954332052923605
E01005205,2193,1018,1175,0.4642042863657091,0.5357957136342909
E01005206,1875,975,900,0.52,0.48
E01005207,2018,985,1033,0.48810703666997024,0.5118929633300298
E01005223,1617,785,832,0.48546691403834263,0.5145330859616574
E01005224,2118,984,1134,0.46458923512747874,0.5354107648725213
E01005225,2094,992,1102,0.47373447946513847,0.5262655205348615
E01005226,1939,954,985,0.4920061887570913,0.5079938112429088
E01005229,1502,731,771,0.4866844207723036,0.5133155792276964
E01005145,3003,1533,1470,0.5104895104895105,0.48951048951048953
E01005149,2184,1075,1109,0.49221611721611724,0.5077838827838828
E01005165,2348,1254,1094,0.5340715502555367,0.46592844974446335
E01005166,2139,1094,1045,0.5114539504441328,0.4885460495558672
E01005167,2315,1142,1173,0.49330453563714904,0.506695464362851
E01034109,1525,756,769,0.49573770491803276,0.5042622950819672
E01034110,1497,744,753,0.4969939879759519,0.503006012024048
E01005202,2383,1187,1196,0.4981116240033571,0.5018883759966429
E01005203,2024,1018,1006,0.5029644268774703,0.49703557312252966
E01005227,2078,1014,1064,0.4879692011549567,0.5120307988450433
E01005228,2250,1016,1234,0.45155555555555554,0.5484444444444444
E01033678,1776,874,902,0.49211711711711714,0.5078828828828829
E01033679,1399,692,707,0.49463902787705505,0.505360972122945
E01005256,2640,1297,1343,0.4912878787878788,0.5087121212121212
E01005257,2009,939,1070,0.4673967147834744,0.5326032852165257
E01005258,1798,888,910,0.4938820912124583,0.5061179087875417
E01005259,1773,840,933,0.47377326565143824,0.5262267343485617
E01005260,1468,715,753,0.48705722070844687,0.5129427792915532
E01005093,1842,917,925,0.497828447339848,0.502171552660152
E01005094,1694,796,898,0.46989374262101535,0.5301062573789846
E01005097,1950,944,1006,0.4841025641025641,0.5158974358974359
E01005255,1664,833,831,0.5006009615384616,0.49939903846153844
E01005261,1786,843,943,0.4720044792833147,0.5279955207166853
E01005092,1946,915,1031,0.47019527235354575,0.5298047276464543
E01005105,2956,1500,1456,0.5074424898511503,0.4925575101488498
E01005106,2334,1194,1140,0.5115681233933161,0.4884318766066838
E01005107,2033,984,1049,0.4840137727496311,0.5159862272503689
E01033668,1154,617,537,0.5346620450606586,0.46533795493934144
E01033669,1427,707,720,0.4954449894884373,0.5045550105115627
E01005189,1688,820,868,0.48578199052132703,0.514218009478673
E01005190,2449,1232,1217,0.5030624744793794,0.49693752552062065
E01034111,1571,746,825,0.4748567791215786,0.5251432208784214
E01034112,1851,901,950,0.48676391139924363,0.5132360886007563
E01034113,1486,726,760,0.48855989232839836,0.5114401076716016
E01034114,1917,955,962,0.4981742305685968,0.5018257694314032
E01005061,1792,876,916,0.4888392857142857,0.5111607142857143
E01005063,2118,1064,1054,0.502360717658168,0.4976392823418319
E01005065,2173,1104,1069,0.5080533824206167,0.49194661757938335
E01005066,1051,610,441,0.5803996194100857,0.4196003805899144
E01034115,1894,921,973,0.48627243928194297,0.513727560718057
E01034116,1109,590,519,0.5320108205590622,0.46798917944093776
E01005208,2808,1317,1491,0.469017094017094,0.530982905982906
E01005210,2646,1206,1440,0.4557823129251701,0.54421768707483
E01005214,2389,1243,1146,0.5203013813311009,0.4796986186688991
E01034117,2202,1075,1127,0.48819255222524977,0.5118074477747502
E01034118,1026,553,473,0.5389863547758285,0.46101364522417154
E01005067,2075,1038,1037,0.5002409638554217,0.49975903614457834
E01005186,2896,1444,1452,0.4986187845303867,0.5013812154696132
E01005232,1926,983,943,0.5103842159916926,0.48961578400830735
E01005235,2079,1027,1052,0.493987493987494,0.506012506012506
E01005239,1803,852,951,0.47254575707154745,0.5274542429284526
E01005187,2246,1095,1151,0.48753339269813,0.51246660730187
E01005188,1919,931,988,0.48514851485148514,0.5148514851485149
E01005191,1860,860,1000,0.46236559139784944,0.5376344086021505
E01005192,1732,891,841,0.5144341801385681,0.4855658198614319
E01005193,1770,898,872,0.5073446327683616,0.49265536723163844
E01005230,2094,1117,977,0.5334288443170965,0.4665711556829035
E01005231,2503,1224,1279,0.4890131841789852,0.5109868158210148
E01005236,2267,1214,1053,0.5355094838994265,0.46449051610057346
E01005237,2037,1053,984,0.5169366715758469,0.48306332842415317
E01034119,2667,1249,1418,0.4683164604424447,0.5316835395575553
E01005195,2447,1140,1307,0.46587658357172046,0.5341234164282795
E01005197,1727,862,865,0.499131441806601,0.5008685581933989
E01005198,2052,998,1054,0.48635477582846004,0.51364522417154
E01005201,2127,1059,1068,0.4978843441466855,0.5021156558533145
E01034120,1777,904,873,0.5087225661226786,0.4912774338773213
E01034121,1422,691,731,0.4859353023909986,0.5140646976090014
E01005243,2911,1401,1510,0.481277911370663,0.518722088629337
E01005245,2806,1379,1427,0.4914468995010691,0.5085531004989309
E01005246,2541,1209,1332,0.4757969303423849,0.5242030696576151
E01034122,1870,907,963,0.48502673796791446,0.5149732620320856
E01034123,1762,882,880,0.5005675368898979,0.49943246311010214
E01005244,2993,1460,1533,0.4878048780487805,0.5121951219512195
E01005285,1536,794,742,0.5169270833333334,0.4830729166666667
E01005288,1823,934,889,0.5123422929237521,0.48765770707624795
E01034124,1568,796,772,0.5076530612244898,0.4923469387755102
E01034125,1557,761,796,0.48876043673731534,0.5112395632626846
E01034126,1655,809,846,0.48882175226586105,0.511178247734139
E01034127,1362,694,668,0.5095447870778267,0.49045521292217326
E01005280,2179,1066,1113,0.48921523634694813,0.5107847636530518
E01005281,2572,1202,1370,0.46734059097978226,0.5326594090202177
E01005284,2598,1441,1157,0.554657428791378,0.44534257120862203
E01005286,2300,1213,1087,0.5273913043478261,0.4726086956521739
E01005287,2347,1161,1186,0.49467405198125264,0.5053259480187473
E01005297,2436,1258,1178,0.5164203612479474,0.48357963875205257
E01005298,1814,912,902,0.5027563395810364,0.4972436604189636
E01005302,2109,1083,1026,0.5135135135135135,0.4864864864864865
E01033680,1261,697,564,0.5527359238699445,0.44726407613005553
E01033686,1319,695,624,0.5269143290371494,0.47308567096285065
E01005150,1696,904,792,0.5330188679245284,0.4669811320754717
E01005151,1477,769,708,0.5206499661475965,0.47935003385240355
E01005152,1436,700,736,0.48746518105849584,0.5125348189415042
E01005159,1610,763,847,0.47391304347826085,0.5260869565217391
E01005296,1567,758,809,0.4837268666241225,0.5162731333758774
E01005299,1579,786,793,0.49778340721975933,0.5022165927802407
E01005178,2010,946,1064,0.47064676616915424,0.5293532338308458
E01005179,2230,1087,1143,0.4874439461883408,0.5125560538116591
E01005180,1920,920,1000,0.4791666666666667,0.5208333333333334
E01005181,2227,1114,1113,0.5002245172878311,0.4997754827121688
E01005182,1619,747,872,0.461395923409512,0.5386040765904879
E01005183,1792,913,879,0.5094866071428571,0.49051339285714285
E01005219,2277,1281,996,0.5625823451910409,0.43741765480895917
E01005220,2137,1045,1092,0.4890032756200281,0.5109967243799719
E01005221,2557,1332,1225,0.5209229565897536,0.4790770434102464
E01005222,2164,1071,1093,0.49491682070240295,0.505083179297597
E01005184,2295,1087,1208,0.4736383442265795,0.5263616557734205
E01005185,3260,1565,1695,0.48006134969325154,0.5199386503067485
E01005271,1985,987,998,0.4972292191435768,0.5027707808564231
E01034128,3735,1822,1913,0.48781793842034804,0.512182061579652
E01005154,1427,697,730,0.48843728100911005,0.51156271899089
E01005156,1479,721,758,0.4874915483434753,0.5125084516565247
E01005158,1492,707,785,0.4738605898123324,0.5261394101876675
E01005300,1548,758,790,0.4896640826873385,0.5103359173126615
E01005301,1482,726,756,0.4898785425101215,0.5101214574898786
E01005118,1472,726,746,0.49320652173913043,0.5067934782608695
E01005120,1901,928,973,0.48816412414518673,0.5118358758548133
E01005215,2045,1029,1016,0.5031784841075795,0.4968215158924205
E01005216,1529,746,783,0.48790058862001306,0.5120994113799869
E01005217,2053,1017,1036,0.4953726254262055,0.5046273745737945
E01005218,1689,847,842,0.5014801657785672,0.4985198342214328
E01005270,1768,822,946,0.4649321266968326,0.5350678733031674
E01005272,1973,945,1028,0.47896604156107453,0.5210339584389255
E01005273,1667,810,857,0.4859028194361128,0.5140971805638872
E01005278,1854,915,939,0.4935275080906149,0.5064724919093851
E01005279,2199,1022,1177,0.46475670759436105,0.535243292405639
E01005305,1708,870,838,0.509367681498829,0.49063231850117095
E01005309,2229,1104,1125,0.4952893674293405,0.5047106325706595
E01005310,1986,925,1061,0.46576032225579056,0.5342396777442094
E01005311,1825,911,914,0.49917808219178084,0.5008219178082192
E01005312,1982,1030,952,0.5196770938446014,0.4803229061553986
E01005082,1799,865,934,0.48082267926625905,0.519177320733741
E01005153,1544,781,763,0.5058290155440415,0.49417098445595853
E01005155,1434,683,751,0.47629009762900976,0.5237099023709902
E01005157,1529,717,812,0.46893394375408765,0.5310660562459124
E01005274,1751,840,911,0.47972587093089664,0.5202741290691034
E01005275,1781,873,908,0.4901740595171252,0.5098259404828748
E01005276,1464,698,766,0.476775956284153,0.523224043715847
E01005277,1677,825,852,0.4919499105545617,0.5080500894454383
E01005076,1348,664,684,0.49258160237388726,0.5074183976261127
E01005081,1822,840,982,0.4610318331503842,0.5389681668496158
E01005083,1838,986,852,0.5364526659412405,0.46354733405875953
E01033670,1446,743,703,0.5138312586445366,0.48616874135546334
E01033671,1788,847,941,0.47371364653243847,0.5262863534675615
E01005125,1574,740,834,0.4701397712833545,0.5298602287166455
E01005304,1959,996,963,0.5084226646248086,0.49157733537519144
E01005306,1580,796,784,0.5037974683544304,0.4962025316455696
E01005307,1803,889,914,0.4930671103716029,0.5069328896283971
E01005308,1688,806,882,0.4774881516587678,0.5225118483412322
E01005119,1738,822,916,0.47295742232451093,0.5270425776754891
E01005121,1687,799,888,0.4736218138707765,0.5263781861292235
E01005122,1913,917,996,0.4793518034500784,0.5206481965499216
E01005123,1774,859,915,0.4842164599774521,0.5157835400225479
E01005124,1862,879,983,0.47207303974221265,0.5279269602577873
E01005077,1677,768,909,0.45796064400715564,0.5420393559928444
E01005078,1553,831,722,0.5350933676754669,0.46490663232453316
E01005079,1643,803,840,0.4887401095556908,0.5112598904443092
E01005084,2010,935,1075,0.4651741293532338,0.5348258706467661
E01005172,1532,804,728,0.5248041775456919,0.4751958224543081
E01005173,1618,781,837,0.4826946847960445,0.5173053152039555
E01005174,1556,774,782,0.4974293059125964,0.5025706940874036
E01005175,1590,791,799,0.49748427672955975,0.5025157232704403
E01005176,1682,824,858,0.48989298454221164,0.5101070154577884
E01005177,1303,617,686,0.47352264006139677,0.5264773599386032
E01005115,1898,929,969,0.48946259220231825,0.5105374077976818
E01005262,1785,864,921,0.48403361344537815,0.5159663865546219
E01005264,1649,785,864,0.47604608853850816,0.5239539114614918
E01005265,1738,796,942,0.4579976985040276,0.5420023014959724
E01005266,2054,933,1121,0.4542356377799416,0.5457643622200584
E01005126,2003,984,1019,0.491263105341987,0.508736894658013
E01005168,1404,690,714,0.49145299145299143,0.5085470085470085
E01005169,1369,682,687,0.4981738495252009,0.5018261504747992
E01005170,1520,747,773,0.49144736842105263,0.5085526315789474
E01005171,1746,852,894,0.4879725085910653,0.5120274914089347
E01005263,1736,946,790,0.5449308755760369,0.45506912442396313
E01005267,1524,749,775,0.4914698162729659,0.5085301837270341
E01005268,2187,1092,1095,0.4993141289437586,0.5006858710562414
E01005269,1535,753,782,0.4905537459283388,0.5094462540716612
E01005069,1418,678,740,0.4781382228490832,0.5218617771509168
E01005111,1460,666,794,0.45616438356164385,0.5438356164383562
E01005113,1672,830,842,0.4964114832535885,0.5035885167464115
E01005114,1745,853,892,0.4888252148997135,0.5111747851002866
E01005116,2089,995,1094,0.47630445189085685,0.5236955481091431
E01005071,1735,834,901,0.4806916426512968,0.5193083573487032
E01005072,1781,862,919,0.48399775407074674,0.5160022459292533
E01005073,1536,760,776,0.4947916666666667,0.5052083333333334
E01005112,1723,840,883,0.4875217643644806,0.5124782356355194
E01005117,2455,1244,1211,0.5067209775967414,0.49327902240325866
E01005085,1673,769,904,0.4596533173939032,0.5403466826060969
E01005086,1912,894,1018,0.4675732217573222,0.5324267782426778
E01005089,1970,942,1028,0.4781725888324873,0.5218274111675127
E01005289,1701,807,894,0.47442680776014107,0.5255731922398589
E01005295,2641,1287,1354,0.48731541082923135,0.5126845891707686
E01005087,2304,1151,1153,0.4995659722222222,0.5004340277777778
E01005088,1933,892,1041,0.46145887221934817,0.5385411277806519
E01005090,1890,881,1009,0.46613756613756613,0.5338624338624338
E01005091,2381,1118,1263,0.46955060898782025,0.5304493910121798
E01005291,1481,723,758,0.48818365968939903,0.511816340310601
E01005068,1690,813,877,0.48106508875739645,0.5189349112426036
E01005070,1847,900,947,0.48727666486193827,0.5127233351380617
E01005074,1623,785,838,0.4836722119531731,0.5163277880468269
E01005075,1550,695,855,0.4483870967741935,0.5516129032258065
E01005319,2323,1069,1254,0.46018080068876455,0.5398191993112355
E01005290,1688,804,884,0.476303317535545,0.523696682464455
E01005292,1523,705,818,0.4629021667760998,0.5370978332239001
E01005293,1174,574,600,0.4889267461669506,0.5110732538330494
E01005294,1617,794,823,0.49103277674706247,0.5089672232529375
E01005317,2020,1021,999,0.5054455445544555,0.49455445544554455
E01005313,1514,706,808,0.4663143989431968,0.5336856010568032
E01005314,1695,784,911,0.4625368731563422,0.5374631268436578
E01005315,1724,835,889,0.484338747099768,0.515661252900232
E01005316,1642,812,830,0.4945188794153471,0.5054811205846529
E01005318,1990,918,1072,0.46130653266331656,0.5386934673366834
E01005130,1447,775,672,0.5355908776779544,0.4644091223220456
E01033651,1691,918,773,0.5428740390301596,0.4571259609698403
E01033658,1394,781,613,0.56025824964132,0.4397417503586801
E01033664,1859,1061,798,0.5707369553523399,0.42926304464766
E01033667,1491,826,665,0.5539906103286385,0.4460093896713615
E01005128,2026,1008,1018,0.49753208292201384,0.5024679170779862
E01033653,1851,1053,798,0.5688816855753647,0.43111831442463533
E01033654,1791,1106,685,0.6175321049692909,0.3824678950307091
E01033661,1988,1084,904,0.545271629778672,0.45472837022132795
E01034129,1082,601,481,0.555452865064695,0.444547134935305
E01034130,1391,815,576,0.5859094176851186,0.4140905823148814
E01005143,3006,1506,1500,0.500998003992016,0.499001996007984
E01033655,1267,729,538,0.5753749013417522,0.4246250986582478
E01033665,1523,874,649,0.5738673670387393,0.4261326329612607
E01033676,2006,953,1053,0.47507477567298106,0.5249252243270189
E01005212,3127,1514,1613,0.4841701311160857,0.5158298688839142
E01033656,2719,1301,1418,0.4784847370356749,0.5215152629643252
E01033662,2014,1058,956,0.5253227408142999,0.4746772591857001
E01005142,2291,1136,1155,0.49585333915320823,0.5041466608467918
E01005147,2783,1376,1407,0.4944304707150557,0.5055695292849443
E01033674,2080,1395,685,0.6706730769230769,0.3293269230769231
E01033675,2207,1082,1125,0.4902582691436339,0.5097417308563661
E01005213,2397,1259,1138,0.5252398831873175,0.47476011681268254
E01033660,1438,773,665,0.5375521557719054,0.4624478442280946
E01033672,1704,919,785,0.5393192488262911,0.46068075117370894
E01033673,1444,844,600,0.5844875346260388,0.4155124653739612
E01033677,1019,583,436,0.5721295387634936,0.4278704612365064
E01033681,1330,728,602,0.5473684210526316,0.45263157894736844
E01033682,1222,704,518,0.5761047463175123,0.4238952536824877
E01034131,1025,626,399,0.6107317073170732,0.38926829268292684
E01034132,1832,1067,765,0.5824235807860262,0.4175764192139738
E01005129,1842,945,897,0.5130293159609121,0.48697068403908794
E01005132,2137,1054,1083,0.4932147870846982,0.5067852129153019
E01034133,1868,943,925,0.5048179871520343,0.49518201284796576
E01034134,1193,639,554,0.5356244761106455,0.46437552388935455
E01033684,1820,1010,810,0.554945054945055,0.44505494505494503
E01033688,1708,874,834,0.5117096018735363,0.4882903981264637
E01034135,1114,637,477,0.5718132854578097,0.4281867145421903
E01034136,1009,583,426,0.5777998017839445,0.4222001982160555
E01005233,2937,1505,1432,0.5124276472591079,0.48757235274089206
E01005234,2313,1163,1150,0.5028102031993082,0.49718979680069175
E01005238,2298,1165,1133,0.5069625761531766,0.4930374238468233
E01034137,1732,902,830,0.5207852193995381,0.4792147806004619
E01005199,2512,1226,1286,0.4880573248407643,0.5119426751592356
E01005200,2459,1167,1292,0.47458316388775923,0.5254168361122408
E01034138,1385,703,682,0.5075812274368231,0.4924187725631769
E01005357,1428,702,726,0.49159663865546216,0.5084033613445378
E01005358,1568,765,803,0.48788265306122447,0.5121173469387755
E01005359,1564,768,796,0.49104859335038364,0.5089514066496164
E01005360,1380,679,701,0.4920289855072464,0.5079710144927536
E01005441,1527,745,782,0.48788474132285525,0.5121152586771447
E01005442,1329,654,675,0.49209932279909707,0.5079006772009029
E01005444,1397,668,729,0.47816750178954903,0.521832498210451
E01005445,1425,694,731,0.4870175438596491,0.5129824561403509
E01005361,1671,806,865,0.4823459006582885,0.5176540993417116
E01005443,1314,621,693,0.4726027397260274,0.5273972602739726
E01005446,1406,663,743,0.47155049786628733,0.5284495021337127
E01005447,1645,768,877,0.4668693009118541,0.5331306990881459
E01005390,1361,656,705,0.4819985304922851,0.5180014695077149
E01005394,1450,710,740,0.4896551724137931,0.5103448275862069
E01005395,1430,712,718,0.4979020979020979,0.5020979020979021
E01005396,1433,718,715,0.5010467550593162,0.4989532449406839
E01005355,1459,715,744,0.4900616860863605,0.5099383139136395
E01005356,1252,617,635,0.4928115015974441,0.5071884984025559
E01005399,1585,759,826,0.4788643533123028,0.5211356466876972
E01005403,1734,870,864,0.5017301038062284,0.4982698961937716
E01005410,1495,753,742,0.5036789297658862,0.4963210702341137
E01005411,1565,759,806,0.4849840255591054,0.5150159744408945
E01005414,1335,635,700,0.4756554307116105,0.5243445692883895
E01005415,1109,527,582,0.47520288548241657,0.5247971145175834
E01005452,1278,632,646,0.4945226917057903,0.5054773082942097
E01005453,1555,774,781,0.4977491961414791,0.5022508038585209
E01032558,1728,794,934,0.45949074074074076,0.5405092592592593
E01032559,2751,1348,1403,0.490003635041803,0.509996364958197
E01005391,1559,755,804,0.4842847979474022,0.5157152020525978
E01005392,1588,749,839,0.4716624685138539,0.5283375314861462
E01005393,1221,593,628,0.4856674856674857,0.5143325143325144
E01005401,1585,767,818,0.48391167192429024,0.5160883280757098
E01005397,1328,657,671,0.4947289156626506,0.5052710843373494
E01005398,1530,731,799,0.4777777777777778,0.5222222222222223
E01005400,1526,745,781,0.48820445609436436,0.5117955439056356
E01005402,1645,806,839,0.4899696048632219,0.5100303951367782
E01005335,1290,628,662,0.4868217054263566,0.5131782945736434
E01005337,2548,1231,1317,0.4831240188383045,0.5168759811616954
E01005339,1484,736,748,0.49595687331536387,0.5040431266846361
E01005340,1600,788,812,0.4925,0.5075
E01005421,1816,836,980,0.460352422907489,0.539647577092511
E01005422,1551,710,841,0.4577691811734365,0.5422308188265635
E01032920,2585,1247,1338,0.48239845261121855,0.5176015473887814
E01005448,1643,838,805,0.5100426049908704,0.48995739500912966
E01005449,1585,777,808,0.49022082018927443,0.5097791798107255
E01005454,1379,670,709,0.485859318346628,0.514140681653372
E01005455,1464,719,745,0.491120218579235,0.5088797814207651
E01005456,1681,812,869,0.4830458060678168,0.5169541939321832
E01005407,1719,851,868,0.49505526468877253,0.5049447353112274
E01005412,1684,815,869,0.4839667458432304,0.5160332541567696
E01005416,1521,737,784,0.48454963839579224,0.5154503616042078
E01005417,1554,764,790,0.49163449163449163,0.5083655083655083
E01005348,2423,1328,1095,0.5480808914568717,0.45191910854312833
E01005350,2408,1308,1100,0.5431893687707641,0.4568106312292359
E01005432,1827,882,945,0.4827586206896552,0.5172413793103449
E01005433,2477,1238,1239,0.49979814291481633,0.5002018570851837
E01005329,1499,753,746,0.5023348899266178,0.49766511007338227
E01005330,1735,886,849,0.5106628242074928,0.4893371757925072
E01005333,1239,603,636,0.48668280871670705,0.513317191283293
E01005336,1521,749,772,0.49243918474687703,0.5075608152531229
E01005349,2506,1276,1230,0.5091779728651237,0.49082202713487627
E01005351,2085,1021,1064,0.4896882494004796,0.5103117505995204
E01005352,1529,793,736,0.5186396337475474,0.4813603662524526
E01005353,1510,767,743,0.5079470198675496,0.49205298013245036
E01005354,1804,887,917,0.4916851441241685,0.5083148558758315
E01005327,1968,943,1025,0.4791666666666667,0.5208333333333334
E01005328,1790,894,896,0.4994413407821229,0.5005586592178771
E01005331,1724,830,894,0.4814385150812065,0.5185614849187935
E01005334,1426,678,748,0.47545582047685836,0.5245441795231417
E01005338,1942,934,1008,0.48094747682801237,0.5190525231719877
E01005387,1472,707,765,0.48029891304347827,0.5197010869565217
E01005388,1339,621,718,0.46377893950709487,0.5362210604929052
E01005389,1767,842,925,0.47651386530843237,0.5234861346915677
E01005418,1411,701,710,0.4968107725017718,0.5031892274982283
E01005428,2365,1128,1237,0.47695560253699787,0.5230443974630021
E01005431,1862,907,955,0.48711063372717506,0.5128893662728249
E01005450,2138,1032,1106,0.48269410664172124,0.5173058933582788
E01005451,1547,760,787,0.491273432449903,0.5087265675500969
E01005408,2018,977,1041,0.48414271555996036,0.5158572844400396
E01005409,1568,755,813,0.4815051020408163,0.5184948979591837
E01032922,2414,1156,1258,0.4788732394366197,0.5211267605633803
E01005406,1407,718,689,0.5103056147832267,0.4896943852167733
E01005413,1591,798,793,0.5015713387806411,0.4984286612193589
E01005419,1451,673,778,0.4638180565127498,0.5361819434872501
E01005420,1615,761,854,0.4712074303405573,0.5287925696594428
E01005321,2334,1201,1133,0.5145672664952871,0.48543273350471294
E01005326,2997,1455,1542,0.4854854854854855,0.5145145145145145
E01005427,2214,1102,1112,0.4977416440831075,0.5022583559168925
E01005429,1920,990,930,0.515625,0.484375
E01005430,2852,1445,1407,0.5066619915848527,0.49333800841514724
E01005320,2700,1328,1372,0.4918518518518519,0.5081481481481481
E01005434,2161,1104,1057,0.5108745950948634,0.4891254049051365
E01005437,2048,1045,1003,0.51025390625,0.48974609375
E01005459,1770,808,962,0.45649717514124294,0.5435028248587571
E01005383,2191,1056,1135,0.4819717024189868,0.5180282975810132
E01005386,1548,705,843,0.45542635658914726,0.5445736434108527
E01032556,1502,704,798,0.46870838881491345,0.5312916111850865
E01032557,1819,813,1006,0.4469488730071468,0.5530511269928532
E01005342,1592,851,741,0.5345477386934674,0.46545226130653267
E01005343,1415,681,734,0.4812720848056537,0.5187279151943462
E01005344,1913,960,953,0.501829587036069,0.498170412963931
E01005381,1956,953,1003,0.48721881390593047,0.5127811860940695
E01005332,2296,1093,1203,0.4760452961672474,0.5239547038327527
E01005341,1413,692,721,0.4897381457891012,0.5102618542108988
E01005345,1503,760,743,0.5056553559547572,0.49434464404524286
E01005346,1394,690,704,0.4949784791965567,0.5050215208034433
E01005347,1311,645,666,0.4919908466819222,0.5080091533180778
E01005322,1512,736,776,0.48677248677248675,0.5132275132275133
E01005323,1568,742,826,0.4732142857142857,0.5267857142857143
E01005324,1620,777,843,0.47962962962962963,0.5203703703703704
E01005325,1497,747,750,0.49899799599198397,0.501002004008016
E01005438,2968,1535,1433,0.5171832884097035,0.4828167115902965
E01005377,1749,831,918,0.4751286449399657,0.5248713550600344
E01005379,1296,569,727,0.4390432098765432,0.5609567901234568
E01005380,1514,717,797,0.47357992073976224,0.5264200792602378
E01005382,1609,788,821,0.4897451833436917,0.5102548166563082
E01005439,1586,765,821,0.4823455233291299,0.5176544766708702
E01005362,1357,656,701,0.4834193072955048,0.5165806927044952
E01005364,1584,767,817,0.4842171717171717,0.5157828282828283
E01005368,1516,750,766,0.4947229551451187,0.5052770448548812
E01005376,1444,688,756,0.47645429362880887,0.5235457063711911
E01005378,1557,738,819,0.47398843930635837,0.5260115606936416
E01005363,1774,882,892,0.4971815107102593,0.5028184892897407
E01005369,1965,886,1079,0.45089058524173026,0.5491094147582697
E01005370,1578,755,823,0.4784537389100127,0.5215462610899874
E01005371,1473,727,746,0.49355057705363203,0.506449422946368
E01005365,1377,676,701,0.49092229484386346,0.5090777051561365
E01005366,1557,687,870,0.441233140655106,0.558766859344894
E01005367,1420,708,712,0.49859154929577465,0.5014084507042254
E01005440,1450,689,761,0.47517241379310343,0.5248275862068965
E01005372,1276,595,681,0.4663009404388715,0.5336990595611285
E01005373,1193,561,632,0.4702430846605197,0.5297569153394803
E01005374,1485,715,770,0.48148148148148145,0.5185185185185185
E01005375,1502,741,761,0.4933422103861518,0.5066577896138482
E01005460,2705,1307,1398,0.48317929759704253,0.5168207024029575
E01005463,1687,803,884,0.4759928867812685,0.5240071132187315
E01034232,1692,868,824,0.5130023640661938,0.48699763593380613
E01034233,1609,856,753,0.5320074580484773,0.4679925419515227
E01005435,2032,1032,1000,0.5078740157480315,0.4921259842519685
E01005436,1827,858,969,0.4696223316912972,0.5303776683087028
E01005461,2423,1186,1237,0.4894758563763929,0.5105241436236071
E01005462,2204,1124,1080,0.5099818511796733,0.4900181488203267
E01005518,1592,777,815,0.4880653266331658,0.5119346733668342
E01005520,1715,812,903,0.47346938775510206,0.5265306122448979
E01005522,1486,740,746,0.4979811574697174,0.5020188425302826
E01005523,1832,896,936,0.4890829694323144,0.5109170305676856
E01005519,1563,798,765,0.510556621880998,0.4894433781190019
E01005594,1512,761,751,0.5033068783068783,0.4966931216931217
E01005597,1979,972,1007,0.49115715007579586,0.5088428499242041
E01005598,1548,744,804,0.4806201550387597,0.5193798449612403
E01005516,1281,636,645,0.4964871194379391,0.5035128805620609
E01005517,1435,702,733,0.489198606271777,0.510801393728223
E01005521,1452,714,738,0.49173553719008267,0.5082644628099173
E01005596,2157,1059,1098,0.4909596662030598,0.5090403337969402
E01005578,1543,765,778,0.4957874270900843,0.5042125729099157
E01005579,1861,926,935,0.49758194519075766,0.5024180548092424
E01005586,1615,800,815,0.4953560371517028,0.5046439628482973
E01005593,2056,1012,1044,0.49221789883268485,0.5077821011673151
E01005595,1328,638,690,0.48042168674698793,0.5195783132530121
E01005489,1249,593,656,0.4747798238590873,0.5252201761409128
E01005490,1571,961,610,0.6117122851686824,0.38828771483131763
E01005491,1436,679,757,0.47284122562674097,0.5271587743732591
E01005493,1762,860,902,0.4880817253121453,0.5119182746878547
E01005494,1758,853,905,0.4852104664391354,0.5147895335608647
E01005495,1769,878,891,0.4963256076879593,0.5036743923120407
E01005488,1507,732,775,0.48573324485733244,0.5142667551426675
E01005492,1534,745,789,0.48565840938722293,0.5143415906127771
E01005499,1512,743,769,0.4914021164021164,0.5085978835978836
E01005571,1648,803,845,0.48725728155339804,0.5127427184466019
E01005570,1307,639,668,0.4889058913542464,0.5110941086457537
E01005572,1500,725,775,0.48333333333333334,0.5166666666666667
E01005573,1433,699,734,0.48778785764131194,0.5122121423586881
E01005574,1728,849,879,0.4913194444444444,0.5086805555555556
E01005587,1367,670,697,0.49012435991221653,0.5098756400877835
E01005588,1314,591,723,0.4497716894977169,0.5502283105022832
E01005580,1647,805,842,0.48876745598057075,0.5112325440194293
E01005581,1973,959,1014,0.48606183476938675,0.5139381652306133
E01005583,1746,887,859,0.5080183276059564,0.4919816723940435
E01005585,1569,804,765,0.5124282982791587,0.4875717017208413
E01034234,1763,893,870,0.5065229722064662,0.49347702779353375
E01034235,1667,831,836,0.498500299940012,0.501499700059988
E01005496,1321,630,691,0.4769114307342922,0.5230885692657078
E01005589,1700,842,858,0.49529411764705883,0.5047058823529412
E01005590,1904,950,954,0.4989495798319328,0.5010504201680672
E01005591,1586,762,824,0.48045397225725095,0.519546027742749
E01005592,1638,795,843,0.48534798534798534,0.5146520146520146
E01005472,1648,797,851,0.4836165048543689,0.5163834951456311
E01005473,1699,837,862,0.492642731018246,0.5073572689817539
E01005482,1661,957,704,0.5761589403973509,0.423841059602649
E01005483,1485,760,725,0.5117845117845118,0.4882154882154882
E01005484,2032,1018,1014,0.5009842519685039,0.49901574803149606
E01005486,1701,853,848,0.5014697236919459,0.4985302763080541
E01005487,1789,877,912,0.490217998882057,0.509782001117943
E01005474,1318,628,690,0.4764795144157815,0.5235204855842185
E01005575,1714,833,881,0.48599766627771296,0.5140023337222871
E01005576,1525,735,790,0.4819672131147541,0.5180327868852459
E01005577,1459,718,741,0.49211788896504455,0.5078821110349554
E01005469,1822,893,929,0.49012074643249176,0.5098792535675082
E01005563,2170,1063,1107,0.48986175115207375,0.5101382488479262
E01005565,1571,777,794,0.4945894334818587,0.5054105665181413
E01005566,2346,1124,1222,0.47911338448422847,0.5208866155157715
E01005568,1940,957,983,0.493298969072165,0.506701030927835
E01005569,1793,849,944,0.4735080870050195,0.5264919129949804
E01005556,1529,751,778,0.49117069980379335,0.5088293001962066
E01005559,1469,705,764,0.47991831177671884,0.5200816882232812
E01005560,1462,716,746,0.4897400820793434,0.5102599179206566
E01005567,1879,921,958,0.4901543374135178,0.5098456625864821
E01005555,1386,679,707,0.4898989898989899,0.51010101010101
E01005557,1139,554,585,0.4863915715539947,0.5136084284460053
E01005558,1594,766,828,0.48055207026348806,0.5194479297365119
E01005561,1412,692,720,0.49008498583569404,0.509915014164306
E01005562,1509,764,745,0.5062955599734924,0.4937044400265076
E01005470,2036,1020,1016,0.5009823182711198,0.49901768172888017
E01005471,1696,851,845,0.5017688679245284,0.4982311320754717
E01005475,1778,886,892,0.4983127109111361,0.5016872890888638
E01005485,2376,1239,1137,0.5214646464646465,0.47853535353535354
E01005564,2410,1217,1193,0.5049792531120332,0.4950207468879668
E01005464,1969,939,1030,0.47689182326053836,0.5231081767394616
E01005465,1810,881,929,0.4867403314917127,0.5132596685082873
E01005466,2485,1184,1301,0.47645875251509057,0.5235412474849095
E01005467,1972,931,1041,0.4721095334685598,0.5278904665314401
E01005468,2166,1044,1122,0.481994459833795,0.518005540166205
E01005476,1796,939,857,0.5228285077951003,0.4771714922048998
E01005477,1771,858,913,0.484472049689441,0.515527950310559
E01005478,1588,765,823,0.4817380352644836,0.5182619647355163
E01005479,1976,959,1017,0.4853238866396761,0.5146761133603239
E01005480,1647,803,844,0.48755312689738917,0.5124468731026108
E01005481,1680,801,879,0.4767857142857143,0.5232142857142857
E01005497,1891,919,972,0.4859862506610259,0.514013749338974
E01005501,1783,891,892,0.4997195737521032,0.5002804262478968
E01005502,1378,682,696,0.4949201741654572,0.5050798258345428
E01005504,1642,796,846,0.48477466504263095,0.5152253349573691
E01005505,2182,1014,1168,0.46471127406049495,0.535288725939505
E01005509,1445,736,709,0.5093425605536333,0.4906574394463668
E01005510,1094,534,560,0.48811700182815354,0.5118829981718465
E01005511,1251,599,652,0.4788169464428457,0.5211830535571543
E01005512,1440,712,728,0.49444444444444446,0.5055555555555555
E01005513,1557,743,814,0.47719974309569685,0.5228002569043031
E01005514,1844,876,968,0.4750542299349241,0.5249457700650759
E01005515,1798,808,990,0.44938820912124583,0.5506117908787542
E01005498,1372,641,731,0.467201166180758,0.532798833819242
E01005500,1592,783,809,0.49183417085427134,0.5081658291457286
E01005503,1318,681,637,0.5166919575113809,0.48330804248861914
E01005506,1545,772,773,0.49967637540453075,0.5003236245954693
E01005507,2261,1119,1142,0.49491375497567447,0.5050862450243255
E01005508,2015,973,1042,0.48287841191067,0.5171215880893301
E01005524,1470,720,750,0.4897959183673469,0.5102040816326531
E01005525,1886,935,951,0.4957582184517497,0.5042417815482503
E01005526,1907,934,973,0.4897745149449397,0.5102254850550603
E01005528,1548,783,765,0.5058139534883721,0.4941860465116279
E01005536,1713,815,898,0.4757734967892586,0.5242265032107414
E01005543,1252,614,638,0.4904153354632588,0.5095846645367412
E01005527,2059,985,1074,0.4783875667799903,0.5216124332200097
E01005529,1660,753,907,0.4536144578313253,0.5463855421686747
E01005551,2027,955,1072,0.47113961519486924,0.5288603848051308
E01005552,2342,1108,1234,0.4730999146029035,0.5269000853970965
E01005553,2037,991,1046,0.48649975454099165,0.5135002454590083
E01005554,2157,1062,1095,0.49235048678720444,0.5076495132127955
E01005534,1414,709,705,0.5014144271570015,0.4985855728429986
E01005535,1469,729,740,0.49625595643294756,0.5037440435670524
E01005537,1269,644,625,0.5074862096138691,0.4925137903861308
E01005538,1482,708,774,0.4777327935222672,0.5222672064777328
E01005540,1345,651,694,0.48401486988847586,0.5159851301115241
E01005541,1534,731,803,0.4765319426336376,0.5234680573663625
E01005542,1616,767,849,0.4746287128712871,0.5253712871287128
E01005533,1623,810,813,0.49907578558225507,0.5009242144177449
E01005539,1315,651,664,0.4950570342205323,0.5049429657794677
E01005546,1242,613,629,0.49355877616747185,0.5064412238325282
E01005547,1755,858,897,0.4888888888888889,0.5111111111111111
E01005548,1275,635,640,0.4980392156862745,0.5019607843137255
E01005530,1458,695,763,0.4766803840877915,0.5233196159122085
E01005531,1160,551,609,0.475,0.525
E01005532,1548,750,798,0.4844961240310077,0.5155038759689923
E01005544,1475,722,753,0.4894915254237288,0.5105084745762711
E01005545,1250,623,627,0.4984,0.5016
E01005549,1548,763,785,0.4928940568475452,0.5071059431524548
E01005550,1466,711,755,0.4849931787175989,0.515006821282401
E01005659,1544,744,800,0.48186528497409326,0.5181347150259067
E01005660,1823,856,967,0.4695556774547449,0.5304443225452551
E01005663,1528,747,781,0.48887434554973824,0.5111256544502618
E01005664,1708,765,943,0.44789227166276346,0.5521077283372365
E01005665,2104,984,1120,0.467680608365019,0.532319391634981
E01005703,1746,841,905,0.4816723940435281,0.518327605956472
E01005704,1344,651,693,0.484375,0.515625
E01005706,1537,725,812,0.4716981132075472,0.5283018867924528
E01005708,1434,726,708,0.5062761506276151,0.49372384937238495
E01005702,2637,1263,1374,0.4789533560864619,0.5210466439135382
E01005707,1751,853,898,0.48715019988577957,0.5128498001142204
E01033976,1965,946,1019,0.4814249363867684,0.5185750636132316
E01033977,1141,560,581,0.49079754601226994,0.50920245398773
E01005661,1900,951,949,0.5005263157894737,0.4994736842105263
E01005662,1623,769,854,0.4738139248305607,0.5261860751694393
E01005709,1606,760,846,0.47322540473225405,0.526774595267746
E01005710,2143,1040,1103,0.48530097993467103,0.514699020065329
E01005670,1759,866,893,0.4923251847640705,0.5076748152359295
E01005672,1278,613,665,0.47965571205007823,0.5203442879499217
E01005676,1225,617,608,0.5036734693877551,0.4963265306122449
E01005677,1581,762,819,0.4819734345351044,0.5180265654648957
E01005686,1463,694,769,0.47436773752563227,0.5256322624743678
E01005688,1568,772,796,0.4923469387755102,0.5076530612244898
E01005691,1417,718,699,0.5067043048694425,0.49329569513055754
E01005692,1375,669,706,0.48654545454545456,0.5134545454545455
E01005711,1394,700,694,0.5021520803443329,0.49784791965566716
E01005712,1838,909,929,0.49455930359085964,0.5054406964091404
E01005713,1627,796,831,0.4892440073755378,0.5107559926244623
E01005714,1712,806,906,0.47079439252336447,0.5292056074766355
E01005715,1746,871,875,0.4988545246277205,0.5011454753722795
E01005718,1601,805,796,0.5028107432854466,0.4971892567145534
E01005673,1486,707,779,0.4757738896366083,0.5242261103633916
E01005678,1569,748,821,0.4767367750159337,0.5232632249840663
E01005679,1550,709,841,0.45741935483870966,0.5425806451612903
E01033978,1027,507,520,0.4936708860759494,0.5063291139240507
E01033979,2044,1466,578,0.7172211350293543,0.2827788649706458
E01005687,1802,882,920,0.4894561598224195,0.5105438401775805
E01005689,1366,664,702,0.486090775988287,0.513909224011713
E01005690,1568,769,799,0.49043367346938777,0.5095663265306123
E01005693,1433,676,757,0.47173761339846476,0.5282623866015352
E01005646,2252,1200,1052,0.5328596802841918,0.46714031971580816
E01005649,1723,862,861,0.5002901915264074,0.4997098084735926
E01005650,1993,1088,905,0.5459106874059207,0.45408931259407925
E01005651,2277,1205,1072,0.5292050944224858,0.4707949055775143
E01005647,1501,719,782,0.47901399067288475,0.5209860093271153
E01005648,2351,1158,1193,0.49255635899617184,0.5074436410038281
E01005652,1555,754,801,0.48488745980707393,0.5151125401929261
E01005653,1562,774,788,0.49551856594110116,0.5044814340588989
E01005671,1567,767,800,0.4894703254626675,0.5105296745373324
E01005674,1573,761,812,0.4837889383343929,0.5162110616656072
E01005694,1709,845,864,0.4944411936805149,0.5055588063194851
E01005696,1784,844,940,0.4730941704035874,0.5269058295964125
E01005698,1745,825,920,0.47277936962750716,0.5272206303724928
E01005700,1516,742,774,0.4894459102902375,0.5105540897097626
E01005716,1633,794,839,0.48622167789344767,0.5137783221065524
E01005717,1555,773,782,0.49710610932475885,0.5028938906752412
E01005734,1417,683,734,0.4820042342978123,0.5179957657021877
E01005735,1422,709,713,0.49859353023909986,0.5014064697609001
E01005736,1368,675,693,0.4934210526315789,0.506578947368421
E01005737,1510,733,777,0.48543046357615893,0.5145695364238411
E01005739,1999,950,1049,0.4752376188094047,0.5247623811905953
E01005695,1556,784,772,0.5038560411311054,0.4961439588688946
E01005697,1531,773,758,0.5048987589810582,0.4951012410189419
E01005738,1931,966,965,0.5002589331952356,0.4997410668047644
E01005740,1599,788,811,0.49280800500312694,0.5071919949968731
E01005741,1680,827,853,0.4922619047619048,0.5077380952380952
E01005742,1555,768,787,0.49389067524115754,0.5061093247588424
E01005625,1370,683,687,0.4985401459854015,0.5014598540145986
E01005627,1172,568,604,0.48464163822525597,0.515358361774744
E01005699,1791,904,887,0.5047459519821329,0.4952540480178671
E01005701,1826,891,935,0.4879518072289157,0.5120481927710844
E01005624,1839,890,949,0.4839586731919521,0.5160413268080478
E01005680,1732,916,816,0.5288683602771362,0.47113163972286376
E01005683,2149,988,1161,0.45974872033503955,0.5402512796649604
E01033980,1043,518,525,0.4966442953020134,0.5033557046979866
E01033981,2739,1412,1327,0.515516611902154,0.4844833880978459
E01005622,1595,753,842,0.47210031347962383,0.5278996865203762
E01005623,1266,633,633,0.5,0.5
E01005626,1286,640,646,0.4976671850699845,0.5023328149300156
E01005628,1575,832,743,0.5282539682539683,0.47174603174603175
E01005725,1459,732,727,0.5017135023989033,0.49828649760109667
E01005726,1433,704,729,0.49127704117236565,0.5087229588276343
E01005727,1349,673,676,0.4988880652335063,0.5011119347664937
E01005728,1791,873,918,0.48743718592964824,0.5125628140703518
E01005733,1470,694,776,0.47210884353741495,0.527891156462585
E01005631,1574,854,720,0.542566709021601,0.45743329097839897
E01005632,2452,1265,1187,0.515905383360522,0.484094616639478
E01005633,1532,755,777,0.49281984334203655,0.5071801566579635
E01005634,1591,785,806,0.49340037712130735,0.5065996228786926
E01005635,1552,812,740,0.5231958762886598,0.47680412371134023
E01005636,1597,798,799,0.4996869129618034,0.5003130870381967
E01005637,1450,743,707,0.5124137931034483,0.48758620689655174
E01005629,1485,730,755,0.49158249158249157,0.5084175084175084
E01005630,1529,761,768,0.4977109221713538,0.5022890778286462
E01005719,2038,1041,997,0.5107948969578018,0.4892051030421982
E01005722,2029,1033,996,0.5091177920157713,0.49088220798422866
E01005723,1661,828,833,0.49849488260084285,0.5015051173991572
E01005724,1413,695,718,0.49186128803963197,0.508138711960368
E01033982,1911,925,986,0.4840397697540555,0.5159602302459445
E01033983,1275,651,624,0.5105882352941177,0.4894117647058824
E01005654,1966,1016,950,0.5167853509664293,0.4832146490335707
E01005656,1697,840,857,0.4949911608721273,0.5050088391278728
E01005657,1802,913,889,0.5066592674805771,0.49334073251942284
E01005721,1552,780,772,0.5025773195876289,0.49742268041237114
E01005681,1502,814,688,0.5419440745672437,0.4580559254327563
E01005682,1741,937,804,0.5381964388282596,0.4618035611717404
E01033984,2443,1184,1259,0.48465002046663935,0.5153499795333606
E01005729,1535,828,707,0.539413680781759,0.46058631921824106
E01005730,1668,804,864,0.48201438848920863,0.5179856115107914
E01005731,1566,781,785,0.4987228607918263,0.5012771392081737
E01005732,1207,599,608,0.49627174813587405,0.503728251864126
E01005599,1903,1015,888,0.5333683657383079,0.4666316342616921
E01005600,2036,1021,1015,0.5014734774066798,0.49852652259332025
E01005601,1740,828,912,0.47586206896551725,0.5241379310344828
E01005602,1675,827,848,0.4937313432835821,0.506268656716418
E01005603,1808,872,936,0.4823008849557522,0.5176991150442478
E01005604,1651,808,843,0.48940036341611143,0.5105996365838885
E01005605,1658,829,829,0.5,0.5
E01005638,2211,1128,1083,0.5101763907734057,0.4898236092265943
E01005639,1516,684,832,0.45118733509234826,0.5488126649076517
E01005640,1360,666,694,0.48970588235294116,0.5102941176470588
E01005641,1365,642,723,0.4703296703296703,0.5296703296703297
E01005642,1208,604,604,0.5,0.5
E01005643,1369,648,721,0.4733382030679328,0.5266617969320672
E01005644,1517,750,767,0.4943968358602505,0.5056031641397495
E01005645,1363,687,676,0.504035216434336,0.495964783565664
E01005616,1446,686,760,0.47441217150760717,0.5255878284923928
E01005617,1480,719,761,0.4858108108108108,0.5141891891891892
E01005618,2080,970,1110,0.46634615384615385,0.5336538461538461
E01005619,1231,632,599,0.5134037367993501,0.48659626320064986
E01005620,2550,1285,1265,0.503921568627451,0.49607843137254903
E01005621,1768,863,905,0.48812217194570134,0.5118778280542986
E01005612,2481,1255,1226,0.505844417573559,0.494155582426441
E01005613,2698,1479,1219,0.5481838398813936,0.45181616011860637
E01005614,3103,1532,1571,0.49371575894295844,0.5062842410570416
E01005611,2515,1316,1199,0.5232604373757456,0.4767395626242545
E01005615,2372,1252,1120,0.5278246205733558,0.47217537942664417
E01033985,1664,835,829,0.5018028846153846,0.49819711538461536
E01033986,1524,789,735,0.5177165354330708,0.4822834645669291
E01032909,1716,872,844,0.5081585081585082,0.49184149184149184
E01033330,1541,928,613,0.6022063595068138,0.3977936404931862
E01033987,1137,631,506,0.5549692172383466,0.4450307827616535
E01033988,1311,705,606,0.5377574370709383,0.4622425629290618
E01033989,1133,647,486,0.5710503089143866,0.4289496910856134
E01033990,1186,573,613,0.4831365935919056,0.5168634064080945
E01005610,2939,1332,1607,0.45321537938074175,0.5467846206192583
E01032684,1386,762,624,0.5497835497835498,0.45021645021645024
E01032906,2043,1153,890,0.5643661282427802,0.4356338717572198
E01033991,1561,821,740,0.5259449071108264,0.4740550928891736
E01033992,1398,771,627,0.5515021459227468,0.44849785407725323
E01005667,2274,1138,1136,0.5004397537379067,0.4995602462620932
E01032912,2271,1128,1143,0.4966974900924703,0.5033025099075297
E01032914,2121,1141,980,0.5379537953795379,0.46204620462046203
E01032915,2139,1103,1036,0.5156615240766713,0.4843384759233287
E01033993,1813,993,820,0.5477109762824048,0.45228902371759516
E01033994,1168,671,497,0.574486301369863,0.425513698630137
E01033995,1205,652,553,0.5410788381742738,0.4589211618257261
E01033996,1218,697,521,0.5722495894909688,0.4277504105090312
E01033997,1030,585,445,0.5679611650485437,0.4320388349514563
E01033998,1330,757,573,0.5691729323308271,0.43082706766917295
E01033999,1223,701,522,0.5731807031888798,0.4268192968111202
E01005886,1466,681,785,0.4645293315143247,0.5354706684856753
E01005888,1530,729,801,0.4764705882352941,0.5235294117647059
E01005889,1425,653,772,0.45824561403508773,0.5417543859649123
E01005891,1221,613,608,0.502047502047502,0.49795249795249796
E01005894,1362,672,690,0.4933920704845815,0.5066079295154186
E01005887,1729,838,891,0.48467322151532677,0.5153267784846732
E01005890,1527,719,808,0.47085789129011135,0.5291421087098886
E01005893,2187,1153,1034,0.5272062185642432,0.47279378143575673
E01005896,1665,830,835,0.4984984984984985,0.5015015015015015
E01005919,1542,707,835,0.4584954604409857,0.5415045395590142
E01005862,1476,729,747,0.49390243902439024,0.5060975609756098
E01005892,1272,633,639,0.49764150943396224,0.5023584905660378
E01005895,1167,536,631,0.4592973436161097,0.5407026563838904
E01005920,1601,788,813,0.49219237976264835,0.5078076202373517
E01005921,1470,691,779,0.47006802721088436,0.5299319727891156
E01005922,1314,630,684,0.4794520547945205,0.5205479452054794
E01005753,1840,847,993,0.4603260869565217,0.5396739130434782
E01005754,2005,1079,926,0.5381546134663342,0.46184538653366586
E01005755,1736,790,946,0.45506912442396313,0.5449308755760369
E01005756,2378,1198,1180,0.503784693019344,0.496215306980656
E01005745,1375,679,696,0.4938181818181818,0.5061818181818182
E01005746,1449,705,744,0.4865424430641822,0.5134575569358178
E01005747,1403,674,729,0.4803991446899501,0.5196008553100498
E01005748,1512,728,784,0.48148148148148145,0.5185185185185185
E01005863,1719,852,867,0.4956369982547993,0.5043630017452007
E01005864,1576,774,802,0.49111675126903553,0.5088832487309645
E01005866,1669,864,805,0.5176752546434991,0.4823247453565009
E01005869,1593,779,814,0.48901443816698054,0.5109855618330195
E01005914,1418,710,708,0.5007052186177715,0.4992947813822285
E01005915,1549,743,806,0.47966429954809553,0.5203357004519045
E01005916,1614,802,812,0.4969021065675341,0.5030978934324659
E01005917,1829,915,914,0.5002733734281027,0.4997266265718972
E01005859,1411,725,686,0.5138199858256556,0.4861800141743444
E01005865,1961,936,1025,0.47730749617542073,0.5226925038245793
E01005867,1482,717,765,0.48380566801619435,0.5161943319838057
E01005868,1522,776,746,0.5098554533508541,0.49014454664914586
E01005743,1274,628,646,0.49293563579277866,0.5070643642072213
E01005744,1554,726,828,0.4671814671814672,0.5328185328185329
E01005749,1654,794,860,0.4800483675937122,0.5199516324062878
E01005750,1669,812,857,0.4865188735769922,0.5134811264230078
E01005751,1400,709,691,0.5064285714285715,0.49357142857142855
E01005897,1528,744,784,0.4869109947643979,0.5130890052356021
E01005898,1708,822,886,0.4812646370023419,0.5187353629976581
E01005900,1608,789,819,0.4906716417910448,0.5093283582089553
E01005903,1457,703,754,0.48249828414550444,0.5175017158544956
E01005904,1530,733,797,0.47908496732026146,0.5209150326797386
E01005853,1615,786,829,0.486687306501548,0.513312693498452
E01005856,1600,776,824,0.485,0.515
E01005860,1516,718,798,0.4736147757255937,0.5263852242744064
E01005861,1543,753,790,0.4880103694102398,0.5119896305897602
E01005752,1405,665,740,0.47330960854092524,0.5266903914590747
E01005899,1619,751,868,0.4638665843113033,0.5361334156886968
E01005901,1367,670,697,0.49012435991221653,0.5098756400877835
E01005902,1620,764,856,0.47160493827160493,0.528395061728395
E01005905,1511,709,802,0.4692256783587028,0.5307743216412971
E01005852,1484,720,764,0.48517520215633425,0.5148247978436657
E01005854,1730,851,879,0.49190751445086706,0.508092485549133
E01005855,1482,742,740,0.5006747638326585,0.4993252361673414
E01005857,1626,799,827,0.491389913899139,0.508610086100861
E01005858,1580,761,819,0.4816455696202532,0.5183544303797468
E01005757,1603,788,815,0.49157829070492826,0.5084217092950717
E01005766,1779,915,864,0.5143338954468802,0.4856661045531197
E01005918,1616,838,778,0.5185643564356436,0.4814356435643564
E01033947,1540,771,769,0.5006493506493507,0.4993506493506494
E01033948,1349,686,663,0.508524833209785,0.49147516679021497
E01005870,1374,687,687,0.5,0.5
E01005871,1382,676,706,0.48914616497829233,0.5108538350217077
E01005873,1469,694,775,0.472430224642614,0.527569775357386
E01005875,1562,774,788,0.49551856594110116,0.5044814340588989
E01005764,1607,759,848,0.4723086496577474,0.5276913503422527
E01005816,1563,779,784,0.4984005118362124,0.5015994881637876
E01005817,1392,682,710,0.4899425287356322,0.5100574712643678
E01005822,1896,962,934,0.5073839662447257,0.49261603375527424
E01005880,1488,720,768,0.4838709677419355,0.5161290322580645
E01005881,1210,592,618,0.48925619834710743,0.5107438016528926
E01005883,1519,735,784,0.4838709677419355,0.5161290322580645
E01005908,1644,797,847,0.48479318734793186,0.5152068126520681
E01005765,1379,661,718,0.47933284989122554,0.5206671501087745
E01005818,1400,691,709,0.49357142857142855,0.5064285714285715
E01005819,1595,769,826,0.48213166144200625,0.5178683385579937
E01005820,1489,713,776,0.4788448623237072,0.5211551376762928
E01005821,1412,674,738,0.4773371104815864,0.5226628895184136
E01005823,1646,817,829,0.49635479951397327,0.5036452004860267
E01005825,1676,755,921,0.45047732696897375,0.5495226730310262
E01005872,1646,809,837,0.491494532199271,0.508505467800729
E01005874,1875,957,918,0.5104,0.4896
E01005876,1495,744,751,0.49765886287625416,0.5023411371237458
E01005877,1738,837,901,0.4815880322209436,0.5184119677790564
E01005878,1749,836,913,0.4779874213836478,0.5220125786163522
E01005879,1318,646,672,0.49013657056145676,0.5098634294385432
E01005882,1274,621,653,0.48744113029827313,0.5125588697017268
E01005884,1435,683,752,0.4759581881533101,0.5240418118466899
E01005885,1491,703,788,0.47149564050972503,0.528504359490275
E01005832,1421,705,716,0.49612948627726955,0.5038705137227305
E01005833,1040,510,530,0.49038461538461536,0.5096153846153846
E01005835,1393,697,696,0.5003589375448672,0.4996410624551328
E01005837,1545,751,794,0.486084142394822,0.513915857605178
E01005843,1450,710,740,0.4896551724137931,0.5103448275862069
E01005769,1552,706,846,0.45489690721649484,0.5451030927835051
E01005778,1408,678,730,0.4815340909090909,0.5184659090909091
E01005779,1472,698,774,0.4741847826086957,0.5258152173913043
E01005780,1482,732,750,0.4939271255060729,0.5060728744939271
E01005781,1655,806,849,0.48700906344410877,0.5129909365558912
E01005759,1677,822,855,0.49016100178890876,0.5098389982110912
E01005760,1929,950,979,0.4924831518921721,0.5075168481078279
E01005797,1414,655,759,0.46322489391796323,0.5367751060820368
E01005800,1615,789,826,0.4885448916408669,0.5114551083591331
E01005804,1134,540,594,0.47619047619047616,0.5238095238095238
E01005824,1508,753,755,0.4993368700265252,0.5006631299734748
E01005826,1611,729,882,0.45251396648044695,0.547486033519553
E01005827,1752,841,911,0.4800228310502283,0.5199771689497716
E01005828,1375,666,709,0.4843636363636364,0.5156363636363637
E01005829,1192,559,633,0.46895973154362414,0.5310402684563759
E01005768,2066,1002,1064,0.4849951597289448,0.5150048402710552
E01005770,1497,725,772,0.48430193720774883,0.5156980627922512
E01005771,1439,694,745,0.48227936066712995,0.51772063933287
E01005775,1665,805,860,0.48348348348348347,0.5165165165165165
E01005761,1409,709,700,0.5031937544357701,0.49680624556423
E01005762,1973,933,1040,0.4728839330968069,0.5271160669031931
E01005763,1733,830,903,0.4789382573571841,0.5210617426428159
E01005799,1874,909,965,0.4850586979722519,0.5149413020277481
E01005798,1642,808,834,0.4920828258221681,0.5079171741778319
E01005801,2216,1084,1132,0.4891696750902527,0.5108303249097473
E01005802,1482,761,721,0.5134952766531714,0.4865047233468286
E01005803,1394,679,715,0.48708751793400284,0.5129124820659972
E01005830,1541,741,800,0.4808565866320571,0.5191434133679429
E01005831,1645,801,844,0.4869300911854103,0.5130699088145897
E01005767,1633,809,824,0.49540722596448256,0.5045927740355175
E01005772,1550,752,798,0.48516129032258065,0.5148387096774194
E01005773,1572,741,831,0.4713740458015267,0.5286259541984732
E01005774,1550,719,831,0.4638709677419355,0.5361290322580645
E01005776,1716,828,888,0.4825174825174825,0.5174825174825175
E01005909,1532,727,805,0.4745430809399478,0.5254569190600522
E01005910,1614,777,837,0.48141263940520446,0.5185873605947955
E01005911,1330,650,680,0.48872180451127817,0.5112781954887218
E01005912,1497,729,768,0.48697394789579157,0.5130260521042084
E01005782,1278,622,656,0.486697965571205,0.513302034428795
E01005783,1546,771,775,0.4987063389391979,0.5012936610608021
E01005784,1494,723,771,0.4839357429718876,0.5160642570281124
E01005785,1673,807,866,0.4823670053795577,0.5176329946204423
E01005786,1848,919,929,0.4972943722943723,0.5027056277056277
E01005834,1542,762,780,0.49416342412451364,0.5058365758754864
E01005836,1833,881,952,0.48063284233497,0.51936715766503
E01005838,1780,856,924,0.48089887640449436,0.5191011235955056
E01005840,1603,776,827,0.4840923268870867,0.5159076731129133
E01005927,1305,636,669,0.48735632183908045,0.5126436781609195
E01005928,1619,779,840,0.4811612106238419,0.5188387893761581
E01005929,1420,694,726,0.4887323943661972,0.5112676056338028
E01005930,1678,803,875,0.4785458879618594,0.5214541120381406
E01005806,1187,603,584,0.5080033698399326,0.4919966301600674
E01005813,1365,661,704,0.48424908424908425,0.5157509157509158
E01005814,1296,614,682,0.4737654320987654,0.5262345679012346
E01005815,1436,706,730,0.49164345403899723,0.5083565459610028
E01005777,1558,749,809,0.48074454428754815,0.5192554557124519
E01005787,1331,661,670,0.4966190833959429,0.5033809166040571
E01005788,1565,764,801,0.4881789137380192,0.5118210862619809
E01005790,1221,597,624,0.48894348894348894,0.5110565110565111
E01005805,1538,779,759,0.5065019505851756,0.49349804941482445
E01005807,1550,769,781,0.49612903225806454,0.5038709677419355
E01005839,1296,615,681,0.47453703703703703,0.5254629629629629
E01005841,1480,747,733,0.5047297297297297,0.49527027027027026
E01005844,1548,733,815,0.47351421188630494,0.5264857881136951
E01005845,1657,809,848,0.48823174411587206,0.5117682558841279
E01005849,1654,786,868,0.4752116082224909,0.524788391777509
E01005851,1622,800,822,0.4932182490752158,0.5067817509247842
E01005808,1375,661,714,0.4807272727272727,0.5192727272727272
E01005809,1226,589,637,0.4804241435562806,0.5195758564437194
E01005810,1560,751,809,0.4814102564102564,0.5185897435897436
E01005811,1300,610,690,0.46923076923076923,0.5307692307692308
E01005812,1206,596,610,0.494195688225539,0.5058043117744611
E01005842,1579,763,816,0.4832172260924636,0.5167827739075365
E01005906,1436,702,734,0.48885793871866295,0.5111420612813371
E01005907,1348,658,690,0.48813056379821956,0.5118694362017804
E01005913,1419,698,721,0.4918957011980268,0.5081042988019733
E01005789,1671,803,868,0.4805505685218432,0.5194494314781568
E01005791,1569,769,800,0.49012109623964306,0.5098789037603569
E01005793,1525,717,808,0.4701639344262295,0.5298360655737705
E01005795,1364,644,720,0.47214076246334313,0.5278592375366569
E01005796,1247,602,645,0.4827586206896552,0.5172413793103449
E01005846,1714,862,852,0.5029171528588098,0.4970828471411902
E01005847,1577,769,808,0.48763474952441344,0.5123652504755866
E01005848,2083,1024,1059,0.49159865578492556,0.5084013442150744
E01005850,1806,878,928,0.48615725359911405,0.5138427464008859
E01005792,1531,739,792,0.48269105160026127,0.5173089483997387
E01005794,1267,620,647,0.489344909234412,0.510655090765588
E01005923,1498,715,783,0.4773030707610147,0.5226969292389854
E01005931,1394,657,737,0.4713055954088953,0.5286944045911047
E01005924,1305,613,692,0.4697318007662835,0.5302681992337165
E01005925,1433,685,748,0.47801814375436147,0.5219818562456385
E01005926,2242,1127,1115,0.5026761819803747,0.49732381801962533
E01005932,1279,615,664,0.4808444096950743,0.5191555903049258
E01006053,1947,954,993,0.4899845916795069,0.5100154083204931
E01006054,1807,855,952,0.47315993359158826,0.5268400664084117
E01006055,1505,734,771,0.4877076411960133,0.5122923588039867
E01006057,1529,747,782,0.48855461085676916,0.5114453891432309
E01006058,2076,1059,1017,0.5101156069364162,0.48988439306358383
E01006059,1447,720,727,0.497581202487906,0.502418797512094
E01005938,1567,801,766,0.5111678366305041,0.48883216336949586
E01005939,1271,632,639,0.4972462627852085,0.5027537372147916
E01005940,1400,690,710,0.4928571428571429,0.5071428571428571
E01005955,1633,809,824,0.49540722596448256,0.5045927740355175
E01006056,1250,621,629,0.4968,0.5032
E01006061,2479,1174,1305,0.4735780556676079,0.5264219443323921
E01006062,1989,970,1019,0.48768225238813473,0.5123177476118652
E01006063,1383,691,692,0.49963846710050613,0.5003615328994938
E01005936,1516,745,771,0.49142480211081796,0.508575197889182
E01005937,1707,814,893,0.47685998828353837,0.5231400117164616
E01005945,2043,926,1117,0.4532550171316691,0.5467449828683308
E01005946,1587,759,828,0.4782608695652174,0.5217391304347826
E01005947,1841,912,929,0.49538294405214556,0.5046170559478544
E01005954,1496,743,753,0.4966577540106952,0.5033422459893048
E01005956,1375,667,708,0.4850909090909091,0.5149090909090909
E01005957,1561,765,796,0.49007046764894296,0.509929532351057
E01005958,1607,799,808,0.4971997510889857,0.5028002489110143
E01005959,1952,933,1019,0.47797131147540983,0.5220286885245902
E01005933,1574,759,815,0.4822109275730623,0.5177890724269377
E01005934,1507,742,765,0.49236894492368943,0.5076310550763106
E01005935,1465,703,762,0.47986348122866895,0.520136518771331
E01005949,1653,814,839,0.4924379915305505,0.5075620084694494
E01005960,1746,852,894,0.4879725085910653,0.5120274914089347
E01005941,1884,1002,882,0.5318471337579618,0.4681528662420382
E01005942,1661,838,823,0.5045153521974715,0.4954846478025286
E01005943,1817,899,918,0.49477160154100164,0.5052283984589984
E01005944,1853,925,928,0.4991905018888289,0.500809498111171
E01006060,1510,766,744,0.5072847682119205,0.49271523178807947
E01006064,1728,857,871,0.49594907407407407,0.5040509259259259
E01006065,1460,694,766,0.47534246575342465,0.5246575342465754
E01006066,1416,701,715,0.4950564971751412,0.5049435028248588
E01006067,1875,915,960,0.488,0.512
E01006068,1559,778,781,0.4990378447722899,0.50096215522771
E01006069,1740,803,937,0.4614942528735632,0.5385057471264367
E01006073,2044,1015,1029,0.4965753424657534,0.5034246575342466
E01005993,1350,647,703,0.4792592592592593,0.5207407407407407
E01005995,1372,667,705,0.48615160349854225,0.5138483965014577
E01005996,1948,974,974,0.5,0.5
E01005997,1536,753,783,0.490234375,0.509765625
E01006000,1787,887,900,0.49636261891438166,0.5036373810856184
E01005994,1508,714,794,0.473474801061008,0.5265251989389921
E01005999,2190,1136,1054,0.5187214611872146,0.4812785388127854
E01006002,1370,642,728,0.4686131386861314,0.5313868613138686
E01006004,1524,744,780,0.4881889763779528,0.5118110236220472
E01006005,1393,640,753,0.45944005743000715,0.5405599425699928
E01006007,1553,753,800,0.48486799742434,0.51513200257566
E01005998,1881,914,967,0.4859117490696438,0.5140882509303561
E01006001,1546,796,750,0.5148771021992238,0.4851228978007762
E01006003,1530,739,791,0.4830065359477124,0.5169934640522876
E01006006,1426,725,701,0.5084151472650772,0.49158485273492286
E01005948,2315,1285,1030,0.5550755939524838,0.4449244060475162
E01005950,2174,1069,1105,0.4917203311867525,0.5082796688132475
E01005951,1857,915,942,0.4927302100161551,0.5072697899838449
E01005953,2297,1134,1163,0.4936874183717893,0.5063125816282107
E01033949,1190,612,578,0.5142857142857142,0.4857142857142857
E01033950,1371,714,657,0.5207877461706784,0.47921225382932164
E01005961,2962,1450,1512,0.48953409858203917,0.5104659014179609
E01005962,1419,680,739,0.4792107117688513,0.5207892882311487
E01005968,1377,660,717,0.4793028322440087,0.5206971677559913
E01005969,1299,628,671,0.48344880677444185,0.5165511932255581
E01006022,1936,1009,927,0.5211776859504132,0.47882231404958675
E01006023,1577,814,763,0.5161699429296132,0.4838300570703868
E01006070,1399,685,714,0.4896354538956397,0.5103645461043602
E01006071,1710,863,847,0.5046783625730994,0.4953216374269006
E01006072,1615,774,841,0.4792569659442725,0.5207430340557275
E01006009,1329,663,666,0.49887133182844245,0.5011286681715575
E01006017,1398,699,699,0.5,0.5
E01006018,1316,648,668,0.49240121580547114,0.5075987841945289
E01006021,1366,671,695,0.4912152269399707,0.5087847730600292
E01006008,1386,708,678,0.5108225108225108,0.48917748917748916
E01006010,1403,691,712,0.4925160370634355,0.5074839629365645
E01006012,1961,957,1004,0.48801631820499747,0.5119836817950025
E01006015,1344,635,709,0.4724702380952381,0.5275297619047619
E01006016,1944,1014,930,0.5216049382716049,0.4783950617283951
E01006011,1709,821,888,0.4803978935049737,0.5196021064950264
E01006013,1307,623,684,0.47666411629686306,0.523335883703137
E01006014,1282,622,660,0.48517940717628705,0.514820592823713
E01006019,1503,727,776,0.48369926813040587,0.5163007318695941
E01006020,1638,746,892,0.4554334554334554,0.5445665445665445
E01005963,1161,562,599,0.48406546080964685,0.5159345391903531
E01005964,1522,736,786,0.4835742444152431,0.5164257555847569
E01005965,1733,817,916,0.47143681477207156,0.5285631852279284
E01005966,1578,771,807,0.48859315589353614,0.5114068441064639
E01005967,1424,751,673,0.5273876404494382,0.4726123595505618
E01006031,2255,1115,1140,0.49445676274944567,0.5055432372505543
E01006032,1528,751,777,0.49149214659685864,0.5085078534031413
E01006033,1768,863,905,0.48812217194570134,0.5118778280542986
E01006034,2132,1047,1085,0.4910881801125704,0.5089118198874296
E01006035,2147,1056,1091,0.4918490917559385,0.5081509082440615
E01006036,2152,1021,1131,0.47444237918215615,0.5255576208178439
E01005970,1413,710,703,0.502476999292286,0.4975230007077141
E01005972,1720,822,898,0.47790697674418603,0.522093023255814
E01005974,1692,831,861,0.49113475177304966,0.5088652482269503
E01005975,1546,714,832,0.46183699870633893,0.538163001293661
E01006024,1764,876,888,0.4965986394557823,0.5034013605442177
E01006026,1527,730,797,0.47806155861165683,0.5219384413883431
E01006037,1601,795,806,0.49656464709556525,0.5034353529044348
E01006038,1586,766,820,0.48297604035308955,0.5170239596469105
E01006047,1326,665,661,0.5015082956259427,0.4984917043740573
E01006048,1596,788,808,0.49373433583959897,0.506265664160401
E01006049,1545,779,766,0.5042071197411003,0.49579288025889967
E01006051,1628,789,839,0.48464373464373467,0.5153562653562653
E01005985,1554,768,786,0.4942084942084942,0.5057915057915058
E01005987,1518,716,802,0.47167325428194995,0.52832674571805
E01005988,1600,782,818,0.48875,0.51125
E01005990,1373,680,693,0.49526584122359796,0.504734158776402
E01005991,1496,722,774,0.48262032085561496,0.517379679144385
E01005971,1354,678,676,0.5007385524372231,0.49926144756277696
E01005986,1245,607,638,0.4875502008032129,0.5124497991967871
E01005989,1206,597,609,0.49502487562189057,0.5049751243781094
E01005992,1207,577,630,0.4780447390223695,0.5219552609776305
E01005973,1367,681,686,0.4981711777615216,0.5018288222384785
E01005976,1482,713,769,0.48110661268556004,0.5188933873144399
E01005977,1450,699,751,0.4820689655172414,0.5179310344827586
E01005978,1335,630,705,0.47191011235955055,0.5280898876404494
E01006025,1917,937,980,0.4887845592070944,0.5112154407929056
E01006027,2343,1142,1201,0.4874093043107128,0.5125906956892873
E01006050,1841,850,991,0.4617055947854427,0.5382944052145573
E01006052,1580,782,798,0.49493670886075947,0.5050632911392405
E01006028,1776,919,857,0.517454954954955,0.48254504504504503
E01006029,1934,909,1025,0.47001034126163393,0.5299896587383661
E01006030,1869,904,965,0.48368111289459603,0.516318887105404
E01006039,1353,685,668,0.5062823355506282,0.49371766444937176
E01006040,1891,908,983,0.48016922263352724,0.5198307773664728
E01006041,1721,848,873,0.4927367809413132,0.5072632190586868
E01005979,1586,766,820,0.48297604035308955,0.5170239596469105
E01005980,1449,687,762,0.474120082815735,0.525879917184265
E01005981,1647,766,881,0.4650880388585307,0.5349119611414693
E01005982,1326,632,694,0.4766214177978884,0.5233785822021116
E01005983,1506,714,792,0.47410358565737054,0.5258964143426295
E01005984,1604,795,809,0.4956359102244389,0.5043640897755611
E01006042,1696,831,865,0.48997641509433965,0.5100235849056604
E01006043,1437,682,755,0.4745998608211552,0.5254001391788448
E01006044,1523,724,799,0.47537754432042023,0.5246224556795798
E01006045,1253,617,636,0.49241819632881084,0.5075818036711891
E01006046,1528,744,784,0.4869109947643979,0.5130890052356021
E01006109,1149,652,497,0.5674499564838991,0.43255004351610093
E01006110,1876,889,987,0.47388059701492535,0.5261194029850746
E01006111,1775,837,938,0.4715492957746479,0.5284507042253521
E01006112,2049,983,1066,0.4797462176671547,0.5202537823328452
E01006188,1990,985,1005,0.4949748743718593,0.5050251256281407
E01034000,1233,638,595,0.5174371451743714,0.48256285482562855
E01034001,1647,872,775,0.5294474802671524,0.4705525197328476
E01006116,1328,649,679,0.48870481927710846,0.5112951807228916
E01006117,1704,823,881,0.482981220657277,0.517018779342723
E01006118,1462,712,750,0.48700410396716826,0.5129958960328317
E01006119,1639,801,838,0.48871262965222695,0.511287370347773
E01006121,1448,690,758,0.47651933701657456,0.5234806629834254
E01006141,1791,876,915,0.48911222780569513,0.5108877721943048
E01006186,2160,1064,1096,0.4925925925925926,0.5074074074074074
E01006187,2599,1285,1314,0.4944209311273567,0.5055790688726434
E01006189,2328,1181,1147,0.5073024054982818,0.49269759450171824
E01006113,1619,785,834,0.4848672019765287,0.5151327980234712
E01006114,1693,814,879,0.48080330773774366,0.5191966922622564
E01006115,1518,741,777,0.4881422924901186,0.5118577075098815
E01006145,2051,991,1060,0.4831789371038518,0.5168210628961483
E01006146,1793,913,880,0.50920245398773,0.49079754601226994
E01006122,1785,891,894,0.4991596638655462,0.5008403361344538
E01006123,1671,816,855,0.4883303411131059,0.5116696588868941
E01006124,1479,714,765,0.4827586206896552,0.5172413793103449
E01006128,1929,906,1023,0.46967340590979784,0.5303265940902022
E01006131,1529,766,763,0.5009810333551341,0.49901896664486595
E01006155,1749,859,890,0.4911377930245855,0.5088622069754145
E01006157,1701,849,852,0.4991181657848324,0.5008818342151675
E01006159,1875,866,1009,0.46186666666666665,0.5381333333333334
E01006182,1606,771,835,0.4800747198007472,0.5199252801992528
E01006183,1724,879,845,0.509860788863109,0.49013921113689096
E01006125,1511,728,783,0.4818001323626737,0.5181998676373263
E01006126,1838,849,989,0.4619151251360174,0.5380848748639826
E01006127,1545,726,819,0.46990291262135925,0.5300970873786408
E01006130,1760,869,891,0.49375,0.50625
E01006132,1539,770,769,0.5003248862897985,0.4996751137102014
E01006156,1674,783,891,0.46774193548387094,0.532258064516129
E01006158,1749,826,923,0.4722698684962836,0.5277301315037164
E01006179,1802,886,916,0.4916759156492786,0.5083240843507214
E01006184,1699,836,863,0.4920541494997057,0.5079458505002943
E01006198,1463,701,762,0.47915242652084755,0.5208475734791524
E01006199,1535,697,838,0.45407166123778503,0.545928338762215
E01006200,1481,690,791,0.4659014179608373,0.5340985820391627
E01006201,1467,750,717,0.5112474437627812,0.4887525562372188
E01006202,1299,649,650,0.4996150885296382,0.5003849114703618
E01006120,1430,698,732,0.4881118881118881,0.5118881118881119
E01006129,1384,655,729,0.47326589595375723,0.5267341040462428
E01006133,1416,673,743,0.4752824858757062,0.5247175141242938
E01006197,1478,686,792,0.46414073071718537,0.5358592692828146
E01006203,1332,660,672,0.4954954954954955,0.5045045045045045
E01006142,1716,834,882,0.486013986013986,0.513986013986014
E01006143,1668,836,832,0.5011990407673861,0.4988009592326139
E01006144,1386,645,741,0.4653679653679654,0.5346320346320347
E01006180,1840,894,946,0.48586956521739133,0.5141304347826087
E01006181,1745,874,871,0.5008595988538682,0.4991404011461318
E01006147,1443,717,726,0.4968814968814969,0.5031185031185031
E01006149,1578,744,834,0.4714828897338403,0.5285171102661597
E01006150,1919,945,974,0.4924439812402293,0.5075560187597707
E01006154,1603,812,791,0.5065502183406113,0.49344978165938863
E01006165,2007,971,1036,0.4838066766317887,0.5161933233682112
E01006166,1640,767,873,0.4676829268292683,0.5323170731707317
E01006169,1647,796,851,0.4833029751062538,0.5166970248937462
E01006170,1602,770,832,0.48064918851435706,0.519350811485643
E01006171,1755,857,898,0.4883190883190883,0.5116809116809117
E01006098,1337,648,689,0.4846671652954376,0.5153328347045625
E01006099,1324,639,685,0.4826283987915408,0.5173716012084593
E01006164,1762,872,890,0.4948921679909194,0.5051078320090806
E01006174,1788,892,896,0.4988814317673378,0.5011185682326622
E01006178,1813,897,916,0.4947600661886376,0.5052399338113623
E01006097,1783,895,888,0.5019629837352776,0.49803701626472235
E01006160,2140,1078,1062,0.5037383177570094,0.49626168224299066
E01006161,2158,1087,1071,0.5037071362372567,0.4962928637627433
E01006162,1622,813,809,0.501233045622688,0.49876695437731194
E01006163,1832,887,945,0.48417030567685587,0.5158296943231441
E01006148,1698,841,857,0.49528857479387517,0.5047114252061249
E01006151,1583,771,812,0.48704990524320907,0.5129500947567909
E01006152,1639,798,841,0.48688224527150703,0.513117754728493
E01006153,1600,767,833,0.479375,0.520625
E01006172,1540,750,790,0.487012987012987,0.512987012987013
E01006104,1687,805,882,0.47717842323651455,0.5228215767634855
E01006105,1767,832,935,0.4708545557441992,0.5291454442558008
E01006106,1474,685,789,0.46472184531886024,0.5352781546811397
E01006107,1594,751,843,0.4711417816813049,0.5288582183186951
E01006108,1667,786,881,0.471505698860228,0.528494301139772
E01006102,1404,653,751,0.4650997150997151,0.5349002849002849
E01006173,1550,769,781,0.49612903225806454,0.5038709677419355
E01006175,1776,809,967,0.455518018018018,0.5444819819819819
E01006176,1734,829,905,0.47808535178777395,0.5219146482122261
E01006177,1653,796,857,0.48154869933454325,0.5184513006654567
E01006091,2970,1442,1528,0.4855218855218855,0.5144781144781144
E01006092,1331,614,717,0.4613072877535687,0.5386927122464312
E01006095,1658,821,837,0.4951749095295537,0.5048250904704463
E01006167,1579,760,819,0.4813172894236859,0.5186827105763141
E01006168,1812,835,977,0.4608167770419426,0.5391832229580574
E01006090,2300,1144,1156,0.4973913043478261,0.5026086956521739
E01006094,1603,808,795,0.5040548970679976,0.4959451029320025
E01006096,1610,799,811,0.4962732919254658,0.5037267080745341
E01006100,1488,741,747,0.49798387096774194,0.5020161290322581
E01006103,1694,856,838,0.5053128689492326,0.4946871310507674
E01006101,1495,768,727,0.5137123745819397,0.4862876254180602
E01006190,1687,825,862,0.4890337877889745,0.5109662122110255
E01006195,1795,901,894,0.501949860724234,0.498050139275766
E01006196,1700,850,850,0.5,0.5
E01006210,1609,789,820,0.490366687383468,0.509633312616532
E01006204,1620,749,871,0.4623456790123457,0.5376543209876543
E01006206,1869,896,973,0.4794007490636704,0.5205992509363296
E01006207,1748,850,898,0.4862700228832952,0.5137299771167048
E01006208,1551,746,805,0.4809800128949065,0.5190199871050934
E01006211,1613,765,848,0.47427154370737756,0.5257284562926224
E01006093,1527,732,795,0.4793713163064833,0.5206286836935167
E01006191,1708,813,895,0.47599531615925056,0.5240046838407494
E01006192,1517,713,804,0.47000659195781147,0.5299934080421885
E01006205,1342,655,687,0.4880774962742176,0.5119225037257824
E01006209,1642,794,848,0.4835566382460414,0.5164433617539586
E01006078,2122,1057,1065,0.49811498586239394,0.501885014137606
E01006080,1968,941,1027,0.47815040650406504,0.521849593495935
E01006089,2014,982,1032,0.48758689175769615,0.5124131082423039
E01006193,1569,753,816,0.47992351816443596,0.5200764818355641
E01006194,2430,1175,1255,0.4835390946502058,0.5164609053497943
E01006074,1642,798,844,0.48599269183922045,0.5140073081607796
E01006075,2146,1083,1063,0.5046598322460392,0.49534016775396084
E01006076,1675,808,867,0.4823880597014925,0.5176119402985074
E01006079,2598,1290,1308,0.49653579676674364,0.5034642032332564
E01006087,1452,724,728,0.4986225895316804,0.5013774104683195
E01006083,1279,634,645,0.49569976544175137,0.5043002345582487
E01006084,1742,847,895,0.4862227324913892,0.5137772675086107
E01006088,1630,806,824,0.49447852760736194,0.505521472392638
E01006139,1803,889,914,0.4930671103716029,0.5069328896283971
E01006140,1697,830,867,0.4890984089569829,0.5109015910430171
E01006077,1644,783,861,0.4762773722627737,0.5237226277372263
E01006081,1385,677,708,0.4888086642599278,0.5111913357400723
E01006082,1498,726,772,0.48464619492656874,0.5153538050734312
E01006085,1542,721,821,0.4675745784695201,0.5324254215304799
E01006086,1688,802,886,0.47511848341232227,0.5248815165876777
E01006134,1493,746,747,0.4996651038178165,0.5003348961821835
E01006135,1768,832,936,0.47058823529411764,0.5294117647058824
E01006136,1703,827,876,0.48561362301820316,0.5143863769817968
E01006137,1421,665,756,0.46798029556650245,0.5320197044334976
E01006138,1893,902,991,0.47649234020073955,0.5235076597992604
E01006315,1503,763,740,0.5076513639387891,0.49234863606121093
E01006316,2002,978,1024,0.4885114885114885,0.5114885114885115
E01006317,1549,730,819,0.47127178825048416,0.5287282117495158
E01006319,1573,772,801,0.4907819453273999,0.5092180546726002
E01006229,1377,675,702,0.49019607843137253,0.5098039215686274
E01006230,2122,1079,1043,0.5084825636192272,0.49151743638077283
E01006233,1404,684,720,0.48717948717948717,0.5128205128205128
E01006237,1922,971,951,0.5052029136316337,0.4947970863683663
E01006238,1509,703,806,0.46587143803843606,0.534128561961564
E01006259,1316,646,670,0.4908814589665654,0.5091185410334347
E01006312,1370,656,714,0.47883211678832116,0.5211678832116788
E01006313,1458,726,732,0.49794238683127573,0.5020576131687243
E01006314,1724,848,876,0.4918793503480278,0.5081206496519721
E01006318,1426,707,719,0.4957924263674614,0.5042075736325385
E01006320,1279,626,653,0.48944487881157156,0.5105551211884285
E01006321,1601,815,786,0.5090568394753279,0.4909431605246721
E01006231,1467,703,764,0.47920927062031354,0.5207907293796864
E01006232,1989,963,1026,0.4841628959276018,0.5158371040723982
E01006234,1145,575,570,0.5021834061135371,0.4978165938864629
E01006235,1528,729,799,0.47709424083769636,0.5229057591623036
E01006253,1523,753,770,0.4944189100459619,0.505581089954038
E01006254,1574,775,799,0.4923761118170267,0.5076238881829733
E01006255,1492,728,764,0.4879356568364611,0.5120643431635389
E01006256,1709,856,853,0.5008777062609713,0.49912229373902867
E01006260,1517,725,792,0.4779169413315755,0.5220830586684245
E01006370,1886,1058,828,0.5609756097560976,0.43902439024390244
E01006372,1609,785,824,0.48788067122436296,0.512119328775637
E01006373,1459,726,733,0.4976010966415353,0.5023989033584647
E01006374,1463,710,753,0.48530416951469585,0.5146958304853042
E01006390,1613,765,848,0.47427154370737756,0.5257284562926224
E01006236,1573,753,820,0.47870311506675145,0.5212968849332485
E01006388,1837,914,923,0.497550353837779,0.502449646162221
E01006389,1318,638,680,0.48406676783004554,0.5159332321699545
E01006391,1530,749,781,0.4895424836601307,0.5104575163398692
E01006257,1204,585,619,0.48588039867109634,0.5141196013289037
E01006258,1601,778,823,0.48594628357276703,0.514053716427233
E01006369,2031,1059,972,0.5214180206794683,0.47858197932053176
E01006371,1476,756,720,0.5121951219512195,0.4878048780487805
E01006375,1683,854,829,0.5074272133095663,0.49257278669043375
E01006306,1479,779,700,0.5267072346179851,0.47329276538201487
E01006307,1374,703,671,0.5116448326055313,0.4883551673944687
E01006386,1587,878,709,0.5532451165721487,0.4467548834278513
E01006387,1316,637,679,0.48404255319148937,0.5159574468085106
E01006392,1476,740,736,0.5013550135501355,0.4986449864498645
E01006350,1858,905,953,0.48708288482238965,0.5129171151776103
E01006351,2022,951,1071,0.47032640949554894,0.5296735905044511
E01006357,1832,900,932,0.4912663755458515,0.5087336244541485
E01006360,1680,816,864,0.4857142857142857,0.5142857142857142
E01006361,1661,811,850,0.48826008428657436,0.5117399157134257
E01006356,1434,745,689,0.5195258019525802,0.4804741980474198
E01006396,1480,736,744,0.4972972972972973,0.5027027027027027
E01006397,1080,517,563,0.4787037037037037,0.5212962962962963
E01006398,1008,494,514,0.49007936507936506,0.5099206349206349
E01006399,1603,794,809,0.495321272613849,0.5046787273861509
E01006305,1710,827,883,0.48362573099415207,0.5163742690058479
E01006308,1620,806,814,0.49753086419753084,0.5024691358024691
E01006309,1669,831,838,0.4979029358897543,0.5020970641102457
E01006310,1589,808,781,0.5084959093769666,0.49150409062303335
E01006311,1534,737,797,0.4804432855280313,0.5195567144719687
E01006269,1737,846,891,0.48704663212435234,0.5129533678756477
E01006271,1681,836,845,0.49732302201070794,0.5026769779892921
E01006272,1635,831,804,0.5082568807339449,0.4917431192660551
E01006273,1482,732,750,0.4939271255060729,0.5060728744939271
E01006276,2154,1051,1103,0.48792943361188484,0.5120705663881151
E01006353,1458,731,727,0.5013717421124828,0.49862825788751713
E01006354,1440,724,716,0.5027777777777778,0.49722222222222223
E01006355,1473,711,762,0.48268839103869654,0.5173116089613035
E01006358,2133,1027,1106,0.48148148148148145,0.5185185185185185
E01006359,1384,698,686,0.5043352601156069,0.4956647398843931
E01006349,2037,1040,997,0.510554737358861,0.4894452626411389
E01006352,2034,998,1036,0.49065880039331367,0.5093411996066863
E01006404,1781,893,888,0.5014037057832679,0.4985962942167322
E01006405,1747,858,889,0.4911276473955352,0.5088723526044648
E01006411,1433,696,737,0.4856943475226797,0.5143056524773203
E01006270,1444,722,722,0.5,0.5
E01006274,1531,736,795,0.480731548007838,0.519268451992162
E01006275,1572,774,798,0.49236641221374045,0.5076335877862596
E01006277,1877,943,934,0.5023974427277571,0.49760255727224295
E01006286,1558,766,792,0.49165596919127086,0.5083440308087291
E01006239,2082,1043,1039,0.5009606147934679,0.4990393852065322
E01006240,1573,757,816,0.48124602670057215,0.5187539732994279
E01006241,2539,1258,1281,0.4954706577392674,0.5045293422607325
E01006287,1145,564,581,0.4925764192139738,0.5074235807860262
E01006289,1689,845,844,0.5002960331557135,0.4997039668442866
E01006362,1634,807,827,0.4938800489596083,0.5061199510403916
E01006363,1516,751,765,0.4953825857519789,0.5046174142480211
E01006364,1831,885,946,0.4833424358274167,0.5166575641725832
E01006365,2266,1106,1160,0.4880847308031774,0.5119152691968226
E01006366,1850,913,937,0.4935135135135135,0.5064864864864865
E01006367,1781,859,922,0.4823133071308254,0.5176866928691746
E01006368,1884,928,956,0.49256900212314225,0.5074309978768577
E01006278,1631,790,841,0.4843654199877376,0.5156345800122624
E01006279,1577,791,786,0.501585288522511,0.4984147114774889
E01006280,1455,700,755,0.48109965635738833,0.5189003436426117
E01006281,1938,952,986,0.49122807017543857,0.5087719298245614
E01006285,1916,946,970,0.49373695198329853,0.5062630480167014
E01006406,1377,679,698,0.49310094408133626,0.5068990559186638
E01006407,1453,721,732,0.49621472814865797,0.503785271851342
E01006408,1749,843,906,0.48198970840480276,0.5180102915951973
E01006409,1298,651,647,0.5015408320493067,0.4984591679506934
E01006410,1272,620,652,0.48742138364779874,0.5125786163522013
E01006393,1382,688,694,0.49782923299565845,0.5021707670043415
E01006394,1540,730,810,0.474025974025974,0.525974025974026
E01006395,2628,1290,1338,0.4908675799086758,0.5091324200913242
E01006400,1995,970,1025,0.48621553884711777,0.5137844611528822
E01006401,1354,666,688,0.4918759231905465,0.5081240768094535
E01006402,1128,566,562,0.50177304964539,0.49822695035460995
E01006403,1626,799,827,0.491389913899139,0.508610086100861
E01006290,1389,675,714,0.48596112311015116,0.5140388768898488
E01006291,1463,705,758,0.4818865345181135,0.5181134654818865
E01006292,1500,752,748,0.5013333333333333,0.49866666666666665
E01006293,1618,808,810,0.49938195302843014,0.5006180469715699
E01006242,1929,931,998,0.48263348885432866,0.5173665111456713
E01006243,2120,1056,1064,0.4981132075471698,0.5018867924528302
E01006244,1676,808,868,0.4821002386634845,0.5178997613365155
E01006245,2629,1309,1320,0.497907949790795,0.502092050209205
E01006213,1518,746,772,0.4914361001317523,0.5085638998682477
E01006215,1712,862,850,0.5035046728971962,0.49649532710280375
E01006217,2378,1168,1210,0.4911690496215307,0.5088309503784693
E01006218,2432,1211,1221,0.4979440789473684,0.5020559210526315
E01006219,1184,580,604,0.48986486486486486,0.5101351351351351
E01006288,1824,866,958,0.47478070175438597,0.5252192982456141
E01006294,1940,976,964,0.5030927835051546,0.49690721649484537
E01006295,1568,800,768,0.5102040816326531,0.4897959183673469
E01006377,1557,753,804,0.4836223506743738,0.5163776493256262
E01006378,1303,642,661,0.4927091327705295,0.5072908672294705
E01006212,1392,710,682,0.5100574712643678,0.4899425287356322
E01006214,1379,679,700,0.49238578680203043,0.5076142131979695
E01006216,2190,1083,1107,0.4945205479452055,0.5054794520547945
E01006322,2089,1052,1037,0.5035902345619914,0.49640976543800863
E01006329,1637,1073,564,0.6554673182651192,0.3445326817348809
E01006282,1857,933,924,0.5024232633279483,0.4975767366720517
E01006283,1584,805,779,0.5082070707070707,0.4917929292929293
E01006284,1577,803,774,0.5091946734305643,0.49080532656943565
E01006336,1658,797,861,0.4806996381182147,0.5193003618817853
E01006337,1496,738,758,0.49331550802139035,0.5066844919786097
E01006376,1771,871,900,0.49181253529079616,0.5081874647092038
E01006381,2050,1031,1019,0.5029268292682927,0.4970731707317073
E01006382,1257,618,639,0.4916467780429594,0.5083532219570406
E01006383,1609,790,819,0.49098819142324424,0.5090118085767558
E01006384,1321,657,664,0.49735049205147613,0.5026495079485238
E01006250,2138,1051,1087,0.4915809167446211,0.5084190832553789
E01006251,1544,775,769,0.5019430051813472,0.49805699481865284
E01006379,1581,786,795,0.4971537001897533,0.5028462998102466
E01006380,2731,1328,1403,0.486268766019773,0.513731233980227
E01006385,1445,695,750,0.4809688581314879,0.5190311418685121
E01006328,1525,765,760,0.5016393442622951,0.49836065573770494
E01006333,2087,1109,978,0.5313847628174413,0.4686152371825587
E01006334,2076,1062,1014,0.5115606936416185,0.4884393063583815
E01006338,1668,823,845,0.4934052757793765,0.5065947242206235
E01006248,2280,1150,1130,0.5043859649122807,0.4956140350877193
E01006249,1655,778,877,0.4700906344410876,0.5299093655589124
E01006330,1535,764,771,0.4977198697068404,0.5022801302931597
E01006331,1515,766,749,0.5056105610561056,0.49438943894389437
E01006332,2015,997,1018,0.4947890818858561,0.5052109181141439
E01006262,1710,866,844,0.5064327485380117,0.4935672514619883
E01006263,1490,731,759,0.4906040268456376,0.5093959731543625
E01006266,1373,665,708,0.48434085943190097,0.515659140568099
E01006267,1620,826,794,0.5098765432098765,0.4901234567901235
E01006268,1639,807,832,0.4923733984136669,0.5076266015863331
E01006323,1552,787,765,0.5070876288659794,0.49291237113402064
E01006324,1291,656,635,0.5081332300542215,0.4918667699457785
E01006325,1505,750,755,0.4983388704318937,0.5016611295681063
E01006326,1412,723,689,0.5120396600566572,0.48796033994334276
E01006327,2562,1281,1281,0.5,0.5
E01006246,1535,746,789,0.4859934853420195,0.5140065146579804
E01006247,1282,628,654,0.48985959438377535,0.5101404056162246
E01006252,1399,660,739,0.47176554681915656,0.5282344531808435
E01006297,1595,752,843,0.4714733542319749,0.5285266457680251
E01006335,1578,774,804,0.49049429657794674,0.5095057034220533
E01006220,1742,848,894,0.48679678530424797,0.513203214695752
E01006221,1560,772,788,0.4948717948717949,0.5051282051282051
E01006222,1556,774,782,0.4974293059125964,0.5025706940874036
E01006224,1433,721,712,0.5031402651779484,0.49685973482205165
E01006226,1714,845,869,0.49299883313885645,0.5070011668611435
E01006223,1586,794,792,0.5006305170239597,0.49936948297604034
E01006225,1507,725,782,0.4810882548108825,0.5189117451891174
E01006261,1487,695,792,0.4673839946200404,0.5326160053799597
E01006264,1230,612,618,0.4975609756097561,0.5024390243902439
E01006265,1396,669,727,0.4792263610315186,0.5207736389684814
E01006296,1503,737,766,0.490352628077179,0.5096473719228211
E01006298,1424,675,749,0.47401685393258425,0.5259831460674157
E01006299,1935,977,958,0.5049095607235142,0.49509043927648577
E01006300,1359,670,689,0.493009565857248,0.506990434142752
E01006301,1484,717,767,0.4831536388140162,0.5168463611859838
E01006227,1581,781,800,0.4939911448450348,0.5060088551549652
E01006228,1628,843,785,0.5178132678132679,0.4821867321867322
E01006342,1556,781,775,0.5019280205655527,0.4980719794344473
E01006344,1440,656,784,0.45555555555555555,0.5444444444444444
E01006346,2062,1056,1006,0.5121241513094084,0.48787584869059164
E01006339,1254,595,659,0.474481658692185,0.5255183413078149
E01006340,1888,939,949,0.4973516949152542,0.5026483050847458
E01006343,1612,795,817,0.49317617866004965,0.5068238213399504
E01006345,1559,739,820,0.4740218088518281,0.5259781911481719
E01006348,2643,1307,1336,0.4945138100643208,0.5054861899356792
E01006302,1835,912,923,0.49700272479564034,0.5029972752043597
E01006303,1625,818,807,0.5033846153846154,0.4966153846153846
E01006304,1521,749,772,0.49243918474687703,0.5075608152531229
E01006341,1664,802,862,0.48197115384615385,0.5180288461538461
E01006347,1518,740,778,0.4874835309617918,0.5125164690382081
E01006448,2163,1000,1163,0.4623208506703652,0.5376791493296348
E01006492,1300,627,673,0.4823076923076923,0.5176923076923077
E01006493,1843,828,1015,0.449267498643516,0.550732501356484
E01006494,1800,816,984,0.4533333333333333,0.5466666666666666
E01006495,2316,1098,1218,0.4740932642487047,0.5259067357512953
E01006454,1547,750,797,0.4848093083387201,0.5151906916612798
E01006456,1521,758,763,0.4983563445101907,0.5016436554898094
E01006457,1247,597,650,0.4787489975942261,0.5212510024057738
E01006458,1547,757,790,0.48933419521654814,0.5106658047834518
E01006490,2646,1239,1407,0.46825396825396826,0.5317460317460317
E01006491,2018,1002,1016,0.4965312190287413,0.5034687809712587
E01006415,1987,972,1015,0.4891796678409663,0.5108203321590338
E01006417,1259,598,661,0.4749801429706116,0.5250198570293884
E01006436,1455,695,760,0.47766323024054985,0.5223367697594502
E01006437,1389,670,719,0.48236141108711306,0.5176385889128869
E01006447,1382,706,676,0.5108538350217077,0.48914616497829233
E01006455,1753,800,953,0.45636052481460354,0.5436394751853965
E01006506,1308,642,666,0.4908256880733945,0.5091743119266054
E01006507,1536,706,830,0.4596354166666667,0.5403645833333334
E01006508,1377,688,689,0.49963689179375453,0.5003631082062454
E01006509,1771,826,945,0.466403162055336,0.5335968379446641
E01006510,1338,630,708,0.47085201793721976,0.5291479820627802
E01006416,1517,695,822,0.45814106789716547,0.5418589321028345
E01006418,1315,599,716,0.4555133079847909,0.5444866920152092
E01006434,1519,731,788,0.48123765635286375,0.5187623436471362
E01006435,1524,711,813,0.46653543307086615,0.5334645669291339
E01006438,1150,574,576,0.4991304347826087,0.5008695652173913
E01006439,1654,833,821,0.5036275695284159,0.496372430471584
E01006446,1451,687,764,0.47346657477601656,0.5265334252239835
E01006412,1582,725,857,0.4582806573957016,0.5417193426042983
E01006413,1421,695,726,0.48909218859957776,0.5109078114004222
E01006414,1374,625,749,0.45487627365356625,0.5451237263464338
E01034832,1010,490,520,0.48514851485148514,0.5148514851485149
E01034833,2181,1039,1142,0.4763869784502522,0.5236130215497479
E01006460,1533,733,800,0.4781474233529028,0.5218525766470972
E01006461,1441,690,751,0.47883414295628035,0.5211658570437196
E01006464,2666,1338,1328,0.5018754688672168,0.4981245311327832
E01006466,1490,717,773,0.4812080536912752,0.5187919463087248
E01034834,1212,595,617,0.4909240924092409,0.509075907590759
E01034835,1125,588,537,0.5226666666666666,0.47733333333333333
E01006453,1182,532,650,0.4500846023688663,0.5499153976311336
E01006467,1304,573,731,0.43941717791411045,0.5605828220858896
E01006470,1411,698,713,0.49468462083628634,0.5053153791637137
E01033228,2698,1243,1455,0.46071163825055594,0.5392883617494441
E01006459,1632,791,841,0.4846813725490196,0.5153186274509803
E01006462,1700,833,867,0.49,0.51
E01006496,1401,664,737,0.4739471805852962,0.5260528194147038
E01006498,1571,798,773,0.5079567154678549,0.49204328453214513
E01006499,1928,936,992,0.4854771784232365,0.5145228215767634
E01006440,1401,634,767,0.45253390435403285,0.5474660956459672
E01006442,1480,725,755,0.48986486486486486,0.5101351351351351
E01006443,1469,689,780,0.4690265486725664,0.5309734513274337
E01006444,1385,623,762,0.44981949458483755,0.5501805054151625
E01006445,1266,583,683,0.46050552922590837,0.5394944707740916
E01006465,1579,797,782,0.5047498416719443,0.49525015832805575
E01006482,1504,688,816,0.4574468085106383,0.5425531914893617
E01006483,1463,684,779,0.4675324675324675,0.5324675324675324
E01006484,1301,615,686,0.4727132974634896,0.5272867025365103
E01006449,1595,740,855,0.46394984326018807,0.5360501567398119
E01006450,1712,801,911,0.4678738317757009,0.532126168224299
E01006451,1417,664,753,0.46859562455892734,0.5314043754410727
E01006452,1409,681,728,0.48332150461320084,0.5166784953867991
E01006497,1114,520,594,0.466786355475763,0.533213644524237
E01006500,1049,480,569,0.45757864632983797,0.5424213536701621
E01006501,1379,666,713,0.48295866569978246,0.5170413343002176
E01006504,1187,573,614,0.4827295703454086,0.5172704296545914
E01006505,1673,816,857,0.4877465630603706,0.5122534369396294
E01006472,1506,728,778,0.48339973439575035,0.5166002656042497
E01006485,1836,886,950,0.48257080610021785,0.5174291938997821
E01006486,1139,546,593,0.4793678665496049,0.520632133450395
E01006487,1451,694,757,0.47829083390764987,0.5217091660923501
E01006488,2460,1172,1288,0.4764227642276423,0.5235772357723577
E01006489,1350,643,707,0.4762962962962963,0.5237037037037037
E01006477,1459,671,788,0.4599040438656614,0.5400959561343386
E01006478,1835,864,971,0.4708446866485014,0.5291553133514987
E01006479,1440,672,768,0.4666666666666667,0.5333333333333333
E01006480,1409,648,761,0.45990063875088716,0.5400993612491128
E01006481,1360,641,719,0.4713235294117647,0.5286764705882353
E01006471,1465,710,755,0.48464163822525597,0.515358361774744
E01006473,1612,793,819,0.49193548387096775,0.5080645161290323
E01006474,1927,939,988,0.48728593668915415,0.5127140633108459
E01006475,1430,655,775,0.458041958041958,0.541958041958042
E01006476,1404,676,728,0.48148148148148145,0.5185185185185185
E01006420,2410,1210,1200,0.5020746887966805,0.4979253112033195
E01006424,1925,958,967,0.49766233766233764,0.5023376623376623
E01006502,1645,806,839,0.4899696048632219,0.5100303951367782
E01006503,1235,621,614,0.5028340080971659,0.497165991902834
E01006421,1117,552,565,0.4941808415398389,0.5058191584601611
E01006425,1276,613,663,0.48040752351097177,0.5195924764890282
E01006430,1525,732,793,0.48,0.52
E01006433,1575,753,822,0.4780952380952381,0.5219047619047619
E01006419,1388,684,704,0.49279538904899134,0.5072046109510087
E01006422,1250,613,637,0.4904,0.5096
E01006423,1332,648,684,0.4864864864864865,0.5135135135135135
E01006427,1432,672,760,0.4692737430167598,0.5307262569832403
E01006426,1354,667,687,0.49261447562776955,0.5073855243722304
E01006428,1570,733,837,0.46687898089171975,0.5331210191082802
E01006429,1125,520,605,0.4622222222222222,0.5377777777777778
E01006431,1838,887,951,0.48258977149075083,0.5174102285092492
E01006432,1564,729,835,0.46611253196930946,0.5338874680306905
E01006651,1615,752,863,0.46563467492260063,0.5343653250773994
E01006653,1809,884,925,0.4886677722498618,0.5113322277501382
E01006655,1834,845,989,0.4607415485278081,0.539258451472192
E01006658,1394,647,747,0.46413199426111906,0.5358680057388809
E01006660,1388,668,720,0.4812680115273775,0.5187319884726225
E01006652,1449,693,756,0.4782608695652174,0.5217391304347826
E01006656,1397,657,740,0.47029348604151755,0.5297065139584825
E01006657,1120,521,599,0.46517857142857144,0.5348214285714286
E01006780,1359,674,685,0.49595290654893304,0.5040470934510669
E01006783,1337,657,680,0.4913986537023186,0.5086013462976814
E01006781,1326,621,705,0.4683257918552036,0.5316742081447964
E01006782,1488,752,736,0.5053763440860215,0.4946236559139785
E01006784,1215,577,638,0.4748971193415638,0.5251028806584362
E01006785,1711,851,860,0.4973699590882525,0.5026300409117476
E01006786,2302,1431,871,0.6216333622936577,0.3783666377063423
E01006661,1648,751,897,0.4557038834951456,0.5442961165048543
E01006662,1904,859,1045,0.45115546218487396,0.5488445378151261
E01006663,1102,527,575,0.4782214156079855,0.5217785843920145
E01006664,1955,900,1055,0.46035805626598464,0.5396419437340153
E01006669,1457,698,759,0.4790665751544269,0.5209334248455731
E01006654,1367,681,686,0.4981711777615216,0.5018288222384785
E01006659,1827,1273,554,0.6967706622879036,0.3032293377120963
E01006734,1444,641,803,0.4439058171745152,0.5560941828254847
E01006735,1472,698,774,0.4741847826086957,0.5258152173913043
E01006736,1499,718,781,0.4789859906604403,0.5210140093395597
E01006737,1386,670,716,0.4834054834054834,0.5165945165945166
E01006787,1330,669,661,0.5030075187969925,0.49699248120300754
E01006788,1664,784,880,0.47115384615384615,0.5288461538461539
E01006790,1814,830,984,0.45755237045203967,0.5424476295479603
E01006791,1642,766,876,0.46650426309378806,0.5334957369062119
E01006665,1479,693,786,0.4685598377281947,0.5314401622718052
E01006666,1367,643,724,0.4703730797366496,0.5296269202633505
E01006667,1438,683,755,0.4749652294853964,0.5250347705146036
E01006668,1504,718,786,0.4773936170212766,0.5226063829787234
E01006670,1463,732,731,0.5003417634996582,0.49965823650034175
E01006607,1545,709,836,0.4588996763754045,0.5411003236245955
E01006612,1439,666,773,0.462821403752606,0.5371785962473941
E01006729,1442,704,738,0.4882108183079057,0.5117891816920943
E01032510,2152,1041,1111,0.4837360594795539,0.5162639405204461
E01032511,1338,641,697,0.4790732436472347,0.5209267563527653
E01006608,1125,531,594,0.472,0.528
E01006609,1203,587,616,0.48794679966749793,0.5120532003325021
E01006610,1459,675,784,0.46264564770390676,0.5373543522960932
E01006613,1261,632,629,0.5011895321173672,0.49881046788263284
E01006705,1296,630,666,0.4861111111111111,0.5138888888888888
E01006598,1712,725,987,0.42348130841121495,0.576518691588785
E01006599,1878,892,986,0.4749733759318424,0.5250266240681576
E01006672,1894,879,1015,0.4640971488912355,0.5359028511087646
E01034396,1853,845,1008,0.4560172692930383,0.5439827307069617
E01034397,1841,842,999,0.45736013036393264,0.5426398696360674
E01006600,1419,650,769,0.4580690627202255,0.5419309372797745
E01006603,1468,680,788,0.46321525885558584,0.5367847411444142
E01006730,1402,689,713,0.4914407988587732,0.5085592011412268
E01006731,1222,584,638,0.4779050736497545,0.5220949263502455
E01006732,1721,754,967,0.43811737361998837,0.5618826263800116
E01006611,1332,651,681,0.48873873873873874,0.5112612612612613
E01006614,1113,546,567,0.49056603773584906,0.5094339622641509
E01006615,1396,677,719,0.48495702005730656,0.5150429799426934
E01006698,1563,764,799,0.4888035828534869,0.5111964171465131
E01006700,1571,773,798,0.49204328453214513,0.5079567154678549
E01006623,1309,644,665,0.4919786096256685,0.5080213903743316
E01006624,1548,750,798,0.4844961240310077,0.5155038759689923
E01006627,1370,654,716,0.47737226277372263,0.5226277372262774
E01006671,1285,616,669,0.4793774319066148,0.5206225680933853
E01006699,1730,856,874,0.49479768786127165,0.5052023121387283
E01006701,1589,788,801,0.49590937696664567,0.5040906230333543
E01006702,1656,797,859,0.48128019323671495,0.518719806763285
E01006703,1649,836,813,0.5069739235900546,0.49302607640994545
E01006778,2176,1079,1097,0.4958639705882353,0.5041360294117647
E01006541,1472,735,737,0.499320652173913,0.5006793478260869
E01006543,1138,551,587,0.484182776801406,0.515817223198594
E01006544,1629,726,903,0.44567219152854515,0.5543278084714549
E01006616,1306,651,655,0.498468606431853,0.501531393568147
E01006762,1729,803,926,0.4644303065355697,0.5355696934644303
E01006604,1571,728,843,0.4633991088478676,0.5366008911521324
E01006605,1613,770,843,0.4773713577185369,0.5226286422814631
E01006618,1608,746,862,0.4639303482587065,0.5360696517412935
E01006625,1371,680,691,0.4959883296863603,0.5040116703136397
E01006626,1418,668,750,0.4710860366713681,0.5289139633286318
E01006637,1517,707,810,0.46605141727092947,0.5339485827290705
E01006638,1298,578,720,0.4453004622496148,0.5546995377503852
E01006639,1618,782,836,0.48331273176761436,0.5166872682323856
E01006644,1948,943,1005,0.48408624229979463,0.5159137577002053
E01006645,1516,702,814,0.4630606860158311,0.5369393139841688
E01006542,1567,772,795,0.49266113592852584,0.5073388640714741
E01006558,1304,644,660,0.4938650306748466,0.5061349693251533
E01006562,1484,732,752,0.49326145552560646,0.5067385444743935
E01033747,1931,913,1018,0.47281201450025895,0.5271879854997411
E01006545,1355,656,699,0.4841328413284133,0.5158671586715867
E01006546,1341,676,665,0.5041014168530947,0.49589858314690527
E01006547,1667,851,816,0.510497900419916,0.489502099580084
E01006548,1811,891,920,0.4919933738266151,0.5080066261733849
E01006766,1278,641,637,0.5015649452269171,0.4984350547730829
E01006767,1840,951,889,0.5168478260869566,0.4831521739130435
E01006606,1515,749,766,0.49438943894389437,0.5056105610561056
E01006761,1431,737,694,0.5150244584206848,0.48497554157931516
E01006763,1462,688,774,0.47058823529411764,0.5294117647058824
E01006764,1563,790,773,0.5054382597568778,0.4945617402431222
E01006765,1493,740,753,0.4956463496316142,0.5043536503683858
E01006768,1334,697,637,0.5224887556221889,0.4775112443778111
E01006617,1486,684,802,0.46029609690444145,0.5397039030955586
E01006619,1759,828,931,0.4707220011370097,0.5292779988629903
E01006620,1395,675,720,0.4838709677419355,0.5161290322580645
E01006621,1610,789,821,0.49006211180124226,0.5099378881987577
E01006622,1532,760,772,0.4960835509138381,0.5039164490861618
E01006640,1907,942,965,0.4939695857367593,0.5060304142632407
E01006776,1840,916,924,0.49782608695652175,0.5021739130434782
E01006779,2032,942,1090,0.46358267716535434,0.5364173228346457
E01034398,1149,550,599,0.47867711053089645,0.5213228894691035
E01034399,1079,593,486,0.5495829471733086,0.45041705282669137
E01034400,1065,519,546,0.48732394366197185,0.5126760563380282
E01006560,1901,946,955,0.49763282482903737,0.5023671751709626
E01006564,1631,807,824,0.49478847332924586,0.5052115266707541
E01006646,2159,1048,1111,0.4854099119962946,0.5145900880037054
E01006648,2379,1192,1187,0.5010508617065994,0.4989491382934006
E01006540,1779,903,876,0.5075885328836425,0.4924114671163575
E01006563,1713,890,823,0.5195563339171045,0.4804436660828955
E01006647,2104,1003,1101,0.4767110266159696,0.5232889733840305
E01006693,1519,711,808,0.46807109940750496,0.5319289005924951
E01006572,1261,583,678,0.4623314829500397,0.5376685170499603
E01006574,1527,738,789,0.48330058939096265,0.5166994106090373
E01006641,1646,774,872,0.47023086269744835,0.5297691373025516
E01006642,1397,613,784,0.43879742304939157,0.5612025769506085
E01006643,1804,798,1006,0.442350332594235,0.5576496674057649
E01006567,1668,840,828,0.5035971223021583,0.49640287769784175
E01006568,1539,718,821,0.4665367121507472,0.5334632878492528
E01006570,1422,694,728,0.4880450070323488,0.5119549929676512
E01006571,1435,665,770,0.4634146341463415,0.5365853658536586
E01006711,1571,805,766,0.5124124761298536,0.4875875238701464
E01006717,1385,709,676,0.511913357400722,0.488086642599278
E01006718,1541,754,787,0.4892926670992862,0.5107073329007138
E01006719,1381,668,713,0.4837074583635047,0.5162925416364953
E01032508,1733,819,914,0.4725908828620889,0.5274091171379112
E01032509,1298,625,673,0.4815100154083205,0.5184899845916795
E01006690,1834,977,857,0.5327153762268266,0.46728462377317337
E01006692,2510,1309,1201,0.5215139442231076,0.4784860557768924
E01006695,1802,985,817,0.5466148723640399,0.45338512763596006
E01006759,1037,550,487,0.5303760848601736,0.46962391513982643
E01006760,1438,859,579,0.5973574408901252,0.40264255910987484
E01006565,1513,702,811,0.4639788499669531,0.536021150033047
E01006569,1419,661,758,0.46582100070472165,0.5341789992952783
E01006573,1448,689,759,0.47582872928176795,0.524171270718232
E01006712,1224,563,661,0.4599673202614379,0.5400326797385621
E01006713,1299,613,686,0.4719014626635874,0.5280985373364127
E01006691,1784,871,913,0.4882286995515695,0.5117713004484304
E01006694,1960,1060,900,0.5408163265306123,0.45918367346938777
E01006696,1995,941,1054,0.4716791979949875,0.5283208020050125
E01006697,1926,1000,926,0.5192107995846313,0.48078920041536866
E01006746,1658,730,928,0.44028950542822676,0.5597104945717732
E01006512,2266,1065,1201,0.46999117387466904,0.530008826125331
E01006747,2756,1392,1364,0.5050798258345428,0.4949201741654572
E01006748,2195,1103,1092,0.5025056947608201,0.49749430523918
E01006751,2698,1290,1408,0.4781319495922906,0.5218680504077094
E01033763,2467,1183,1284,0.47952979327117956,0.5204702067288204
E01006566,1366,661,705,0.4838945827232797,0.5161054172767203
E01006585,1339,683,656,0.5100821508588499,0.4899178491411501
E01006586,1730,860,870,0.49710982658959535,0.5028901734104047
E01006587,1525,757,768,0.4963934426229508,0.5036065573770492
E01006716,1413,656,757,0.46426043878273177,0.5357395612172682
E01006575,1290,623,667,0.48294573643410854,0.5170542635658915
E01006576,1758,866,892,0.4926052332195677,0.5073947667804323
E01006577,1526,751,775,0.4921363040629096,0.5078636959370905
E01006579,1563,765,798,0.4894433781190019,0.510556621880998
E01006584,1414,680,734,0.4809052333804809,0.5190947666195191
E01006725,1498,713,785,0.4759679572763685,0.5240320427236315
E01006726,1728,840,888,0.4861111111111111,0.5138888888888888
E01006727,1246,598,648,0.4799357945425361,0.5200642054574639
E01006728,1576,737,839,0.4676395939086294,0.5323604060913706
E01034401,3789,2021,1768,0.5333861177091581,0.4666138822908419
E01006578,1345,639,706,0.475092936802974,0.5249070631970261
E01006580,1292,628,664,0.48606811145510836,0.5139318885448917
E01006581,1539,743,796,0.48278102664067574,0.5172189733593242
E01006773,1314,624,690,0.4748858447488584,0.5251141552511416
E01006774,1414,687,727,0.48585572842998587,0.5141442715700142
E01006514,2548,1209,1339,0.4744897959183674,0.5255102040816326
E01006673,2227,1155,1072,0.5186349348899866,0.4813650651100135
E01033757,1317,688,629,0.5223993925588458,0.4776006074411541
E01033768,1133,629,504,0.5551632833186231,0.44483671668137686
E01034402,1099,610,489,0.5550500454959054,0.44494995450409464
E01034403,1234,636,598,0.5153970826580226,0.4846029173419773
E01006550,1786,870,916,0.48712206047032475,0.5128779395296752
E01006557,1897,855,1042,0.4507116499736426,0.5492883500263575
E01006721,1579,785,794,0.49715009499683344,0.5028499050031665
E01006722,2004,994,1010,0.49600798403193613,0.5039920159680639
E01006723,1949,974,975,0.49974345818368393,0.5002565418163161
E01006724,1587,712,875,0.44864524259609323,0.5513547574039067
E01006552,1864,955,909,0.5123390557939914,0.4876609442060086
E01006556,2069,1052,1017,0.5084581923634606,0.4915418076365394
E01006674,2425,1146,1279,0.4725773195876289,0.5274226804123712
E01006679,2718,1288,1430,0.47387785136129507,0.5261221486387049
E01006709,1498,738,760,0.49265687583444595,0.507343124165554
E01006769,1340,647,693,0.4828358208955224,0.5171641791044777
E01006770,1160,536,624,0.46206896551724136,0.5379310344827586
E01006771,1584,714,870,0.45075757575757575,0.5492424242424242
E01006772,1116,531,585,0.47580645161290325,0.5241935483870968
E01006775,1479,669,810,0.45233265720081134,0.5476673427991886
E01006582,1716,845,871,0.49242424242424243,0.5075757575757576
E01006589,1453,725,728,0.4989676531314522,0.5010323468685478
E01006591,1496,697,799,0.4659090909090909,0.5340909090909091
E01006592,1529,713,816,0.46631785480706345,0.5336821451929366
E01006597,1678,776,902,0.46245530393325385,0.5375446960667462
E01006553,1484,707,777,0.47641509433962265,0.5235849056603774
E01006588,1579,745,834,0.47181760607979734,0.5281823939202026
E01006590,1576,796,780,0.5050761421319797,0.4949238578680203
E01006593,1449,702,747,0.484472049689441,0.515527950310559
E01034404,2194,929,1265,0.4234275296262534,0.5765724703737466
E01006520,1566,844,722,0.5389527458492975,0.4610472541507024
E01006549,1454,787,667,0.5412654745529574,0.45873452544704263
E01006675,2001,1103,898,0.551224387806097,0.44877561219390305
E01006677,1572,715,857,0.4548346055979644,0.5451653944020356
E01006518,1832,889,943,0.48526200873362446,0.5147379912663755
E01006630,2187,1028,1159,0.47005029721079106,0.5299497027892089
E01006632,1784,845,939,0.4736547085201794,0.5263452914798207
E01006676,1979,951,1028,0.4805457301667509,0.5194542698332492
E01006678,1927,882,1045,0.4577062791904515,0.5422937208095485
E01006706,1312,584,728,0.4451219512195122,0.5548780487804879
E01006707,1406,630,776,0.4480796586059744,0.5519203413940256
E01006708,1862,868,994,0.46616541353383456,0.5338345864661654
E01006710,1411,638,773,0.45216158752657687,0.5478384124734231
E01006792,1359,667,692,0.49080206033848417,0.5091979396615158
E01006794,1594,778,816,0.4880803011292346,0.5119196988707654
E01006800,1451,702,749,0.48380427291523087,0.5161957270847691
E01006801,1922,892,1030,0.46409989594172735,0.5359001040582726
E01006532,1559,771,788,0.49454778704297625,0.5054522129570237
E01006539,1365,680,685,0.4981684981684982,0.5018315018315018
E01006583,1630,733,897,0.44969325153374234,0.5503067484662577
E01006594,1323,665,658,0.5026455026455027,0.4973544973544973
E01006796,1611,810,801,0.5027932960893855,0.4972067039106145
E01006522,1716,931,785,0.5425407925407926,0.4574592074592075
E01006524,1300,623,677,0.47923076923076924,0.5207692307692308
E01006526,1385,662,723,0.4779783393501805,0.5220216606498195
E01006529,1342,679,663,0.5059612518628912,0.4940387481371088
E01006551,1232,556,676,0.4512987012987013,0.5487012987012987
E01006554,1669,773,896,0.463151587777112,0.5368484122228879
E01006525,1188,564,624,0.47474747474747475,0.5252525252525253
E01006595,1756,814,942,0.4635535307517084,0.5364464692482915
E01006596,1421,705,716,0.49612948627726955,0.5038705137227305
E01006689,1579,760,819,0.4813172894236859,0.5186827105763141
E01006633,1378,651,727,0.47242380261248185,0.5275761973875182
E01032505,1276,601,675,0.47100313479623823,0.5289968652037618
E01032506,1422,717,705,0.5042194092827004,0.4957805907172996
E01032507,1380,658,722,0.47681159420289854,0.5231884057971015
E01033748,1205,640,565,0.5311203319502075,0.46887966804979253
E01033767,1006,489,517,0.4860834990059642,0.5139165009940357
E01006793,1382,677,705,0.48986975397973953,0.5101302460202605
E01006795,1444,699,745,0.4840720221606648,0.5159279778393352
E01006797,1368,658,710,0.48099415204678364,0.5190058479532164
E01006798,1305,615,690,0.47126436781609193,0.5287356321839081
E01006799,1687,809,878,0.47954949614700654,0.5204505038529935
E01006521,1566,752,814,0.48020434227330777,0.5197956577266922
E01006523,1465,764,701,0.5215017064846417,0.4784982935153584
E01006528,1353,689,664,0.5092387287509239,0.49076127124907615
E01006628,1754,854,900,0.4868871151653364,0.5131128848346637
E01006629,1315,625,690,0.4752851711026616,0.5247148288973384
E01006527,1384,670,714,0.4841040462427746,0.5158959537572254
E01006680,1492,749,743,0.5020107238605898,0.4979892761394102
E01006682,1266,610,656,0.48183254344391785,0.5181674565560821
E01006683,1527,748,779,0.48984937786509497,0.510150622134905
E01006686,1352,665,687,0.4918639053254438,0.5081360946745562
E01006534,1890,935,955,0.4947089947089947,0.5052910052910053
E01006535,1659,798,861,0.4810126582278481,0.5189873417721519
E01006536,1816,873,943,0.480726872246696,0.5192731277533039
E01006681,1533,756,777,0.4931506849315068,0.5068493150684932
E01006530,1417,649,768,0.4580098800282287,0.5419901199717714
E01006531,1434,667,767,0.46513249651324967,0.5348675034867504
E01006533,1351,666,685,0.4929681717246484,0.5070318282753515
E01006537,2521,1261,1260,0.5001983339944467,0.49980166600555337
E01006538,1269,624,645,0.491725768321513,0.508274231678487
E01006519,1314,656,658,0.4992389649923896,0.5007610350076104
E01006684,2178,1055,1123,0.48438934802571165,0.5156106519742883
E01006685,1494,727,767,0.4866131191432396,0.5133868808567604
E01006687,2457,1234,1223,0.5022385022385022,0.49776149776149775
E01006688,1591,790,801,0.4965430546825896,0.5034569453174105
E01006740,1575,743,832,0.47174603174603175,0.5282539682539683
E01006742,1618,783,835,0.48393077873918416,0.5160692212608158
E01006744,1479,688,791,0.4651791751183232,0.5348208248816768
E01006745,1787,890,897,0.498041410184667,0.5019585898153329
E01006738,1402,633,769,0.4514978601997147,0.5485021398002853
E01006739,2546,1227,1319,0.4819324430479183,0.5180675569520817
E01006741,1882,888,994,0.4718384697130712,0.5281615302869288
E01006743,1999,1003,996,0.5017508754377189,0.49824912456228115
E01006753,1866,877,989,0.469989281886388,0.530010718113612
E01006754,1801,865,936,0.4802887284841755,0.5197112715158245
E01006755,1574,784,790,0.49809402795425667,0.5019059720457433
E01006756,1762,777,985,0.4409761634506243,0.5590238365493757
E01006757,1470,674,796,0.45850340136054424,0.5414965986394558
E01006758,1438,675,763,0.4694019471488178,0.5305980528511822
E01033758,1959,988,971,0.5043389484430832,0.4956610515569168
E01033760,2478,1069,1409,0.4313962873284907,0.5686037126715093
E01033761,2158,1092,1066,0.5060240963855421,0.4939759036144578
E01033762,3677,1754,1923,0.4770193092194724,0.5229806907805276
E01034405,2404,1123,1281,0.46713810316139764,0.5328618968386023
E01034406,1458,691,767,0.4739368998628258,0.5260631001371742
E01033750,2185,1126,1059,0.5153318077803204,0.48466819221967966
E01033756,1014,547,467,0.539447731755424,0.46055226824457596
E01033765,1501,683,818,0.45502998001332445,0.5449700199866756
E01034407,1249,660,589,0.5284227381905524,0.47157726180944753
E01034408,1286,673,613,0.5233281493001555,0.47667185069984447
E01033751,2488,1328,1160,0.5337620578778135,0.4662379421221865
E01034409,2036,1148,888,0.5638506876227898,0.4361493123772102
E01034410,1029,576,453,0.5597667638483965,0.4402332361516035
E01034411,1119,647,472,0.5781948168007149,0.42180518319928506
E01006882,1182,562,620,0.4754653130287648,0.5245346869712352
E01006883,1379,654,725,0.47425670775924583,0.5257432922407542
E01006884,1389,681,708,0.490280777537797,0.509719222462203
E01006885,1308,629,679,0.4808868501529052,0.5191131498470948
E01006886,1244,603,641,0.4847266881028939,0.5152733118971061
E01006887,1344,659,685,0.49032738095238093,0.5096726190476191
E01006802,1590,788,802,0.49559748427672956,0.5044025157232704
E01006804,1512,733,779,0.48478835978835977,0.5152116402116402
E01006806,1411,695,716,0.49255846917080087,0.5074415308291992
E01006807,1322,637,685,0.48184568835098335,0.5181543116490166
E01006803,1399,716,683,0.511794138670479,0.4882058613295211
E01006805,1534,751,783,0.4895697522816167,0.5104302477183833
E01006808,1183,601,582,0.5080304311073541,0.4919695688926458
E01006809,1332,672,660,0.5045045045045045,0.4954954954954955
E01006849,1467,723,744,0.49284253578732107,0.5071574642126789
E01006850,1594,771,823,0.4836888331242158,0.5163111668757842
E01006851,1333,649,684,0.48687171792948236,0.5131282820705176
E01006852,1249,612,637,0.4899919935948759,0.5100080064051241
E01006853,1703,836,867,0.4908984145625367,0.5091015854374633
E01006854,1423,696,727,0.48910751932536894,0.5108924806746311
E01006855,1504,733,771,0.48736702127659576,0.5126329787234043
E01006836,1424,672,752,0.47191011235955055,0.5280898876404494
E01006839,1271,641,630,0.5043273013375295,0.4956726986624705
E01006840,1420,717,703,0.5049295774647887,0.4950704225352113
E01006842,1650,766,884,0.46424242424242423,0.5357575757575758
E01006837,1557,770,787,0.4945407835581246,0.5054592164418754
E01006838,1446,699,747,0.483402489626556,0.516597510373444
E01006841,1567,750,817,0.4786215698787492,0.5213784301212508
E01006843,1228,579,649,0.4714983713355049,0.5285016286644951
E01006914,1287,635,652,0.4933954933954934,0.5066045066045066
E01006915,1478,751,727,0.5081190798376184,0.4918809201623816
E01006916,1517,751,766,0.4950560316413975,0.5049439683586026
E01006917,1723,840,883,0.4875217643644806,0.5124782356355194
E01006918,1278,625,653,0.4890453834115806,0.5109546165884195
E01006919,1794,857,937,0.4777034559643255,0.5222965440356745
E01006810,1153,559,594,0.48482220294882916,0.5151777970511708
E01006811,1312,630,682,0.4801829268292683,0.5198170731707317
E01006812,1472,712,760,0.483695652173913,0.5163043478260869
E01006813,1450,716,734,0.49379310344827587,0.5062068965517241
E01006814,1423,723,700,0.5080815179198875,0.49191848208011246
E01006815,1245,609,636,0.4891566265060241,0.5108433734939759
E01006818,1205,598,607,0.4962655601659751,0.5037344398340249
E01006822,1507,735,772,0.4877239548772396,0.5122760451227605
E01006823,1324,630,694,0.47583081570996977,0.5241691842900302
E01006824,1234,605,629,0.49027552674230146,0.5097244732576985
E01006825,1477,744,733,0.5037237643872715,0.4962762356127285
E01006866,1719,818,901,0.4758580570098895,0.5241419429901105
E01006867,2106,1068,1038,0.5071225071225072,0.4928774928774929
E01006868,1518,742,776,0.4888010540184453,0.5111989459815547
E01006869,1571,768,803,0.48886059834500317,0.5111394016549968
E01006819,1738,859,879,0.4942462600690449,0.5057537399309551
E01006820,1492,731,761,0.48994638069705093,0.510053619302949
E01006821,1483,730,753,0.49224544841537426,0.5077545515846258
E01006871,1716,815,901,0.47494172494172493,0.5250582750582751
E01006832,1693,873,820,0.5156526875369167,0.48434731246308327
E01006834,1276,648,628,0.5078369905956113,0.49216300940438873
E01006877,1565,835,730,0.5335463258785943,0.46645367412140576
E01006880,1355,679,676,0.5011070110701107,0.4988929889298893
E01006881,1430,723,707,0.5055944055944056,0.4944055944055944
E01006863,1646,819,827,0.4975698663426488,0.5024301336573511
E01006864,1914,934,980,0.48798328108672934,0.5120167189132706
E01033793,1290,641,649,0.4968992248062015,0.5031007751937985
E01033794,1714,810,904,0.4725787631271879,0.5274212368728122
E01006845,1772,850,922,0.4796839729119639,0.5203160270880361
E01006870,1425,710,715,0.4982456140350877,0.5017543859649123
E01006872,1587,844,743,0.5318210459987398,0.46817895400126025
E01006873,1519,694,825,0.45687952600395,0.54312047399605
E01006874,1372,691,681,0.5036443148688047,0.4963556851311953
E01006856,1526,755,771,0.4947575360419397,0.5052424639580603
E01006857,1409,697,712,0.49467707594038324,0.5053229240596168
E01006858,1525,728,797,0.47737704918032786,0.5226229508196721
E01006859,1682,848,834,0.5041617122473246,0.4958382877526754
E01006860,1537,760,777,0.494469746258946,0.505530253741054
E01006861,1965,935,1030,0.4758269720101781,0.5241730279898219
E01006862,2240,1098,1142,0.4901785714285714,0.5098214285714285
E01006831,1359,658,701,0.4841795437821928,0.5158204562178073
E01006833,2065,1032,1033,0.4997578692493947,0.5002421307506053
E01006835,1323,679,644,0.5132275132275133,0.48677248677248675
E01006876,1379,680,699,0.49311094996374183,0.5068890500362582
E01006878,1284,617,667,0.48052959501557635,0.5194704049844237
E01006879,1455,744,711,0.511340206185567,0.488659793814433
E01006904,1641,807,834,0.49177330895795246,0.5082266910420475
E01006816,1753,864,889,0.49286936679977184,0.5071306332002282
E01006817,1452,722,730,0.4972451790633609,0.5027548209366391
E01006875,1342,668,674,0.4977645305514158,0.5022354694485842
E01006899,2163,1106,1057,0.511326860841424,0.4886731391585761
E01006826,1201,581,620,0.48376353039134057,0.5162364696086594
E01006827,1537,751,786,0.4886141834743006,0.5113858165256994
E01006828,2130,1033,1097,0.4849765258215962,0.5150234741784038
E01006829,1706,840,866,0.492379835873388,0.5076201641266119
E01006844,1618,800,818,0.49443757725587145,0.5055624227441285
E01006846,1437,705,732,0.4906054279749478,0.5093945720250522
E01006847,1980,956,1024,0.48282828282828283,0.5171717171717172
E01006848,1279,644,635,0.5035183737294762,0.49648162627052383
E01006896,1444,701,743,0.48545706371191133,0.5145429362880887
E01006897,1460,708,752,0.4849315068493151,0.5150684931506849
E01006901,1471,737,734,0.5010197144799456,0.4989802855200544
E01006890,1392,669,723,0.48060344827586204,0.5193965517241379
E01006892,1356,655,701,0.4830383480825959,0.5169616519174042
E01006893,1325,657,668,0.4958490566037736,0.5041509433962265
E01006894,1368,660,708,0.4824561403508772,0.5175438596491229
E01006898,1739,840,899,0.48303622771707877,0.5169637722829212
E01006908,1322,648,674,0.49016641452344933,0.5098335854765507
E01006909,1319,609,710,0.46171341925701287,0.5382865807429871
E01006910,1877,905,972,0.4821523708044752,0.5178476291955247
E01006911,1446,729,717,0.504149377593361,0.495850622406639
E01033795,1487,734,753,0.49361129791526565,0.5063887020847344
E01033796,1663,818,845,0.49188214070956104,0.508117859290439
E01006888,1194,568,626,0.47571189279731996,0.52428810720268
E01006889,1379,675,704,0.4894851341551849,0.5105148658448151
E01006891,1605,797,808,0.4965732087227414,0.5034267912772585
E01006895,1398,681,717,0.4871244635193133,0.5128755364806867
E01006903,1440,691,749,0.4798611111111111,0.5201388888888889
E01006905,1318,621,697,0.47116843702579664,0.5288315629742033
E01006907,1572,758,814,0.4821882951653944,0.5178117048346056
E01006912,1698,839,859,0.49411071849234395,0.5058892815076561
E01006913,1446,703,743,0.48616874135546334,0.5138312586445366
E01006830,1599,775,824,0.48467792370231394,0.515322076297686
E01006906,1522,747,775,0.4908015768725361,0.5091984231274639
E01032904,1851,911,940,0.4921663965424095,0.5078336034575905
E01032905,2824,1374,1450,0.48654390934844194,0.5134560906515581
E01006946,1389,623,766,0.44852411807055437,0.5514758819294456
E01007028,1414,674,740,0.4766619519094767,0.5233380480905233
E01007029,1160,508,652,0.4379310344827586,0.5620689655172414
E01007030,1556,760,796,0.4884318766066838,0.5115681233933161
E01007036,1165,563,602,0.4832618025751073,0.5167381974248927
E01006947,1372,669,703,0.48760932944606417,0.5123906705539358
E01007031,1370,660,710,0.48175182481751827,0.5182481751824818
E01007032,1357,648,709,0.47752394988946206,0.522476050110538
E01007033,1360,640,720,0.47058823529411764,0.5294117647058824
E01007035,1389,650,739,0.4679625629949604,0.5320374370050396
E01006944,1742,822,920,0.4718714121699196,0.5281285878300803
E01006948,1445,709,736,0.4906574394463668,0.5093425605536333
E01006949,1500,713,787,0.47533333333333333,0.5246666666666666
E01006951,1545,724,821,0.4686084142394822,0.5313915857605178
E01007034,1293,622,671,0.48105181747873166,0.5189481825212684
E01006945,1830,911,919,0.49781420765027323,0.5021857923497268
E01006950,1697,869,828,0.512080141426046,0.48791985857395404
E01006969,1491,744,747,0.49899396378269617,0.5010060362173038
E01033094,1182,665,517,0.562605752961083,0.4373942470389171
E01033097,1171,628,543,0.5362937660119556,0.4637062339880444
E01033797,1125,584,541,0.5191111111111111,0.48088888888888887
E01033798,1027,557,470,0.5423563777994158,0.45764362220058424
E01007055,1382,660,722,0.47756874095513746,0.5224312590448625
E01007056,1643,818,825,0.497869750456482,0.5021302495435179
E01007057,1494,695,799,0.46519410977242304,0.534805890227577
E01007062,1430,707,723,0.4944055944055944,0.5055944055944056
E01007063,1500,727,773,0.4846666666666667,0.5153333333333333
E01007058,1527,773,754,0.5062213490504257,0.49377865094957435
E01007059,1560,767,793,0.49166666666666664,0.5083333333333333
E01007060,1479,710,769,0.48005409060175797,0.519945909398242
E01007061,1480,728,752,0.4918918918918919,0.5081081081081081
E01007064,1326,661,665,0.4984917043740573,0.5015082956259427
E01006934,1459,693,766,0.47498286497601094,0.5250171350239891
E01006970,2188,1174,1014,0.5365630712979891,0.463436928702011
E01006994,1764,872,892,0.4943310657596372,0.5056689342403629
E01006996,1851,922,929,0.49810913019989195,0.501890869800108
E01006998,1577,741,836,0.46987951807228917,0.5301204819277109
E01006995,1341,644,697,0.4802386278896346,0.5197613721103654
E01006997,1496,723,773,0.4832887700534759,0.5167112299465241
E01006999,1586,720,866,0.45397225725094575,0.5460277427490542
E01007000,1521,715,806,0.4700854700854701,0.5299145299145299
E01007001,1680,776,904,0.46190476190476193,0.5380952380952381
E01007002,2048,977,1071,0.47705078125,0.52294921875
E01006928,1438,726,712,0.5048678720445062,0.4951321279554937
E01006935,1649,815,834,0.4942389326864767,0.5057610673135233
E01006971,1605,777,828,0.48411214953271026,0.5158878504672897
E01006972,1522,696,826,0.45729303547963207,0.5427069645203679
E01006973,1559,728,831,0.4669660038486209,0.5330339961513791
E01006974,1504,721,783,0.47938829787234044,0.5206117021276596
E01006929,1483,743,740,0.5010114632501685,0.4989885367498314
E01006930,1423,663,760,0.46591707659873505,0.534082923401265
E01006931,1515,715,800,0.47194719471947194,0.528052805280528
E01006932,1401,664,737,0.4739471805852962,0.5260528194147038
E01006933,1370,672,698,0.4905109489051095,0.5094890510948905
E01006920,1611,757,854,0.46989447548106766,0.5301055245189323
E01006924,1459,674,785,0.46196024674434544,0.5380397532556546
E01006925,1821,889,932,0.48819330038440417,0.5118066996155958
E01006927,1690,836,854,0.49467455621301776,0.5053254437869823
E01006921,1322,632,690,0.47806354009077157,0.5219364599092284
E01006922,1444,705,739,0.48822714681440443,0.5117728531855956
E01006923,1515,704,811,0.4646864686468647,0.5353135313531353
E01006926,1739,828,911,0.4761357101782634,0.5238642898217366
E01006985,1373,668,705,0.4865258557902403,0.5134741442097597
E01006986,1344,650,694,0.4836309523809524,0.5163690476190477
E01006987,1200,577,623,0.48083333333333333,0.5191666666666667
E01006989,1247,571,676,0.4578989574979952,0.5421010425020049
E01006990,1169,550,619,0.4704875962360992,0.5295124037639007
E01006988,1506,705,801,0.4681274900398406,0.5318725099601593
E01007079,1527,720,807,0.4715127701375246,0.5284872298624754
E01007080,1439,682,757,0.4739402362751911,0.5260597637248089
E01007081,1584,708,876,0.44696969696969696,0.553030303030303
E01006991,1448,695,753,0.47997237569060774,0.5200276243093923
E01006992,1277,614,663,0.480814408770556,0.519185591229444
E01006993,1416,685,731,0.4837570621468927,0.5162429378531074
E01007078,1504,716,788,0.47606382978723405,0.523936170212766
E01007075,1315,594,721,0.45171102661596957,0.5482889733840304
E01007076,1563,772,791,0.49392194497760716,0.5060780550223928
E01007077,1426,707,719,0.4957924263674614,0.5042075736325385
E01007082,1289,613,676,0.47556245151280063,0.5244375484871994
E01007067,1411,682,729,0.4833451452870305,0.5166548547129696
E01007068,1142,553,589,0.4842381786339755,0.5157618213660246
E01007069,1445,652,793,0.45121107266435984,0.5487889273356401
E01007070,1412,682,730,0.4830028328611898,0.5169971671388102
E01007101,1423,698,725,0.4905130007027407,0.5094869992972593
E01007095,1560,759,801,0.48653846153846153,0.5134615384615384
E01007096,1284,594,690,0.46261682242990654,0.5373831775700935
E01007100,1325,621,704,0.46867924528301885,0.5313207547169811
E01033799,1469,711,758,0.48400272294077606,0.5159972770592239
E01033800,1687,915,772,0.5423829282750444,0.4576170717249555
E01007074,1406,675,731,0.4800853485064011,0.5199146514935988
E01007097,1493,743,750,0.49765572672471536,0.5023442732752846
E01007098,1640,826,814,0.5036585365853659,0.49634146341463414
E01007099,1531,721,810,0.47093403004572176,0.5290659699542782
E01007065,1280,644,636,0.503125,0.496875
E01007066,1437,670,767,0.4662491301322199,0.5337508698677801
E01007071,1413,697,716,0.49327671620665253,0.5067232837933475
E01007072,1376,660,716,0.4796511627906977,0.5203488372093024
E01007073,1242,615,627,0.49516908212560384,0.5048309178743962
E01007020,1353,669,684,0.49445676274944567,0.5055432372505543
E01007022,1347,676,671,0.5018559762435041,0.4981440237564959
E01007023,1376,651,725,0.4731104651162791,0.5268895348837209
E01007027,2020,975,1045,0.48267326732673266,0.5173267326732673
E01007037,1567,756,811,0.4824505424377792,0.5175494575622208
E01007038,1620,756,864,0.4666666666666667,0.5333333333333333
E01006936,1433,679,754,0.473831123517097,0.526168876482903
E01006937,1366,696,670,0.5095168374816984,0.4904831625183016
E01006938,1361,669,692,0.49155033063923587,0.5084496693607642
E01006939,1474,705,769,0.47829036635006783,0.5217096336499322
E01006940,1427,719,708,0.50385423966363,0.49614576033637003
E01006943,1304,648,656,0.49693251533742333,0.5030674846625767
E01007083,1129,530,599,0.46944198405668736,0.5305580159433126
E01007085,1344,642,702,0.47767857142857145,0.5223214285714286
E01007086,1176,544,632,0.46258503401360546,0.5374149659863946
E01007091,1199,533,666,0.4445371142618849,0.5554628857381151
E01007092,1130,542,588,0.479646017699115,0.5203539823008849
E01006979,1312,618,694,0.47103658536585363,0.5289634146341463
E01006980,1288,622,666,0.4829192546583851,0.5170807453416149
E01007024,1050,491,559,0.4676190476190476,0.5323809523809524
E01007026,1181,575,606,0.48687552921253174,0.5131244707874683
E01007089,1449,680,769,0.4692891649413389,0.5307108350586611
E01007021,1256,603,653,0.48009554140127386,0.5199044585987261
E01007025,1307,624,683,0.4774292272379495,0.5225707727620506
E01007105,1578,745,833,0.4721166032953105,0.5278833967046895
E01007106,1772,859,913,0.4847629796839729,0.5152370203160271
E01007107,1356,644,712,0.4749262536873156,0.5250737463126843
E01007108,1543,735,808,0.4763447828904731,0.5236552171095269
E01007039,1289,603,686,0.4678044996121024,0.5321955003878976
E01007040,2067,997,1070,0.48234155781325594,0.5176584421867441
E01007042,1300,612,688,0.4707692307692308,0.5292307692307693
E01007044,1444,699,745,0.4840720221606648,0.5159279778393352
E01007045,1183,581,602,0.4911242603550296,0.5088757396449705
E01007041,1395,680,715,0.4874551971326165,0.5125448028673835
E01007043,1360,660,700,0.4852941176470588,0.5147058823529411
E01007046,1780,914,866,0.5134831460674157,0.48651685393258426
E01007053,1326,637,689,0.4803921568627451,0.5196078431372549
E01007084,1248,597,651,0.47836538461538464,0.5216346153846154
E01006941,1541,737,804,0.4782608695652174,0.5217391304347826
E01006942,1461,702,759,0.4804928131416838,0.5195071868583162
E01006954,1531,750,781,0.48987589810581317,0.5101241018941868
E01007104,1386,678,708,0.48917748917748916,0.5108225108225108
E01007109,1494,683,811,0.4571619812583668,0.5428380187416332
E01007048,1652,777,875,0.4703389830508475,0.5296610169491526
E01007054,1325,640,685,0.4830188679245283,0.5169811320754717
E01007087,1338,649,689,0.4850523168908819,0.5149476831091181
E01007088,1239,611,628,0.49313962873284906,0.5068603712671509
E01007090,1266,567,699,0.44786729857819907,0.5521327014218009
E01006955,1595,781,814,0.4896551724137931,0.5103448275862069
E01006956,1581,859,722,0.5433270082226439,0.4566729917773561
E01006958,1536,795,741,0.517578125,0.482421875
E01007102,1506,769,737,0.5106241699867198,0.4893758300132802
E01007103,1471,714,757,0.48538409245411285,0.5146159075458872
E01006978,1318,660,658,0.5007587253414264,0.4992412746585736
E01006981,1386,667,719,0.48124098124098125,0.5187590187590188
E01006982,1279,586,693,0.4581704456606724,0.5418295543393276
E01006983,1596,764,832,0.47869674185463656,0.5213032581453634
E01006984,1278,588,690,0.460093896713615,0.539906103286385
E01006952,1322,650,672,0.491679273827534,0.5083207261724659
E01006953,1445,728,717,0.5038062283737024,0.4961937716262976
E01006957,1572,787,785,0.5006361323155216,0.4993638676844784
E01006959,1494,729,765,0.4879518072289157,0.5120481927710844
E01006977,2077,952,1125,0.45835339431872896,0.5416466056812711
E01006976,1386,650,736,0.468975468975469,0.5310245310245311
E01007014,1509,712,797,0.47183565275016565,0.5281643472498343
E01007047,1538,768,770,0.49934980494148246,0.5006501950585176
E01033095,2470,1179,1291,0.4773279352226721,0.522672064777328
E01007004,1414,674,740,0.4766619519094767,0.5233380480905233
E01007005,1435,745,690,0.519163763066202,0.4808362369337979
E01007011,1478,702,776,0.4749661705006766,0.5250338294993234
E01007016,1789,804,985,0.4494130799329234,0.5505869200670765
E01007017,1554,732,822,0.47104247104247104,0.528957528957529
E01007019,1449,655,794,0.4520358868184955,0.5479641131815045
E01007049,2149,1051,1098,0.4890646812470917,0.5109353187529083
E01007050,1248,600,648,0.4807692307692308,0.5192307692307693
E01007051,1303,614,689,0.4712202609363008,0.5287797390636991
E01007052,1325,625,700,0.4716981132075472,0.5283018867924528
E01006964,1652,800,852,0.48426150121065376,0.5157384987893463
E01007003,1210,605,605,0.5,0.5
E01007006,1405,678,727,0.4825622775800712,0.5174377224199288
E01007012,1353,671,682,0.4959349593495935,0.5040650406504065
E01007013,1453,685,768,0.47143840330351,0.52856159669649
E01006967,1727,921,806,0.5332947307469601,0.46670526925303996
E01007007,1281,666,615,0.5199063231850117,0.48009367681498827
E01007008,1320,683,637,0.5174242424242425,0.4825757575757576
E01007009,1789,1012,777,0.5656791503633315,0.4343208496366685
E01007010,1575,712,863,0.45206349206349206,0.5479365079365079
E01006960,1154,587,567,0.5086655112651647,0.4913344887348354
E01006961,1596,783,813,0.4906015037593985,0.5093984962406015
E01006962,1394,708,686,0.5078909612625538,0.4921090387374462
E01006963,1726,907,819,0.5254924681344149,0.47450753186558514
E01006965,1515,738,777,0.4871287128712871,0.5128712871287129
E01006966,1654,750,904,0.4534461910519952,0.5465538089480049
E01007229,1653,800,853,0.4839685420447671,0.5160314579552329
E01007230,1240,577,663,0.4653225806451613,0.5346774193548387
E01007231,1554,766,788,0.4929214929214929,0.5070785070785071
E01007237,1595,782,813,0.490282131661442,0.509717868338558
E01007238,1551,765,786,0.4932301740812379,0.5067698259187621
E01007218,1522,752,770,0.4940867279894875,0.5059132720105125
E01007232,1564,800,764,0.5115089514066496,0.4884910485933504
E01007233,1702,841,861,0.49412455934195065,0.5058754406580493
E01007234,1498,731,767,0.48798397863818427,0.5120160213618158
E01007236,1319,630,689,0.47763457164518575,0.5223654283548143
E01007307,1683,848,835,0.5038621509209744,0.49613784907902553
E01007308,1410,679,731,0.48156028368794324,0.5184397163120568
E01007312,1474,701,773,0.4755766621438263,0.5244233378561737
E01007313,1561,710,851,0.4548366431774504,0.5451633568225497
E01007315,1486,712,774,0.4791386271870794,0.5208613728129206
E01007211,1162,558,604,0.4802065404475043,0.5197934595524957
E01007235,1513,754,759,0.4983476536682089,0.5016523463317911
E01007310,1317,650,667,0.4935459377372817,0.5064540622627183
E01007311,1397,690,707,0.49391553328561205,0.506084466714388
E01007314,1418,692,726,0.48801128349788436,0.5119887165021156
E01007316,1491,722,769,0.4842387659289068,0.5157612340710932
E01007215,1471,730,741,0.49626104690686607,0.5037389530931339
E01007216,1548,780,768,0.5038759689922481,0.49612403100775193
E01007219,1495,768,727,0.5137123745819397,0.4862876254180602
E01007220,1394,681,713,0.4885222381635581,0.5114777618364419
E01007275,1430,715,715,0.5,0.5
E01007203,1927,948,979,0.4919564089257914,0.5080435910742086
E01007205,1621,777,844,0.4793337446020975,0.5206662553979026
E01007210,2020,977,1043,0.48366336633663365,0.5163366336633664
E01007309,1478,719,759,0.486468200270636,0.513531799729364
E01007212,1439,699,740,0.4857539958304378,0.5142460041695622
E01007213,1474,688,786,0.46675712347354137,0.5332428765264586
E01007214,1544,767,777,0.49676165803108807,0.5032383419689119
E01007217,1675,792,883,0.4728358208955224,0.5271641791044777
E01007276,1486,743,743,0.5,0.5
E01007272,1421,699,722,0.4919071076706545,0.5080928923293455
E01007273,1313,636,677,0.4843869002284844,0.5156130997715156
E01007274,1367,661,706,0.48354059985369424,0.5164594001463058
E01007277,1388,677,711,0.4877521613832853,0.5122478386167147
E01007278,1465,686,779,0.468259385665529,0.531740614334471
E01007204,1723,815,908,0.4730121880441091,0.5269878119558908
E01007206,1845,902,943,0.4888888888888889,0.5111111111111111
E01007207,1407,623,784,0.4427860696517413,0.5572139303482587
E01007209,1416,708,708,0.5,0.5
E01007269,1708,803,905,0.47014051522248246,0.5298594847775175
E01007270,1743,869,874,0.4985656913367757,0.5014343086632244
E01007271,1588,774,814,0.48740554156171284,0.5125944584382871
E01034836,1256,560,696,0.445859872611465,0.554140127388535
E01034837,1634,777,857,0.4755201958384333,0.5244798041615667
E01007120,1374,651,723,0.4737991266375546,0.5262008733624454
E01007121,1479,722,757,0.48816768086544965,0.5118323191345504
E01007122,1554,750,804,0.4826254826254826,0.5173745173745173
E01007123,1603,727,876,0.4535246412975671,0.5464753587024329
E01007124,1687,747,940,0.44279786603438054,0.5572021339656195
E01007208,1664,785,879,0.4717548076923077,0.5282451923076923
E01007221,1472,686,786,0.46603260869565216,0.5339673913043478
E01007225,2098,999,1099,0.47616777883698763,0.5238322211630124
E01007227,1523,730,793,0.479317137229153,0.520682862770847
E01007228,1399,679,720,0.4853466761972838,0.5146533238027162
E01007195,1605,762,843,0.4747663551401869,0.525233644859813
E01007199,1502,731,771,0.4866844207723036,0.5133155792276964
E01007222,1526,731,795,0.47903014416775885,0.5209698558322412
E01007223,1409,646,763,0.45848119233498935,0.5415188076650106
E01007193,1644,781,863,0.4750608272506083,0.5249391727493917
E01007194,1484,686,798,0.46226415094339623,0.5377358490566038
E01007200,1619,791,828,0.48857319332921556,0.5114268066707844
E01007201,1464,701,763,0.47882513661202186,0.5211748633879781
E01007202,1375,652,723,0.4741818181818182,0.5258181818181819
E01007125,1594,738,856,0.4629861982434128,0.5370138017565872
E01007156,1519,777,742,0.511520737327189,0.48847926267281105
E01007157,1496,716,780,0.4786096256684492,0.5213903743315508
E01007158,1525,736,789,0.48262295081967216,0.5173770491803279
E01007159,1950,946,1004,0.48512820512820515,0.5148717948717949
E01007127,1630,782,848,0.47975460122699387,0.5202453987730061
E01007128,1690,948,742,0.5609467455621302,0.4390532544378698
E01007129,1448,731,717,0.5048342541436464,0.4951657458563536
E01007133,1209,615,594,0.5086848635235732,0.4913151364764268
E01034838,1022,497,525,0.4863013698630137,0.5136986301369864
E01034839,1042,623,419,0.5978886756238004,0.4021113243761996
E01007224,1445,705,740,0.48788927335640137,0.5121107266435986
E01007226,1577,753,824,0.4774889029803424,0.5225110970196576
E01007265,1346,643,703,0.47771173848439824,0.5222882615156018
E01007299,1277,621,656,0.48629600626468283,0.5137039937353172
E01007306,1556,762,794,0.4897172236503856,0.5102827763496144
E01007297,1488,645,843,0.4334677419354839,0.5665322580645161
E01007298,1517,726,791,0.47857613711272246,0.5214238628872775
E01007301,1563,759,804,0.4856046065259117,0.5143953934740882
E01007302,1926,947,979,0.4916926272066459,0.5083073727933541
E01007305,1575,741,834,0.4704761904761905,0.5295238095238095
E01007119,1647,757,890,0.4596235579842137,0.5403764420157863
E01007161,1543,746,797,0.48347375243033053,0.5165262475696695
E01007162,1451,658,793,0.4534803583735355,0.5465196416264645
E01007300,2260,1029,1231,0.45530973451327433,0.5446902654867256
E01007155,1693,946,747,0.5587714116952156,0.4412285883047844
E01007160,1609,798,811,0.4959602237414543,0.5040397762585457
E01007240,1609,856,753,0.5320074580484773,0.4679925419515227
E01007241,1368,654,714,0.4780701754385965,0.5219298245614035
E01007242,1667,796,871,0.47750449910017995,0.52249550089982
E01007130,1789,902,887,0.5041922861934042,0.4958077138065959
E01007131,1682,829,853,0.4928656361474435,0.5071343638525565
E01007179,1284,665,619,0.5179127725856698,0.48208722741433024
E01007291,1632,773,859,0.4736519607843137,0.5263480392156863
E01007292,1551,783,768,0.504835589941973,0.4951644100580271
E01007294,1438,693,745,0.4819193324061196,0.5180806675938804
E01007180,1542,757,785,0.4909208819714656,0.5090791180285343
E01007181,1512,699,813,0.4623015873015873,0.5376984126984127
E01007239,1652,807,845,0.48849878934624696,0.511501210653753
E01007243,1536,729,807,0.474609375,0.525390625
E01007244,2153,1065,1088,0.4946586158848119,0.5053413841151881
E01007259,1190,565,625,0.47478991596638653,0.5252100840336135
E01007261,1320,628,692,0.47575757575757577,0.5242424242424243
E01007264,1348,644,704,0.47774480712166173,0.5222551928783383
E01007266,1510,745,765,0.49337748344370863,0.5066225165562914
E01007267,1415,673,742,0.4756183745583039,0.5243816254416961
E01007268,1292,607,685,0.4698142414860681,0.5301857585139319
E01007163,2257,1108,1149,0.4909171466548516,0.5090828533451485
E01007245,1446,710,736,0.49100968188105115,0.5089903181189488
E01007246,1396,688,708,0.49283667621776506,0.5071633237822349
E01007247,1636,809,827,0.4944987775061125,0.5055012224938875
E01007252,1473,729,744,0.49490835030549896,0.505091649694501
E01007249,1303,613,690,0.47045280122793554,0.5295471987720645
E01007251,1092,542,550,0.49633699633699635,0.5036630036630036
E01007257,1295,582,713,0.4494208494208494,0.5505791505791506
E01007303,1491,724,767,0.48558014755197854,0.5144198524480215
E01007304,1551,717,834,0.4622823984526112,0.5377176015473888
E01007196,1586,720,866,0.45397225725094575,0.5460277427490542
E01007197,1637,788,849,0.4813683567501527,0.5186316432498472
E01007198,1587,759,828,0.4782608695652174,0.5217391304347826
E01007263,1446,679,767,0.46957123098201936,0.5304287690179806
E01007282,1324,610,714,0.4607250755287009,0.5392749244712991
E01007175,1974,991,983,0.5020263424518744,0.4979736575481256
E01007290,1963,1017,946,0.5180845644421803,0.4819154355578197
E01007293,1609,766,843,0.47607209446861404,0.5239279055313859
E01007295,1690,855,835,0.5059171597633136,0.4940828402366864
E01007296,1702,812,890,0.4770857814336075,0.5229142185663925
E01007258,1400,654,746,0.46714285714285714,0.5328571428571428
E01007260,1561,743,818,0.47597693786034595,0.5240230621396541
E01007262,1496,754,742,0.5040106951871658,0.4959893048128342
E01007281,1341,647,694,0.482475764354959,0.517524235645041
E01007283,1229,621,608,0.5052888527257934,0.4947111472742067
E01007173,1525,754,771,0.4944262295081967,0.5055737704918033
E01007174,1701,809,892,0.4756025867136978,0.5243974132863022
E01007176,1632,825,807,0.5055147058823529,0.4944852941176471
E01007177,1541,721,820,0.46787800129785856,0.5321219987021415
E01007178,1587,794,793,0.5003150598613737,0.49968494013862635
E01007248,1485,751,734,0.5057239057239057,0.49427609427609426
E01007250,1366,671,695,0.4912152269399707,0.5087847730600292
E01007253,1589,768,821,0.48332284455632474,0.5166771554436753
E01007254,1616,798,818,0.4938118811881188,0.5061881188118812
E01007115,1555,759,796,0.48810289389067524,0.5118971061093247
E01007138,1755,858,897,0.4888888888888889,0.5111111111111111
E01007139,1609,789,820,0.490366687383468,0.509633312616532
E01007141,1609,731,878,0.454319453076445,0.545680546923555
E01007289,1629,806,823,0.49478207489257214,0.5052179251074279
E01007111,1470,722,748,0.49115646258503404,0.508843537414966
E01007112,1514,758,756,0.5006605019815059,0.49933949801849403
E01007113,1307,629,678,0.4812547819433818,0.5187452180566182
E01007114,1483,713,770,0.480782198246797,0.519217801753203
E01007116,1469,726,743,0.494213750850919,0.505786249149081
E01007280,1693,824,869,0.48670998227997636,0.5132900177200236
E01007284,1633,793,840,0.4856093080220453,0.5143906919779547
E01007285,1445,682,763,0.47197231833910036,0.5280276816608996
E01007287,1834,857,977,0.46728462377317337,0.5327153762268266
E01007183,1253,612,641,0.48842777334397447,0.5115722266560255
E01007255,1517,755,762,0.4976928147659855,0.5023071852340145
E01007256,1540,693,847,0.45,0.55
E01007279,1574,762,812,0.4841168996188056,0.5158831003811944
E01007286,1450,730,720,0.503448275862069,0.496551724137931
E01007110,1597,789,808,0.4940513462742642,0.5059486537257357
E01007117,1634,800,834,0.48959608323133413,0.5104039167686658
E01007118,1484,679,805,0.45754716981132076,0.5424528301886793
E01007151,1525,708,817,0.4642622950819672,0.5357377049180327
E01007154,1487,724,763,0.48688634835238737,0.5131136516476127
E01007142,1900,898,1002,0.4726315789473684,0.5273684210526316
E01007143,1973,987,986,0.5002534211860111,0.4997465788139889
E01007152,1590,762,828,0.47924528301886793,0.5207547169811321
E01007153,1488,684,804,0.4596774193548387,0.5403225806451613
E01034840,1402,677,725,0.48288159771754635,0.5171184022824536
E01034841,1362,669,693,0.4911894273127753,0.5088105726872246
E01007182,1526,699,827,0.4580602883355177,0.5419397116644823
E01007184,1452,677,775,0.4662534435261708,0.5337465564738292
E01007185,1595,749,846,0.4695924764890282,0.5304075235109718
E01007192,1311,625,686,0.4767353165522502,0.5232646834477498
E01007288,1638,759,879,0.4633699633699634,0.5366300366300366
E01007144,1300,624,676,0.48,0.52
E01007145,1182,571,611,0.48307952622673433,0.5169204737732657
E01007146,1452,705,747,0.4855371900826446,0.5144628099173554
E01007147,1405,670,735,0.47686832740213525,0.5231316725978647
E01007148,1643,836,807,0.5088253195374315,0.49117468046256846
E01007135,1563,796,767,0.509277031349968,0.490722968650032
E01007136,1642,768,874,0.46772228989037756,0.5322777101096224
E01007137,1648,780,868,0.4733009708737864,0.5266990291262136
E01007170,1631,792,839,0.4855916615573268,0.5144083384426732
E01007186,1489,713,776,0.4788448623237072,0.5211551376762928
E01007187,1454,708,746,0.48693259972489683,0.5130674002751031
E01007188,1470,719,751,0.4891156462585034,0.5108843537414965
E01007189,1548,752,796,0.48578811369509045,0.5142118863049095
E01007190,1515,732,783,0.48316831683168315,0.5168316831683168
E01007191,1363,684,679,0.5018341892883346,0.49816581071166544
E01007149,1461,703,758,0.4811772758384668,0.5188227241615332
E01007150,1340,649,691,0.4843283582089552,0.5156716417910447
E01007165,1207,588,619,0.4871582435791218,0.5128417564208783
E01007171,1541,765,776,0.4964308890330954,0.5035691109669046
E01007172,1424,663,761,0.46558988764044945,0.5344101123595506
E01007164,1834,921,913,0.5021810250817884,0.49781897491821153
E01007166,1387,653,734,0.4708002883922134,0.5291997116077866
E01007167,1559,771,788,0.49454778704297625,0.5054522129570237
E01007168,1662,784,878,0.4717208182912154,0.5282791817087846
E01007169,1687,799,888,0.4736218138707765,0.5263781861292235
E01012782,1439,678,761,0.47116052814454484,0.5288394718554552
E01012785,1298,622,676,0.47919876733436056,0.5208012326656395
E01012786,1226,610,616,0.49755301794453505,0.5024469820554649
E01012787,1459,686,773,0.4701850582590816,0.5298149417409185
E01012788,1432,681,751,0.4755586592178771,0.5244413407821229
E01012789,1275,607,668,0.476078431372549,0.523921568627451
E01012875,1689,837,852,0.4955595026642984,0.5044404973357016
E01012876,1706,796,910,0.46658851113716293,0.5334114888628371
E01012877,1607,783,824,0.48724331051649034,0.5127566894835096
E01012878,1792,867,925,0.4838169642857143,0.5161830357142857
E01012879,1435,656,779,0.45714285714285713,0.5428571428571428
E01012778,1442,670,772,0.4646324549237171,0.5353675450762829
E01012783,1317,667,650,0.5064540622627183,0.4935459377372817
E01012784,1986,947,1039,0.4768378650553877,0.5231621349446123
E01012790,1324,640,684,0.48338368580060426,0.5166163141993958
E01012906,1632,762,870,0.46691176470588236,0.5330882352941176
E01012908,1052,507,545,0.48193916349809884,0.5180608365019012
E01012764,1137,547,590,0.4810905892700088,0.5189094107299912
E01012765,1373,673,700,0.4901675163874727,0.5098324836125273
E01012768,1296,612,684,0.4722222222222222,0.5277777777777778
E01012769,1288,651,637,0.5054347826086957,0.4945652173913043
E01012829,1856,904,952,0.4870689655172414,0.5129310344827587
E01012830,1396,679,717,0.4863896848137536,0.5136103151862464
E01012905,1333,627,706,0.4703675918979745,0.5296324081020255
E01012910,1208,607,601,0.5024834437086093,0.49751655629139074
E01012912,1675,819,856,0.48895522388059703,0.511044776119403
E01012822,1506,746,760,0.4953519256308101,0.5046480743691899
E01012904,1241,596,645,0.4802578565672844,0.5197421434327155
E01012907,1513,729,784,0.48182419035029744,0.5181758096497026
E01012909,1179,583,596,0.4944868532654792,0.5055131467345207
E01012911,1108,540,568,0.48736462093862815,0.5126353790613718
E01012873,1541,688,853,0.4464633354964309,0.5535366645035691
E01012874,1525,729,796,0.4780327868852459,0.5219672131147541
E01012880,1738,862,876,0.49597238204833144,0.5040276179516686
E01012881,1537,747,790,0.4860117111255693,0.5139882888744307
E01012915,1511,742,769,0.49106551952349436,0.5089344804765056
E01012917,1818,868,950,0.47744774477447743,0.5225522552255225
E01012918,1740,889,851,0.5109195402298851,0.48908045977011494
E01012833,1617,725,892,0.4483611626468769,0.551638837353123
E01012835,1061,515,546,0.48539114043355325,0.5146088595664468
E01012836,1470,750,720,0.5102040816326531,0.4897959183673469
E01012839,1340,650,690,0.48507462686567165,0.5149253731343284
E01012840,1518,720,798,0.4743083003952569,0.525691699604743
E01012824,1966,965,1001,0.4908443540183113,0.5091556459816887
E01012825,1481,725,756,0.48953409858203917,0.5104659014179609
E01012834,1736,839,897,0.483294930875576,0.5167050691244239
E01012837,1617,759,858,0.46938775510204084,0.5306122448979592
E01012838,1672,754,918,0.45095693779904306,0.5490430622009569
E01012821,1857,877,980,0.47226709746903606,0.5277329025309639
E01012827,1564,755,809,0.4827365728900256,0.5172634271099744
E01012828,1488,718,770,0.4825268817204301,0.5174731182795699
E01035463,2478,1193,1285,0.4814366424535916,0.5185633575464084
E01012766,1397,698,699,0.49964209019327127,0.5003579098067287
E01012767,1515,797,718,0.526072607260726,0.4739273927392739
E01012914,3294,1621,1673,0.49210686095932,0.50789313904068
E01012916,1903,856,1047,0.44981607987388333,0.5501839201261166
E01012812,1330,685,645,0.5150375939849624,0.4849624060150376
E01012813,1671,849,822,0.5080789946140036,0.4919210053859964
E01012814,1488,725,763,0.48723118279569894,0.5127688172043011
E01012815,1488,735,753,0.4939516129032258,0.5060483870967742
E01012818,1218,608,610,0.49917898193760263,0.5008210180623974
E01012791,1611,787,824,0.48851644941030414,0.5114835505896959
E01012792,1500,736,764,0.49066666666666664,0.5093333333333333
E01012793,1402,670,732,0.47788873038516405,0.5221112696148359
E01012794,1470,761,709,0.5176870748299319,0.482312925170068
E01012913,1984,1004,980,0.5060483870967742,0.4939516129032258
E01012761,1706,909,797,0.5328253223915592,0.4671746776084408
E01012868,1701,967,734,0.5684891240446796,0.4315108759553204
E01012869,1604,897,707,0.5592269326683291,0.4407730673316708
E01012871,1664,928,736,0.5576923076923077,0.4423076923076923
E01012872,1478,854,624,0.577807848443843,0.42219215155615697
E01012804,1698,873,825,0.5141342756183745,0.48586572438162545
E01012806,1438,710,728,0.4937413073713491,0.5062586926286509
E01012807,1356,674,682,0.4970501474926254,0.5029498525073747
E01012817,1420,717,703,0.5049295774647887,0.4950704225352113
E01012819,1390,698,692,0.5021582733812949,0.497841726618705
E01012841,1576,733,843,0.4651015228426396,0.5348984771573604
E01012844,1269,565,704,0.44523246650906223,0.5547675334909378
E01012849,1571,754,817,0.47994907702100575,0.5200509229789942
E01012898,1692,765,927,0.4521276595744681,0.5478723404255319
E01035464,2292,1050,1242,0.4581151832460733,0.5418848167539267
E01012758,1548,820,728,0.5297157622739018,0.4702842377260982
E01012762,1358,676,682,0.49779086892488955,0.5022091310751104
E01012763,1720,925,795,0.5377906976744186,0.4622093023255814
E01012866,1653,811,842,0.4906231094978826,0.5093768905021173
E01012870,1713,978,735,0.5709281961471103,0.4290718038528897
E01012774,1502,723,779,0.481358189081225,0.5186418109187749
E01012795,2010,959,1051,0.4771144278606965,0.5228855721393035
E01012797,1305,614,691,0.4704980842911877,0.5295019157088122
E01012798,1679,810,869,0.48243001786777845,0.5175699821322216
E01012801,1404,678,726,0.4829059829059829,0.5170940170940171
E01012816,1450,700,750,0.4827586206896552,0.5172413793103449
E01012848,1885,1359,526,0.7209549071618037,0.2790450928381963
E01012894,2174,1069,1105,0.4917203311867525,0.5082796688132475
E01012896,1971,995,976,0.5048198883815322,0.49518011161846776
E01012901,1497,724,773,0.48363393453573816,0.5163660654642619
E01012842,1508,739,769,0.490053050397878,0.5099469496021221
E01012843,1638,779,859,0.47557997557997556,0.5244200244200244
E01012845,1540,746,794,0.4844155844155844,0.5155844155844156
E01012846,1354,652,702,0.4815361890694239,0.518463810930576
E01012847,1296,620,676,0.4783950617283951,0.5216049382716049
E01012820,1318,655,663,0.4969650986342944,0.5030349013657056
E01012899,1424,702,722,0.49297752808988765,0.5070224719101124
E01012900,1560,761,799,0.4878205128205128,0.5121794871794871
E01012902,1548,760,788,0.4909560723514212,0.5090439276485789
E01012903,1671,819,852,0.49012567324955114,0.5098743267504489
E01012796,1242,603,639,0.4855072463768116,0.5144927536231884
E01012799,1213,587,626,0.48392415498763397,0.516075845012366
E01012800,1432,729,703,0.5090782122905028,0.4909217877094972
E01012802,1333,654,679,0.490622655663916,0.5093773443360841
E01012803,1366,660,706,0.48316251830161056,0.5168374816983895
E01012850,1667,924,743,0.5542891421715657,0.44571085782843434
E01012852,1655,872,783,0.5268882175226586,0.47311178247734137
E01012856,1740,923,817,0.5304597701149425,0.46954022988505745
E01012857,1750,930,820,0.5314285714285715,0.4685714285714286
E01012867,1737,900,837,0.5181347150259067,0.48186528497409326
E01012756,1455,731,724,0.5024054982817869,0.49759450171821307
E01012757,1370,690,680,0.5036496350364964,0.49635036496350365
E01012759,1633,768,865,0.47030006123698714,0.5296999387630129
E01012760,1429,744,685,0.5206438068579426,0.4793561931420574
E01012862,1374,675,699,0.4912663755458515,0.5087336244541485
E01012805,1386,724,662,0.5223665223665224,0.47763347763347763
E01012808,1693,840,853,0.49616066154754873,0.5038393384524513
E01012809,1771,959,812,0.541501976284585,0.45849802371541504
E01012810,1843,907,936,0.4921323928377645,0.5078676071622354
E01012811,1574,850,724,0.5400254129606099,0.4599745870393901
E01012773,1570,779,791,0.4961783439490446,0.5038216560509554
E01012776,1433,688,745,0.4801116538729937,0.5198883461270063
E01012863,2406,1190,1216,0.4945968412302577,0.5054031587697423
E01012864,1752,945,807,0.5393835616438356,0.4606164383561644
E01012865,1314,710,604,0.5403348554033486,0.4596651445966514
E01012770,1507,750,757,0.49767750497677504,0.5023224950232249
E01012771,1513,722,791,0.47719762062128224,0.5228023793787178
E01012772,1559,791,768,0.5073765234124439,0.4926234765875561
E01012775,1622,781,841,0.4815043156596794,0.5184956843403206
E01012777,1544,738,806,0.47797927461139894,0.522020725388601
E01012854,2159,1209,950,0.5599814729041223,0.44001852709587774
E01012855,2116,1148,968,0.5425330812854442,0.45746691871455575
E01033104,1420,867,553,0.6105633802816901,0.38943661971830984
E01033109,1484,891,593,0.6004043126684636,0.3995956873315364
E01035465,1152,672,480,0.5833333333333334,0.4166666666666667
E01035466,1354,792,562,0.5849335302806499,0.4150664697193501
E01012859,1586,833,753,0.5252206809583859,0.47477931904161413
E01012889,1627,829,798,0.5095267363245236,0.49047326367547633
E01012891,2345,1217,1128,0.5189765458422175,0.4810234541577825
E01012892,2041,1078,963,0.528172464478197,0.47182753552180307
E01012893,1610,744,866,0.462111801242236,0.537888198757764
E01012858,2246,1124,1122,0.5004452359750667,0.4995547640249332
E01012860,2487,1249,1238,0.5022114997989545,0.4977885002010454
E01012886,1556,767,789,0.4929305912596401,0.5070694087403599
E01012888,1604,815,789,0.5081047381546134,0.4918952618453865
E01035467,1630,813,817,0.49877300613496933,0.5012269938650307
E01035468,1215,614,601,0.5053497942386831,0.49465020576131685
E01012882,1541,768,773,0.4983776768332252,0.5016223231667748
E01012883,1449,670,779,0.46238785369220153,0.5376121463077985
E01012884,1837,898,939,0.48884050081654873,0.5111594991834513
E01012887,1551,775,776,0.4996776273372018,0.5003223726627982
E01032595,1844,868,976,0.47071583514099785,0.5292841648590022
E01012779,1327,593,734,0.4468726450640543,0.5531273549359458
E01012780,1871,909,962,0.48583645109567075,0.5141635489043292
E01012781,1291,625,666,0.48412083656080557,0.5158791634391944
E01012832,1797,863,934,0.4802448525319978,0.5197551474680022
E01035469,2084,1038,1046,0.4980806142034549,0.5019193857965452
E01033105,1554,792,762,0.5096525096525096,0.49034749034749037
E01033107,1322,667,655,0.5045385779122542,0.49546142208774585
E01035470,2537,1255,1282,0.4946787544343713,0.5053212455656287
E01035471,1340,690,650,0.5149253731343284,0.48507462686567165
E01035472,1801,897,904,0.4980566352026652,0.5019433647973348
E01012933,1025,499,526,0.4868292682926829,0.5131707317073171
E01012934,1730,836,894,0.48323699421965316,0.5167630057803468
E01012939,1857,889,968,0.47872913301023157,0.5212708669897684
E01012940,1573,766,807,0.4869675778766688,0.5130324221233312
E01012941,1353,639,714,0.4722838137472284,0.5277161862527716
E01034752,1474,700,774,0.47489823609226595,0.5251017639077341
E01034753,1162,554,608,0.47676419965576594,0.5232358003442341
E01012929,1847,906,941,0.49052517596101786,0.5094748240389821
E01012930,1354,643,711,0.47488921713441656,0.5251107828655834
E01012935,1322,620,702,0.4689863842662632,0.5310136157337367
E01012937,2114,1020,1094,0.4824976348155156,0.5175023651844843
E01012942,1197,570,627,0.47619047619047616,0.5238095238095238
E01012928,1694,805,889,0.47520661157024796,0.5247933884297521
E01012931,1549,729,820,0.47062621045836023,0.5293737895416397
E01012932,1648,814,834,0.49393203883495146,0.5060679611650486
E01012946,1568,747,821,0.4764030612244898,0.5235969387755102
E01012949,1328,608,720,0.4578313253012048,0.5421686746987951
E01012936,1221,591,630,0.48402948402948404,0.515970515970516
E01012943,1695,842,853,0.4967551622418879,0.5032448377581121
E01012945,1494,765,729,0.5120481927710844,0.4879518072289157
E01012952,1496,745,751,0.4979946524064171,0.5020053475935828
E01012944,1428,756,672,0.5294117647058824,0.47058823529411764
E01012947,1414,682,732,0.4823196605374823,0.5176803394625177
E01012948,1348,713,635,0.5289317507418397,0.4710682492581602
E01012951,1206,573,633,0.47512437810945274,0.5248756218905473
E01012950,1311,629,682,0.4797864225781846,0.5202135774218154
E01012990,1412,712,700,0.5042492917847026,0.49575070821529743
E01012991,1582,747,835,0.4721871049304678,0.5278128950695322
E01012992,1411,686,725,0.4861800141743444,0.5138199858256556
E01012978,1676,812,864,0.48448687350835323,0.5155131264916468
E01012981,1364,697,667,0.5109970674486803,0.48900293255131966
E01012983,1779,853,926,0.47948285553681846,0.5205171444631815
E01012989,1787,860,927,0.4812534974818131,0.5187465025181869
E01013125,1711,848,863,0.49561659848042083,0.5043834015195792
E01013057,1646,836,810,0.5078979343863913,0.49210206561360875
E01013059,1649,809,840,0.49060036385688294,0.509399636143117
E01013060,2431,1108,1323,0.455779514603044,0.544220485396956
E01013061,1567,748,819,0.4773452456924059,0.5226547543075941
E01013126,2391,1472,919,0.615641990798829,0.3843580092011711
E01012986,1529,754,775,0.49313276651406146,0.5068672334859385
E01012987,1702,845,857,0.4964747356051704,0.5035252643948296
E01012988,1583,790,793,0.4990524320909665,0.5009475679090335
E01013048,2242,1125,1117,0.5017841213202497,0.4982158786797502
E01013053,1759,819,940,0.46560545764639,0.5343945423536101
E01013054,1939,927,1012,0.4780814853017019,0.5219185146982981
E01013055,1737,846,891,0.48704663212435234,0.5129533678756477
E01013056,1585,790,795,0.49842271293375395,0.501577287066246
E01013058,1442,718,724,0.49791955617198336,0.5020804438280166
E01013119,1467,730,737,0.49761417859577367,0.5023858214042263
E01034754,1225,598,627,0.4881632653061225,0.5118367346938776
E01034755,1637,779,858,0.4758704948075748,0.5241295051924252
E01013046,1605,734,871,0.4573208722741433,0.5426791277258567
E01013047,1539,753,786,0.48927875243664715,0.5107212475633528
E01013049,1668,824,844,0.4940047961630695,0.5059952038369304
E01013050,1722,847,875,0.491869918699187,0.508130081300813
E01013051,1664,779,885,0.46814903846153844,0.5318509615384616
E01012922,1484,740,744,0.49865229110512127,0.5013477088948787
E01012923,2020,1172,848,0.5801980198019802,0.4198019801980198
E01012925,1309,623,686,0.47593582887700536,0.5240641711229946
E01012927,1447,709,738,0.48997926744989634,0.5100207325501037
E01012924,1694,840,854,0.49586776859504134,0.5041322314049587
E01012926,2348,1170,1178,0.49829642248722317,0.5017035775127768
E01013027,1698,855,843,0.5035335689045937,0.49646643109540634
E01013034,1795,908,887,0.5058495821727019,0.49415041782729807
E01013120,1995,969,1026,0.4857142857142857,0.5142857142857142
E01013121,2234,1115,1119,0.4991047448522829,0.500895255147717
E01013123,2103,1053,1050,0.5007132667617689,0.4992867332382311
E01013124,2243,1039,1204,0.46321890325456977,0.5367810967454302
E01013064,1363,634,729,0.46515040352164344,0.5348495964783566
E01013065,1574,759,815,0.4822109275730623,0.5177890724269377
E01013066,1564,741,823,0.47378516624040923,0.5262148337595908
E01013067,1618,796,822,0.4919653893695921,0.5080346106304079
E01013068,2296,1071,1225,0.46646341463414637,0.5335365853658537
E01013070,1438,692,746,0.4812239221140473,0.5187760778859527
E01013038,1464,713,751,0.4870218579234973,0.5129781420765027
E01013045,1540,737,803,0.4785714285714286,0.5214285714285715
E01013069,1532,733,799,0.47845953002610964,0.5215404699738904
E01013071,1509,707,802,0.4685222001325381,0.5314777998674619
E01013022,1978,960,1018,0.48533872598584427,0.5146612740141557
E01013023,1822,908,914,0.4983534577387486,0.5016465422612514
E01013024,1849,896,953,0.48458626284478096,0.515413737155219
E01013122,1458,735,723,0.5041152263374485,0.49588477366255146
E01013127,1591,794,797,0.49905719673161536,0.5009428032683847
E01013036,1412,645,767,0.45679886685552407,0.5432011331444759
E01013037,1374,673,701,0.4898107714701601,0.5101892285298398
E01013040,2332,1107,1225,0.47469982847341335,0.5253001715265866
E01013041,1558,715,843,0.45892169448010267,0.5410783055198973
E01013062,1581,748,833,0.4731182795698925,0.5268817204301075
E01013063,1485,717,768,0.48282828282828283,0.5171717171717172
E01012919,1458,669,789,0.4588477366255144,0.5411522633744856
E01012921,1140,566,574,0.4964912280701754,0.5035087719298246
E01013039,1933,960,973,0.4966373512674599,0.5033626487325401
E01013042,1512,742,770,0.49074074074074076,0.5092592592592593
E01013043,1280,607,673,0.47421875,0.52578125
E01013044,1954,964,990,0.49334698055271237,0.5066530194472876
E01013029,1472,712,760,0.483695652173913,0.5163043478260869
E01013030,1402,695,707,0.4957203994293866,0.5042796005706134
E01013031,1389,676,713,0.4866810655147588,0.5133189344852411
E01013032,1412,696,716,0.49291784702549574,0.5070821529745042
E01013035,1470,733,737,0.49863945578231295,0.501360544217687
E01012954,1440,684,756,0.475,0.525
E01012956,1165,569,596,0.488412017167382,0.511587982832618
E01012958,1012,487,525,0.48122529644268774,0.5187747035573123
E01012961,2206,1066,1140,0.48322756119673616,0.5167724388032638
E01012966,1236,587,649,0.4749190938511327,0.5250809061488673
E01012953,1316,661,655,0.5022796352583586,0.49772036474164133
E01012955,1605,799,806,0.49781931464174456,0.5021806853582554
E01012959,1467,717,750,0.4887525562372188,0.5112474437627812
E01012962,1167,528,639,0.4524421593830334,0.5475578406169666
E01012964,1720,864,856,0.5023255813953489,0.49767441860465117
E01012967,1555,751,804,0.4829581993569132,0.5170418006430868
E01012968,1607,766,841,0.47666459240821407,0.523335407591786
E01012969,1083,540,543,0.4986149584487535,0.5013850415512465
E01034756,2494,1203,1291,0.48235765838011224,0.5176423416198878
E01012957,1364,640,724,0.46920821114369504,0.530791788856305
E01012960,1629,769,860,0.47206875383670965,0.5279312461632903
E01012963,1422,692,730,0.4866385372714487,0.5133614627285513
E01013112,1380,669,711,0.48478260869565215,0.5152173913043478
E01013018,1917,931,986,0.4856546687532603,0.5143453312467396
E01013019,1962,1398,564,0.7125382262996942,0.2874617737003058
E01013021,1422,701,721,0.4929676511954993,0.5070323488045007
E01013025,1358,665,693,0.4896907216494845,0.5103092783505154
E01013026,1664,837,827,0.5030048076923077,0.4969951923076923
E01013105,1423,675,748,0.47434996486296555,0.5256500351370345
E01013110,1512,692,820,0.4576719576719577,0.5423280423280423
E01013111,1384,717,667,0.5180635838150289,0.4819364161849711
E01013115,1393,681,712,0.48887293610911703,0.511127063890883
E01013117,1479,732,747,0.4949290060851927,0.5050709939148073
E01013108,1620,798,822,0.4925925925925926,0.5074074074074074
E01013113,1442,672,770,0.46601941747572817,0.5339805825242718
E01013114,1483,732,751,0.4935940660822657,0.5064059339177344
E01013116,1859,915,944,0.492200107584723,0.507799892415277
E01013118,1470,736,734,0.5006802721088436,0.4993197278911565
E01013094,1407,694,713,0.49324804548685147,0.5067519545131486
E01013095,1484,698,786,0.47035040431266845,0.5296495956873315
E01013096,1810,880,930,0.4861878453038674,0.5138121546961326
E01013097,1256,634,622,0.5047770700636943,0.49522292993630573
E01013102,1392,668,724,0.47988505747126436,0.5201149425287356
E01013028,1585,789,796,0.49779179810725555,0.5022082018927445
E01013078,1435,708,727,0.49337979094076656,0.5066202090592334
E01013081,1514,750,764,0.4953764861294584,0.5046235138705416
E01013082,1626,822,804,0.5055350553505535,0.4944649446494465
E01013085,1713,869,844,0.5072971395213076,0.49270286047869233
E01012970,1814,896,918,0.49393605292171994,0.5060639470782801
E01012972,1564,726,838,0.4641943734015345,0.5358056265984654
E01012974,1556,743,813,0.47750642673521854,0.5224935732647815
E01013092,2669,1319,1350,0.4941925814911952,0.5058074185088048
E01033495,1516,748,768,0.49340369393139843,0.5065963060686016
E01033496,1569,783,786,0.49904397705544934,0.5009560229445507
E01034757,1212,603,609,0.4975247524752475,0.5024752475247525
E01034758,1621,828,793,0.5107958050586058,0.4892041949413942
E01013033,1549,762,787,0.4919302775984506,0.5080697224015494
E01013098,2208,1097,1111,0.49682971014492755,0.5031702898550725
E01013099,1428,679,749,0.47549019607843135,0.5245098039215687
E01013100,1642,811,831,0.4939098660170524,0.5060901339829477
E01013101,1607,787,820,0.4897324206596142,0.5102675793403858
E01013008,1388,677,711,0.4877521613832853,0.5122478386167147
E01013009,1556,767,789,0.4929305912596401,0.5070694087403599
E01013013,1437,698,739,0.4857341684064022,0.5142658315935977
E01013014,1395,704,691,0.5046594982078854,0.4953405017921147
E01013107,2175,1030,1145,0.4735632183908046,0.5264367816091954
E01013088,1837,909,928,0.49482852476864453,0.5051714752313554
E01013089,1669,799,870,0.4787297783103655,0.5212702216896345
E01013090,1453,713,740,0.4907088781830695,0.5092911218169305
E01013091,1510,751,759,0.49735099337748345,0.5026490066225165
E01013093,1609,786,823,0.4885021752641392,0.5114978247358608
E01013005,1966,943,1023,0.47965412004069174,0.5203458799593083
E01013007,1484,714,770,0.4811320754716981,0.5188679245283019
E01013011,1519,711,808,0.46807109940750496,0.5319289005924951
E01013012,1792,846,946,0.4720982142857143,0.5279017857142857
E01012996,1748,842,906,0.4816933638443936,0.5183066361556065
E01012998,2293,1133,1160,0.49411251635412123,0.5058874836458788
E01013015,1755,890,865,0.5071225071225072,0.4928774928774929
E01013016,1786,912,874,0.5106382978723404,0.48936170212765956
E01013003,1437,692,745,0.4815588030619346,0.5184411969380655
E01013017,1833,925,908,0.5046372067648663,0.49536279323513366
E01013020,1868,919,949,0.4919700214132762,0.5080299785867237
E01013076,1517,764,753,0.5036255767963085,0.4963744232036915
E01013079,1583,787,796,0.49715729627289956,0.5028427037271005
E01013080,1361,661,700,0.4856722997795738,0.5143277002204262
E01013083,1400,712,688,0.5085714285714286,0.49142857142857144
E01013084,1303,612,691,0.4696853415195702,0.5303146584804298
E01013086,1467,719,748,0.49011588275391954,0.5098841172460804
E01013087,1347,687,660,0.5100222717149221,0.48997772828507796
E01012993,1473,705,768,0.4786150712830957,0.5213849287169042
E01012997,1927,959,968,0.49766476388168135,0.5023352361183187
E01012999,1685,847,838,0.5026706231454006,0.4973293768545994
E01013001,1797,885,912,0.49248747913188645,0.5075125208681135
E01013074,1603,804,799,0.5015595757953837,0.4984404242046163
E01012994,1860,884,976,0.4752688172043011,0.524731182795699
E01012995,1922,913,1009,0.4750260145681582,0.5249739854318418
E01013000,2192,1199,993,0.5469890510948905,0.4530109489051095
E01013002,1831,904,927,0.4937192790824686,0.5062807209175314
E01013004,1787,894,893,0.5002797985450476,0.49972020145495244
E01013072,1684,833,851,0.49465558194774345,0.5053444180522565
E01013073,1801,904,897,0.5019433647973348,0.4980566352026652
E01013075,1338,661,677,0.4940209267563528,0.5059790732436472
E01013077,2066,981,1085,0.47483059051306875,0.5251694094869312
E01013006,1527,758,769,0.49639816633922723,0.5036018336607727
E01013010,1423,703,720,0.49402670414617006,0.5059732958538299
E01013103,1336,635,701,0.4752994011976048,0.5247005988023952
E01013104,1162,562,600,0.4836488812392427,0.5163511187607573
E01013106,1185,578,607,0.4877637130801688,0.5122362869198313
E01032596,1403,690,713,0.4918032786885246,0.5081967213114754
E01012975,1567,758,809,0.4837268666241225,0.5162731333758774
E01012984,1840,923,917,0.5016304347826087,0.4983695652173913
E01012985,1712,818,894,0.477803738317757,0.522196261682243
E01034759,1553,749,804,0.4822923374114617,0.5177076625885383
E01034760,1436,706,730,0.49164345403899723,0.5083565459610028
E01012976,1308,625,683,0.47782874617737003,0.52217125382263
E01012979,1734,830,904,0.4786620530565167,0.5213379469434832
E01012980,1651,755,896,0.4572986069049061,0.5427013930950939
E01012982,1516,742,774,0.4894459102902375,0.5105540897097626
E01013174,1521,734,787,0.482577251808021,0.517422748191979
E01013175,1775,900,875,0.5070422535211268,0.49295774647887325
E01013176,1371,689,682,0.5025528811086798,0.4974471188913202
E01013177,1394,703,691,0.5043041606886657,0.49569583931133426
E01013178,1348,669,679,0.49629080118694363,0.5037091988130564
E01013179,1565,756,809,0.4830670926517572,0.5169329073482428
E01013180,1385,693,692,0.5003610108303249,0.4996389891696751
E01013136,1245,612,633,0.491566265060241,0.5084337349397591
E01013142,1658,853,805,0.514475271411339,0.485524728588661
E01035473,2131,1059,1072,0.4969497888315345,0.5030502111684655
E01013218,1294,672,622,0.5193199381761978,0.4806800618238022
E01013219,1467,698,769,0.4758009543285617,0.5241990456714383
E01013220,1571,738,833,0.4697644812221515,0.5302355187778485
E01013221,1679,877,802,0.5223347230494342,0.4776652769505658
E01013222,1532,746,786,0.4869451697127937,0.5130548302872062
E01013144,1418,693,725,0.48871650211565587,0.5112834978843441
E01013145,1196,596,600,0.4983277591973244,0.5016722408026756
E01013146,1676,840,836,0.5011933174224343,0.4988066825775656
E01013148,1309,661,648,0.5049656226126814,0.4950343773873186
E01013195,1352,666,686,0.492603550295858,0.507396449704142
E01013196,1268,609,659,0.4802839116719243,0.5197160883280757
E01013201,1532,754,778,0.49216710182767626,0.5078328981723238
E01013202,1468,711,757,0.4843324250681199,0.5156675749318801
E01013203,1535,763,772,0.4970684039087948,0.5029315960912052
E01013138,1320,659,661,0.49924242424242427,0.5007575757575757
E01013140,1426,731,695,0.5126227208976157,0.48737727910238426
E01013141,1519,727,792,0.47860434496379195,0.521395655036208
E01013143,1369,674,695,0.49233016800584367,0.5076698319941563
E01013173,1323,638,685,0.48223733938019653,0.5177626606198035
E01013224,2008,1025,983,0.5104581673306773,0.4895418326693227
E01013226,1428,717,711,0.5021008403361344,0.49789915966386555
E01035474,1484,737,747,0.49663072776280326,0.5033692722371967
E01035475,1714,832,882,0.485414235705951,0.514585764294049
E01013187,1316,671,645,0.5098784194528876,0.49012158054711247
E01013188,1560,763,797,0.4891025641025641,0.5108974358974359
E01013231,1534,737,797,0.4804432855280313,0.5195567144719687
E01013233,1348,640,708,0.47477744807121663,0.5252225519287834
E01013147,1363,650,713,0.4768892149669846,0.5231107850330154
E01013234,1351,628,723,0.46484085862324204,0.5351591413767579
E01033414,2819,1361,1458,0.4827953174884711,0.517204682511529
E01013159,1499,728,771,0.485657104736491,0.514342895263509
E01013161,1304,672,632,0.5153374233128835,0.48466257668711654
E01013162,1514,774,740,0.5112285336856011,0.48877146631439894
E01013165,1290,672,618,0.5209302325581395,0.4790697674418605
E01013158,1356,663,693,0.4889380530973451,0.5110619469026548
E01013160,1370,686,684,0.5007299270072992,0.4992700729927007
E01013163,1265,639,626,0.5051383399209486,0.49486166007905136
E01013164,1868,906,962,0.48501070663811563,0.5149892933618844
E01013197,1208,586,622,0.48509933774834435,0.5149006622516556
E01013149,1091,529,562,0.4848762603116407,0.5151237396883593
E01013150,1225,598,627,0.4881632653061225,0.5118367346938776
E01013227,1511,744,767,0.4923891462607545,0.5076108537392455
E01013228,1489,732,757,0.4916051040967092,0.5083948959032908
E01013229,1577,762,815,0.48319594166138236,0.5168040583386176
E01013131,1498,711,787,0.47463284379172227,0.5253671562082777
E01013132,1430,713,717,0.4986013986013986,0.5013986013986014
E01013133,1431,666,765,0.46540880503144655,0.5345911949685535
E01013134,1399,674,725,0.48177269478198714,0.5182273052180129
E01013206,1369,658,711,0.4806428049671293,0.5193571950328707
E01013207,1318,634,684,0.48103186646433993,0.5189681335356601
E01013211,1412,699,713,0.495042492917847,0.5049575070821529
E01013212,1353,696,657,0.5144124168514412,0.48558758314855877
E01013181,1483,722,761,0.4868509777478085,0.5131490222521915
E01013182,1447,702,745,0.4851416724257084,0.5148583275742916
E01013183,1486,745,741,0.5013458950201884,0.49865410497981155
E01013184,1483,763,720,0.5144976399190829,0.4855023600809171
E01013185,1473,712,761,0.48336727766463,0.5166327223353699
E01013186,1550,747,803,0.48193548387096774,0.5180645161290323
E01013130,1369,657,712,0.4799123447772096,0.5200876552227903
E01013135,1470,698,772,0.4748299319727891,0.5251700680272109
E01013154,1286,636,650,0.49455676516329705,0.505443234836703
E01013156,1283,593,690,0.4621979734996103,0.5378020265003897
E01013204,1386,664,722,0.4790764790764791,0.5209235209235209
E01013205,1382,670,712,0.48480463096960924,0.5151953690303908
E01013208,1393,634,759,0.45513280689160085,0.5448671931083992
E01013209,1433,691,742,0.48220516399162594,0.5177948360083741
E01013210,1380,659,721,0.47753623188405797,0.5224637681159421
E01013153,1237,607,630,0.49070331447049315,0.5092966855295069
E01013157,1713,838,875,0.4892002335084647,0.5107997664915354
E01013167,1750,852,898,0.4868571428571429,0.5131428571428571
E01035476,2462,1160,1302,0.471161657189277,0.528838342810723
E01013189,1584,742,842,0.4684343434343434,0.5315656565656566
E01013191,1500,723,777,0.482,0.518
E01013192,1452,722,730,0.4972451790633609,0.5027548209366391
E01013194,1400,666,734,0.4757142857142857,0.5242857142857142
E01035477,1858,900,958,0.48439181916038754,0.5156081808396125
E01035478,2037,986,1051,0.4840451644575356,0.5159548355424645
E01013170,1438,700,738,0.48678720445062584,0.5132127955493742
E01013171,1836,925,911,0.5038126361655774,0.49618736383442263
E01013172,1467,703,764,0.47920927062031354,0.5207907293796864
E01013193,1508,716,792,0.47480106100795755,0.5251989389920424
E01035479,1313,638,675,0.4859101294744859,0.5140898705255141
E01035480,1641,805,836,0.49055453991468617,0.5094454600853139
E01013213,1137,529,608,0.465259454705365,0.534740545294635
E01013214,1428,681,747,0.47689075630252103,0.523109243697479
E01013215,1670,791,879,0.47365269461077847,0.5263473053892216
E01013216,1199,591,608,0.49291075896580483,0.5070892410341952
E01013217,1375,674,701,0.49018181818181816,0.5098181818181818
E01013225,1159,576,583,0.4969801553062985,0.5030198446937014
E01013128,1281,625,656,0.4879000780640125,0.5120999219359875
E01013129,1352,673,679,0.4977810650887574,0.5022189349112426
E01013151,1170,576,594,0.49230769230769234,0.5076923076923077
E01013152,1463,714,749,0.4880382775119617,0.5119617224880383
E01013155,1270,606,664,0.47716535433070867,0.5228346456692914
E01013198,1383,689,694,0.4981923355025307,0.5018076644974693
E01013199,1030,525,505,0.5097087378640777,0.49029126213592233
E01013200,1195,566,629,0.47364016736401676,0.5263598326359833
E01013254,1750,846,904,0.48342857142857143,0.5165714285714286
E01013255,2065,1043,1022,0.5050847457627119,0.49491525423728816
E01013256,2497,1240,1257,0.49659591509811774,0.5034040849018823
E01013257,1866,918,948,0.4919614147909968,0.5080385852090032
E01013258,1713,861,852,0.5026269702276708,0.4973730297723292
E01013259,2030,983,1047,0.48423645320197045,0.5157635467980296
E01013303,1342,664,678,0.4947839046199702,0.5052160953800298
E01013304,1594,793,801,0.4974905897114178,0.5025094102885822
E01013305,1630,804,826,0.49325153374233127,0.5067484662576687
E01013307,1797,882,915,0.49081803005008345,0.5091819699499165
E01013288,1500,723,777,0.482,0.518
E01013291,1569,732,837,0.4665391969407266,0.5334608030592735
E01013292,1695,834,861,0.4920353982300885,0.5079646017699115
E01013294,1589,773,816,0.48646947765890497,0.513530522341095
E01013270,2035,997,1038,0.48992628992628995,0.51007371007371
E01013306,1610,817,793,0.5074534161490684,0.4925465838509317
E01013308,1837,905,932,0.492651061513337,0.5073489384866631
E01013309,1622,780,842,0.4808877928483354,0.5191122071516646
E01013286,2249,1030,1219,0.45798132503334815,0.5420186749666518
E01013287,1469,713,756,0.4853641933287951,0.5146358066712049
E01013289,1591,784,807,0.4927718416090509,0.507228158390949
E01013290,1698,852,846,0.5017667844522968,0.49823321554770317
E01013293,1470,711,759,0.48367346938775513,0.5163265306122449
E01013245,1446,712,734,0.49239280774550487,0.5076071922544951
E01013246,1535,800,735,0.5211726384364821,0.4788273615635179
E01013247,1691,826,865,0.488468361916026,0.511531638083974
E01013248,1778,882,896,0.49606299212598426,0.5039370078740157
E01013249,1802,872,930,0.4839067702552719,0.516093229744728
E01013297,2557,1295,1262,0.5064528744622605,0.49354712553773955
E01013300,1765,958,807,0.5427762039660057,0.4572237960339943
E01013302,1585,798,787,0.5034700315457413,0.4965299684542587
E01013331,1585,828,757,0.522397476340694,0.477602523659306
E01013296,1842,1004,838,0.5450597176981542,0.4549402823018458
E01013298,1780,886,894,0.49775280898876406,0.5022471910112359
E01013299,1604,783,821,0.48815461346633415,0.5118453865336658
E01013330,1896,1046,850,0.5516877637130801,0.44831223628691985
E01013332,1870,995,875,0.5320855614973262,0.4679144385026738
E01013295,1377,662,715,0.4807552650689906,0.5192447349310094
E01013301,1613,804,809,0.49845009299442034,0.5015499070055797
E01013333,1651,849,802,0.5142337976983646,0.48576620230163536
E01013334,1649,832,817,0.5045482110369921,0.4954517889630079
E01013310,1479,716,763,0.4841108857336038,0.5158891142663962
E01013312,1905,921,984,0.48346456692913387,0.5165354330708661
E01013313,1513,759,754,0.5016523463317911,0.4983476536682089
E01013314,1540,807,733,0.5240259740259741,0.475974025974026
E01013267,1218,589,629,0.48357963875205257,0.5164203612479474
E01013268,1207,587,620,0.4863297431648716,0.5136702568351285
E01013269,1773,873,900,0.49238578680203043,0.5076142131979695
E01013271,1999,972,1027,0.48624312156078037,0.5137568784392196
E01013272,1702,843,859,0.49529964747356053,0.5047003525264395
E01013273,1689,816,873,0.48312611012433393,0.5168738898756661
E01013279,1536,729,807,0.474609375,0.525390625
E01013285,1191,594,597,0.4987405541561713,0.5012594458438288
E01013316,1433,705,728,0.4919748778785764,0.5080251221214236
E01013321,1634,800,834,0.48959608323133413,0.5104039167686658
E01013274,1943,988,955,0.5084920226453937,0.4915079773546063
E01013275,1474,734,740,0.49796472184531887,0.5020352781546812
E01013276,1596,750,846,0.4699248120300752,0.5300751879699248
E01013277,1427,694,733,0.4863349684653118,0.5136650315346881
E01013315,1494,718,776,0.48058902275769744,0.5194109772423026
E01013317,1375,638,737,0.464,0.536
E01013318,1440,713,727,0.4951388888888889,0.5048611111111111
E01013319,2090,1029,1061,0.49234449760765553,0.5076555023923445
E01013238,1657,816,841,0.4924562462281231,0.5075437537718769
E01013311,1839,908,931,0.4937466014138119,0.5062533985861881
E01013320,1295,643,652,0.4965250965250965,0.5034749034749034
E01035481,1382,675,707,0.48842257597684513,0.5115774240231549
E01035482,1239,606,633,0.4891041162227603,0.5108958837772397
E01035483,1413,684,729,0.4840764331210191,0.5159235668789809
E01013278,1617,788,829,0.4873222016079159,0.5126777983920842
E01013280,1452,697,755,0.4800275482093664,0.5199724517906336
E01013281,1433,681,752,0.47522679692951847,0.5247732030704815
E01013283,1495,738,757,0.4936454849498328,0.5063545150501673
E01013236,1579,754,825,0.47751741608613046,0.5224825839138696
E01013239,1451,722,729,0.49758787043418334,0.5024121295658167
E01013282,1593,775,818,0.48650345260514755,0.5134965473948525
E01013284,1524,758,766,0.4973753280839895,0.5026246719160105
E01013237,1766,852,914,0.4824462061155153,0.5175537938844847
E01013261,1397,682,715,0.4881889763779528,0.5118110236220472
E01013262,1284,633,651,0.4929906542056075,0.5070093457943925
E01013263,1382,654,728,0.4732272069464544,0.5267727930535456
E01033296,1386,680,706,0.4906204906204906,0.5093795093795094
E01033297,1740,849,891,0.4879310344827586,0.5120689655172413
E01013260,1398,699,699,0.5,0.5
E01013264,1837,894,943,0.48666303756124113,0.5133369624387588
E01013265,1576,771,805,0.48921319796954316,0.5107868020304569
E01013266,1810,889,921,0.49116022099447515,0.5088397790055249
E01013241,1472,709,763,0.48165760869565216,0.5183423913043478
E01013242,1842,921,921,0.5,0.5
E01013243,2247,1076,1171,0.4788607031597686,0.5211392968402314
E01013244,1932,935,997,0.4839544513457557,0.5160455486542443
E01013324,1442,742,700,0.5145631067961165,0.4854368932038835
E01013326,1565,792,773,0.5060702875399361,0.4939297124600639
E01013327,1370,647,723,0.47226277372262776,0.5277372262773723
E01013328,1255,621,634,0.49482071713147413,0.5051792828685259
E01013322,2139,1020,1119,0.47685834502103785,0.5231416549789621
E01013323,1562,791,771,0.5064020486555698,0.49359795134443024
E01013325,1480,726,754,0.4905405405405405,0.5094594594594595
E01013329,1859,911,948,0.4900484131253362,0.5099515868746638
E01013250,1702,825,877,0.48472385428907167,0.5152761457109283
E01013251,1798,875,923,0.4866518353726363,0.5133481646273638
E01013252,1630,804,826,0.49325153374233127,0.5067484662576687
E01013253,1941,975,966,0.5023183925811437,0.49768160741885625
E01013436,1713,853,860,0.4979568009340339,0.5020431990659662
E01013438,2004,945,1059,0.47155688622754494,0.5284431137724551
E01013439,1399,694,705,0.4960686204431737,0.5039313795568263
E01013440,1830,894,936,0.4885245901639344,0.5114754098360655
E01013370,1485,678,807,0.45656565656565656,0.5434343434343434
E01013373,1523,720,803,0.4727511490479317,0.5272488509520683
E01013375,1250,588,662,0.4704,0.5296
E01013376,1435,697,738,0.4857142857142857,0.5142857142857142
E01013371,1421,697,724,0.4904996481351161,0.5095003518648838
E01013372,1556,698,858,0.448586118251928,0.5514138817480719
E01013374,1512,728,784,0.48148148148148145,0.5185185185185185
E01013377,1592,744,848,0.46733668341708545,0.5326633165829145
E01013404,1723,793,930,0.4602437608821822,0.5397562391178178
E01013407,1439,652,787,0.453092425295344,0.546907574704656
E01013408,1246,579,667,0.46468699839486355,0.5353130016051364
E01013410,1350,630,720,0.4666666666666667,0.5333333333333333
E01013405,1363,652,711,0.4783565663976522,0.5216434336023478
E01013406,2022,979,1043,0.48417408506429277,0.5158259149357072
E01013409,1835,876,959,0.4773841961852861,0.5226158038147138
E01013411,1437,684,753,0.4759916492693111,0.524008350730689
E01013428,1732,828,904,0.4780600461893764,0.5219399538106235
E01013429,1954,980,974,0.5015353121801432,0.4984646878198567
E01013430,1671,805,866,0.4817474566128067,0.5182525433871933
E01013431,2161,1100,1061,0.5090236001850995,0.4909763998149005
E01013435,1443,686,757,0.4753984753984754,0.5246015246015246
E01013344,1376,693,683,0.5036337209302325,0.49636627906976744
E01013346,1649,812,837,0.49241964827167983,0.5075803517283202
E01013432,1985,970,1015,0.48866498740554154,0.5113350125944585
E01013433,1373,645,728,0.4697742170429716,0.5302257829570284
E01013434,1493,725,768,0.4855994641661085,0.5144005358338914
E01013379,1402,674,728,0.48074179743223966,0.5192582025677603
E01013380,1672,789,883,0.47188995215311,0.52811004784689
E01013385,1391,708,683,0.5089863407620417,0.4910136592379583
E01013387,1549,717,832,0.46287927695287284,0.5371207230471272
E01013388,1009,472,537,0.46778989098116946,0.5322101090188305
E01013389,1164,555,609,0.47680412371134023,0.5231958762886598
E01013437,1384,733,651,0.5296242774566474,0.4703757225433526
E01013343,1775,788,987,0.443943661971831,0.556056338028169
E01013345,1680,785,895,0.46726190476190477,0.5327380952380952
E01013347,1615,781,834,0.48359133126934983,0.5164086687306502
E01013349,1394,667,727,0.4784791965566714,0.5215208034433285
E01013350,1618,786,832,0.4857849196538937,0.5142150803461063
E01013348,1759,787,972,0.44741330301307564,0.5525866969869244
E01013368,2136,1005,1131,0.4705056179775281,0.5294943820224719
E01013382,1623,770,853,0.47443006777572394,0.5255699322242761
E01013383,2821,1346,1475,0.4771357674583481,0.5228642325416519
E01013386,1769,843,926,0.4765404183154324,0.5234595816845675
E01013421,1578,714,864,0.4524714828897338,0.5475285171102662
E01013422,1721,814,907,0.47298082510168504,0.527019174898315
E01013426,1724,807,917,0.4680974477958237,0.5319025522041764
E01013427,1419,683,736,0.4813248766737139,0.5186751233262861
E01013335,1626,803,823,0.49384993849938497,0.506150061500615
E01013336,1519,764,755,0.5029624753127058,0.4970375246872943
E01013337,1653,810,843,0.4900181488203267,0.5099818511796733
E01013338,2321,1130,1191,0.4868591124515295,0.5131408875484705
E01013339,1541,750,791,0.48669695003244645,0.5133030499675535
E01013392,1631,818,813,0.5015328019619865,0.4984671980380135
E01013366,1751,907,844,0.5179897201599086,0.48201027984009137
E01013369,1703,846,857,0.4967704051673517,0.5032295948326483
E01013416,1481,720,761,0.4861580013504389,0.5138419986495611
E01033067,1602,787,815,0.4912609238451935,0.5087390761548065
E01033068,1106,594,512,0.5370705244122965,0.4629294755877034
E01033069,1035,531,504,0.5130434782608696,0.48695652173913045
E01033070,2668,1194,1474,0.44752623688155924,0.5524737631184408
E01013381,1642,827,815,0.5036540803897686,0.49634591961023145
E01013402,1724,836,888,0.48491879350348027,0.5150812064965197
E01013419,2718,1278,1440,0.47019867549668876,0.5298013245033113
E01013420,2024,965,1059,0.47677865612648224,0.5232213438735178
E01013384,1646,785,861,0.47691373025516404,0.523086269744836
E01013398,1577,764,813,0.4844641724793913,0.5155358275206088
E01013399,1752,831,921,0.4743150684931507,0.5256849315068494
E01013400,1710,797,913,0.46608187134502926,0.5339181286549708
E01013401,1605,782,823,0.48722741433021804,0.5127725856697819
E01013403,1895,874,1021,0.46121372031662267,0.5387862796833773
E01013393,1486,713,773,0.4798115746971736,0.5201884253028264
E01013394,1427,686,741,0.48072880168185006,0.5192711983181499
E01013395,1415,693,722,0.48975265017667846,0.5102473498233215
E01013396,1540,728,812,0.4727272727272727,0.5272727272727272
E01013441,1494,732,762,0.4899598393574297,0.5100401606425703
E01013445,1569,743,826,0.4735500318674315,0.5264499681325685
E01013390,1466,719,747,0.49045020463847205,0.509549795361528
E01013391,1958,973,985,0.4969356486210419,0.5030643513789581
E01013397,1488,732,756,0.49193548387096775,0.5080645161290323
E01013413,1600,781,819,0.488125,0.511875
E01013417,1791,878,913,0.49022892238972643,0.5097710776102736
E01013442,1485,712,773,0.4794612794612795,0.5205387205387205
E01013443,1639,759,880,0.46308724832214765,0.5369127516778524
E01013444,1520,717,803,0.47171052631578947,0.5282894736842105
E01013446,1670,828,842,0.49580838323353293,0.5041916167664671
E01013447,1531,743,788,0.4853037230568256,0.5146962769431744
E01013448,1435,702,733,0.489198606271777,0.510801393728223
E01013360,1795,868,927,0.48356545961002784,0.5164345403899722
E01013361,1691,819,872,0.48432879952690716,0.5156712004730929
E01013362,1928,1078,850,0.5591286307053942,0.4408713692946058
E01013363,3000,1301,1699,0.43366666666666664,0.5663333333333334
E01013364,1870,904,966,0.4834224598930481,0.5165775401069519
E01013418,1490,730,760,0.4899328859060403,0.5100671140939598
E01013351,1924,915,1009,0.47557172557172556,0.5244282744282744
E01013352,1734,831,903,0.47923875432525953,0.5207612456747405
E01013451,1270,616,654,0.48503937007874015,0.5149606299212598
E01013452,1650,770,880,0.4666666666666667,0.5333333333333333
E01013357,2338,1120,1218,0.47904191616766467,0.5209580838323353
E01013358,1516,743,773,0.4901055408970976,0.5098944591029023
E01013412,2154,1021,1133,0.4740018570102136,0.5259981429897864
E01013414,1748,855,893,0.4891304347826087,0.5108695652173914
E01013353,1574,780,794,0.49555273189326554,0.5044472681067345
E01013354,1316,643,673,0.4886018237082067,0.5113981762917933
E01013355,1801,871,930,0.4836202109938923,0.5163797890061077
E01013356,1356,659,697,0.4859882005899705,0.5140117994100295
E01013359,1589,771,818,0.4852108244178729,0.5147891755821271
E01013449,1634,781,853,0.47796817625459,0.52203182374541
E01013378,6219,2822,3397,0.45377070268531916,0.5462292973146808
E01013450,1237,628,609,0.50767987065481,0.49232012934519
E01034761,1698,824,874,0.48527679623085984,0.5147232037691402
E01034762,1386,668,718,0.481962481962482,0.5180375180375181
E01013340,1321,650,671,0.49205147615442846,0.5079485238455715
E01013341,1326,605,721,0.45625942684766213,0.5437405731523378
E01013342,1489,727,762,0.4882471457353929,0.5117528542646071
E01013423,1311,656,655,0.5003813882532419,0.4996186117467582
E01013424,1297,641,656,0.49421742482652276,0.5057825751734772
E01013425,1539,746,793,0.48473034437946716,0.5152696556205328
E01027558,1906,928,978,0.48688352570828963,0.5131164742917104
E01027559,1701,840,861,0.49382716049382713,0.5061728395061729
E01027569,1363,685,678,0.5025678650036683,0.4974321349963316
E01027570,2454,1188,1266,0.4841075794621027,0.5158924205378973
E01027568,2252,1114,1138,0.4946714031971581,0.5053285968028419
E01027571,1868,927,941,0.49625267665952894,0.5037473233404711
E01027572,2055,1004,1051,0.48856447688564475,0.5114355231143553
E01027573,1702,802,900,0.4712103407755582,0.5287896592244419
E01027574,1719,846,873,0.49214659685863876,0.5078534031413613
E01027575,1850,914,936,0.49405405405405406,0.505945945945946
E01027577,1934,945,989,0.4886246122026887,0.5113753877973113
E01027579,1172,572,600,0.4880546075085324,0.5119453924914675
E01027578,1446,696,750,0.48132780082987553,0.5186721991701245
E01027580,1101,523,578,0.4750227066303361,0.5249772933696639
E01027582,1632,797,835,0.4883578431372549,0.5116421568627451
E01034956,1444,714,730,0.49445983379501385,0.5055401662049861
E01034957,1288,650,638,0.5046583850931677,0.4953416149068323
E01027556,1980,960,1020,0.48484848484848486,0.5151515151515151
E01027560,2458,1225,1233,0.4983726606997559,0.5016273393002441
E01027563,1455,659,796,0.4529209621993127,0.5470790378006873
E01027586,1954,937,1017,0.4795291709314227,0.5204708290685772
E01027555,1908,895,1013,0.4690775681341719,0.5309224318658281
E01027564,1216,580,636,0.4769736842105263,0.5230263157894737
E01027565,1578,746,832,0.47275031685678076,0.5272496831432193
E01027566,1383,674,709,0.48734634851771513,0.5126536514822849
E01027583,2022,964,1058,0.47675568743818003,0.52324431256182
E01027584,1922,909,1013,0.47294484911550466,0.5270551508844953
E01027557,1573,783,790,0.49777495232040686,0.5022250476795931
E01027561,1915,925,990,0.4830287206266319,0.5169712793733682
E01027562,1538,767,771,0.4986996098829649,0.5013003901170351
E01027567,1529,725,804,0.47416612164813604,0.525833878351864
E01027576,1801,866,935,0.4808439755691283,0.5191560244308717
E01027585,1804,857,947,0.4750554323725055,0.5249445676274944
E01027591,1629,804,825,0.49355432780847147,0.5064456721915286
E01027597,1528,756,772,0.49476439790575916,0.5052356020942408
E01027599,1618,763,855,0.4715698393077874,0.5284301606922126
E01027623,1177,562,615,0.47748513169073914,0.5225148683092609
E01027625,1726,840,886,0.48667439165701043,0.5133256083429896
E01027598,1671,800,871,0.47875523638539796,0.521244763614602
E01027618,2366,1151,1215,0.48647506339814034,0.5135249366018597
E01027624,1231,590,641,0.479285134037368,0.5207148659626321
E01027626,1579,774,805,0.4901836605446485,0.5098163394553515
E01027627,1732,859,873,0.4959584295612009,0.504041570438799
E01027590,2454,1216,1238,0.49551752241238795,0.5044824775876121
E01027592,1704,850,854,0.4988262910798122,0.5011737089201878
E01027613,1721,855,866,0.49680418361417783,0.5031958163858222
E01027617,1038,513,525,0.49421965317919075,0.5057803468208093
E01027603,2053,1029,1024,0.5012177301509986,0.4987822698490015
E01027604,1865,875,990,0.4691689008042895,0.5308310991957105
E01027607,1147,548,599,0.4777680906713165,0.5222319093286836
E01027614,1212,576,636,0.4752475247524752,0.5247524752475248
E01027615,1160,562,598,0.4844827586206897,0.5155172413793103
E01027587,1328,643,685,0.48418674698795183,0.5158132530120482
E01027588,1712,829,883,0.4842289719626168,0.5157710280373832
E01027589,2007,973,1034,0.48480318883906326,0.5151968111609367
E01027593,1711,831,880,0.4856808883693746,0.5143191116306254
E01027628,1826,902,924,0.4939759036144578,0.5060240963855421
E01027633,1804,893,911,0.4950110864745011,0.5049889135254989
E01034958,2699,1535,1164,0.5687291589477584,0.43127084105224156
E01027620,1905,904,1001,0.47454068241469816,0.5254593175853018
E01027630,1788,891,897,0.4983221476510067,0.5016778523489933
E01027631,1364,664,700,0.4868035190615836,0.5131964809384164
E01027632,1743,833,910,0.4779116465863454,0.5220883534136547
E01027637,1827,874,953,0.4783798576902025,0.5216201423097975
E01027629,1483,707,776,0.47673634524612274,0.5232636547538773
E01027635,2682,1399,1283,0.5216256524981358,0.4783743475018643
E01027636,1964,945,1019,0.48116089613034624,0.5188391038696538
E01034959,1899,890,1009,0.46866771985255395,0.531332280147446
E01034960,1501,703,798,0.46835443037974683,0.5316455696202531
E01027594,1870,872,998,0.4663101604278075,0.5336898395721925
E01027595,1787,851,936,0.4762171236709569,0.5237828763290431
E01027596,1649,761,888,0.46149181322013344,0.5385081867798666
E01027601,2047,1006,1041,0.49145090376160233,0.5085490962383976
E01027622,1952,954,998,0.4887295081967213,0.5112704918032787
E01027600,1888,965,923,0.5111228813559322,0.4888771186440678
E01027619,2199,1077,1122,0.4897680763983629,0.5102319236016372
E01027634,2094,1031,1063,0.4923591212989494,0.5076408787010506
E01027606,1426,661,765,0.4635343618513324,0.5364656381486677
E01027609,1358,658,700,0.4845360824742268,0.5154639175257731
E01027610,1590,757,833,0.4761006289308176,0.5238993710691824
E01034961,1522,730,792,0.47963206307490147,0.5203679369250985
E01034962,1144,535,609,0.46765734265734266,0.5323426573426573
E01027605,1508,714,794,0.473474801061008,0.5265251989389921
E01027608,1699,823,876,0.48440258975868156,0.5155974102413184
E01027612,1641,801,840,0.48811700182815354,0.5118829981718465
E01027616,1454,694,760,0.47730398899587345,0.5226960110041265
E01027666,1789,866,923,0.4840693124650643,0.5159306875349358
E01027667,1463,740,723,0.50580997949419,0.49419002050580996
E01027685,1112,526,586,0.47302158273381295,0.5269784172661871
E01027686,1130,562,568,0.49734513274336284,0.5026548672566372
E01027712,1888,1078,810,0.5709745762711864,0.4290254237288136
E01027713,1610,785,825,0.48757763975155277,0.5124223602484472
E01027714,1591,769,822,0.4833438089252043,0.5166561910747958
E01027715,1165,583,582,0.5004291845493563,0.4995708154506438
E01027643,1512,730,782,0.4828042328042328,0.5171957671957672
E01027688,1610,788,822,0.4894409937888199,0.5105590062111801
E01027736,1671,799,872,0.4781567923399162,0.5218432076600837
E01027737,1703,857,846,0.5032295948326483,0.4967704051673517
E01027705,1771,863,908,0.4872953133822699,0.51270468661773
E01027706,1784,852,932,0.47757847533632286,0.5224215246636771
E01027707,1721,829,892,0.48169668797210924,0.5183033120278907
E01027708,1388,663,725,0.4776657060518732,0.5223342939481268
E01027709,1222,588,634,0.48117839607201307,0.5188216039279869
E01027710,1131,541,590,0.47833775419982316,0.5216622458001768
E01027711,1319,654,665,0.49583017437452614,0.5041698256254739
E01027644,1435,688,747,0.4794425087108014,0.5205574912891986
E01027645,1970,951,1019,0.482741116751269,0.5172588832487309
E01027647,1818,884,934,0.48624862486248627,0.5137513751375138
E01027687,1919,933,986,0.48619072433559146,0.5138092756644086
E01027681,1643,817,826,0.4972611077297626,0.5027388922702374
E01027693,1769,872,897,0.49293386093838326,0.5070661390616167
E01027701,1550,771,779,0.4974193548387097,0.5025806451612903
E01027702,1051,507,544,0.48239771646051377,0.5176022835394862
E01027642,1463,697,766,0.4764183185235817,0.5235816814764184
E01027646,1645,807,838,0.4905775075987842,0.5094224924012158
E01027674,1301,629,672,0.48347425057647964,0.5165257494235204
E01027675,2983,1439,1544,0.48240026818638954,0.5175997318136104
E01027641,1232,601,631,0.4878246753246753,0.5121753246753247
E01027665,1314,636,678,0.4840182648401826,0.5159817351598174
E01027722,1484,713,771,0.4804582210242588,0.5195417789757413
E01034963,1307,622,685,0.47589900535577656,0.5241009946442234
E01034964,2689,1854,835,0.6894756415024172,0.31052435849758275
E01027668,1555,711,844,0.4572347266881029,0.5427652733118971
E01027669,1923,909,1014,0.47269890795631825,0.5273010920436817
E01027673,1727,820,907,0.4748118123914302,0.5251881876085698
E01027676,1788,876,912,0.4899328859060403,0.5100671140939598
E01027638,1305,633,672,0.4850574712643678,0.5149425287356322
E01027639,1218,605,613,0.4967159277504105,0.5032840722495895
E01027640,1455,696,759,0.47835051546391755,0.5216494845360825
E01027690,1377,660,717,0.4793028322440087,0.5206971677559913
E01027738,1255,613,642,0.48844621513944225,0.5115537848605578
E01027739,1037,501,536,0.4831243972999036,0.5168756027000965
E01027741,1384,675,709,0.4877167630057804,0.5122832369942196
E01027689,1364,658,706,0.48240469208211145,0.5175953079178885
E01027691,1527,737,790,0.48264571054354943,0.5173542894564506
E01027720,1873,908,965,0.4847837693539776,0.5152162306460224
E01027721,1441,690,751,0.47883414295628035,0.5211658570437196
E01027723,1464,716,748,0.4890710382513661,0.5109289617486339
E01027670,1543,739,804,0.47893713545042127,0.5210628645495787
E01027671,1511,733,778,0.48510919920582396,0.514890800794176
E01027672,1615,789,826,0.4885448916408669,0.5114551083591331
E01027704,1222,603,619,0.49345335515548283,0.5065466448445172
E01027649,2145,1017,1128,0.47412587412587415,0.5258741258741259
E01027651,1463,707,756,0.48325358851674644,0.5167464114832536
E01027657,1196,607,589,0.5075250836120402,0.49247491638795987
E01027658,1519,746,773,0.4911125740618828,0.5088874259381172
E01027692,1141,554,587,0.4855390008764242,0.5144609991235758
E01027740,1523,743,780,0.48785292186474066,0.5121470781352594
E01027648,1511,745,766,0.4930509596293845,0.5069490403706155
E01027650,1588,777,811,0.4892947103274559,0.510705289672544
E01027726,1736,830,906,0.478110599078341,0.521889400921659
E01027727,1771,862,909,0.4867306606437041,0.5132693393562959
E01027728,1323,608,715,0.4595616024187453,0.5404383975812547
E01027729,1462,685,777,0.4685362517099863,0.5314637482900136
E01027652,1719,810,909,0.4712041884816754,0.5287958115183246
E01027655,1316,611,705,0.4642857142857143,0.5357142857142857
E01027659,1710,903,807,0.5280701754385965,0.47192982456140353
E01027677,1422,723,699,0.5084388185654009,0.49156118143459915
E01027678,1759,953,806,0.541785105173394,0.45821489482660605
E01027680,1286,628,658,0.48833592534992226,0.5116640746500778
E01027683,1788,891,897,0.4983221476510067,0.5016778523489933
E01027684,1431,723,708,0.5052410901467506,0.4947589098532495
E01027695,1717,858,859,0.49970879440885263,0.5002912055911474
E01027696,2419,1220,1199,0.5043406366267053,0.49565936337329475
E01027703,2014,962,1052,0.47765640516385305,0.522343594836147
E01027660,1480,719,761,0.4858108108108108,0.5141891891891892
E01027661,1417,675,742,0.4763585038814397,0.5236414961185604
E01027662,1222,584,638,0.4779050736497545,0.5220949263502455
E01027663,1355,659,696,0.4863468634686347,0.5136531365313654
E01027697,1455,720,735,0.4948453608247423,0.5051546391752577
E01027733,1362,642,720,0.4713656387665198,0.5286343612334802
E01027682,1649,812,837,0.49241964827167983,0.5075803517283202
E01027694,1178,576,602,0.48896434634974534,0.5110356536502547
E01027734,1708,825,883,0.48302107728337235,0.5169789227166276
E01027735,1596,787,809,0.4931077694235589,0.5068922305764411
E01027656,1695,821,874,0.48436578171091443,0.5156342182890855
E01027679,1511,688,823,0.4553275976174719,0.5446724023825281
E01027730,1490,743,747,0.4986577181208054,0.5013422818791946
E01027731,1453,663,790,0.45629731589814176,0.5437026841018582
E01027732,1225,575,650,0.46938775510204084,0.5306122448979592
E01027653,1737,804,933,0.46286701208981,0.5371329879101899
E01027654,1145,549,596,0.4794759825327511,0.5205240174672489
E01027698,1547,741,806,0.4789915966386555,0.5210084033613446
E01027716,1506,729,777,0.48406374501992033,0.5159362549800797
E01027717,1586,774,812,0.4880201765447667,0.5119798234552333
E01027718,2027,957,1070,0.4721262950172669,0.5278737049827331
E01027719,1509,739,770,0.4897282968853545,0.5102717031146454
E01027699,1319,648,671,0.49128127369219105,0.5087187263078089
E01027700,1568,763,805,0.48660714285714285,0.5133928571428571
E01027724,1682,802,880,0.4768133174791914,0.5231866825208086
E01027725,1542,733,809,0.47535667963683526,0.5246433203631647
E01027743,1175,580,595,0.49361702127659574,0.5063829787234042
E01027751,1287,631,656,0.4902874902874903,0.5097125097125097
E01027752,1189,586,603,0.4928511354079058,0.5071488645920942
E01027759,1407,698,709,0.496090973702914,0.503909026297086
E01027761,1105,523,582,0.47330316742081446,0.5266968325791855
E01027762,1336,664,672,0.49700598802395207,0.5029940119760479
E01027765,1603,742,861,0.462882096069869,0.537117903930131
E01027766,1174,542,632,0.4616695059625213,0.5383304940374787
E01027767,1450,673,777,0.46413793103448275,0.5358620689655172
E01027768,1121,531,590,0.47368421052631576,0.5263157894736842
E01027769,1230,600,630,0.4878048780487805,0.5121951219512195
E01027770,1499,729,770,0.48632421614409604,0.513675783855904
E01027745,1650,806,844,0.48848484848484847,0.5115151515151515
E01027746,1449,690,759,0.47619047619047616,0.5238095238095238
E01027747,1551,887,664,0.5718891038039974,0.42811089619600257
E01027748,1166,561,605,0.4811320754716981,0.5188679245283019
E01027749,1948,983,965,0.5046201232032854,0.4953798767967146
E01027771,2536,1843,693,0.7267350157728707,0.27326498422712936
E01027772,1289,643,646,0.49883630721489525,0.5011636927851048
E01033184,2007,1290,717,0.6427503736920778,0.3572496263079223
E01034965,2781,1462,1319,0.5257101761956131,0.4742898238043869
E01034966,1800,886,914,0.4922222222222222,0.5077777777777778
E01034967,1724,856,868,0.4965197215777262,0.5034802784222738
E01027742,1319,640,679,0.4852160727824109,0.514783927217589
E01027753,1220,641,579,0.5254098360655738,0.4745901639344262
E01027763,1054,508,546,0.4819734345351044,0.5180265654648957
E01027764,1076,528,548,0.49070631970260226,0.5092936802973977
E01027773,1078,545,533,0.5055658627087198,0.49443413729128016
E01027744,1259,616,643,0.4892772041302621,0.5107227958697379
E01027756,1811,876,935,0.48371065709552735,0.5162893429044727
E01027758,1499,799,700,0.5330220146764509,0.466977985323549
E01027760,1199,580,619,0.4837364470391993,0.5162635529608006
E01033185,1367,664,703,0.4857351865398683,0.5142648134601316
E01033186,1419,664,755,0.4679351656095842,0.5320648343904157
E01027776,1530,761,769,0.4973856209150327,0.5026143790849673
E01027777,1307,651,656,0.49808722264728383,0.5019127773527161
E01027783,1842,896,946,0.48642779587404994,0.5135722041259501
E01027784,1666,816,850,0.4897959183673469,0.5102040816326531
E01027792,2227,1038,1189,0.46609788953749437,0.5339021104625056
E01027793,1441,696,745,0.48299791811242193,0.5170020818875781
E01027794,1990,942,1048,0.4733668341708543,0.5266331658291458
E01027795,1599,749,850,0.46841776110068795,0.5315822388993121
E01027801,1742,825,917,0.473593570608496,0.5264064293915041
E01027802,1615,804,811,0.4978328173374613,0.5021671826625387
E01027775,1982,1022,960,0.515640766902119,0.4843592330978809
E01027780,2144,1035,1109,0.48274253731343286,0.5172574626865671
E01027781,1242,590,652,0.4750402576489533,0.5249597423510467
E01027800,1729,825,904,0.47715442452284557,0.5228455754771544
E01027779,1113,524,589,0.47079964061096136,0.5292003593890386
E01027796,1843,946,897,0.513293543136191,0.48670645686380903
E01027798,2034,1021,1013,0.5019665683382497,0.49803343166175024
E01027803,1860,921,939,0.49516129032258066,0.5048387096774194
E01027774,1901,957,944,0.5034192530247238,0.49658074697527615
E01027778,2234,1122,1112,0.5022381378692927,0.4977618621307073
E01027782,1702,808,894,0.47473560517038776,0.5252643948296122
E01027797,1697,843,854,0.4967589864466706,0.5032410135533294
E01027799,1762,852,910,0.48354143019296253,0.5164585698070374
E01027787,1876,888,988,0.47334754797441364,0.5266524520255863
E01034968,1624,780,844,0.4802955665024631,0.5197044334975369
E01034969,1611,780,831,0.48417132216014896,0.515828677839851
E01034970,1236,633,603,0.5121359223300971,0.4878640776699029
E01034971,1449,686,763,0.47342995169082125,0.5265700483091788
E01027786,1583,756,827,0.4775742261528743,0.5224257738471257
E01027788,1583,755,828,0.47694251421351863,0.5230574857864814
E01027790,1904,954,950,0.5010504201680672,0.4989495798319328
E01027791,1634,800,834,0.48959608323133413,0.5104039167686658
E01027837,1303,614,689,0.4712202609363008,0.5287797390636991
E01027839,1931,907,1024,0.46970481615743137,0.5302951838425686
E01027871,1558,746,812,0.47881899871630296,0.521181001283697
E01034972,2111,1092,1019,0.5172903837044055,0.4827096162955945
E01027813,1888,928,960,0.4915254237288136,0.5084745762711864
E01027822,1381,700,681,0.5068790731354091,0.49312092686459086
E01027840,1972,984,988,0.49898580121703856,0.5010141987829615
E01027841,1285,646,639,0.5027237354085603,0.4972762645914397
E01027838,1583,746,837,0.47125710675931776,0.5287428932406822
E01027864,1418,684,734,0.4823695345557123,0.5176304654442877
E01027865,1159,590,569,0.5090595340811044,0.4909404659188956
E01027866,2066,987,1079,0.4777347531461762,0.5222652468538238
E01027821,1422,681,741,0.47890295358649787,0.5210970464135021
E01027823,1399,655,744,0.4681915654038599,0.5318084345961401
E01027836,2184,1066,1118,0.4880952380952381,0.5119047619047619
E01027857,1239,612,627,0.4939467312348668,0.5060532687651331
E01034973,1947,963,984,0.4946070878274268,0.5053929121725732
E01027842,1624,760,864,0.46798029556650245,0.5320197044334976
E01027843,1487,725,762,0.48755884330867516,0.5124411566913248
E01027844,1493,742,751,0.49698593436034827,0.5030140656396517
E01027845,1684,814,870,0.4833729216152019,0.5166270783847982
E01027855,1856,883,973,0.47575431034482757,0.5242456896551724
E01027856,1221,578,643,0.47338247338247336,0.5266175266175266
E01027805,1271,642,629,0.5051140833988985,0.4948859166011015
E01027806,1671,911,760,0.5451825254338719,0.4548174745661281
E01027847,1714,913,801,0.5326721120186698,0.46732788798133024
E01034974,2751,1334,1417,0.48491457651763,0.5150854234823701
E01027849,1134,519,615,0.4576719576719577,0.5423280423280423
E01027850,1276,627,649,0.49137931034482757,0.5086206896551724
E01027872,1369,649,720,0.47406866325785246,0.5259313367421475
E01027874,1784,827,957,0.46356502242152464,0.5364349775784754
E01027810,1526,743,783,0.48689384010484926,0.5131061598951507
E01027811,1501,701,800,0.4670219853431046,0.5329780146568954
E01027812,1763,855,908,0.48496880317640384,0.5150311968235961
E01027851,1435,686,749,0.47804878048780486,0.5219512195121951
E01027862,1541,749,792,0.48604802076573655,0.5139519792342635
E01027824,1527,733,794,0.48002619515389655,0.5199738048461034
E01027825,2156,1024,1132,0.4749536178107607,0.5250463821892394
E01027826,1396,701,695,0.5021489971346705,0.4978510028653295
E01027861,1361,678,683,0.4981631153563556,0.5018368846436444
E01027863,1366,642,724,0.4699853587115666,0.5300146412884333
E01027873,1393,648,745,0.46518305814788224,0.5348169418521177
E01027804,1465,806,659,0.5501706484641639,0.4498293515358362
E01027852,1499,801,698,0.5343562374916611,0.4656437625083389
E01027853,1116,561,555,0.5026881720430108,0.49731182795698925
E01027854,1309,691,618,0.5278838808250573,0.4721161191749427
E01027868,2228,1062,1166,0.47666068222621183,0.5233393177737882
E01027807,1530,739,791,0.4830065359477124,0.5169934640522876
E01027808,1613,764,849,0.4736515809051457,0.5263484190948543
E01027809,1220,585,635,0.47950819672131145,0.5204918032786885
E01027818,1913,881,1032,0.4605331939362258,0.5394668060637742
E01027867,1404,677,727,0.4821937321937322,0.5178062678062678
E01027817,1457,716,741,0.4914207275223061,0.5085792724776939
E01027819,2343,1144,1199,0.48826291079812206,0.5117370892018779
E01027820,1466,695,771,0.4740791268758527,0.5259208731241474
E01027858,1339,662,677,0.4943988050784167,0.5056011949215833
E01027860,1601,747,854,0.4665833853841349,0.5334166146158651
E01027814,1687,802,885,0.4754001185536455,0.5245998814463545
E01027815,1387,677,710,0.48810382119682766,0.5118961788031723
E01027816,1706,818,888,0.4794841735052755,0.5205158264947245
E01027859,1752,823,929,0.4697488584474886,0.5302511415525114
E01027827,1560,722,838,0.46282051282051284,0.5371794871794872
E01027828,2063,990,1073,0.47988366456616577,0.5201163354338342
E01027829,1373,648,725,0.471959213401311,0.528040786598689
E01027830,1672,801,871,0.47906698564593303,0.520933014354067
E01027833,1538,751,787,0.488296488946684,0.511703511053316
E01027834,1570,714,856,0.4547770700636943,0.5452229299363057
E01027835,1775,873,902,0.49183098591549296,0.508169014084507
E01027918,1477,754,723,0.5104942450914015,0.4895057549085985
E01027919,1154,579,575,0.5017331022530329,0.4982668977469671
E01027920,1083,528,555,0.48753462603878117,0.5124653739612188
E01027921,1740,801,939,0.4603448275862069,0.5396551724137931
E01027922,2056,1041,1015,0.5063229571984436,0.49367704280155644
E01027875,1968,986,982,0.5010162601626016,0.49898373983739835
E01027886,1431,718,713,0.5017470300489169,0.49825296995108315
E01027887,1556,779,777,0.5006426735218509,0.4993573264781491
E01027888,1948,964,984,0.4948665297741273,0.5051334702258727
E01027904,2505,1237,1268,0.493812375249501,0.506187624750499
E01027876,1571,756,815,0.4812221514958625,0.5187778485041374
E01027877,1926,929,997,0.48234683281412255,0.5176531671858775
E01027900,1973,956,1017,0.4845413076533198,0.5154586923466802
E01027901,1761,884,877,0.5019875070982396,0.49801249290176036
E01027902,1437,708,729,0.49269311064718163,0.5073068893528184
E01027903,1198,537,661,0.44824707846410683,0.5517529215358932
E01027914,1546,769,777,0.4974126778783959,0.5025873221216042
E01027915,2055,987,1068,0.4802919708029197,0.5197080291970803
E01027916,1621,765,856,0.4719309068476249,0.528069093152375
E01034975,1555,740,815,0.4758842443729904,0.5241157556270096
E01034976,1792,893,899,0.49832589285714285,0.5016741071428571
E01034977,1414,670,744,0.4738330975954738,0.5261669024045261
E01034978,1380,676,704,0.48985507246376814,0.5101449275362319
E01027878,1244,626,618,0.5032154340836013,0.4967845659163987
E01027907,1414,712,702,0.5035360678925035,0.49646393210749645
E01027908,1608,764,844,0.47512437810945274,0.5248756218905473
E01027909,2226,1130,1096,0.5076370170709793,0.49236298292902064
E01034979,1392,709,683,0.5093390804597702,0.4906609195402299
E01034980,1123,565,558,0.5031166518254675,0.4968833481745325
E01034981,1501,732,769,0.4876748834110593,0.5123251165889408
E01034982,1231,598,633,0.48578391551584077,0.5142160844841592
E01034983,1560,760,800,0.48717948717948717,0.5128205128205128
E01027881,1872,893,979,0.47702991452991456,0.5229700854700855
E01027906,1575,762,813,0.4838095238095238,0.5161904761904762
E01027913,1165,576,589,0.4944206008583691,0.5055793991416309
E01034984,2397,1157,1240,0.4826866916979558,0.5173133083020443
E01027879,1235,594,641,0.48097165991902835,0.5190283400809717
E01027880,1478,727,751,0.4918809201623816,0.5081190798376184
E01027882,1759,867,892,0.4928936895963616,0.5071063104036384
E01027894,2745,1310,1435,0.4772313296903461,0.5227686703096539
E01027895,1427,694,733,0.4863349684653118,0.5136650315346881
E01027883,1045,500,545,0.4784688995215311,0.5215311004784688
E01027884,1646,814,832,0.4945321992709599,0.5054678007290401
E01027885,1755,854,901,0.4866096866096866,0.5133903133903134
E01027896,1992,1004,988,0.5040160642570282,0.4959839357429719
E01027897,2208,1108,1100,0.5018115942028986,0.49818840579710144
E01027891,1697,867,830,0.5109015910430171,0.4890984089569829
E01027892,1810,894,916,0.49392265193370166,0.5060773480662983
E01027893,2187,1067,1120,0.48788294467306814,0.5121170553269319
E01027899,1717,837,880,0.48747815958066393,0.512521840419336
E01027889,1770,892,878,0.503954802259887,0.496045197740113
E01027890,2428,1220,1208,0.5024711696869851,0.4975288303130148
E01027923,2334,1143,1191,0.4897172236503856,0.5102827763496144
E01027924,2302,1146,1156,0.49782797567332754,0.5021720243266724
E01007434,2464,1197,1267,0.48579545454545453,0.5142045454545454
E01007435,1613,791,822,0.4903905765654061,0.5096094234345939
E01007438,1430,657,773,0.45944055944055945,0.5405594405594406
E01007439,1451,719,732,0.49552033080634045,0.5044796691936595
E01007433,1655,788,867,0.4761329305135952,0.5238670694864048
E01007436,1389,672,717,0.4838012958963283,0.5161987041036717
E01007437,1401,707,694,0.5046395431834404,0.4953604568165596
E01007440,1477,727,750,0.4922139471902505,0.5077860528097495
E01007329,1576,785,791,0.4980964467005076,0.5019035532994924
E01007331,1819,886,933,0.48708081363386474,0.5129191863661352
E01007342,1264,609,655,0.48180379746835444,0.5181962025316456
E01007343,1461,712,749,0.487337440109514,0.5126625598904859
E01007356,1438,689,749,0.47913769123783034,0.5208623087621697
E01007357,1410,679,731,0.48156028368794324,0.5184397163120568
E01007361,1922,916,1006,0.47658688865764826,0.5234131113423517
E01007362,2137,1046,1091,0.48947122133832477,0.5105287786616752
E01007363,1631,759,872,0.4653586756591048,0.5346413243408952
E01007355,1436,698,738,0.4860724233983287,0.5139275766016713
E01007358,1401,675,726,0.4817987152034261,0.5182012847965739
E01007359,1441,717,724,0.49757113115891743,0.5024288688410826
E01007360,1491,720,771,0.482897384305835,0.5171026156941649
E01007386,1805,873,932,0.48365650969529084,0.5163434903047092
E01007328,2102,1049,1053,0.49904852521408183,0.5009514747859182
E01007330,1773,858,915,0.48392554991539766,0.5160744500846024
E01007332,2418,1189,1229,0.49172870140612074,0.5082712985938792
E01007333,1487,721,766,0.48486886348352387,0.5151311365164761
E01007323,1539,749,790,0.4866796621182586,0.5133203378817414
E01007324,1645,811,834,0.4930091185410334,0.5069908814589665
E01007325,1630,794,836,0.48711656441717793,0.5128834355828221
E01007326,1696,833,863,0.49115566037735847,0.5088443396226415
E01007327,1670,805,865,0.4820359281437126,0.5179640718562875
E01007411,1485,741,744,0.498989898989899,0.501010101010101
E01007341,1292,654,638,0.5061919504643962,0.4938080495356037
E01007345,1602,779,823,0.48626716604244696,0.5137328339575531
E01007346,1593,781,812,0.49026993094789706,0.5097300690521029
E01007347,1806,895,911,0.4955703211517165,0.5044296788482835
E01007334,1297,635,662,0.48959136468774095,0.5104086353122591
E01007335,1404,695,709,0.495014245014245,0.5049857549857549
E01007400,2294,1157,1137,0.504359197907585,0.495640802092415
E01007404,1308,633,675,0.48394495412844035,0.5160550458715596
E01007406,1676,806,870,0.4809069212410501,0.5190930787589498
E01007408,1441,707,734,0.4906315058986815,0.5093684941013186
E01007409,1461,776,685,0.5311430527036276,0.46885694729637234
E01007410,1773,888,885,0.5008460236886633,0.49915397631133673
E01032551,2581,1255,1326,0.48624564122433167,0.5137543587756683
E01034258,1489,733,756,0.4922766957689725,0.5077233042310275
E01034259,1463,752,711,0.5140123034859877,0.4859876965140123
E01007344,2626,1297,1329,0.4939070830159939,0.506092916984006
E01007402,1975,950,1025,0.4810126582278481,0.5189873417721519
E01007403,1454,674,780,0.46354883081155435,0.5364511691884457
E01007405,1922,931,991,0.48439125910509884,0.5156087408949012
E01007379,1449,715,734,0.49344375431331955,0.5065562456866805
E01007380,1846,897,949,0.4859154929577465,0.5140845070422535
E01007381,2077,986,1091,0.47472315840154067,0.5252768415984593
E01007387,1393,680,713,0.4881550610193826,0.5118449389806173
E01007442,1452,698,754,0.4807162534435262,0.5192837465564738
E01007444,2166,1072,1094,0.494921514312096,0.5050784856879039
E01007446,1278,602,676,0.47104851330203446,0.5289514866979655
E01007336,1509,803,706,0.5321404903909874,0.46785950960901257
E01007340,1877,1032,845,0.5498135322322856,0.4501864677677144
E01007415,1507,744,763,0.4936960849369608,0.5063039150630392
E01007417,1847,933,914,0.505143475906876,0.494856524093124
E01007441,1524,767,757,0.5032808398950132,0.4967191601049869
E01007443,2253,1246,1007,0.5530403905903241,0.446959609409676
E01007445,1574,765,809,0.48602287166454894,0.5139771283354511
E01007372,1695,832,863,0.49085545722713864,0.5091445427728614
E01007373,1731,828,903,0.4783362218370884,0.5216637781629117
E01007374,1329,636,693,0.4785553047404063,0.5214446952595937
E01007375,1733,828,905,0.47778418926716676,0.5222158107328332
E01007377,1406,695,711,0.49431009957325744,0.5056899004267426
E01007378,1625,804,821,0.4947692307692308,0.5052307692307693
E01007319,1426,687,739,0.48176718092566617,0.5182328190743338
E01007321,1410,679,731,0.48156028368794324,0.5184397163120568
E01007322,2117,1076,1041,0.5082664147378365,0.49173358526216343
E01007337,1813,954,859,0.5261996690568119,0.4738003309431881
E01007418,1285,637,648,0.49571984435797667,0.5042801556420233
E01007419,1571,766,805,0.4875875238701464,0.5124124761298536
E01007420,1390,693,697,0.4985611510791367,0.5014388489208633
E01007425,1842,902,940,0.48968512486427795,0.510314875135722
E01007338,1580,824,756,0.5215189873417722,0.47848101265822784
E01007339,1479,776,703,0.5246788370520622,0.4753211629479378
E01007413,1454,713,741,0.4903713892709766,0.5096286107290234
E01007414,2261,1144,1117,0.5059708093763822,0.4940291906236179
E01007317,1521,749,772,0.49243918474687703,0.5075608152531229
E01007318,1592,764,828,0.4798994974874372,0.5201005025125628
E01007320,1712,860,852,0.5023364485981309,0.4976635514018692
E01007416,1406,710,696,0.5049786628733998,0.4950213371266003
E01007382,1598,797,801,0.49874843554443055,0.5012515644555695
E01007383,1319,664,655,0.5034116755117514,0.4965883244882487
E01007384,1677,808,869,0.48181276088252833,0.5181872391174717
E01007385,1382,652,730,0.4717800289435601,0.5282199710564399
E01007348,1489,734,755,0.49294828744123576,0.5070517125587642
E01007349,1564,755,809,0.4827365728900256,0.5172634271099744
E01007350,1109,550,559,0.49594229035166815,0.5040577096483319
E01007351,1724,868,856,0.5034802784222738,0.4965197215777262
E01007352,1469,716,753,0.4874063989108237,0.5125936010891763
E01007353,1694,806,888,0.4757969303423849,0.5242030696576151
E01007354,1641,791,850,0.48202315661182205,0.517976843388178
E01007458,1467,728,739,0.49625085207907293,0.5037491479209271
E01007459,1513,731,782,0.48314606741573035,0.5168539325842697
E01007460,1440,715,725,0.4965277777777778,0.5034722222222222
E01007461,1710,846,864,0.49473684210526314,0.5052631578947369
E01007462,1566,755,811,0.4821200510855683,0.5178799489144317
E01007463,1738,854,884,0.49136939010356734,0.5086306098964327
E01007369,2032,1008,1024,0.49606299212598426,0.5039370078740157
E01007370,1790,857,933,0.4787709497206704,0.5212290502793296
E01007371,1898,914,984,0.4815595363540569,0.5184404636459431
E01007376,1451,690,761,0.4755341144038594,0.5244658855961406
E01007447,1718,853,865,0.49650756693830034,0.5034924330616997
E01007448,2255,1178,1077,0.5223946784922394,0.4776053215077605
E01007449,1735,872,863,0.5025936599423632,0.4974063400576369
E01007450,2022,1004,1018,0.49653808110781406,0.503461918892186
E01007427,1675,839,836,0.5008955223880597,0.4991044776119403
E01007428,1517,753,764,0.4963744232036915,0.5036255767963085
E01007429,1441,675,766,0.46842470506592643,0.5315752949340735
E01007430,2837,1350,1487,0.4758547761720127,0.5241452238279873
E01007431,1382,679,703,0.4913169319826339,0.5086830680173662
E01007432,1691,818,873,0.48373743347131876,0.5162625665286813
E01007364,1408,713,695,0.5063920454545454,0.49360795454545453
E01007365,1210,572,638,0.4727272727272727,0.5272727272727272
E01007366,2263,1097,1166,0.48475475033141846,0.5152452496685815
E01007367,1149,571,578,0.4969538729329852,0.5030461270670148
E01007368,1733,829,904,0.4783612233121754,0.5216387766878245
E01007451,1850,905,945,0.4891891891891892,0.5108108108108108
E01007452,1659,836,823,0.5039180229053647,0.4960819770946353
E01007453,1684,805,879,0.47802850356294535,0.5219714964370546
E01007455,1406,679,727,0.4829302987197724,0.5170697012802276
E01032924,1586,787,799,0.4962168978562421,0.5037831021437579
E01032925,1405,702,703,0.499644128113879,0.500355871886121
E01007421,1377,675,702,0.49019607843137253,0.5098039215686274
E01007422,1541,746,795,0.48410123296560675,0.5158987670343933
E01007423,1651,806,845,0.4881889763779528,0.5118110236220472
E01007426,1925,979,946,0.5085714285714286,0.49142857142857144
E01007396,1566,759,807,0.4846743295019157,0.5153256704980843
E01007397,1536,735,801,0.478515625,0.521484375
E01007398,1635,775,860,0.4740061162079511,0.5259938837920489
E01007399,2005,969,1036,0.4832917705735661,0.5167082294264339
E01007424,1929,942,987,0.48833592534992226,0.5116640746500778
E01007388,1728,885,843,0.5121527777777778,0.4878472222222222
E01007393,1813,876,937,0.48317705460562604,0.516822945394374
E01007394,1375,690,685,0.5018181818181818,0.49818181818181817
E01007456,1752,864,888,0.4931506849315068,0.5068493150684932
E01007457,1784,869,915,0.48710762331838564,0.5128923766816144
E01007389,1335,672,663,0.503370786516854,0.4966292134831461
E01007390,1476,745,731,0.5047425474254743,0.49525745257452575
E01007391,1512,732,780,0.48412698412698413,0.5158730158730159
E01007392,1501,747,754,0.49766822118587606,0.5023317788141239
E01007395,2091,1000,1091,0.4782400765184122,0.5217599234815877
E01007632,1598,791,807,0.49499374217772213,0.5050062578222778
E01007633,1395,689,706,0.4939068100358423,0.5060931899641578
E01007634,1764,849,915,0.4812925170068027,0.5187074829931972
E01007635,1952,939,1013,0.48104508196721313,0.5189549180327869
E01007487,1562,728,834,0.4660691421254802,0.5339308578745199
E01007488,1628,821,807,0.5042997542997543,0.4957002457002457
E01007489,2091,1000,1091,0.4782400765184122,0.5217599234815877
E01007490,1705,843,862,0.49442815249266864,0.5055718475073314
E01007491,1665,806,859,0.4840840840840841,0.5159159159159159
E01007492,1604,765,839,0.4769326683291771,0.523067331670823
E01007493,1719,833,886,0.48458406050029085,0.5154159394997091
E01007636,1584,751,833,0.4741161616161616,0.5258838383838383
E01007637,1536,755,781,0.4915364583333333,0.5084635416666666
E01007638,1530,732,798,0.47843137254901963,0.5215686274509804
E01007639,2157,1070,1087,0.4960593416782568,0.5039406583217432
E01007640,1570,775,795,0.49363057324840764,0.5063694267515924
E01007641,1424,709,715,0.4978932584269663,0.5021067415730337
E01007642,1589,772,817,0.4858401510383889,0.514159848961611
E01007625,1403,713,690,0.5081967213114754,0.4918032786885246
E01007626,1562,780,782,0.499359795134443,0.5006402048655569
E01007627,1595,775,820,0.48589341692789967,0.5141065830721003
E01007628,1378,671,707,0.4869375907111756,0.5130624092888244
E01007629,1534,733,801,0.47783572359843546,0.5221642764015645
E01007468,1216,579,637,0.4761513157894737,0.5238486842105263
E01007469,1259,627,632,0.4980142970611596,0.5019857029388404
E01007470,1358,695,663,0.5117820324005891,0.4882179675994109
E01007472,1377,681,696,0.49455337690631807,0.5054466230936819
E01007473,1421,683,738,0.48064743138634763,0.5193525686136523
E01007474,1192,578,614,0.4848993288590604,0.5151006711409396
E01007554,1531,786,745,0.5133899412148922,0.48661005878510777
E01007555,1314,631,683,0.4802130898021309,0.5197869101978692
E01007556,1336,634,702,0.4745508982035928,0.5254491017964071
E01007561,1345,650,695,0.483271375464684,0.516728624535316
E01007562,1351,673,678,0.4981495188749075,0.5018504811250926
E01007563,1433,669,764,0.4668527564549895,0.5331472435450104
E01007621,1394,687,707,0.4928263988522238,0.5071736011477762
E01007622,1414,669,745,0.47312588401697314,0.5268741159830269
E01007623,1221,569,652,0.46601146601146604,0.533988533988534
E01007624,1923,944,979,0.4908996359854394,0.5091003640145606
E01007630,1324,628,696,0.4743202416918429,0.525679758308157
E01007631,1169,560,609,0.47904191616766467,0.5209580838323353
E01007553,1605,787,818,0.49034267912772583,0.5096573208722741
E01007557,2935,2389,546,0.81396933560477,0.18603066439522997
E01007558,1458,704,754,0.4828532235939643,0.5171467764060357
E01007559,1190,708,482,0.5949579831932773,0.4050420168067227
E01007560,1651,776,875,0.4700181708055724,0.5299818291944276
E01007464,1464,711,753,0.48565573770491804,0.514344262295082
E01007465,1866,918,948,0.4919614147909968,0.5080385852090032
E01007466,1987,941,1046,0.4735782586814293,0.5264217413185707
E01007467,1505,749,756,0.49767441860465117,0.5023255813953489
E01007471,1378,677,701,0.49129172714078373,0.5087082728592163
E01007504,1387,681,706,0.49098774333093004,0.5090122566690699
E01007507,1275,643,632,0.504313725490196,0.4956862745098039
E01007506,1782,870,912,0.4882154882154882,0.5117845117845118
E01007508,1538,772,766,0.5019505851755527,0.4980494148244473
E01007509,1647,757,890,0.4596235579842137,0.5403764420157863
E01007510,1503,760,743,0.5056553559547572,0.49434464404524286
E01007511,1528,721,807,0.4718586387434555,0.5281413612565445
E01007475,1429,709,720,0.49615115465360393,0.5038488453463961
E01007476,1804,887,917,0.4916851441241685,0.5083148558758315
E01007477,1391,678,713,0.4874191229331416,0.5125808770668584
E01007478,1629,816,813,0.5009208103130756,0.4990791896869245
E01007512,2097,1022,1075,0.48736289938006677,0.5126371006199333
E01007513,1458,678,780,0.46502057613168724,0.5349794238683128
E01007515,1456,692,764,0.47527472527472525,0.5247252747252747
E01007518,1446,688,758,0.47579529737206083,0.5242047026279392
E01007519,1290,612,678,0.4744186046511628,0.5255813953488372
E01007505,1579,786,793,0.49778340721975933,0.5022165927802407
E01007514,1497,778,719,0.5197060788243153,0.4802939211756847
E01007516,1395,689,706,0.4939068100358423,0.5060931899641578
E01007517,1428,730,698,0.511204481792717,0.4887955182072829
E01007479,1514,743,771,0.4907529722589168,0.5092470277410832
E01007480,1495,723,772,0.4836120401337793,0.5163879598662208
E01007482,1352,633,719,0.4681952662721893,0.5318047337278107
E01033259,1643,803,840,0.4887401095556908,0.5112598904443092
E01033260,1652,845,807,0.511501210653753,0.48849878934624696
E01007570,1432,692,740,0.48324022346368717,0.5167597765363129
E01007650,1656,826,830,0.49879227053140096,0.501207729468599
E01007651,1837,875,962,0.4763200870985302,0.5236799129014698
E01007652,2074,1006,1068,0.485053037608486,0.5149469623915139
E01007653,1574,792,782,0.5031766200762389,0.49682337992376113
E01007656,1636,818,818,0.5,0.5
E01007581,1373,653,720,0.47560087399854334,0.5243991260014567
E01007582,1380,672,708,0.48695652173913045,0.5130434782608696
E01007588,1630,782,848,0.47975460122699387,0.5202453987730061
E01007589,1620,770,850,0.47530864197530864,0.5246913580246914
E01007483,1304,635,669,0.4869631901840491,0.5130368098159509
E01007484,1309,633,676,0.48357524828113063,0.5164247517188694
E01007485,1388,685,703,0.4935158501440922,0.5064841498559077
E01007486,1223,583,640,0.4766966475878986,0.5233033524121014
E01007564,1548,748,800,0.48320413436692505,0.5167958656330749
E01007565,1508,740,768,0.4907161803713528,0.5092838196286472
E01007566,1626,793,833,0.48769987699877,0.5123001230012301
E01007567,1316,640,676,0.48632218844984804,0.513677811550152
E01007568,1541,742,799,0.48150551589876706,0.518494484101233
E01007569,1608,773,835,0.48072139303482586,0.5192786069651741
E01007644,1767,902,865,0.5104697226938314,0.48953027730616866
E01007646,1587,824,763,0.5192186515437933,0.4807813484562067
E01007647,1534,751,783,0.4895697522816167,0.5104302477183833
E01007649,1472,733,739,0.49796195652173914,0.5020380434782609
E01007654,1527,804,723,0.5265225933202358,0.47347740667976423
E01034236,1097,710,387,0.6472196900638104,0.3527803099361896
E01034237,1050,658,392,0.6266666666666667,0.37333333333333335
E01007583,1353,661,692,0.4885439763488544,0.5114560236511456
E01007586,1429,696,733,0.48705388383484954,0.5129461161651504
E01007587,1604,742,862,0.4625935162094763,0.5374064837905237
E01007620,1602,770,832,0.48064918851435706,0.519350811485643
E01007584,1534,771,763,0.5026075619295959,0.4973924380704042
E01007585,1533,702,831,0.45792563600782776,0.5420743639921722
E01007617,1457,726,731,0.4982841455044612,0.5017158544955388
E01007618,1190,576,614,0.48403361344537815,0.5159663865546219
E01007619,1835,922,913,0.5024523160762943,0.49754768392370574
E01007529,2309,1529,780,0.6621914248592464,0.3378085751407536
E01007530,1546,809,737,0.5232858990944372,0.47671410090556277
E01007531,1603,818,785,0.5102932002495322,0.4897067997504679
E01007643,1630,779,851,0.47791411042944787,0.5220858895705521
E01007655,2028,1105,923,0.5448717948717948,0.4551282051282051
E01034238,1188,664,524,0.5589225589225589,0.44107744107744107
E01034239,1484,779,705,0.5249326145552561,0.4750673854447439
E01007494,1506,763,743,0.5066401062416999,0.49335989375830014
E01007532,1804,992,812,0.549889135254989,0.4501108647450111
E01007533,1519,758,761,0.4990125082290981,0.500987491770902
E01007535,1467,781,686,0.5323790047716428,0.4676209952283572
E01007522,1522,733,789,0.4816031537450723,0.5183968462549278
E01007525,1530,711,819,0.4647058823529412,0.5352941176470588
E01007528,1440,681,759,0.47291666666666665,0.5270833333333333
E01007604,1329,655,674,0.4928517682468021,0.5071482317531979
E01007521,1457,710,747,0.48730267673301303,0.5126973232669869
E01007523,1480,737,743,0.497972972972973,0.5020270270270271
E01007524,1597,794,803,0.4971822166562304,0.5028177833437696
E01007526,2027,1003,1024,0.49481993093241244,0.5051800690675876
E01007607,1529,737,792,0.48201438848920863,0.5179856115107914
E01007599,1770,850,920,0.480225988700565,0.519774011299435
E01007600,1336,654,682,0.48952095808383234,0.5104790419161677
E01007601,1536,755,781,0.4915364583333333,0.5084635416666666
E01007602,1989,957,1032,0.48114630467571645,0.5188536953242836
E01007603,1565,757,808,0.4837060702875399,0.51629392971246
E01007520,1305,621,684,0.47586206896551725,0.5241379310344828
E01007605,1476,716,760,0.48509485094850946,0.5149051490514905
E01007606,2209,1083,1126,0.4902670891806247,0.5097329108193753
E01034240,1461,748,713,0.5119780971937029,0.48802190280629704
E01034241,1372,656,716,0.478134110787172,0.521865889212828
E01007495,1733,895,838,0.5164454702827467,0.4835545297172533
E01007500,1260,616,644,0.4888888888888889,0.5111111111111111
E01007534,1965,1033,932,0.5256997455470738,0.47430025445292623
E01034242,1746,839,907,0.4805269186712486,0.5194730813287515
E01034243,1913,942,971,0.4924202822791427,0.5075797177208573
E01007496,1607,797,810,0.49595519601742377,0.5040448039825762
E01007497,1326,627,699,0.47285067873303166,0.5271493212669683
E01007498,1539,782,757,0.5081221572449642,0.4918778427550357
E01007499,1401,662,739,0.4725196288365453,0.5274803711634547
E01007501,1294,636,658,0.49149922720247297,0.508500772797527
E01007503,1526,768,758,0.5032765399737876,0.4967234600262123
E01007575,1267,588,679,0.46408839779005523,0.5359116022099447
E01007578,1534,766,768,0.49934810951760106,0.500651890482399
E01007579,2802,1384,1418,0.4939329050678087,0.5060670949321913
E01007580,1269,646,623,0.5090622537431048,0.4909377462568952
E01007571,1652,793,859,0.48002421307506055,0.5199757869249395
E01007572,1325,658,667,0.49660377358490565,0.5033962264150943
E01007573,1449,707,742,0.48792270531400966,0.5120772946859904
E01007574,1446,706,740,0.48824343015214383,0.5117565698478561
E01007576,1417,708,709,0.49964714184897674,0.5003528581510233
E01007577,1395,698,697,0.5003584229390681,0.4996415770609319
E01007536,1846,898,948,0.48645720476706394,0.5135427952329361
E01007542,2065,1023,1042,0.4953995157384988,0.5046004842615012
E01007543,1427,716,711,0.5017519271198319,0.4982480728801682
E01007544,1658,790,868,0.4764776839565742,0.5235223160434258
E01007546,1338,678,660,0.5067264573991032,0.49327354260089684
E01007551,1622,796,826,0.4907521578298397,0.5092478421701603
E01007552,1331,628,703,0.4718256949661908,0.5281743050338091
E01007613,1626,824,802,0.5067650676506765,0.4932349323493235
E01007545,1355,703,652,0.5188191881918819,0.48118081180811806
E01007547,1470,777,693,0.5285714285714286,0.4714285714285714
E01007548,1856,879,977,0.4735991379310345,0.5264008620689655
E01007549,1422,699,723,0.49156118143459915,0.5084388185654009
E01007550,1677,809,868,0.4824090638044126,0.5175909361955874
E01007537,1605,808,797,0.5034267912772585,0.4965732087227414
E01007538,1523,723,800,0.4747209455022981,0.525279054497702
E01007539,1435,659,776,0.4592334494773519,0.5407665505226481
E01007540,1618,785,833,0.48516687268232384,0.5148331273176762
E01007541,1492,722,770,0.4839142091152815,0.5160857908847185
E01007591,1405,691,714,0.4918149466192171,0.5081850533807829
E01007594,1957,940,1017,0.4803270311701584,0.5196729688298416
E01007596,1182,581,601,0.49153976311336717,0.5084602368866328
E01007598,1465,719,746,0.4907849829351536,0.5092150170648464
E01007590,1215,615,600,0.5061728395061729,0.49382716049382713
E01007592,1720,854,866,0.4965116279069767,0.5034883720930232
E01007593,1957,941,1016,0.48083801737353093,0.5191619826264691
E01007595,1451,696,755,0.47966919365954513,0.5203308063404548
E01007597,1554,740,814,0.47619047619047616,0.5238095238095238
E01007609,2203,1037,1166,0.47072174307762144,0.5292782569223786
E01007610,1755,830,925,0.47293447293447294,0.5270655270655271
E01034244,1110,548,562,0.4936936936936937,0.5063063063063064
E01034245,1897,927,970,0.48866631523458093,0.5113336847654191
E01007611,1283,622,661,0.4848012470771629,0.5151987529228371
E01007612,1346,649,697,0.4821693907875186,0.5178306092124815
E01007614,1387,690,697,0.4974765681326604,0.5025234318673396
E01007615,1267,604,663,0.47671665351223363,0.5232833464877664
E01007616,1165,512,653,0.4394849785407725,0.5605150214592275
E01007694,1881,943,938,0.5013290802764487,0.4986709197235513
E01007695,2778,1371,1407,0.49352051835853133,0.5064794816414687
E01007697,1679,816,863,0.4860035735556879,0.5139964264443121
E01007698,1427,716,711,0.5017519271198319,0.4982480728801682
E01034246,1751,875,876,0.49971444888635064,0.5002855511136494
E01034247,2154,1035,1119,0.4805013927576602,0.5194986072423399
E01007816,1693,856,837,0.505611340815121,0.4943886591848789
E01007817,1449,699,750,0.4824016563146998,0.5175983436853002
E01007819,1552,782,770,0.5038659793814433,0.4961340206185567
E01007820,1748,847,901,0.4845537757437071,0.5154462242562929
E01007821,1585,746,839,0.47066246056782335,0.5293375394321767
E01007822,1937,899,1038,0.46411977284460504,0.535880227155395
E01007796,1161,545,616,0.4694229112833764,0.5305770887166236
E01007797,1222,609,613,0.4983633387888707,0.5016366612111293
E01007798,1554,759,795,0.48841698841698844,0.5115830115830116
E01007799,1460,706,754,0.48356164383561645,0.5164383561643836
E01007800,1550,800,750,0.5161290322580645,0.4838709677419355
E01007818,1600,771,829,0.481875,0.518125
E01007777,2192,1050,1142,0.479014598540146,0.5209854014598541
E01007793,1392,701,691,0.5035919540229885,0.4964080459770115
E01007794,1316,615,701,0.4673252279635258,0.5326747720364742
E01007795,1327,662,665,0.49886963074604374,0.5011303692539563
E01007778,1398,697,701,0.49856938483547925,0.5014306151645207
E01007779,1959,957,1002,0.4885145482388974,0.5114854517611026
E01007780,1397,682,715,0.4881889763779528,0.5118110236220472
E01007781,1474,719,755,0.48778833107191316,0.5122116689280869
E01007782,1467,709,758,0.4832992501704158,0.5167007498295841
E01007771,1327,642,685,0.48379804069329313,0.5162019593067069
E01007772,1375,686,689,0.4989090909090909,0.5010909090909091
E01007773,1421,672,749,0.4729064039408867,0.5270935960591133
E01007774,1447,695,752,0.48030407740152037,0.5196959225984796
E01007696,1397,693,704,0.49606299212598426,0.5039370078740157
E01007801,1447,718,729,0.4961990324809952,0.5038009675190048
E01007802,1241,611,630,0.492344883158743,0.5076551168412571
E01007803,1261,627,634,0.4972244250594766,0.5027755749405234
E01007808,1322,633,689,0.47881996974281393,0.5211800302571861
E01007775,1355,643,712,0.4745387453874539,0.5254612546125461
E01007776,1542,733,809,0.47535667963683526,0.5246433203631647
E01007783,1704,851,853,0.4994131455399061,0.5005868544600939
E01007784,1719,906,813,0.5270506108202443,0.47294938917975565
E01007728,1157,575,582,0.4969749351771824,0.5030250648228176
E01007729,1553,783,770,0.5041854475209272,0.49581455247907275
E01007730,1394,698,696,0.5007173601147776,0.49928263988522237
E01007731,1147,557,590,0.48561464690496947,0.5143853530950305
E01007732,1297,669,628,0.5158057054741712,0.48419429452582885
E01007733,1232,614,618,0.49837662337662336,0.5016233766233766
E01007719,1234,593,641,0.4805510534846029,0.5194489465153971
E01007720,1525,742,783,0.48655737704918034,0.5134426229508197
E01007721,1639,802,837,0.48932275777913364,0.5106772422208664
E01007727,1412,690,722,0.4886685552407932,0.5113314447592068
E01007740,1527,719,808,0.47085789129011135,0.5291421087098886
E01007804,1404,673,731,0.4793447293447293,0.5206552706552706
E01007805,1466,700,766,0.47748976807639837,0.5225102319236017
E01007806,1373,690,683,0.5025491624180627,0.49745083758193737
E01007807,1433,708,725,0.49406838799720865,0.5059316120027914
E01007681,1251,607,644,0.48521183053557154,0.5147881694644284
E01007691,2028,1006,1022,0.4960552268244576,0.5039447731755424
E01007692,1525,714,811,0.4681967213114754,0.5318032786885246
E01032926,1752,863,889,0.4925799086757991,0.507420091324201
E01032927,1437,708,729,0.49269311064718163,0.5073068893528184
E01007723,1402,695,707,0.4957203994293866,0.5042796005706134
E01007735,1431,719,712,0.5024458420684835,0.4975541579315164
E01007737,1627,794,833,0.4880147510755993,0.5119852489244008
E01007738,1516,740,776,0.48812664907651715,0.5118733509234829
E01007739,1525,763,762,0.5003278688524591,0.499672131147541
E01007736,1634,830,804,0.5079559363525091,0.4920440636474908
E01007765,1395,658,737,0.47168458781362005,0.5283154121863799
E01007766,1461,720,741,0.4928131416837782,0.5071868583162218
E01007768,1995,1059,936,0.530827067669173,0.4691729323308271
E01007770,1768,864,904,0.48868778280542985,0.5113122171945701
E01007741,1461,716,745,0.49007529089664614,0.5099247091033539
E01007742,1417,671,746,0.4735356386732534,0.5264643613267467
E01007743,1185,604,581,0.509704641350211,0.490295358649789
E01007744,1446,735,711,0.508298755186722,0.491701244813278
E01007745,1619,764,855,0.4718962322421248,0.5281037677578753
E01007746,1450,723,727,0.4986206896551724,0.5013793103448276
E01007715,1931,956,975,0.49508026929052307,0.5049197307094769
E01007716,1946,980,966,0.5035971223021583,0.49640287769784175
E01007717,1771,889,882,0.5019762845849802,0.4980237154150198
E01007718,1559,798,761,0.5118665811417575,0.48813341885824246
E01007677,1983,945,1038,0.47655068078668683,0.5234493192133132
E01007714,2249,1252,997,0.5566918630502445,0.44330813694975546
E01007767,1495,769,726,0.51438127090301,0.48561872909698994
E01007769,1723,901,822,0.5229251305861868,0.4770748694138131
E01007685,1337,664,673,0.49663425579655945,0.5033657442034405
E01007754,1317,676,641,0.5132877752467729,0.486712224753227
E01007755,1278,620,658,0.48513302034428796,0.514866979655712
E01007756,1382,679,703,0.4913169319826339,0.5086830680173662
E01007761,1577,754,823,0.47812301838934684,0.5218769816106531
E01007762,1403,679,724,0.4839629365645046,0.5160370634354954
E01007682,1299,640,659,0.4926866820631255,0.5073133179368745
E01007683,1327,637,690,0.4800301431801055,0.5199698568198945
E01007686,1421,667,754,0.46938775510204084,0.5306122448979592
E01007688,1485,683,802,0.4599326599326599,0.54006734006734
E01007725,1226,591,635,0.4820554649265905,0.5179445350734094
E01007726,1532,710,822,0.46344647519582244,0.5365535248041775
E01007757,1583,805,778,0.5085281111813014,0.4914718888186987
E01007758,1505,719,786,0.4777408637873754,0.5222591362126245
E01007759,1446,703,743,0.48616874135546334,0.5138312586445366
E01007760,1615,780,835,0.48297213622291024,0.5170278637770898
E01007763,1536,729,807,0.474609375,0.525390625
E01007764,1827,856,971,0.46852764094143406,0.5314723590585659
E01007708,1691,776,915,0.45890005913660553,0.5410999408633944
E01007709,1478,729,749,0.493234100135318,0.506765899864682
E01007710,1554,754,800,0.4851994851994852,0.5148005148005148
E01007711,1769,871,898,0.49236856981345395,0.5076314301865461
E01007724,1415,688,727,0.4862190812720848,0.5137809187279152
E01007734,1736,800,936,0.4608294930875576,0.5391705069124424
E01007675,1958,969,989,0.49489274770173647,0.5051072522982636
E01007678,1592,785,807,0.49309045226130654,0.5069095477386935
E01007679,1966,986,980,0.5015259409969481,0.49847405900305186
E01007680,1909,945,964,0.4950235725510739,0.5049764274489261
E01007712,2034,991,1043,0.4872173058013766,0.5127826941986234
E01007713,1632,768,864,0.47058823529411764,0.5294117647058824
E01007676,1627,752,875,0.46220036877688997,0.53779963122311
E01007702,1716,818,898,0.4766899766899767,0.5233100233100233
E01007703,1224,587,637,0.4795751633986928,0.5204248366013072
E01007704,1552,788,764,0.5077319587628866,0.49226804123711343
E01007705,1463,725,738,0.4955570745044429,0.504442925495557
E01007707,1466,735,731,0.5013642564802183,0.49863574351978174
E01007666,1267,635,632,0.5011838989739542,0.4988161010260458
E01007809,1646,785,861,0.47691373025516404,0.523086269744836
E01007810,2942,1446,1496,0.49150237933378654,0.5084976206662135
E01007815,1637,815,822,0.49786194257788635,0.5021380574221136
E01007699,2727,1348,1379,0.4943160982764943,0.5056839017235056
E01007700,1955,944,1011,0.48286445012787726,0.5171355498721227
E01007701,1615,792,823,0.4904024767801858,0.5095975232198142
E01007706,1338,670,668,0.5007473841554559,0.4992526158445441
E01034248,1580,779,801,0.4930379746835443,0.5069620253164557
E01034249,1504,757,747,0.5033244680851063,0.4966755319148936
E01034250,1067,506,561,0.4742268041237113,0.5257731958762887
E01007788,1495,741,754,0.4956521739130435,0.5043478260869565
E01007789,1580,751,829,0.4753164556962025,0.5246835443037975
E01007792,1240,628,612,0.5064516129032258,0.4935483870967742
E01034251,1067,524,543,0.49109653233364575,0.5089034676663543
E01034252,2118,1024,1094,0.48347497639282344,0.5165250236071766
E01007657,1373,672,701,0.48943918426802624,0.5105608157319738
E01007659,1080,533,547,0.4935185185185185,0.5064814814814815
E01007785,1364,659,705,0.4831378299120235,0.5168621700879765
E01007786,1180,553,627,0.46864406779661016,0.5313559322033898
E01007790,1659,825,834,0.4972875226039783,0.5027124773960217
E01007791,1375,684,691,0.4974545454545454,0.5025454545454545
E01007667,1535,758,777,0.4938110749185668,0.5061889250814332
E01007668,1581,772,809,0.4882985452245414,0.5117014547754586
E01007669,1447,707,740,0.48859709744298546,0.5114029025570145
E01007670,1428,693,735,0.4852941176470588,0.5147058823529411
E01007672,1389,688,701,0.4953203743700504,0.5046796256299496
E01007673,1548,751,797,0.4851421188630491,0.5148578811369509
E01007671,2046,1002,1044,0.4897360703812317,0.5102639296187683
E01007674,2100,1039,1061,0.49476190476190474,0.5052380952380953
E01007747,1309,646,663,0.4935064935064935,0.5064935064935064
E01007750,1606,803,803,0.5,0.5
E01007658,1452,701,751,0.48278236914600553,0.5172176308539945
E01007660,1195,585,610,0.4895397489539749,0.5104602510460251
E01007661,1471,733,738,0.4983004758667573,0.5016995241332427
E01007662,1097,529,568,0.4822242479489517,0.5177757520510483
E01007663,1462,706,756,0.4829001367989056,0.5170998632010944
E01007664,1836,898,938,0.4891067538126362,0.5108932461873639
E01007748,1410,639,771,0.4531914893617021,0.5468085106382978
E01007749,1852,914,938,0.49352051835853133,0.5064794816414687
E01007751,2314,1137,1177,0.4913569576490925,0.5086430423509075
E01007752,1483,709,774,0.47808496291301417,0.5219150370869858
E01007753,1590,784,806,0.4930817610062893,0.5069182389937107
E01007684,1795,900,895,0.5013927576601671,0.4986072423398329
E01007687,1589,775,814,0.48772813089993705,0.512271869100063
E01007689,1555,732,823,0.4707395498392283,0.5292604501607717
E01007690,1709,836,873,0.489174956114687,0.510825043885313
E01007811,1291,637,654,0.49341595662277304,0.506584043377227
E01007812,1240,595,645,0.4798387096774194,0.5201612903225806
E01034253,2345,1123,1222,0.4788912579957356,0.5211087420042644
E01008144,1942,965,977,0.49691040164778577,0.5030895983522142
E01008145,1395,688,707,0.4931899641577061,0.5068100358422939
E01008148,1505,702,803,0.4664451827242525,0.5335548172757475
E01008149,1415,691,724,0.488339222614841,0.511660777385159
E01008150,1426,705,721,0.4943899018232819,0.5056100981767181
E01008142,1466,717,749,0.48908594815825374,0.5109140518417462
E01008143,1567,772,795,0.49266113592852584,0.5073388640714741
E01008146,1221,618,603,0.5061425061425061,0.49385749385749383
E01008147,1364,661,703,0.4846041055718475,0.5153958944281525
E01007888,1348,660,688,0.4896142433234421,0.5103857566765578
E01007892,1454,683,771,0.46973865199449794,0.5302613480055021
E01007893,1425,706,719,0.49543859649122807,0.5045614035087719
E01007898,1455,715,740,0.49140893470790376,0.5085910652920962
E01007899,1423,707,716,0.4968376669009136,0.5031623330990864
E01007900,1687,812,875,0.48132780082987553,0.5186721991701245
E01007901,1422,682,740,0.47960618846694797,0.5203938115330521
E01007887,1399,670,729,0.4789135096497498,0.5210864903502502
E01007889,2735,1345,1390,0.49177330895795246,0.5082266910420475
E01007890,1341,649,692,0.48396718866517524,0.5160328113348247
E01007891,1476,731,745,0.49525745257452575,0.5047425474254743
E01007894,1406,670,736,0.47652916073968704,0.5234708392603129
E01007895,1416,669,747,0.4724576271186441,0.527542372881356
E01007896,1225,602,623,0.49142857142857144,0.5085714285714286
E01007897,1322,647,675,0.48940998487140697,0.510590015128593
E01008134,1279,611,668,0.47771696637998434,0.5222830336200156
E01008135,1655,798,857,0.48217522658610273,0.5178247734138973
E01008137,1351,667,684,0.49370836417468544,0.5062916358253146
E01008141,1531,759,772,0.495754408883083,0.504245591116917
E01008053,1319,674,645,0.5109931766489765,0.4890068233510235
E01008056,1432,689,743,0.48114525139664804,0.5188547486033519
E01008058,1754,864,890,0.4925883694412771,0.507411630558723
E01008138,1253,586,667,0.4676775738228252,0.5323224261771747
E01008139,1522,739,783,0.4855453350854139,0.514454664914586
E01007856,1312,619,693,0.4717987804878049,0.5282012195121951
E01008054,1387,655,732,0.4722422494592646,0.5277577505407354
E01008055,1591,694,897,0.43620364550597107,0.5637963544940289
E01008057,1626,761,865,0.46801968019680196,0.531980319803198
E01008126,1552,754,798,0.48582474226804123,0.5141752577319587
E01008128,1807,874,933,0.48367459878251245,0.5163254012174876
E01008136,1387,695,692,0.5010814708002884,0.4989185291997116
E01008140,1867,919,948,0.4922335297268345,0.5077664702731655
E01033275,1599,807,792,0.5046904315196998,0.49530956848030017
E01033280,1571,793,778,0.5047740292807129,0.4952259707192871
E01008085,1330,623,707,0.46842105263157896,0.531578947368421
E01008086,1450,698,752,0.48137931034482756,0.5186206896551724
E01008116,1290,637,653,0.4937984496124031,0.506201550387597
E01008117,1829,906,923,0.4953526517222526,0.5046473482777474
E01008118,1383,686,697,0.4960231381055676,0.5039768618944324
E01008119,1355,640,715,0.47232472324723246,0.5276752767527675
E01008125,1534,759,775,0.49478487614080835,0.5052151238591917
E01007849,2116,1029,1087,0.4862948960302457,0.5137051039697542
E01007857,1682,748,934,0.4447086801426873,0.5552913198573127
E01008059,1648,789,859,0.4787621359223301,0.5212378640776699
E01008060,1549,715,834,0.4615881213686249,0.5384118786313751
E01008061,1670,800,870,0.47904191616766467,0.5209580838323353
E01008063,1399,709,690,0.5067905646890636,0.49320943531093636
E01033277,2987,1426,1561,0.4774020756611985,0.5225979243388015
E01008087,1479,714,765,0.4827586206896552,0.5172413793103449
E01008088,1359,673,686,0.4952170713760118,0.5047829286239882
E01008090,1635,786,849,0.48073394495412847,0.5192660550458715
E01008092,1443,706,737,0.48925848925848925,0.5107415107415108
E01008122,1646,770,876,0.46780072904009723,0.5321992709599028
E01008124,1469,694,775,0.472430224642614,0.527569775357386
E01007848,1794,853,941,0.4754738015607581,0.5245261984392419
E01007851,1491,753,738,0.5050301810865191,0.4949698189134809
E01007947,1542,738,804,0.4785992217898833,0.5214007782101168
E01007948,1653,752,901,0.45493042952208107,0.5450695704779189
E01008062,1684,815,869,0.4839667458432304,0.5160332541567696
E01007847,1287,669,618,0.5198135198135199,0.4801864801864802
E01007850,1383,669,714,0.4837310195227766,0.5162689804772235
E01007852,1492,781,711,0.5234584450402144,0.4765415549597855
E01007853,1750,874,876,0.49942857142857144,0.5005714285714286
E01007854,1433,699,734,0.48778785764131194,0.5122121423586881
E01007855,1989,1007,982,0.5062845651080945,0.4937154348919055
E01007941,1700,828,872,0.48705882352941177,0.5129411764705882
E01007945,1686,816,870,0.48398576512455516,0.5160142348754448
E01007946,1577,743,834,0.47114774889029803,0.528852251109702
E01007950,1553,738,815,0.4752092723760464,0.5247907276239536
E01008123,1394,659,735,0.4727403156384505,0.5272596843615495
E01007987,1427,695,732,0.48703573931324456,0.5129642606867554
E01007988,1476,709,767,0.4803523035230352,0.5196476964769647
E01007989,1403,679,724,0.4839629365645046,0.5160370634354954
E01007991,1514,693,821,0.45772787318361957,0.5422721268163805
E01007995,1510,755,755,0.5,0.5
E01008089,1689,842,847,0.4985198342214328,0.5014801657785672
E01008091,1392,693,699,0.4978448275862069,0.5021551724137931
E01008093,1425,694,731,0.4870175438596491,0.5129824561403509
E01007903,1644,808,836,0.49148418491484186,0.5085158150851582
E01007904,1709,842,867,0.49268578115857226,0.5073142188414277
E01007913,1582,803,779,0.5075853350189633,0.49241466498103664
E01007914,1569,809,760,0.5156150414276609,0.4843849585723391
E01007870,1793,935,858,0.5214723926380368,0.4785276073619632
E01007871,1786,904,882,0.5061590145576708,0.49384098544232924
E01007943,1753,854,899,0.48716486023958927,0.5128351397604107
E01008094,1203,571,632,0.4746467165419784,0.5253532834580216
E01007869,1601,784,817,0.4896939412866958,0.5103060587133041
E01007872,1802,894,908,0.4961154273029967,0.5038845726970034
E01007873,2216,1124,1092,0.5072202166064982,0.4927797833935018
E01007942,1880,960,920,0.5106382978723404,0.48936170212765956
E01007949,1754,904,850,0.5153933865450399,0.4846066134549601
E01007990,1434,694,740,0.4839609483960948,0.5160390516039052
E01007992,1505,729,776,0.48438538205980064,0.5156146179401994
E01007993,1626,782,844,0.48093480934809346,0.5190651906519065
E01007994,1343,637,706,0.4743112434847357,0.5256887565152644
E01007996,1659,812,847,0.48945147679324896,0.510548523206751
E01007874,1894,944,950,0.498416050686378,0.5015839493136219
E01007875,1811,943,868,0.5207067918277195,0.4792932081722805
E01007940,1819,918,901,0.5046728971962616,0.4953271028037383
E01033269,1854,942,912,0.5080906148867314,0.4919093851132686
E01033270,1633,892,741,0.5462339252908757,0.45376607470912433
E01034842,3354,1720,1634,0.5128205128205128,0.48717948717948717
E01008129,1637,809,828,0.49419670128283444,0.5058032987171656
E01008130,1545,754,791,0.4880258899676375,0.5119741100323625
E01008131,1600,790,810,0.49375,0.50625
E01008132,1326,636,690,0.4796380090497738,0.5203619909502263
E01008133,1509,711,798,0.4711729622266402,0.5288270377733598
E01008151,1511,777,734,0.514228987425546,0.485771012574454
E01008153,1637,811,826,0.4954184483811851,0.5045815516188149
E01008154,1639,787,852,0.4801708358755339,0.5198291641244661
E01008155,1425,719,706,0.5045614035087719,0.49543859649122807
E01008156,1464,730,734,0.49863387978142076,0.5013661202185792
E01008160,1349,648,701,0.48035581912527797,0.519644180874722
E01007997,1583,778,805,0.4914718888186987,0.5085281111813014
E01007998,1504,785,719,0.5219414893617021,0.47805851063829785
E01008152,1431,702,729,0.49056603773584906,0.5094339622641509
E01008158,1528,731,797,0.47840314136125656,0.5215968586387435
E01008065,2113,1154,959,0.5461429247515381,0.4538570752484619
E01008068,2285,1168,1117,0.5111597374179431,0.4888402625820569
E01008072,1664,840,824,0.5048076923076923,0.4951923076923077
E01008157,1626,803,823,0.49384993849938497,0.506150061500615
E01008161,1684,847,837,0.5029691211401425,0.4970308788598575
E01007883,1924,896,1028,0.4656964656964657,0.5343035343035343
E01007902,1712,856,856,0.5,0.5
E01007905,2074,1032,1042,0.49758919961427195,0.502410800385728
E01007906,2861,1438,1423,0.5026214610276127,0.49737853897238726
E01008064,1509,743,766,0.4923790589794566,0.5076209410205434
E01008066,1425,728,697,0.5108771929824562,0.48912280701754385
E01008069,1465,746,719,0.5092150170648464,0.4907849829351536
E01008074,1295,650,645,0.5019305019305019,0.4980694980694981
E01007951,1617,784,833,0.48484848484848486,0.5151515151515151
E01007960,1558,796,762,0.5109114249037228,0.4890885750962773
E01007962,1296,694,602,0.5354938271604939,0.4645061728395062
E01008159,1504,724,780,0.48138297872340424,0.5186170212765957
E01007866,1732,876,856,0.5057736720554272,0.4942263279445728
E01007867,1918,931,987,0.4854014598540146,0.5145985401459854
E01007868,1301,626,675,0.4811683320522675,0.5188316679477325
E01008067,1784,956,828,0.5358744394618834,0.4641255605381166
E01008073,1591,833,758,0.5235700817096166,0.4764299182903834
E01007907,1698,852,846,0.5017667844522968,0.49823321554770317
E01007908,1360,692,668,0.5088235294117647,0.49117647058823527
E01007909,2528,1303,1225,0.5154272151898734,0.48457278481012656
E01007911,1376,690,686,0.501453488372093,0.498546511627907
E01008014,1836,888,948,0.48366013071895425,0.5163398692810458
E01008016,1519,779,740,0.5128373930217248,0.4871626069782752
E01007952,1558,749,809,0.48074454428754815,0.5192554557124519
E01007953,1520,740,780,0.4868421052631579,0.5131578947368421
E01007954,1617,812,805,0.5021645021645021,0.49783549783549785
E01007961,1525,767,758,0.5029508196721312,0.4970491803278689
E01007863,1613,790,823,0.4897706137631742,0.5102293862368258
E01007864,1609,785,824,0.48788067122436296,0.512119328775637
E01008104,1380,671,709,0.486231884057971,0.513768115942029
E01034843,3055,1510,1545,0.49427168576104746,0.5057283142389526
E01007910,1819,849,970,0.4667399670148433,0.5332600329851567
E01007912,1439,710,729,0.49339819318971506,0.5066018068102849
E01007971,1492,712,780,0.4772117962466488,0.5227882037533512
E01007973,1531,757,774,0.49444807315480077,0.5055519268451992
E01007858,1373,653,720,0.47560087399854334,0.5243991260014567
E01007861,1582,785,797,0.49620733249051835,0.5037926675094817
E01007862,3539,1823,1716,0.5151172647640576,0.48488273523594233
E01007865,1744,819,925,0.46961009174311924,0.5303899082568807
E01008011,1871,836,1035,0.44681988241582044,0.5531801175841796
E01008012,2328,1152,1176,0.4948453608247423,0.5051546391752577
E01008013,2036,1013,1023,0.49754420432220037,0.5024557956777996
E01008015,1536,780,756,0.5078125,0.4921875
E01008017,1633,774,859,0.4739742804654011,0.5260257195345989
E01008018,1571,754,817,0.47994907702100575,0.5200509229789942
E01008105,2854,1593,1261,0.5581639803784163,0.44183601962158375
E01008107,1528,769,759,0.5032722513089005,0.4967277486910995
E01008111,1610,810,800,0.5031055900621118,0.4968944099378882
E01033271,2008,1013,995,0.5044820717131474,0.4955179282868526
E01033272,1579,827,752,0.5237492083597214,0.47625079164027867
E01007955,1425,703,722,0.49333333333333335,0.5066666666666667
E01007956,2115,1027,1088,0.48557919621749407,0.5144208037825059
E01007957,1651,821,830,0.49727437916414297,0.502725620835857
E01007958,1443,679,764,0.47054747054747054,0.5294525294525294
E01007959,1444,696,748,0.481994459833795,0.518005540166205
E01008108,1871,1033,838,0.5521111704970604,0.4478888295029396
E01008109,2887,1405,1482,0.486664357464496,0.513335642535504
E01008112,1749,953,796,0.544882790165809,0.45511720983419096
E01008113,1671,861,810,0.5152603231597845,0.48473967684021546
E01033273,2219,1197,1022,0.5394321766561514,0.4605678233438486
E01033274,2472,1293,1179,0.5230582524271845,0.47694174757281554
E01008095,1881,954,927,0.507177033492823,0.49282296650717705
E01008096,2337,1162,1175,0.4972186563970903,0.5027813436029097
E01008097,1437,665,772,0.4627696590118302,0.5372303409881698
E01008101,1805,867,938,0.48033240997229915,0.5196675900277008
E01007965,1868,859,1009,0.45985010706638113,0.5401498929336188
E01007969,1651,813,838,0.4924288310115082,0.5075711689884919
E01007972,1398,690,708,0.49356223175965663,0.5064377682403434
E01007974,1384,685,699,0.4949421965317919,0.505057803468208
E01007963,1428,704,724,0.49299719887955185,0.5070028011204482
E01007967,1789,860,929,0.480715483510341,0.519284516489659
E01007999,1236,640,596,0.517799352750809,0.48220064724919093
E01008008,1672,819,853,0.48983253588516745,0.5101674641148325
E01008009,1549,712,837,0.4596513879922531,0.540348612007747
E01008043,1753,853,900,0.48659440958357103,0.513405590416429
E01008044,1655,824,831,0.49788519637462236,0.5021148036253776
E01008047,1334,658,676,0.49325337331334335,0.5067466266866567
E01008048,1563,756,807,0.4836852207293666,0.5163147792706334
E01008050,1469,748,721,0.5091899251191286,0.49081007488087136
E01007931,1567,754,813,0.48117421825143586,0.5188257817485641
E01007934,1490,735,755,0.49328859060402686,0.5067114093959731
E01007935,1408,662,746,0.47017045454545453,0.5298295454545454
E01007936,1647,803,844,0.48755312689738917,0.5124468731026108
E01007937,1480,693,787,0.46824324324324323,0.5317567567567567
E01007938,1521,720,801,0.47337278106508873,0.5266272189349113
E01008098,1464,680,784,0.4644808743169399,0.5355191256830601
E01008100,1308,622,686,0.47553516819571867,0.5244648318042814
E01008102,1346,616,730,0.4576523031203566,0.5423476968796433
E01008103,1138,529,609,0.4648506151142355,0.5351493848857645
E01007964,1492,708,784,0.4745308310991957,0.5254691689008043
E01007966,1462,713,749,0.48768809849521205,0.512311901504788
E01007968,1424,689,735,0.48384831460674155,0.5161516853932584
E01007970,1445,718,727,0.49688581314878894,0.5031141868512111
E01008042,1834,951,883,0.5185387131952017,0.48146128680479827
E01008045,1344,673,671,0.5007440476190477,0.4992559523809524
E01008046,1611,801,810,0.4972067039106145,0.5027932960893855
E01008049,1645,821,824,0.4990881458966565,0.5009118541033435
E01008051,1721,827,894,0.48053457292271934,0.5194654270772806
E01008052,1714,899,815,0.5245040840140023,0.47549591598599766
E01007975,1528,746,782,0.4882198952879581,0.5117801047120419
E01007976,1389,648,741,0.46652267818574517,0.5334773218142549
E01007977,1491,788,703,0.528504359490275,0.47149564050972503
E01007979,1783,830,953,0.4655075715086932,0.5344924284913067
E01008099,1491,727,764,0.4875922199865862,0.5124077800134138
E01008000,1430,694,736,0.4853146853146853,0.5146853146853146
E01008001,1492,694,798,0.4651474530831099,0.5348525469168901
E01008004,1580,758,822,0.479746835443038,0.520253164556962
E01008005,1520,761,759,0.5006578947368421,0.4993421052631579
E01008010,1402,664,738,0.47360912981455067,0.5263908701854494
E01007978,1556,806,750,0.5179948586118251,0.4820051413881748
E01007980,1449,713,736,0.49206349206349204,0.5079365079365079
E01007981,1481,728,753,0.49155975692099935,0.5084402430790007
E01007983,1390,707,683,0.5086330935251798,0.4913669064748201
E01007985,1486,754,732,0.5074024226110363,0.49259757738896365
E01007982,1934,920,1014,0.4756980351602896,0.5243019648397105
E01008002,1575,807,768,0.5123809523809524,0.4876190476190476
E01008003,1342,650,692,0.4843517138599106,0.5156482861400894
E01008006,1436,719,717,0.5006963788300836,0.49930362116991645
E01007927,1571,749,822,0.4767663908338638,0.5232336091661363
E01007928,1742,845,897,0.48507462686567165,0.5149253731343284
E01007929,1971,975,996,0.4946727549467275,0.5053272450532724
E01007930,1431,697,734,0.48707197763801535,0.5129280223619846
E01007932,1480,720,760,0.4864864864864865,0.5135135135135135
E01007939,1609,822,787,0.5108763206960846,0.4891236793039155
E01008028,1526,758,768,0.4967234600262123,0.5032765399737876
E01008029,1488,731,757,0.49126344086021506,0.508736559139785
E01008032,1358,682,676,0.5022091310751104,0.49779086892488955
E01008034,1541,734,807,0.4763140817650876,0.5236859182349124
E01007828,1737,828,909,0.47668393782383417,0.5233160621761658
E01007829,1567,777,790,0.4958519463943842,0.5041480536056159
E01007831,1575,749,826,0.47555555555555556,0.5244444444444445
E01007832,1516,724,792,0.47757255936675463,0.5224274406332454
E01007986,1374,661,713,0.4810771470160116,0.5189228529839883
E01008007,1641,820,821,0.4996953077391834,0.5003046922608165
E01008075,1445,644,801,0.44567474048442907,0.554325259515571
E01008076,1381,667,714,0.4829833454018827,0.5170166545981173
E01008077,1551,717,834,0.4622823984526112,0.5377176015473888
E01008031,1376,681,695,0.4949127906976744,0.5050872093023255
E01008033,1200,575,625,0.4791666666666667,0.5208333333333334
E01008038,1445,695,750,0.4809688581314879,0.5190311418685121
E01008040,1585,787,798,0.4965299684542587,0.5034700315457413
E01007835,1335,640,695,0.4794007490636704,0.5205992509363296
E01007836,1583,782,801,0.4939987365761213,0.5060012634238787
E01007843,1680,808,872,0.48095238095238096,0.5190476190476191
E01007846,1381,667,714,0.4829833454018827,0.5170166545981173
E01008030,1422,673,749,0.4732770745428973,0.5267229254571026
E01008035,1154,570,584,0.49393414211438474,0.5060658578856152
E01008036,1327,672,655,0.506405425772419,0.493594574227581
E01008041,1300,637,663,0.49,0.51
E01007827,1876,936,940,0.4989339019189765,0.5010660980810234
E01007830,1466,703,763,0.4795361527967258,0.5204638472032742
E01007833,1661,797,864,0.4798314268512944,0.5201685731487056
E01007984,1413,700,713,0.4953998584571833,0.5046001415428167
E01008078,1474,733,741,0.4972862957937585,0.5027137042062415
E01008079,1203,592,611,0.4921030756442228,0.5078969243557773
E01008019,1782,865,917,0.48540965207631875,0.5145903479236813
E01008020,1236,619,617,0.5008090614886731,0.49919093851132684
E01008022,1426,730,696,0.511921458625526,0.48807854137447404
E01008027,1446,700,746,0.48409405255878285,0.5159059474412172
E01008037,1329,623,706,0.4687735139202408,0.5312264860797592
E01008039,1198,583,615,0.48664440734557596,0.513355592654424
E01007824,1332,655,677,0.49174174174174173,0.5082582582582582
E01007825,1439,676,763,0.4697706740792217,0.5302293259207783
E01007826,1494,728,766,0.48728246318607765,0.5127175368139224
E01007834,1610,776,834,0.48198757763975153,0.5180124223602485
E01007920,1721,825,896,0.47937245787332944,0.5206275421266705
E01007921,1735,812,923,0.4680115273775216,0.5319884726224784
E01007923,1865,879,986,0.471313672922252,0.528686327077748
E01007925,1779,845,934,0.4749859471613266,0.5250140528386734
E01007926,1715,839,876,0.4892128279883382,0.5107871720116618
E01007933,1671,816,855,0.4883303411131059,0.5116696588868941
E01007823,1678,799,879,0.4761620977353993,0.5238379022646007
E01007916,1572,708,864,0.45038167938931295,0.549618320610687
E01007919,1665,798,867,0.47927927927927927,0.5207207207207207
E01008080,1408,687,721,0.48792613636363635,0.5120738636363636
E01008081,1516,777,739,0.512532981530343,0.487467018469657
E01008082,1568,747,821,0.4764030612244898,0.5235969387755102
E01008083,1523,733,790,0.4812869336835194,0.5187130663164806
E01008084,1660,766,894,0.4614457831325301,0.5385542168674698
E01007915,1449,686,763,0.47342995169082125,0.5265700483091788
E01007917,1436,691,745,0.48119777158774374,0.5188022284122563
E01007918,1717,836,881,0.48689574839836924,0.5131042516016308
E01007922,1389,678,711,0.48812095032397407,0.5118790496760259
E01007924,1631,801,830,0.49110974862047824,0.5088902513795218
E01008021,1368,704,664,0.5146198830409356,0.4853801169590643
E01008023,2409,1209,1200,0.50186799501868,0.49813200498132004
E01008024,2184,1074,1110,0.49175824175824173,0.5082417582417582
E01008025,1985,944,1041,0.4755667506297229,0.5244332493702771
E01032585,1324,637,687,0.4811178247734139,0.5188821752265861
E01033261,2423,1262,1161,0.5208419314898886,0.47915806851011145
E01033262,2242,1223,1019,0.5454950936663693,0.45450490633363066
E01033263,2103,1091,1012,0.5187826913932477,0.48121730860675227
E01033264,1986,1038,948,0.5226586102719033,0.4773413897280967
E01033276,1841,1005,836,0.5458989679521999,0.4541010320478001
E01008114,2708,1361,1347,0.5025849335302807,0.49741506646971934
E01008115,1508,790,718,0.5238726790450928,0.4761273209549072
E01033265,1470,825,645,0.5612244897959183,0.4387755102040816
E01034844,2163,1151,1012,0.5321312991215904,0.4678687008784096
E01007878,1312,606,706,0.46189024390243905,0.538109756097561
E01007879,1488,820,668,0.5510752688172043,0.4489247311827957
E01007881,1533,765,768,0.49902152641878667,0.5009784735812133
E01007882,1476,754,722,0.510840108401084,0.489159891598916
E01007885,1979,941,1038,0.47549267306720566,0.5245073269327943
E01007886,1615,747,868,0.46253869969040246,0.5374613003095975
E01033268,2674,1498,1176,0.5602094240837696,0.4397905759162304
E01007838,1433,716,717,0.49965108164689465,0.5003489183531054
E01007839,1598,792,806,0.4956195244055069,0.5043804755944932
E01007841,1511,726,785,0.4804765056254136,0.5195234943745863
E01007842,1572,749,823,0.47646310432569977,0.5235368956743003
E01033279,2301,1117,1184,0.48544111255975664,0.5145588874402434
E01034845,1328,649,679,0.48870481927710846,0.5112951807228916
E01034846,1385,659,726,0.47581227436823104,0.524187725631769
E01010646,1348,609,739,0.45178041543026703,0.548219584569733
E01010647,1057,500,557,0.47303689687795647,0.5269631031220435
E01010648,1379,658,721,0.47715736040609136,0.5228426395939086
E01010692,1917,904,1013,0.4715701617110068,0.5284298382889933
E01010691,1576,754,822,0.4784263959390863,0.5215736040609137
E01010693,1476,716,760,0.48509485094850946,0.5149051490514905
E01010694,1541,738,803,0.4789097988319273,0.5210902011680727
E01010695,1554,709,845,0.45624195624195624,0.5437580437580437
E01010696,1611,795,816,0.4934823091247672,0.5065176908752328
E01010697,1449,666,783,0.45962732919254656,0.5403726708074534
E01010698,1933,910,1023,0.47077082255561303,0.5292291774443869
E01010699,1977,932,1045,0.4714213454729388,0.5285786545270612
E01010767,1444,700,744,0.48476454293628807,0.5152354570637119
E01010768,1626,803,823,0.49384993849938497,0.506150061500615
E01010769,1567,753,814,0.4805360561582642,0.5194639438417358
E01010771,1224,599,625,0.48937908496732024,0.5106209150326797
E01010770,1768,900,868,0.5090497737556561,0.49095022624434387
E01010772,1269,618,651,0.48699763593380613,0.5130023640661938
E01010773,1562,775,787,0.49615877080665816,0.5038412291933418
E01010774,1596,776,820,0.48621553884711777,0.5137844611528822
E01010706,1564,758,806,0.4846547314578005,0.5153452685421995
E01010707,1831,958,873,0.523211359912616,0.4767886400873839
E01010708,1675,823,852,0.49134328358208956,0.5086567164179104
E01010709,2718,1340,1378,0.493009565857248,0.506990434142752
E01010719,1862,940,922,0.5048335123523093,0.49516648764769067
E01010727,1707,870,837,0.5096660808435852,0.4903339191564148
E01010728,1894,941,953,0.4968321013727561,0.503167898627244
E01010729,1723,833,890,0.4834590829947766,0.5165409170052234
E01010700,1644,831,813,0.5054744525547445,0.49452554744525545
E01010701,1505,739,766,0.49102990033222593,0.5089700996677741
E01010702,2060,1002,1058,0.48640776699029126,0.5135922330097087
E01010703,1661,773,888,0.4653822998193859,0.534617700180614
E01010704,1359,680,679,0.5003679175864606,0.49963208241353935
E01010705,1654,776,878,0.46916565900846435,0.5308343409915357
E01010710,2001,1086,915,0.5427286356821589,0.4572713643178411
E01010712,1701,861,840,0.5061728395061729,0.49382716049382713
E01010720,1522,706,816,0.46386333771353483,0.5361366622864652
E01010721,1922,914,1008,0.4755463059313215,0.5244536940686785
E01010723,1582,779,803,0.49241466498103664,0.5075853350189633
E01010724,1386,673,713,0.4855699855699856,0.5144300144300145
E01010725,1533,740,793,0.4827136333985649,0.5172863666014351
E01010579,1509,743,766,0.4923790589794566,0.5076209410205434
E01010580,2513,1214,1299,0.48308794269797056,0.5169120573020295
E01010764,1620,801,819,0.49444444444444446,0.5055555555555555
E01010765,2282,1103,1179,0.48334794040315515,0.5166520595968449
E01010766,1216,574,642,0.4720394736842105,0.5279605263157895
E01010711,1535,845,690,0.5504885993485342,0.4495114006514658
E01010713,1567,742,825,0.47351627313337585,0.5264837268666241
E01010714,1383,669,714,0.4837310195227766,0.5162689804772235
E01010716,1990,996,994,0.5005025125628141,0.4994974874371859
E01010715,1065,493,572,0.4629107981220657,0.5370892018779343
E01010717,1636,747,889,0.456601466992665,0.543398533007335
E01010718,1515,712,803,0.46996699669966996,0.53003300330033
E01010726,1426,721,705,0.5056100981767181,0.4943899018232819
E01010859,1837,874,963,0.4757757212847033,0.5242242787152966
E01010573,1830,904,926,0.49398907103825135,0.5060109289617486
E01010574,1406,666,740,0.47368421052631576,0.5263157894736842
E01010575,1574,752,822,0.4777636594663278,0.5222363405336722
E01010577,1552,762,790,0.49097938144329895,0.509020618556701
E01010722,1639,816,823,0.4978645515558267,0.5021354484441732
E01010860,1723,842,881,0.4886825304701103,0.5113174695298898
E01010862,1634,800,834,0.48959608323133413,0.5104039167686658
E01010863,1413,698,715,0.49398443029016276,0.5060155697098372
E01010578,1604,788,816,0.4912718204488778,0.5087281795511222
E01010581,1645,814,831,0.4948328267477204,0.5051671732522797
E01010582,1669,814,855,0.487717195925704,0.5122828040742959
E01010584,1769,856,913,0.4838892029395139,0.5161107970604861
E01010585,2009,975,1034,0.48531607765057244,0.5146839223494276
E01010568,1719,866,853,0.5037812681791739,0.49621873182082604
E01010569,1756,853,903,0.4857630979498861,0.5142369020501139
E01010571,1944,978,966,0.5030864197530864,0.49691358024691357
E01010572,1483,714,769,0.48145650708024273,0.5185434929197572
E01010576,1516,716,800,0.47229551451187335,0.5277044854881267
E01010683,2299,1128,1171,0.49064810787298824,0.5093518921270117
E01010684,1508,702,806,0.46551724137931033,0.5344827586206896
E01010685,1680,815,865,0.4851190476190476,0.5148809523809523
E01010686,1755,860,895,0.49002849002849,0.50997150997151
E01010570,1498,753,745,0.5026702269692924,0.49732977303070763
E01010583,1260,627,633,0.4976190476190476,0.5023809523809524
E01010784,1579,742,837,0.46991766941101965,0.5300823305889804
E01010785,1569,731,838,0.46590184831102616,0.5340981516889739
E01010786,1587,740,847,0.46628859483301827,0.5337114051669817
E01010790,1601,764,837,0.4772017489069332,0.5227982510930669
E01010680,1789,814,975,0.45500279485746226,0.5449972051425377
E01010681,1503,744,759,0.49500998003992014,0.5049900199600799
E01010682,1433,661,772,0.4612700628053036,0.5387299371946964
E01010687,1802,887,915,0.49223085460599336,0.5077691453940066
E01010688,1901,952,949,0.5007890583903208,0.4992109416096791
E01010689,1954,959,995,0.4907881269191402,0.5092118730808598
E01010690,1859,910,949,0.48951048951048953,0.5104895104895105
E01010782,2225,1112,1113,0.4997752808988764,0.5002247191011236
E01010787,1562,759,803,0.4859154929577465,0.5140845070422535
E01010788,1394,705,689,0.505738880918221,0.49426111908177905
E01033689,1249,691,558,0.5532425940752602,0.4467574059247398
E01033694,1059,539,520,0.5089707271010387,0.4910292728989613
E01010776,1608,780,828,0.48507462686567165,0.5149253731343284
E01010777,1472,750,722,0.5095108695652174,0.4904891304347826
E01010779,1609,750,859,0.4661280298321939,0.5338719701678061
E01010781,1475,692,783,0.46915254237288134,0.5308474576271186
E01010783,1572,769,803,0.4891857506361323,0.5108142493638677
E01010586,1602,748,854,0.46691635455680397,0.533083645443196
E01010587,2062,999,1063,0.4844810863239573,0.5155189136760426
E01010588,1585,752,833,0.4744479495268139,0.5255520504731861
E01010589,1355,619,736,0.45682656826568263,0.5431734317343173
E01010591,1593,764,829,0.4795982423101067,0.5204017576898933
E01010593,1698,791,907,0.4658421672555948,0.5341578327444052
E01010596,1536,740,796,0.4817708333333333,0.5182291666666666
E01010854,1736,855,881,0.4925115207373272,0.5074884792626728
E01010855,1613,794,819,0.4922504649721017,0.5077495350278983
E01010856,1478,700,778,0.4736129905277402,0.5263870094722598
E01010857,1614,783,831,0.4851301115241636,0.5148698884758365
E01010858,1569,767,802,0.4888463989802422,0.5111536010197578
E01010861,1767,880,887,0.4980192416525184,0.5019807583474816
E01010603,1626,786,840,0.4833948339483395,0.5166051660516605
E01010604,1800,883,917,0.4905555555555556,0.5094444444444445
E01010605,1599,789,810,0.49343339587242024,0.5065666041275797
E01010775,1778,881,897,0.4955005624296963,0.5044994375703037
E01010778,2040,965,1075,0.4730392156862745,0.5269607843137255
E01010789,1834,905,929,0.49345692475463465,0.5065430752453653
E01010791,1832,926,906,0.5054585152838428,0.4945414847161572
E01010792,1989,983,1006,0.49421820010055306,0.5057817998994469
E01010793,1845,932,913,0.5051490514905149,0.4948509485094851
E01010652,1661,809,852,0.48705599036724867,0.5129440096327513
E01010653,1968,938,1030,0.4766260162601626,0.5233739837398373
E01010655,1506,674,832,0.44754316069057104,0.5524568393094289
E01010656,1560,741,819,0.475,0.525
E01010657,1440,659,781,0.4576388888888889,0.5423611111111111
E01010649,1457,758,699,0.5202470830473576,0.47975291695264244
E01010650,2168,1008,1160,0.46494464944649444,0.5350553505535055
E01010654,1712,825,887,0.48189252336448596,0.518107476635514
E01010826,1670,824,846,0.4934131736526946,0.5065868263473053
E01010597,1544,767,777,0.49676165803108807,0.5032383419689119
E01010598,1671,802,869,0.4799521244763615,0.5200478755236385
E01010599,1374,653,721,0.475254730713246,0.524745269286754
E01010600,1448,678,770,0.468232044198895,0.5317679558011049
E01010602,1654,816,838,0.49334945586457074,0.5066505441354293
E01010670,1843,912,931,0.4948453608247423,0.5051546391752577
E01010671,1735,837,898,0.48242074927953893,0.5175792507204611
E01010673,1977,1034,943,0.5230146686899343,0.47698533131006576
E01010675,2154,1077,1077,0.5,0.5
E01010669,2231,1035,1196,0.4639175257731959,0.5360824742268041
E01010674,2273,1120,1153,0.49274087109546855,0.5072591289045315
E01010805,1838,921,917,0.501088139281828,0.49891186071817195
E01033898,1594,783,811,0.49121706398996234,0.5087829360100377
E01033899,1651,757,894,0.4585099939430648,0.5414900060569352
E01010590,2200,1073,1127,0.48772727272727273,0.5122727272727273
E01010592,1665,753,912,0.45225225225225224,0.5477477477477477
E01010594,1670,796,874,0.47664670658682634,0.5233532934131736
E01010595,2137,1065,1072,0.4983621899859616,0.5016378100140384
E01010601,1831,887,944,0.4844347351174222,0.5155652648825778
E01010651,1671,831,840,0.49730700179533216,0.5026929982046678
E01010825,1539,756,783,0.49122807017543857,0.5087719298245614
E01010827,1557,817,740,0.5247270391779062,0.47527296082209375
E01010804,2292,1134,1158,0.49476439790575916,0.5052356020942408
E01010806,1683,812,871,0.48247177658942364,0.5175282234105764
E01010807,2326,1190,1136,0.5116079105760963,0.4883920894239037
E01010808,2335,1155,1180,0.49464668094218417,0.5053533190578159
E01010809,2152,1041,1111,0.4837360594795539,0.5162639405204461
E01010676,2420,1207,1213,0.4987603305785124,0.5012396694214876
E01010679,2103,1048,1055,0.4983357108892059,0.5016642891107941
E01010824,1917,958,959,0.4997391757955138,0.5002608242044861
E01010840,1882,936,946,0.4973432518597237,0.5026567481402763
E01010841,1835,963,872,0.5247956403269755,0.47520435967302455
E01010828,1640,789,851,0.48109756097560974,0.5189024390243903
E01010829,1694,877,817,0.5177095631641087,0.4822904368358914
E01010830,2429,1233,1196,0.507616303005352,0.492383696994648
E01010831,2197,1147,1050,0.5220755575785162,0.47792444242148385
E01010832,2429,1183,1246,0.48703170028818443,0.5129682997118156
E01010672,1347,661,686,0.49072011878247956,0.5092798812175204
E01010678,1419,719,700,0.5066948555320648,0.49330514446793516
E01010799,1598,775,823,0.48498122653316644,0.5150187734668336
E01010800,1833,856,977,0.46699399890889254,0.5330060010911075
E01010801,2025,988,1037,0.48790123456790124,0.5120987654320988
E01010802,2065,961,1104,0.46537530266343824,0.5346246973365617
E01010803,1916,923,993,0.48173277661795405,0.5182672233820459
E01010810,2219,1099,1120,0.4952681388012618,0.5047318611987381
E01010811,2249,1099,1150,0.4886616273899511,0.5113383726100489
E01010813,1905,940,965,0.49343832020997375,0.5065616797900262
E01010618,1805,880,925,0.48753462603878117,0.5124653739612188
E01010619,2216,1084,1132,0.4891696750902527,0.5108303249097473
E01010625,1847,881,966,0.47698971304818627,0.5230102869518137
E01010626,2144,1069,1075,0.4986007462686567,0.5013992537313433
E01010627,1662,835,827,0.5024067388688327,0.49759326113116725
E01010628,1857,900,957,0.48465266558966075,0.5153473344103393
E01010629,2309,1110,1199,0.48072758770030316,0.5192724122996968
E01010630,1941,950,991,0.48943843379701185,0.5105615662029882
E01010631,1591,740,851,0.46511627906976744,0.5348837209302325
E01010632,1536,734,802,0.4778645833333333,0.5221354166666666
E01010658,1987,966,1021,0.48616004026170107,0.513839959738299
E01010812,2074,1066,1008,0.5139826422372228,0.48601735776277727
E01010833,1741,863,878,0.4956921309592188,0.5043078690407812
E01010843,2045,1021,1024,0.49926650366748165,0.5007334963325183
E01010620,2011,1021,990,0.5077076081551467,0.4922923918448533
E01010621,2336,1199,1137,0.5132705479452054,0.4867294520547945
E01010622,2627,1290,1337,0.49105443471640653,0.5089455652835935
E01010623,1699,869,830,0.5114773396115362,0.4885226603884638
E01010624,2170,1115,1055,0.5138248847926268,0.4861751152073733
E01010794,1983,952,1031,0.4800806858295512,0.5199193141704488
E01010795,1939,962,977,0.4961320268179474,0.5038679731820526
E01010796,1692,816,876,0.48226950354609927,0.5177304964539007
E01010797,1414,701,713,0.4957567185289958,0.5042432814710043
E01010798,1503,743,760,0.49434464404524286,0.5056553559547572
E01010834,2849,1519,1330,0.5331695331695332,0.4668304668304668
E01010836,2051,1090,961,0.5314480741101901,0.4685519258898099
E01010837,2108,1040,1068,0.49335863377609107,0.5066413662239089
E01010838,2184,1118,1066,0.5119047619047619,0.4880952380952381
E01010839,1683,826,857,0.49079025549613786,0.5092097445038621
E01033900,1584,814,770,0.5138888888888888,0.4861111111111111
E01033901,1666,822,844,0.49339735894357745,0.5066026410564226
E01010608,1739,846,893,0.4864864864864865,0.5135135135135135
E01010613,1644,762,882,0.4635036496350365,0.5364963503649635
E01010730,1278,691,587,0.5406885758998435,0.4593114241001565
E01010734,1552,786,766,0.5064432989690721,0.49355670103092786
E01010609,1614,762,852,0.4721189591078067,0.5278810408921933
E01010610,2096,965,1131,0.4604007633587786,0.5395992366412213
E01010611,2226,1075,1151,0.4829290206648697,0.5170709793351302
E01010614,1708,946,762,0.5538641686182669,0.446135831381733
E01010633,1505,733,772,0.4870431893687708,0.5129568106312292
E01010634,1569,762,807,0.48565965583174,0.51434034416826
E01010635,1460,692,768,0.473972602739726,0.5260273972602739
E01010636,1701,803,898,0.4720752498530276,0.5279247501469724
E01010637,2050,734,1316,0.35804878048780486,0.6419512195121951
E01010731,1615,884,731,0.5473684210526316,0.45263157894736844
E01010732,1613,786,827,0.48729076255424675,0.5127092374457533
E01010733,1668,852,816,0.5107913669064749,0.4892086330935252
E01010736,2057,1019,1038,0.49538162372386974,0.5046183762761303
E01010737,1680,839,841,0.4994047619047619,0.5005952380952381
E01010659,1957,888,1069,0.45375574859478796,0.546244251405212
E01010662,1483,708,775,0.47741065407956845,0.5225893459204316
E01010664,1594,790,804,0.49560853199498117,0.5043914680050188
E01010761,1714,805,909,0.46966161026837805,0.530338389731622
E01033695,2168,996,1172,0.45940959409594095,0.540590405904059
E01033696,1592,785,807,0.49309045226130654,0.5069095477386935
E01033697,2824,1402,1422,0.4964589235127479,0.5035410764872521
E01010663,1797,889,908,0.49471341124095713,0.5052865887590429
E01010665,1899,921,978,0.4849921011058452,0.5150078988941548
E01010666,1759,820,939,0.4661739624786811,0.533826037521319
E01010667,1862,928,934,0.4983888292158969,0.5016111707841031
E01010735,1876,946,930,0.5042643923240938,0.4957356076759062
E01010738,2064,1055,1009,0.5111434108527132,0.4888565891472868
E01010739,2075,1079,996,0.52,0.48
E01010740,1920,988,932,0.5145833333333333,0.48541666666666666
E01010744,1843,896,947,0.4861638632664135,0.5138361367335865
E01010612,1448,724,724,0.5,0.5
E01010819,1493,738,755,0.4943067649028801,0.5056932350971199
E01010820,1454,721,733,0.4958734525447043,0.5041265474552957
E01010821,1931,862,1069,0.44640082858622476,0.5535991714137752
E01010822,1273,622,651,0.48860958366064416,0.5113904163393559
E01010615,1370,674,696,0.491970802919708,0.5080291970802919
E01010616,1934,913,1021,0.4720785935884178,0.5279214064115823
E01010742,2096,1029,1067,0.49093511450381677,0.5090648854961832
E01010743,1675,883,792,0.5271641791044777,0.4728358208955224
E01010847,1619,791,828,0.48857319332921556,0.5114268066707844
E01010848,1585,754,831,0.4757097791798107,0.5242902208201893
E01010852,1957,936,1021,0.4782830863566684,0.5217169136433316
E01010853,1430,704,726,0.49230769230769234,0.5076923076923077
E01010668,1475,713,762,0.48338983050847456,0.5166101694915254
E01010755,2006,928,1078,0.4626121635094716,0.5373878364905285
E01010762,1572,771,801,0.4904580152671756,0.5095419847328244
E01010763,1647,800,847,0.48573163327261687,0.5142683667273831
E01010846,2138,1005,1133,0.4700654817586529,0.5299345182413471
E01010745,1898,932,966,0.4910432033719705,0.5089567966280295
E01010747,1606,787,819,0.4900373599003736,0.5099626400996264
E01010748,1612,765,847,0.47456575682382135,0.5254342431761787
E01010749,1337,612,725,0.45774121166791326,0.5422587883320867
E01010814,1625,781,844,0.4806153846153846,0.5193846153846153
E01010815,2591,1265,1326,0.4882284832111154,0.5117715167888846
E01010816,1912,962,950,0.5031380753138075,0.49686192468619245
E01010817,2660,1241,1419,0.46654135338345865,0.5334586466165413
E01010818,2082,1024,1058,0.4918347742555235,0.5081652257444764
E01010752,2125,1048,1077,0.49317647058823527,0.5068235294117647
E01010753,1316,651,665,0.4946808510638298,0.5053191489361702
E01010754,1558,768,790,0.49293966623876767,0.5070603337612324
E01010756,1801,899,902,0.4991671293725708,0.5008328706274292
E01010758,1293,639,654,0.494199535962877,0.505800464037123
E01010759,1557,784,773,0.5035324341682723,0.4964675658317277
E01010760,1918,967,951,0.5041710114702815,0.49582898852971846
E01010741,1400,662,738,0.47285714285714286,0.5271428571428571
E01010845,2096,985,1111,0.4699427480916031,0.5300572519083969
E01010849,1399,688,711,0.49177984274481773,0.5082201572551823
E01010850,1392,671,721,0.48204022988505746,0.5179597701149425
E01010851,1424,695,729,0.488061797752809,0.511938202247191
E01010864,1239,612,627,0.4939467312348668,0.5060532687651331
E01010867,1756,878,878,0.5,0.5
E01010874,1511,706,805,0.4672402382528127,0.5327597617471873
E01010746,2042,983,1059,0.4813907933398629,0.5186092066601371
E01010750,1521,735,786,0.4832347140039448,0.5167652859960552
E01010751,1400,684,716,0.48857142857142855,0.5114285714285715
E01010865,1595,778,817,0.4877742946708464,0.5122257053291536
E01010866,1324,647,677,0.48867069486404835,0.5113293051359517
E01010868,1663,797,866,0.4792543595911004,0.5207456404088996
E01010869,1760,819,941,0.4653409090909091,0.5346590909090909
E01010870,1421,684,737,0.4813511611541168,0.5186488388458832
E01010871,1715,851,864,0.49620991253644314,0.5037900874635568
E01010872,1864,857,1007,0.45976394849785407,0.5402360515021459
E01010873,1204,577,627,0.4792358803986711,0.520764119601329
E01010638,1431,708,723,0.4947589098532495,0.5052410901467506
E01010642,2054,993,1061,0.4834469328140214,0.5165530671859786
E01010643,1350,682,668,0.5051851851851852,0.4948148148148148
E01010644,2058,971,1087,0.4718172983479106,0.5281827016520894
E01010645,1801,874,927,0.4852859522487507,0.5147140477512493
E01010639,1996,1005,991,0.5035070140280561,0.4964929859719439
E01010640,1707,840,867,0.492091388400703,0.507908611599297
E01010641,1520,714,806,0.4697368421052632,0.5302631578947369
E01010606,2043,1060,983,0.5188448360254527,0.4811551639745472
E01010607,2147,1082,1065,0.503959012575687,0.496040987424313
E01010617,1717,822,895,0.47874199184624344,0.5212580081537566
E01033692,1114,609,505,0.5466786355475763,0.4533213644524237
E01033693,2833,1449,1384,0.5114719378750441,0.48852806212495586
E01010842,2304,1218,1086,0.5286458333333334,0.4713541666666667
E01033690,1858,1025,833,0.5516684607104413,0.44833153928955866
E01033691,2285,1206,1079,0.5277899343544857,0.4722100656455142
E01010911,1741,838,903,0.4813325674899483,0.5186674325100517
E01010912,1530,715,815,0.4673202614379085,0.5326797385620915
E01010913,1295,633,662,0.4888030888030888,0.5111969111969112
E01010915,1507,738,769,0.48971466489714666,0.5102853351028533
E01010914,1614,802,812,0.4969021065675341,0.5030978934324659
E01010924,1068,512,556,0.4794007490636704,0.5205992509363296
E01010925,1512,729,783,0.48214285714285715,0.5178571428571429
E01010926,1204,565,639,0.4692691029900332,0.5307308970099668
E01010931,1421,676,745,0.4757213230119634,0.5242786769880365
E01010932,1551,756,795,0.4874274661508704,0.5125725338491296
E01010933,1675,822,853,0.49074626865671644,0.5092537313432836
E01010935,1402,669,733,0.47717546362339514,0.5228245363766049
E01010936,2017,962,1055,0.4769459593455627,0.5230540406544373
E01010937,1499,713,786,0.47565043362241494,0.524349566377585
E01010881,1568,744,824,0.4744897959183674,0.5255102040816326
E01010882,1321,637,684,0.4822104466313399,0.5177895533686601
E01010883,1574,771,803,0.4898348157560356,0.5101651842439644
E01010887,1464,724,740,0.49453551912568305,0.505464480874317
E01010888,1451,673,778,0.4638180565127498,0.5361819434872501
E01010923,1560,733,827,0.46987179487179487,0.5301282051282051
E01010916,1556,713,843,0.4582262210796915,0.5417737789203085
E01010939,1659,829,830,0.49969861362266427,0.5003013863773358
E01010941,1391,665,726,0.47807332854061824,0.5219266714593818
E01010942,1778,895,883,0.5033745781777278,0.4966254218222722
E01010944,1395,649,746,0.4652329749103943,0.5347670250896057
E01010938,1523,691,832,0.45370978332239004,0.54629021667761
E01010940,1422,689,733,0.48452883263009844,0.5154711673699015
E01010943,1475,717,758,0.48610169491525423,0.5138983050847458
E01010961,1193,586,607,0.4911986588432523,0.5088013411567477
E01010917,1763,833,930,0.47249007373794666,0.5275099262620533
E01010918,1647,802,845,0.4869459623557984,0.5130540376442015
E01010919,1588,763,825,0.4804785894206549,0.5195214105793451
E01010920,1598,817,781,0.5112640801001251,0.48873591989987486
E01010921,1621,815,806,0.5027760641579272,0.4972239358420728
E01010934,1954,952,1002,0.4872057318321392,0.5127942681678608
E01010967,1513,779,734,0.5148711169861203,0.4851288830138797
E01032923,2129,1063,1066,0.4992954438703617,0.5007045561296384
E01034582,1306,749,557,0.5735068912710567,0.42649310872894336
E01034583,1039,560,479,0.5389797882579404,0.46102021174205965
E01010927,2265,1116,1149,0.49271523178807947,0.5072847682119205
E01010928,1468,710,758,0.48365122615803813,0.5163487738419619
E01010997,1495,733,762,0.4903010033444816,0.5096989966555184
E01010999,1553,750,803,0.48293625241468124,0.5170637475853187
E01010929,2729,1362,1367,0.49908391352143644,0.5009160864785636
E01010930,1679,810,869,0.48243001786777845,0.5175699821322216
E01010998,1783,885,898,0.4963544587773416,0.5036455412226585
E01011000,2413,1144,1269,0.47409863240779115,0.5259013675922088
E01010904,1589,784,805,0.4933920704845815,0.5066079295154186
E01010906,1427,670,757,0.4695164681149264,0.5304835318850736
E01010907,1474,724,750,0.49118046132971505,0.508819538670285
E01010909,1727,780,947,0.451650260567458,0.548349739432542
E01010960,1605,799,806,0.49781931464174456,0.5021806853582554
E01010964,1617,799,818,0.4941249226963513,0.5058750773036488
E01010965,1400,709,691,0.5064285714285715,0.49357142857142855
E01010966,1737,843,894,0.4853195164075993,0.5146804835924007
E01010995,1360,691,669,0.5080882352941176,0.4919117647058823
E01010982,1359,655,704,0.481972038263429,0.5180279617365711
E01010983,1637,790,847,0.48259010384850337,0.5174098961514967
E01010985,1429,685,744,0.4793561931420574,0.5206438068579426
E01010986,1726,849,877,0.4918887601390498,0.5081112398609502
E01010987,1867,885,982,0.4740224959828602,0.5259775040171398
E01010988,1438,677,761,0.47079276773296247,0.5292072322670376
E01010996,1495,726,769,0.48561872909698994,0.51438127090301
E01011001,1687,850,837,0.5038529934795495,0.4961470065204505
E01011002,1865,938,927,0.5029490616621984,0.4970509383378016
E01011003,1497,773,724,0.5163660654642619,0.48363393453573816
E01010878,1654,830,824,0.501813784764208,0.49818621523579204
E01010879,1798,885,913,0.4922135706340378,0.5077864293659622
E01010905,1951,940,1011,0.48180420297283444,0.5181957970271656
E01010908,2162,1044,1118,0.482886216466235,0.517113783533765
E01010910,1319,644,675,0.488248673237301,0.511751326762699
E01010969,1760,859,901,0.48806818181818185,0.5119318181818182
E01010970,2027,991,1036,0.48889985199802666,0.5111001480019733
E01010974,1516,725,791,0.4782321899736148,0.5217678100263852
E01010977,1835,888,947,0.48392370572207083,0.5160762942779291
E01010975,1468,680,788,0.46321525885558584,0.5367847411444142
E01010976,1869,904,965,0.48368111289459603,0.516318887105404
E01010978,1387,690,697,0.4974765681326604,0.5025234318673396
E01010979,1383,731,652,0.5285610990600145,0.47143890093998553
E01010980,1495,724,771,0.4842809364548495,0.5157190635451505
E01010981,1457,708,749,0.48592999313658203,0.514070006863418
E01010989,1471,751,720,0.5105370496261047,0.4894629503738953
E01010990,1604,782,822,0.48753117206982544,0.5124688279301746
E01010991,1423,690,733,0.4848910751932537,0.5151089248067463
E01010992,1711,856,855,0.5002922267679719,0.49970777323202803
E01010993,1721,832,889,0.4834398605461941,0.516560139453806
E01010875,1697,787,910,0.4637595757218621,0.5362404242781379
E01010876,1603,755,848,0.470991890205864,0.529008109794136
E01010877,1431,722,709,0.5045422781271838,0.4954577218728162
E01010880,1370,652,718,0.4759124087591241,0.5240875912408759
E01010949,1569,784,785,0.4996813256851498,0.5003186743148502
E01010922,1815,892,923,0.4914600550964187,0.5085399449035812
E01010956,1634,782,852,0.4785801713586291,0.5214198286413708
E01010958,1323,631,692,0.47694633408919124,0.5230536659108088
E01010959,1725,830,895,0.4811594202898551,0.518840579710145
E01010968,1765,868,897,0.49178470254957507,0.5082152974504249
E01010971,1943,952,991,0.489963973237262,0.5100360267627381
E01010972,1613,757,856,0.46931184128952264,0.5306881587104774
E01010973,1744,838,906,0.4805045871559633,0.5194954128440367
E01010884,1614,770,844,0.4770755885997522,0.5229244114002478
E01010885,1513,715,798,0.47257105089226703,0.527428949107733
E01010886,1123,562,561,0.5004452359750667,0.4995547640249332
E01010984,1360,663,697,0.4875,0.5125
E01010946,1287,634,653,0.4926184926184926,0.5073815073815073
E01010947,1482,740,742,0.4993252361673414,0.5006747638326585
E01010950,1458,746,712,0.5116598079561042,0.4883401920438957
E01010951,1512,726,786,0.4801587301587302,0.5198412698412699
E01010891,1722,832,890,0.4831591173054588,0.5168408826945412
E01010892,1901,934,967,0.49132035770647026,0.5086796422935297
E01010895,1383,690,693,0.49891540130151846,0.5010845986984815
E01010945,1566,753,813,0.48084291187739464,0.5191570881226054
E01010948,1415,702,713,0.496113074204947,0.503886925795053
E01010889,1706,851,855,0.4988276670574443,0.5011723329425557
E01010890,1773,880,893,0.49633389734912575,0.5036661026508742
E01010893,1446,669,777,0.46265560165975106,0.5373443983402489
E01010894,1821,846,975,0.4645799011532125,0.5354200988467874
E01010901,1865,919,946,0.4927613941018767,0.5072386058981233
E01010903,1692,796,896,0.47044917257683216,0.5295508274231678
E01010896,1593,780,813,0.4896421845574388,0.5103578154425612
E01010897,1656,819,837,0.4945652173913043,0.5054347826086957
E01010898,1643,808,835,0.4917833231892879,0.5082166768107121
E01010899,1361,640,721,0.47024246877296105,0.529757531227039
E01010900,1587,772,815,0.4864524259609326,0.5135475740390675
E01010902,1548,773,775,0.49935400516795864,0.5006459948320413
E01010952,1635,796,839,0.4868501529051988,0.5131498470948013
E01010953,1505,743,762,0.493687707641196,0.506312292358804
E01010954,2491,1232,1259,0.49458048976314734,0.5054195102368527
E01010955,1404,718,686,0.5113960113960114,0.4886039886039886
E01010957,1481,701,780,0.47332883187035785,0.5266711681296421
E01011051,1684,796,888,0.47268408551068886,0.5273159144893111
E01011055,1282,623,659,0.4859594383775351,0.5140405616224649
E01011056,1680,798,882,0.475,0.525
E01011057,1644,783,861,0.4762773722627737,0.5237226277372263
E01011058,1262,582,680,0.4611727416798732,0.5388272583201268
E01011048,1653,779,874,0.47126436781609193,0.5287356321839081
E01011049,1730,831,899,0.48034682080924856,0.5196531791907515
E01011050,1462,747,715,0.5109439124487004,0.4890560875512996
E01011052,1616,814,802,0.5037128712871287,0.4962871287128713
E01011053,1394,688,706,0.4935437589670014,0.5064562410329986
E01011059,1817,854,963,0.47000550357732523,0.5299944964226747
E01011062,1901,939,962,0.4939505523408732,0.5060494476591267
E01011064,1686,770,916,0.45670225385527874,0.5432977461447213
E01011068,1576,766,810,0.4860406091370558,0.5139593908629442
E01011069,1417,719,698,0.507410021171489,0.49258997882851097
E01011241,1605,788,817,0.49096573208722744,0.5090342679127726
E01011242,1617,780,837,0.48237476808905383,0.5176252319109462
E01011243,1628,789,839,0.48464373464373467,0.5153562653562653
E01011244,2012,1001,1011,0.4975149105367793,0.5024850894632207
E01011060,1612,801,811,0.4968982630272953,0.5031017369727047
E01011061,1670,821,849,0.49161676646706587,0.5083832335329341
E01011063,2165,1029,1136,0.4752886836027714,0.5247113163972287
E01011065,1619,814,805,0.5027794935145151,0.4972205064854849
E01011066,1498,732,766,0.4886515353805073,0.5113484646194927
E01011027,1310,628,682,0.47938931297709925,0.5206106870229008
E01011028,1445,706,739,0.4885813148788927,0.5114186851211072
E01011030,1654,819,835,0.4951632406287787,0.5048367593712213
E01011031,2018,993,1025,0.4920713577799802,0.5079286422200199
E01011054,1366,669,697,0.48975109809663253,0.5102489019033675
E01011013,1572,770,802,0.48982188295165396,0.510178117048346
E01011014,1579,781,798,0.49461684610512985,0.5053831538948702
E01011023,1808,917,891,0.5071902654867256,0.4928097345132743
E01011024,1954,974,980,0.4984646878198567,0.5015353121801432
E01011067,1649,813,836,0.49302607640994545,0.5069739235900546
E01011247,1573,771,802,0.4901462174189447,0.5098537825810553
E01011249,1809,874,935,0.48313985627418465,0.5168601437258153
E01011251,1691,793,898,0.4689532820816085,0.5310467179183915
E01011245,1544,748,796,0.4844559585492228,0.5155440414507773
E01011246,1536,743,793,0.4837239583333333,0.5162760416666666
E01011248,1412,688,724,0.48725212464589235,0.5127478753541076
E01011250,1780,870,910,0.4887640449438202,0.5112359550561798
E01011015,1550,766,784,0.4941935483870968,0.5058064516129033
E01011029,1567,768,799,0.4901084875558392,0.5098915124441609
E01011032,2191,1099,1092,0.5015974440894568,0.4984025559105431
E01011034,1559,768,791,0.4926234765875561,0.5073765234124439
E01011157,1742,871,871,0.5,0.5
E01011161,1312,640,672,0.4878048780487805,0.5121951219512195
E01011163,1377,650,727,0.4720406681190995,0.5279593318809005
E01011164,1779,857,922,0.48173130972456435,0.5182686902754357
E01011165,1798,887,911,0.4933259176863181,0.5066740823136818
E01011166,1678,843,835,0.5023837902264601,0.49761620977353993
E01011167,1974,979,995,0.4959473150962513,0.5040526849037488
E01011033,1724,857,867,0.4970997679814385,0.5029002320185615
E01011035,1630,826,804,0.5067484662576687,0.49325153374233127
E01011036,1773,884,889,0.49858996051889454,0.5014100394811055
E01011037,2322,1123,1199,0.483634797588286,0.516365202411714
E01011016,1433,722,711,0.5038381018841591,0.4961618981158409
E01011017,1522,780,742,0.5124835742444153,0.48751642575558474
E01011018,1411,710,701,0.5031892274982283,0.4968107725017718
E01011019,1435,714,721,0.4975609756097561,0.5024390243902439
E01011020,1375,697,678,0.5069090909090909,0.4930909090909091
E01011021,1588,780,808,0.491183879093199,0.5088161209068011
E01011022,1424,701,723,0.4922752808988764,0.5077247191011236
E01011126,1884,917,967,0.4867303609341826,0.5132696390658175
E01011127,1352,680,672,0.5029585798816568,0.4970414201183432
E01011156,1509,737,772,0.48840291583830353,0.5115970841616965
E01011158,1953,949,1004,0.48591909882232465,0.5140809011776754
E01011159,1719,841,878,0.48923792902850494,0.5107620709714951
E01011160,1320,652,668,0.49393939393939396,0.5060606060606061
E01011162,1477,701,776,0.4746106973595125,0.5253893026404874
E01011025,1585,765,820,0.48264984227129337,0.5173501577287066
E01011026,1574,773,801,0.49110546378653114,0.5088945362134689
E01011136,1659,822,837,0.49547920433996384,0.5045207956600362
E01011137,1510,730,780,0.48344370860927155,0.5165562913907285
E01011128,2015,1057,958,0.5245657568238213,0.47543424317617866
E01011130,2200,1133,1067,0.515,0.485
E01034584,1673,851,822,0.5086670651524208,0.4913329348475792
E01034585,1373,693,680,0.504734158776402,0.49526584122359796
E01011121,1791,884,907,0.4935790061418202,0.5064209938581797
E01011122,1375,661,714,0.4807272727272727,0.5192727272727272
E01011123,1650,820,830,0.49696969696969695,0.503030303030303
E01011124,1949,962,987,0.4935864545920985,0.5064135454079015
E01011125,2112,993,1119,0.47017045454545453,0.5298295454545454
E01011129,1275,610,665,0.47843137254901963,0.5215686274509804
E01011138,1918,945,973,0.4927007299270073,0.5072992700729927
E01011139,1579,786,793,0.49778340721975933,0.5022165927802407
E01011140,1740,865,875,0.49712643678160917,0.5028735632183908
E01011141,1801,888,913,0.49305941143808996,0.50694058856191
E01011132,1545,749,796,0.484789644012945,0.515210355987055
E01011142,1564,778,786,0.49744245524296676,0.5025575447570333
E01011217,1541,730,811,0.4737183646982479,0.5262816353017521
E01011218,1642,791,851,0.4817295980511571,0.5182704019488429
E01011216,1493,721,772,0.48292029470864034,0.5170797052913597
E01011219,1580,804,776,0.5088607594936709,0.4911392405063291
E01011220,1789,868,921,0.48518725544997204,0.5148127445500279
E01011221,1687,816,871,0.4836988737403675,0.5163011262596325
E01011046,1401,700,701,0.49964311206281226,0.5003568879371877
E01011100,1478,690,788,0.4668470906630582,0.5331529093369418
E01011102,1333,664,669,0.4981245311327832,0.5018754688672168
E01011108,1389,682,707,0.49100071994240463,0.5089992800575954
E01011133,1692,868,824,0.5130023640661938,0.48699763593380613
E01011134,2127,1039,1088,0.48848142924306537,0.5115185707569346
E01011143,1851,923,928,0.49864937871420856,0.5013506212857914
E01011144,1712,889,823,0.5192757009345794,0.4807242990654206
E01011260,1470,724,746,0.4925170068027211,0.507482993197279
E01011257,2038,1013,1025,0.4970559371933268,0.5029440628066733
E01011258,1979,1068,911,0.53966649823143,0.46033350176856996
E01011259,2094,1012,1082,0.48328557784145176,0.5167144221585482
E01011261,1479,731,748,0.4942528735632184,0.5057471264367817
E01011262,1757,874,883,0.4974388161639158,0.5025611838360843
E01011263,1788,877,911,0.4904921700223714,0.5095078299776287
E01011101,1832,878,954,0.47925764192139736,0.5207423580786026
E01011103,1377,628,749,0.4560639070442992,0.5439360929557008
E01011104,1633,786,847,0.48132271892222905,0.518677281077771
E01011105,2482,1180,1302,0.47542304593070106,0.5245769540692989
E01011212,1566,716,850,0.45721583652618136,0.5427841634738186
E01011213,1539,757,782,0.4918778427550357,0.5081221572449642
E01011214,1517,741,776,0.4884640738299275,0.5115359261700725
E01011215,2311,1125,1186,0.4868022501081783,0.5131977498918218
E01011039,1806,891,915,0.49335548172757476,0.5066445182724253
E01011042,1613,781,832,0.4841909485430874,0.5158090514569126
E01011047,1494,743,751,0.49732262382864795,0.5026773761713521
E01011210,2084,1032,1052,0.4952015355086372,0.5047984644913628
E01011252,1137,584,553,0.51363236587511,0.48636763412489004
E01011253,1243,594,649,0.4778761061946903,0.5221238938053098
E01011254,1523,734,789,0.4819435325016415,0.5180564674983585
E01011255,1451,696,755,0.47966919365954513,0.5203308063404548
E01011256,1301,648,653,0.4980784012298232,0.5019215987701768
E01011038,1794,846,948,0.47157190635451507,0.5284280936454849
E01011041,1561,771,790,0.49391415759128765,0.5060858424087123
E01011106,1630,767,863,0.4705521472392638,0.5294478527607362
E01011107,2236,1187,1049,0.5308586762075134,0.4691413237924866
E01011201,1722,764,958,0.4436701509872242,0.5563298490127758
E01011203,1853,882,971,0.47598488936859146,0.5240151106314085
E01011211,1976,974,1002,0.49291497975708504,0.507085020242915
E01034586,1480,691,789,0.4668918918918919,0.5331081081081082
E01034587,1563,749,814,0.47920665387076133,0.5207933461292387
E01011040,1911,964,947,0.5044479330193616,0.4955520669806384
E01011043,2729,1369,1360,0.5016489556614144,0.49835104433858557
E01011044,1649,832,817,0.5045482110369921,0.4954517889630079
E01011045,1976,1042,934,0.5273279352226721,0.4726720647773279
E01011089,1257,598,659,0.47573587907716786,0.5242641209228321
E01011091,1358,653,705,0.4808541973490427,0.5191458026509573
E01011092,1271,615,656,0.4838709677419355,0.5161290322580645
E01011200,2285,1136,1149,0.4971553610503282,0.5028446389496718
E01011204,1536,758,778,0.4934895833333333,0.5065104166666666
E01011206,1662,797,865,0.4795427196149218,0.5204572803850782
E01011208,1626,737,889,0.453259532595326,0.5467404674046741
E01011240,1815,850,965,0.46831955922865015,0.5316804407713499
E01011231,1445,705,740,0.48788927335640137,0.5121107266435986
E01011236,1735,941,794,0.5423631123919308,0.45763688760806914
E01011238,1737,949,788,0.5463442717328728,0.45365572826712725
E01011239,1618,794,824,0.4907292954264524,0.5092707045735476
E01011093,1459,719,740,0.49280328992460587,0.5071967100753941
E01011094,1578,733,845,0.4645120405576679,0.5354879594423321
E01011096,1521,721,800,0.4740302432610125,0.5259697567389875
E01011098,1625,808,817,0.49723076923076925,0.5027692307692307
E01011146,1550,751,799,0.48451612903225805,0.515483870967742
E01011151,1497,729,768,0.48697394789579157,0.5130260521042084
E01011202,1570,735,835,0.4681528662420382,0.5318471337579618
E01011205,1593,763,830,0.47897049591964846,0.5210295040803515
E01011090,1451,705,746,0.48587181254307377,0.5141281874569262
E01011095,1373,648,725,0.471959213401311,0.528040786598689
E01011097,1647,813,834,0.4936247723132969,0.5063752276867031
E01011099,1452,684,768,0.47107438016528924,0.5289256198347108
E01011150,1643,815,828,0.4960438222763238,0.5039561777236762
E01011155,2124,1079,1045,0.5080037664783428,0.4919962335216573
E01011207,1481,725,756,0.48953409858203917,0.5104659014179609
E01011234,1535,707,828,0.46058631921824106,0.539413680781759
E01011232,1569,819,750,0.5219885277246654,0.4780114722753346
E01011233,1705,831,874,0.4873900293255132,0.5126099706744868
E01011235,1866,1012,854,0.5423365487674169,0.45766345123258306
E01011237,1686,862,824,0.5112692763938316,0.4887307236061684
E01011004,1307,629,678,0.4812547819433818,0.5187452180566182
E01011006,1488,699,789,0.46975806451612906,0.530241935483871
E01011008,1452,721,731,0.4965564738292011,0.5034435261707989
E01011012,1523,710,813,0.4661851608667104,0.5338148391332895
E01011145,1434,689,745,0.4804741980474198,0.5195258019525802
E01011147,1678,830,848,0.49463647199046484,0.5053635280095352
E01011148,1744,864,880,0.4954128440366973,0.5045871559633027
E01011152,1691,835,856,0.4937906564163217,0.5062093435836783
E01011007,1752,912,840,0.5205479452054794,0.4794520547945205
E01011223,1909,919,990,0.4814038763750655,0.5185961236249346
E01011225,1664,823,841,0.49459134615384615,0.5054086538461539
E01011229,2799,1411,1388,0.504108610217935,0.49589138978206504
E01011080,2088,1048,1040,0.5019157088122606,0.49808429118773945
E01011081,1811,956,855,0.5278851463279955,0.4721148536720044
E01011082,1865,957,908,0.5131367292225201,0.4868632707774799
E01011230,2026,990,1036,0.4886475814412636,0.5113524185587365
E01011005,1471,721,750,0.49014276002719237,0.5098572399728076
E01011009,1349,656,693,0.48628613787991104,0.513713862120089
E01011010,1583,737,846,0.4655716993051169,0.5344283006948831
E01011011,1480,721,759,0.4871621621621622,0.5128378378378379
E01011077,1596,805,791,0.5043859649122807,0.4956140350877193
E01011149,1802,910,892,0.5049944506104328,0.49500554938956715
E01011153,1690,831,859,0.49171597633136094,0.508284023668639
E01011154,1601,762,839,0.4759525296689569,0.5240474703310432
E01011191,1538,742,796,0.48244473342002603,0.517555266579974
E01011192,1569,739,830,0.4710006373486297,0.5289993626513703
E01011193,2268,1127,1141,0.49691358024691357,0.5030864197530864
E01011194,1299,643,656,0.49499615088529636,0.5050038491147036
E01011079,2004,1011,993,0.5044910179640718,0.49550898203592814
E01011083,1775,850,925,0.4788732394366197,0.5211267605633803
E01011084,1986,928,1058,0.46727089627391744,0.5327291037260826
E01011085,1716,809,907,0.47144522144522144,0.5285547785547785
E01011224,1791,868,923,0.48464544946957006,0.5153545505304299
E01011226,1484,733,751,0.4939353099730458,0.5060646900269542
E01011227,1525,721,804,0.4727868852459016,0.5272131147540984
E01011228,1361,661,700,0.4856722997795738,0.5143277002204262
E01011071,1940,959,981,0.4943298969072165,0.5056701030927835
E01011072,1604,782,822,0.48753117206982544,0.5124688279301746
E01011073,1554,771,783,0.49613899613899615,0.5038610038610039
E01011078,1869,885,984,0.47351524879614765,0.5264847512038523
E01011086,1583,750,833,0.4737839545167404,0.5262160454832596
E01011087,1496,738,758,0.49331550802139035,0.5066844919786097
E01011088,1303,614,689,0.4712202609363008,0.5287797390636991
E01011222,1619,848,771,0.5237801111797405,0.4762198888202594
E01011190,1589,782,807,0.4921334172435494,0.5078665827564506
E01011195,1746,847,899,0.48510882016036655,0.5148911798396334
E01011196,1945,966,979,0.4966580976863753,0.5033419023136246
E01011197,1504,728,776,0.48404255319148937,0.5159574468085106
E01011070,1673,822,851,0.4913329348475792,0.5086670651524208
E01011074,1833,893,940,0.48717948717948717,0.5128205128205128
E01011075,1459,716,743,0.49074708704592185,0.5092529129540782
E01011076,1416,732,684,0.5169491525423728,0.4830508474576271
E01011169,1407,692,715,0.4918265813788202,0.5081734186211798
E01011170,1886,922,964,0.48886532343584305,0.5111346765641569
E01011173,1210,587,623,0.48512396694214877,0.5148760330578512
E01011176,1377,671,706,0.48729121278140886,0.5127087872185911
E01034588,2341,1104,1237,0.4715933361811192,0.5284066638188808
E01011109,1900,950,950,0.5,0.5
E01011113,1540,739,801,0.4798701298701299,0.5201298701298701
E01011114,1695,792,903,0.4672566371681416,0.5327433628318584
E01011119,1434,708,726,0.49372384937238495,0.5062761506276151
E01011168,1631,794,837,0.48681790312691603,0.513182096873084
E01011174,1827,878,949,0.48056923918992883,0.5194307608100711
E01011175,1747,828,919,0.47395535203205497,0.526044647967945
E01011177,2027,967,1060,0.47705969412925503,0.5229403058707449
E01011178,1873,897,976,0.4789108382274426,0.5210891617725574
E01011118,1521,736,785,0.4838921761998685,0.5161078238001315
E01011120,1423,721,702,0.5066760365425158,0.4933239634574842
E01011198,1585,774,811,0.48832807570977915,0.5116719242902208
E01011199,1484,731,753,0.4925876010781671,0.5074123989218329
E01011110,1464,725,739,0.4952185792349727,0.5047814207650273
E01011111,1876,885,991,0.47174840085287845,0.5282515991471215
E01011112,1609,786,823,0.4885021752641392,0.5114978247358608
E01011115,1829,876,953,0.47895024603608527,0.5210497539639147
E01011116,1572,778,794,0.494910941475827,0.5050890585241731
E01011117,1715,817,898,0.4763848396501458,0.5236151603498542
E01011180,1894,942,952,0.49736008447729674,0.5026399155227033
E01011182,1664,840,824,0.5048076923076923,0.4951923076923077
E01011186,1813,873,940,0.4815223386651958,0.5184776613348042
E01011188,1647,802,845,0.4869459623557984,0.5130540376442015
E01011179,1677,825,852,0.4919499105545617,0.5080500894454383
E01011181,1746,853,893,0.488545246277205,0.5114547537227949
E01011183,2254,1146,1108,0.5084294587400178,0.49157054125998223
E01011184,1400,688,712,0.49142857142857144,0.5085714285714286
E01011185,1596,756,840,0.47368421052631576,0.5263157894736842
E01011187,1671,787,884,0.47097546379413524,0.5290245362058648
E01011189,1857,890,967,0.47926763597199784,0.5207323640280022
E01011698,1462,697,765,0.47674418604651164,0.5232558139534884
E01011699,1289,602,687,0.4670287044220326,0.5329712955779674
E01011701,1367,653,714,0.4776883686905633,0.5223116313094367
E01011702,1648,792,856,0.48058252427184467,0.5194174757281553
E01011703,1223,589,634,0.48160261651676206,0.5183973834832379
E01011697,2285,1465,820,0.6411378555798687,0.3588621444201313
E01011700,1482,736,746,0.4966261808367072,0.5033738191632928
E01011704,2230,1040,1190,0.4663677130044843,0.5336322869955157
E01011705,1369,654,715,0.4777209642074507,0.5222790357925493
E01011581,1660,787,873,0.47409638554216865,0.5259036144578313
E01011582,1613,799,814,0.495350278983261,0.504649721016739
E01011583,1574,761,813,0.4834815756035578,0.5165184243964421
E01011584,1683,797,886,0.47355912061794414,0.5264408793820559
E01011569,1731,825,906,0.47660311958405543,0.5233968804159446
E01011571,1609,770,839,0.4785581106277191,0.5214418893722809
E01011572,1776,856,920,0.481981981981982,0.5180180180180181
E01011573,1311,641,670,0.4889397406559878,0.5110602593440122
E01011574,1401,670,731,0.4782298358315489,0.5217701641684511
E01011707,1296,619,677,0.47762345679012347,0.5223765432098766
E01011709,2047,991,1056,0.48412310698583294,0.5158768930141671
E01011710,1414,707,707,0.5,0.5
E01011711,1417,670,747,0.4728299223712068,0.5271700776287932
E01011712,1448,700,748,0.48342541436464087,0.5165745856353591
E01011561,1186,570,616,0.4806070826306914,0.5193929173693086
E01011696,1549,764,785,0.4932214331826985,0.5067785668173015
E01011706,1532,756,776,0.4934725848563969,0.5065274151436031
E01011708,1471,737,734,0.5010197144799456,0.4989802855200544
E01011713,1785,862,923,0.48291316526610645,0.5170868347338936
E01011570,2305,1119,1186,0.4854663774403471,0.514533622559653
E01011576,1463,712,751,0.48667122351332875,0.5133287764866712
E01032503,1447,702,745,0.4851416724257084,0.5148583275742916
E01032504,1781,835,946,0.46883773161145426,0.5311622683885457
E01011266,2613,1344,1269,0.5143513203214696,0.4856486796785304
E01011270,1720,870,850,0.5058139534883721,0.4941860465116279
E01011279,1318,631,687,0.4787556904400607,0.5212443095599393
E01011280,2074,1018,1056,0.49083895853423337,0.5091610414657667
E01011265,1955,916,1039,0.4685421994884911,0.5314578005115089
E01011267,1699,796,903,0.468510888758093,0.531489111241907
E01011271,2172,1042,1130,0.47974217311233885,0.5202578268876611
E01011272,1455,725,730,0.49828178694158076,0.5017182130584192
E01011268,1395,671,724,0.48100358422939066,0.5189964157706093
E01011273,1483,696,787,0.46931894807821983,0.5306810519217802
E01011274,1361,655,706,0.48126377663482733,0.5187362233651727
E01011275,1409,661,748,0.4691270404542229,0.5308729595457772
E01011264,1284,626,658,0.48753894080996885,0.5124610591900312
E01011269,1569,742,827,0.47291268323773106,0.5270873167622689
E01011276,1736,867,869,0.49942396313364057,0.5005760368663594
E01011578,1273,605,668,0.4752553024351925,0.5247446975648076
E01011554,1445,711,734,0.49204152249134947,0.5079584775086505
E01011562,1567,742,825,0.47351627313337585,0.5264837268666241
E01011563,1389,677,712,0.48740100791936647,0.5125989920806335
E01011564,1558,765,793,0.4910141206675225,0.5089858793324775
E01011567,1472,695,777,0.47214673913043476,0.5278532608695652
E01011376,1662,804,858,0.48375451263537905,0.516245487364621
E01011377,1389,648,741,0.46652267818574517,0.5334773218142549
E01011378,1416,708,708,0.5,0.5
E01011382,1609,767,842,0.4766935985083903,0.5233064014916097
E01011277,1607,788,819,0.4903546981953951,0.5096453018046049
E01011278,1622,791,831,0.4876695437731196,0.5123304562268804
E01011579,1337,636,701,0.47569184741959614,0.5243081525804039
E01011580,1372,644,728,0.46938775510204084,0.5306122448979592
E01011556,1650,798,852,0.48363636363636364,0.5163636363636364
E01011557,1421,641,780,0.4510907811400422,0.5489092188599578
E01011565,1482,678,804,0.4574898785425101,0.5425101214574899
E01011566,1337,648,689,0.4846671652954376,0.5153328347045625
E01011568,1915,912,1003,0.4762402088772846,0.5237597911227154
E01011380,1550,758,792,0.4890322580645161,0.5109677419354839
E01011381,1475,736,739,0.49898305084745764,0.5010169491525424
E01011385,1338,663,675,0.49551569506726456,0.5044843049327354
E01011386,1815,920,895,0.5068870523415978,0.4931129476584022
E01011379,1611,774,837,0.48044692737430167,0.5195530726256983
E01011384,1518,728,790,0.4795783926218709,0.5204216073781291
E01032501,1149,550,599,0.47867711053089645,0.5213228894691035
E01032502,1875,915,960,0.488,0.512
E01011555,1382,669,713,0.4840810419681621,0.515918958031838
E01011558,1778,814,964,0.4578177727784027,0.5421822272215973
E01011559,1476,729,747,0.49390243902439024,0.5060975609756098
E01011560,1936,931,1005,0.48088842975206614,0.5191115702479339
E01011383,1673,774,899,0.46264196054991036,0.5373580394500896
E01011388,1579,748,831,0.473717542748575,0.526282457251425
E01011684,1557,757,800,0.4861913937058446,0.5138086062941555
E01011695,1710,824,886,0.4818713450292398,0.5181286549707602
E01011650,1522,741,781,0.4868593955321945,0.5131406044678055
E01011651,1490,701,789,0.4704697986577181,0.5295302013422819
E01011653,1376,667,709,0.48473837209302323,0.5152616279069767
E01011655,1478,719,759,0.486468200270636,0.513531799729364
E01011455,1371,656,715,0.4784828592268417,0.5215171407731582
E01011456,2048,921,1127,0.44970703125,0.55029296875
E01011459,1679,816,863,0.4860035735556879,0.5139964264443121
E01011461,1564,762,802,0.48721227621483376,0.5127877237851662
E01011311,1265,622,643,0.491699604743083,0.508300395256917
E01011649,1581,770,811,0.48703352308665404,0.512966476913346
E01011715,1354,669,685,0.49409158050221563,0.5059084194977843
E01011719,1430,688,742,0.4811188811188811,0.5188811188811189
E01011509,1436,643,793,0.4477715877437326,0.5522284122562674
E01011511,1414,727,687,0.5141442715700142,0.48585572842998587
E01011512,1722,858,864,0.49825783972125437,0.5017421602787456
E01011515,1495,746,749,0.49899665551839467,0.5010033444816053
E01011516,1744,895,849,0.5131880733944955,0.4868119266055046
E01011508,1433,719,714,0.5017445917655269,0.4982554082344731
E01011517,1714,807,907,0.470828471411902,0.529171528588098
E01011652,1396,665,731,0.47636103151862463,0.5236389684813754
E01011654,1473,708,765,0.48065173116089616,0.5193482688391039
E01011505,1702,816,886,0.4794359576968273,0.5205640423031728
E01011506,1539,747,792,0.4853801169590643,0.5146198830409356
E01011507,1656,800,856,0.4830917874396135,0.5169082125603864
E01011510,1528,744,784,0.4869109947643979,0.5130890052356021
E01011514,1783,848,935,0.47560291643297814,0.5243970835670219
E01011452,1651,812,839,0.49182313749242884,0.5081768625075712
E01011454,1607,797,810,0.49595519601742377,0.5040448039825762
E01011457,1630,800,830,0.49079754601226994,0.50920245398773
E01011458,2677,1315,1362,0.49122151662308555,0.5087784833769144
E01011465,1749,818,931,0.4676958261863922,0.5323041738136077
E01011453,1565,750,815,0.4792332268370607,0.5207667731629393
E01011460,1540,732,808,0.4753246753246753,0.5246753246753246
E01011462,1726,872,854,0.5052143684820394,0.4947856315179606
E01011463,1692,794,898,0.46926713947990545,0.5307328605200946
E01011464,1810,895,915,0.494475138121547,0.505524861878453
E01011714,1947,958,989,0.49203903441191577,0.5079609655880842
E01011716,1588,757,831,0.47670025188916876,0.5232997481108312
E01011717,1621,787,834,0.4855027760641579,0.5144972239358421
E01011718,1975,927,1048,0.46936708860759496,0.5306329113924051
E01011720,1510,742,768,0.4913907284768212,0.5086092715231788
E01011296,1625,795,830,0.48923076923076925,0.5107692307692308
E01011297,1725,830,895,0.4811594202898551,0.518840579710145
E01011309,1505,751,754,0.49900332225913624,0.5009966777408638
E01011310,1627,786,841,0.4830977258758451,0.5169022741241549
E01011513,2238,1090,1148,0.4870420017873101,0.51295799821269
E01011688,1518,714,804,0.47035573122529645,0.5296442687747036
E01011689,1611,781,830,0.48479205462445685,0.5152079453755432
E01011691,1500,735,765,0.49,0.51
E01011504,1564,731,833,0.4673913043478261,0.532608695652174
E01011641,1612,774,838,0.4801488833746898,0.5198511166253101
E01011642,1383,670,713,0.48445408532176426,0.5155459146782357
E01011645,1509,758,751,0.5023194168323393,0.49768058316766073
E01011484,1601,758,843,0.47345409119300436,0.5265459088069956
E01011485,1628,786,842,0.4828009828009828,0.5171990171990172
E01011686,1541,775,766,0.5029201817001947,0.4970798182998053
E01032493,1366,674,692,0.493411420204978,0.5065885797950219
E01032494,1909,922,987,0.4829753797799895,0.5170246202200105
E01011350,1540,773,767,0.5019480519480519,0.4980519480519481
E01011351,1714,812,902,0.47374562427071176,0.5262543757292882
E01011352,1849,870,979,0.4705246078961601,0.5294753921038399
E01011353,1934,965,969,0.49896587383660806,0.5010341261633919
E01011656,1524,696,828,0.4566929133858268,0.5433070866141733
E01011657,1281,617,664,0.4816549570647931,0.5183450429352069
E01011659,1461,676,785,0.46269678302532513,0.5373032169746749
E01011661,1707,852,855,0.4991212653778559,0.5008787346221442
E01011643,1521,728,793,0.47863247863247865,0.5213675213675214
E01011644,1338,644,694,0.4813153961136024,0.5186846038863976
E01011646,1801,868,933,0.4819544697390339,0.5180455302609661
E01011647,1880,941,939,0.500531914893617,0.49946808510638296
E01011648,1859,934,925,0.5024206562668101,0.4975793437331899
E01011354,1573,717,856,0.45581691036236494,0.5441830896376351
E01011355,1490,700,790,0.4697986577181208,0.5302013422818792
E01011357,2056,1010,1046,0.4912451361867704,0.5087548638132295
E01011450,1301,605,696,0.4650269023827825,0.5349730976172176
E01011588,1777,840,937,0.4727068092290377,0.5272931907709623
E01011589,1597,758,839,0.4746399499060739,0.5253600500939261
E01011590,1699,855,844,0.5032371983519718,0.4967628016480283
E01011592,1612,742,870,0.46029776674937967,0.5397022332506204
E01011593,1966,955,1011,0.48575788402848424,0.5142421159715158
E01011421,1526,722,804,0.47313237221494103,0.526867627785059
E01011425,1552,739,813,0.47615979381443296,0.523840206185567
E01011658,1709,783,926,0.45816266822703333,0.5418373317729667
E01011660,1826,855,971,0.46823658269441404,0.531763417305586
E01011662,1366,676,690,0.49487554904831627,0.5051244509516838
E01011721,1565,713,852,0.45559105431309904,0.544408945686901
E01011722,2115,1048,1067,0.4955082742316785,0.5044917257683215
E01011723,1716,797,919,0.46445221445221446,0.5355477855477856
E01011724,1869,905,964,0.48421615837346177,0.5157838416265382
E01011356,2017,1022,995,0.5066931085770947,0.4933068914229053
E01011358,1551,772,779,0.4977433913604126,0.5022566086395873
E01011359,1896,924,972,0.4873417721518987,0.5126582278481012
E01011360,2231,1072,1159,0.4805020170327208,0.5194979829672792
E01011361,2863,1349,1514,0.4711840726510653,0.5288159273489347
E01011435,1824,951,873,0.5213815789473685,0.4786184210526316
E01011440,1685,793,892,0.47062314540059347,0.5293768545994065
E01011441,1957,978,979,0.49974450689831373,0.5002554931016863
E01035040,1738,922,816,0.5304948216340621,0.46950517836593786
E01035041,1302,705,597,0.5414746543778802,0.45852534562211983
E01011477,2024,1060,964,0.5237154150197628,0.4762845849802372
E01011480,1639,843,796,0.5143380109823062,0.4856619890176937
E01011488,1464,738,726,0.5040983606557377,0.4959016393442623
E01011489,1764,881,883,0.49943310657596374,0.5005668934240363
E01011324,1837,973,864,0.5296679368535656,0.4703320631464344
E01011325,1647,807,840,0.4899817850637523,0.5100182149362478
E01011326,1485,680,805,0.45791245791245794,0.5420875420875421
E01011332,1622,737,885,0.45437731196054254,0.5456226880394575
E01011423,1735,845,890,0.48703170028818443,0.5129682997118156
E01011424,1938,939,999,0.4845201238390093,0.5154798761609907
E01011427,2045,1004,1041,0.49095354523227386,0.5090464547677261
E01011431,2097,1079,1018,0.5145445875059609,0.4854554124940391
E01011422,1616,859,757,0.531559405940594,0.46844059405940597
E01011426,1698,831,867,0.48939929328621906,0.5106007067137809
E01011428,2138,1113,1025,0.5205799812909261,0.4794200187090739
E01011429,2059,1057,1002,0.5133559980573094,0.48664400194269064
E01011663,1701,779,922,0.45796590241034685,0.5420340975896532
E01011664,1323,596,727,0.4504913076341648,0.5495086923658352
E01011665,1387,666,721,0.4801730353280461,0.5198269646719539
E01011667,1584,692,892,0.43686868686868685,0.5631313131313131
E01011323,1298,635,663,0.48921417565485364,0.5107858243451464
E01011329,1493,722,771,0.4835900870730074,0.5164099129269927
E01011330,1345,650,695,0.483271375464684,0.516728624535316
E01011333,1369,653,716,0.47699050401753107,0.5230094959824689
E01011327,1348,643,705,0.47700296735905046,0.5229970326409495
E01011328,1591,753,838,0.4732872407291012,0.5267127592708988
E01011335,1710,814,896,0.4760233918128655,0.5239766081871345
E01011591,1637,811,826,0.4954184483811851,0.5045815516188149
E01011430,1732,863,869,0.4982678983833718,0.5017321016166282
E01011432,1739,854,885,0.49108683151236343,0.5089131684876366
E01011433,1927,1016,911,0.527244421380384,0.472755578619616
E01011434,1805,937,868,0.5191135734072022,0.4808864265927978
E01011445,1790,708,1082,0.39553072625698327,0.6044692737430167
E01011446,1754,852,902,0.48574686431014824,0.5142531356898518
E01011447,1428,641,787,0.4488795518207283,0.5511204481792717
E01011448,1679,706,973,0.4204883859440143,0.5795116140559857
E01011449,1480,702,778,0.4743243243243243,0.5256756756756756
E01011670,2617,1166,1451,0.44554833779136416,0.5544516622086358
E01011671,1687,810,877,0.48014226437462953,0.5198577356253705
E01033002,2179,1103,1076,0.5061955025240936,0.4938044974759064
E01033003,2293,1253,1040,0.546445704317488,0.453554295682512
E01035042,2287,1041,1246,0.455181460428509,0.5448185395714911
E01035043,1416,660,756,0.4661016949152542,0.5338983050847458
E01011478,1769,877,892,0.49576031656302993,0.50423968343697
E01011479,1521,850,671,0.5588428665351742,0.44115713346482577
E01011481,1812,934,878,0.5154525386313465,0.4845474613686534
E01011482,1737,924,813,0.531951640759931,0.4680483592400691
E01011483,1625,875,750,0.5384615384615384,0.46153846153846156
E01011406,1315,619,696,0.47072243346007603,0.529277566539924
E01011407,1424,711,713,0.49929775280898875,0.5007022471910112
E01011408,1493,692,801,0.463496316141996,0.5365036838580041
E01011409,1442,737,705,0.5110957004160888,0.48890429958391124
E01011410,1658,810,848,0.48854041013269,0.51145958986731
E01011412,1816,862,954,0.4746696035242291,0.525330396475771
E01011331,1341,643,698,0.47949291573452646,0.5205070842654735
E01011334,1397,686,711,0.4910522548317824,0.5089477451682176
E01011336,1551,737,814,0.475177304964539,0.524822695035461
E01011337,1734,826,908,0.47635524798154555,0.5236447520184544
E01011281,2182,1034,1148,0.4738771769019248,0.5261228230980751
E01011282,1390,665,725,0.4784172661870504,0.5215827338129496
E01011283,1575,735,840,0.4666666666666667,0.5333333333333333
E01011286,1295,633,662,0.4888030888030888,0.5111969111969112
E01011295,1708,871,837,0.5099531615925058,0.49004683840749413
E01011339,2115,986,1129,0.466193853427896,0.533806146572104
E01011340,1815,866,949,0.47713498622589534,0.5228650137741047
E01011342,1877,874,1003,0.4656366542354822,0.5343633457645178
E01011346,1892,958,934,0.5063424947145877,0.49365750528541225
E01011341,2172,1016,1156,0.4677716390423573,0.5322283609576427
E01011343,1980,997,983,0.5035353535353535,0.49646464646464644
E01011345,1498,690,808,0.4606141522029373,0.5393858477970628
E01011666,1424,698,726,0.4901685393258427,0.5098314606741573
E01011585,1401,675,726,0.4817987152034261,0.5182012847965739
E01011587,1748,871,877,0.4982837528604119,0.5017162471395881
E01011594,1543,724,819,0.4692158133506157,0.5307841866493843
E01011596,1648,786,862,0.47694174757281554,0.5230582524271845
E01011598,1581,778,803,0.49209361163820364,0.5079063883617964
E01011678,4342,1806,2536,0.4159373560571165,0.5840626439428834
E01011681,1693,819,874,0.48375664500886,0.5162433549911399
E01035044,2644,1190,1454,0.45007564296520425,0.5499243570347958
E01035045,1308,673,635,0.514525993883792,0.48547400611620795
E01011338,2029,996,1033,0.49088220798422866,0.5091177920157713
E01011673,1862,925,937,0.4967776584317938,0.5032223415682062
E01011677,1624,878,746,0.5406403940886699,0.45935960591133007
E01033031,1606,866,740,0.539227895392279,0.46077210460772106
E01033035,1817,935,882,0.5145844799119428,0.4854155200880572
E01011344,2057,1069,988,0.5196888672824501,0.4803111327175498
E01011347,1975,950,1025,0.4810126582278481,0.5189873417721519
E01011348,1796,828,968,0.4610244988864143,0.5389755011135857
E01011349,1819,982,837,0.5398570643210555,0.4601429356789445
E01011586,1850,901,949,0.48702702702702705,0.512972972972973
E01011595,2167,1076,1091,0.49653899400092294,0.5034610059990771
E01011597,1709,852,857,0.49853715623171446,0.5014628437682855
E01011599,1664,810,854,0.48677884615384615,0.5132211538461539
E01011287,1461,696,765,0.47638603696098564,0.5236139630390144
E01032499,1707,826,881,0.4838898652606913,0.5161101347393088
E01032500,1386,729,657,0.525974025974026,0.474025974025974
E01032606,2109,1047,1062,0.49644381223328593,0.5035561877667141
E01032607,1273,642,631,0.5043205027494109,0.4956794972505892
E01032608,1114,557,557,0.5,0.5
E01011608,1379,650,729,0.4713560551124003,0.5286439448875997
E01011609,1432,721,711,0.5034916201117319,0.4965083798882682
E01011610,1530,744,786,0.48627450980392156,0.5137254901960784
E01011611,1487,700,787,0.47074646940147946,0.5292535305985205
E01011614,1860,912,948,0.49032258064516127,0.5096774193548387
E01011413,1455,701,754,0.481786941580756,0.518213058419244
E01011415,1639,828,811,0.5051860890787065,0.49481391092129345
E01011416,1485,725,760,0.4882154882154882,0.5117845117845118
E01011417,1528,728,800,0.47643979057591623,0.5235602094240838
E01011420,1359,660,699,0.4856512141280353,0.5143487858719646
E01011615,1583,779,804,0.4921036007580543,0.5078963992419456
E01011617,1641,755,886,0.46008531383302864,0.5399146861669714
E01011618,1659,788,871,0.47498493068113323,0.5250150693188668
E01011621,1567,765,802,0.4881940012763242,0.5118059987236758
E01011284,2216,1186,1030,0.5351985559566786,0.4648014440433213
E01011292,1956,1020,936,0.5214723926380368,0.4785276073619632
E01011293,1963,1069,894,0.5445746306673459,0.4554253693326541
E01011294,1721,1138,583,0.6612434631028472,0.3387565368971528
E01011363,1961,1018,943,0.5191228964813871,0.48087710351861296
E01011616,1645,763,882,0.46382978723404256,0.5361702127659574
E01011620,1383,643,740,0.46493130874909616,0.5350686912509038
E01011622,1742,795,947,0.4563719862227325,0.5436280137772675
E01011624,1858,892,966,0.48008611410118407,0.5199138858988159
E01011411,1714,850,864,0.4959159859976663,0.5040840140023337
E01011414,1500,762,738,0.508,0.492
E01011418,1457,707,750,0.4852436513383665,0.5147563486616334
E01011419,1109,550,559,0.49594229035166815,0.5040577096483319
E01011396,1888,884,1004,0.4682203389830508,0.5317796610169492
E01011399,1502,723,779,0.481358189081225,0.5186418109187749
E01011400,1394,684,710,0.49067431850789095,0.509325681492109
E01011403,1515,692,823,0.45676567656765676,0.5432343234323432
E01011623,1701,846,855,0.4973544973544973,0.5026455026455027
E01011625,1724,857,867,0.4970997679814385,0.5029002320185615
E01011626,2399,1196,1203,0.49854105877448934,0.5014589412255106
E01033021,2066,1055,1011,0.510648596321394,0.489351403678606
E01033033,1617,860,757,0.5318491032776747,0.4681508967223253
E01033034,1480,788,692,0.5324324324324324,0.46756756756756757
E01011602,1975,971,1004,0.4916455696202532,0.5083544303797468
E01011603,1592,784,808,0.49246231155778897,0.507537688442211
E01011605,1758,873,885,0.49658703071672355,0.5034129692832765
E01011606,2048,982,1066,0.4794921875,0.5205078125
E01011613,1795,846,949,0.4713091922005571,0.5286908077994429
E01011397,1501,740,761,0.49300466355762823,0.5069953364423717
E01011398,1141,565,576,0.49517966695880805,0.5048203330411919
E01011401,1773,860,913,0.485053581500282,0.514946418499718
E01011404,1377,682,695,0.495279593318809,0.504720406681191
E01011405,1474,705,769,0.47829036635006783,0.5217096336499322
E01011725,1514,705,809,0.4656538969616909,0.5343461030383091
E01011729,1700,829,871,0.48764705882352943,0.5123529411764706
E01011730,1564,742,822,0.4744245524296675,0.5255754475703325
E01011735,1693,795,898,0.46958062610750145,0.5304193738924985
E01011600,1516,710,806,0.4683377308707124,0.5316622691292876
E01011601,1622,802,820,0.49445129469790383,0.5055487053020962
E01011604,1347,643,704,0.4773570898292502,0.5226429101707498
E01011607,1658,804,854,0.48492159227985526,0.5150784077201448
E01011612,1392,695,697,0.4992816091954023,0.5007183908045977
E01011726,1561,728,833,0.4663677130044843,0.5336322869955157
E01011727,1549,777,772,0.5016139444803098,0.4983860555196901
E01011728,1384,666,718,0.48121387283236994,0.5187861271676301
E01011739,1603,801,802,0.49968808484092325,0.5003119151590767
E01011362,1935,1039,896,0.5369509043927648,0.4630490956072351
E01011731,1428,695,733,0.48669467787114845,0.5133053221288515
E01011732,1982,967,1015,0.48789101917255295,0.512108980827447
E01011733,1574,739,835,0.46950444726810675,0.5304955527318933
E01011366,1786,906,880,0.5072788353863382,0.49272116461366183
E01011368,1664,848,816,0.5096153846153846,0.49038461538461536
E01011370,1689,867,822,0.5133214920071048,0.4866785079928952
E01033013,1431,717,714,0.5010482180293501,0.4989517819706499
E01035046,1158,639,519,0.5518134715025906,0.4481865284974093
E01035047,1331,738,593,0.5544703230653644,0.44552967693463563
E01011734,2795,1401,1394,0.501252236135957,0.49874776386404296
E01011736,1402,688,714,0.49072753209700426,0.5092724679029957
E01011737,1538,734,804,0.47724317295188556,0.5227568270481144
E01011738,1497,736,761,0.4916499665998664,0.5083500334001336
E01011364,2124,1065,1059,0.501412429378531,0.4985875706214689
E01011371,1809,908,901,0.5019347705914871,0.498065229408513
E01011373,1555,767,788,0.4932475884244373,0.5067524115755627
E01011374,1253,646,607,0.515562649640862,0.48443735035913804
E01011312,2025,1017,1008,0.5022222222222222,0.49777777777777776
E01011316,2014,1036,978,0.5143992055610725,0.4856007944389275
E01011372,1750,880,870,0.5028571428571429,0.49714285714285716
E01011375,2087,1101,986,0.5275515093435553,0.4724484906564447
E01011390,1365,656,709,0.4805860805860806,0.5194139194139195
E01011391,1558,763,795,0.48973042362002567,0.5102695763799743
E01011392,1985,938,1047,0.472544080604534,0.527455919395466
E01011402,2053,958,1095,0.46663419386264005,0.53336580613736
E01011298,1555,758,797,0.487459807073955,0.512540192926045
E01011299,2838,1394,1444,0.49119097956307256,0.5088090204369274
E01011302,1781,856,925,0.480628860190904,0.519371139809096
E01011303,1146,576,570,0.5026178010471204,0.4973821989528796
E01011300,1457,697,760,0.4783802333562114,0.5216197666437886
E01011301,1241,598,643,0.48186946011281223,0.5181305398871877
E01011304,1587,754,833,0.4751102709514808,0.5248897290485193
E01011305,1492,715,777,0.4792225201072386,0.5207774798927614
E01011306,1301,626,675,0.4811683320522675,0.5188316679477325
E01011315,1613,810,803,0.5021698698078115,0.49783013019218847
E01011317,1774,878,896,0.49492671927846676,0.5050732807215332
E01011318,1552,750,802,0.4832474226804124,0.5167525773195877
E01011321,1660,823,837,0.49578313253012046,0.5042168674698795
E01011369,1589,765,824,0.4814348646947766,0.5185651353052234
E01011313,1744,863,881,0.4948394495412844,0.5051605504587156
E01011314,1573,807,766,0.5130324221233312,0.4869675778766688
E01011319,1604,816,788,0.5087281795511222,0.4912718204488778
E01011320,1790,907,883,0.5067039106145251,0.49329608938547487
E01011322,1659,807,852,0.4864376130198915,0.5135623869801085
E01011471,1577,766,811,0.48573240329740014,0.5142675967025999
E01011472,1656,769,887,0.4643719806763285,0.5356280193236715
E01011473,1537,682,855,0.44372153545868576,0.5562784645413142
E01011474,1591,752,839,0.4726587052168448,0.5273412947831553
E01011518,2294,1171,1123,0.5104620749782041,0.489537925021796
E01011524,1216,617,599,0.5074013157894737,0.4925986842105263
E01011526,1268,616,652,0.48580441640378547,0.5141955835962145
E01011531,1672,797,875,0.47667464114832536,0.5233253588516746
E01011466,1537,732,805,0.47625243981782694,0.523747560182173
E01011469,1418,688,730,0.48519040902679833,0.5148095909732017
E01011475,1610,784,826,0.48695652173913045,0.5130434782608696
E01011476,1231,592,639,0.4809098294069862,0.5190901705930138
E01011519,1515,735,780,0.48514851485148514,0.5148514851485149
E01011522,1370,678,692,0.4948905109489051,0.5051094890510949
E01011525,1551,744,807,0.4796905222437137,0.5203094777562862
E01011528,1598,804,794,0.5031289111389237,0.49687108886107634
E01011532,1602,754,848,0.4706616729088639,0.529338327091136
E01011520,1497,715,782,0.47762191048764197,0.5223780895123581
E01011521,2175,1065,1110,0.4896551724137931,0.5103448275862069
E01011523,1894,911,983,0.48099260823653645,0.5190073917634636
E01011527,1741,857,884,0.4922458357265939,0.5077541642734061
E01011529,1365,659,706,0.4827838827838828,0.5172161172161173
E01011635,1835,936,899,0.5100817438692098,0.4899182561307902
E01011637,1691,848,843,0.5014784151389711,0.498521584861029
E01011638,1400,695,705,0.49642857142857144,0.5035714285714286
E01032487,1040,459,581,0.44134615384615383,0.5586538461538462
E01032488,1808,870,938,0.4811946902654867,0.5188053097345132
E01011627,1358,657,701,0.48379970544919,0.5162002945508101
E01011628,1228,589,639,0.4796416938110749,0.5203583061889251
E01011629,1308,602,706,0.4602446483180428,0.5397553516819572
E01011632,1347,629,718,0.4669636228656273,0.5330363771343727
E01011633,1467,711,756,0.48466257668711654,0.5153374233128835
E01011502,1387,679,708,0.48954578226387885,0.5104542177361211
E01032497,1610,785,825,0.48757763975155277,0.5124223602484472
E01032498,1662,830,832,0.4993983152827918,0.5006016847172082
E01035048,1894,911,983,0.48099260823653645,0.5190073917634636
E01035049,1487,746,741,0.5016812373907196,0.49831876260928043
E01011496,1522,769,753,0.5052562417871223,0.4947437582128778
E01011630,2018,990,1028,0.4905847373637265,0.5094152626362736
E01011634,1586,771,815,0.48612862547288777,0.5138713745271122
E01011636,1886,909,977,0.48197242841993637,0.5180275715800636
E01011639,1509,704,805,0.4665341285619616,0.5334658714380385
E01011491,1451,674,777,0.46450723638869745,0.5354927636113026
E01011492,1732,790,942,0.4561200923787529,0.5438799076212472
E01011493,1612,783,829,0.4857320099255583,0.5142679900744417
E01011494,1681,807,874,0.48007138607971445,0.5199286139202856
E01011497,1729,823,906,0.4759976865240023,0.5240023134759977
E01011540,2014,944,1070,0.46871896722939427,0.5312810327706058
E01032489,2113,1057,1056,0.5002366303833412,0.4997633696166588
E01032490,1395,689,706,0.4939068100358423,0.5060931899641578
E01032491,1195,593,602,0.49623430962343096,0.503765690376569
E01032492,2102,1016,1086,0.483349191246432,0.5166508087535681
E01011307,1600,760,840,0.475,0.525
E01011308,1496,706,790,0.47192513368983957,0.5280748663101604
E01011393,2201,1052,1149,0.47796456156292594,0.522035438437074
E01011394,1156,572,584,0.49480968858131485,0.5051903114186851
E01011395,1198,589,609,0.49165275459098495,0.508347245409015
E01011533,1387,722,665,0.5205479452054794,0.4794520547945205
E01011541,2036,1018,1018,0.5,0.5
E01011545,1359,683,676,0.5025754231052244,0.4974245768947756
E01011547,1992,987,1005,0.4954819277108434,0.5045180722891566
E01011500,1577,736,841,0.46670894102726695,0.533291058972733
E01032496,2198,1091,1107,0.4963603275705187,0.5036396724294814
E01035050,1619,807,812,0.49845583693638046,0.5015441630636195
E01035051,1608,782,826,0.486318407960199,0.513681592039801
E01035052,1453,729,724,0.5017205781142464,0.49827942188575364
E01035053,1733,836,897,0.482400461627236,0.517599538372764
E01011530,1367,711,656,0.5201170446232626,0.47988295537673736
E01011534,2359,1125,1234,0.47689699025010596,0.523103009749894
E01011546,1723,831,892,0.4822983168891468,0.5177016831108532
E01011548,1507,725,782,0.4810882548108825,0.5189117451891174
E01011550,1354,695,659,0.5132939438700148,0.48670605612998524
E01011537,2047,980,1067,0.4787493893502687,0.5212506106497313
E01011538,1584,762,822,0.4810606060606061,0.5189393939393939
E01011551,1756,898,858,0.5113895216400911,0.4886104783599089
E01011552,1523,713,810,0.4681549573210768,0.5318450426789232
E01011535,1714,843,871,0.4918319719953326,0.5081680280046674
E01011536,1653,809,844,0.48941318814277074,0.5105868118572293
E01011549,1428,713,715,0.4992997198879552,0.5007002801120448
E01011553,1380,685,695,0.4963768115942029,0.5036231884057971
E01011685,2215,1140,1075,0.5146726862302483,0.4853273137697517
E01011687,1527,758,769,0.49639816633922723,0.5036018336607727
E01011690,1362,664,698,0.48751835535976507,0.5124816446402349
E01011692,1502,754,748,0.5019973368841545,0.4980026631158455
E01011693,1513,753,760,0.4976867151354924,0.5023132848645075
E01011694,1855,971,884,0.5234501347708895,0.4765498652291105
E01032876,1874,913,961,0.4871931696905016,0.5128068303094984
E01011442,1875,917,958,0.48906666666666665,0.5109333333333334
E01011443,1881,871,1010,0.4630515683147262,0.5369484316852738
E01011444,1992,892,1100,0.44779116465863456,0.5522088353413654
E01011451,1553,761,792,0.4900193174500966,0.5099806825499034
E01011668,1705,786,919,0.46099706744868035,0.5390029325513197
E01011669,1481,764,717,0.5158676569885212,0.4841323430114787
E01032946,3146,1459,1687,0.46376350921805465,0.5362364907819454
E01033008,2148,938,1210,0.4366852886405959,0.5633147113594041
E01033010,3480,1551,1929,0.44568965517241377,0.5543103448275862
E01033011,1343,761,582,0.5666418466120625,0.43335815338793743
E01033015,1509,835,674,0.5533465871438038,0.44665341285619614
E01033016,1047,567,480,0.5415472779369628,0.4584527220630373
E01011467,1992,1000,992,0.5020080321285141,0.4979919678714859
E01011468,2031,1029,1002,0.5066469719350074,0.4933530280649926
E01011470,1294,618,676,0.4775888717156105,0.5224111282843895
E01035054,2569,1390,1179,0.5410665628649279,0.458933437135072
E01011740,1599,764,835,0.47779862414008756,0.5222013758599124
E01011741,1405,670,735,0.47686832740213525,0.5231316725978647
E01011742,1680,832,848,0.49523809523809526,0.5047619047619047
E01011745,1748,841,907,0.48112128146453087,0.5188787185354691
E01011746,2519,1249,1270,0.49583167923779276,0.5041683207622072
E01011752,1672,823,849,0.4922248803827751,0.5077751196172249
E01011753,1427,712,715,0.4989488437281009,0.5010511562718991
E01011756,1385,670,715,0.48375451263537905,0.516245487364621
E01011762,1520,761,759,0.5006578947368421,0.4993421052631579
E01034260,1423,712,711,0.500351370344343,0.49964862965565704
E01034261,1242,630,612,0.5072463768115942,0.4927536231884058
E01011743,1407,713,694,0.5067519545131486,0.49324804548685147
E01011744,1609,791,818,0.4916096954630205,0.5083903045369795
E01011747,1707,798,909,0.46748681898066785,0.5325131810193322
E01011750,1640,807,833,0.4920731707317073,0.5079268292682927
E01011754,1538,752,786,0.4889466840052016,0.5110533159947984
E01011757,2369,1172,1197,0.49472351203039255,0.5052764879696074
E01011759,2012,943,1069,0.4686878727634195,0.5313121272365805
E01011761,2198,1090,1108,0.4959053685168335,0.5040946314831665
E01011763,1426,670,756,0.46984572230014027,0.5301542776998598
E01011764,1749,865,884,0.494568324757004,0.505431675242996
E01011748,1534,752,782,0.49022164276401564,0.5097783572359843
E01011751,1295,655,640,0.5057915057915058,0.4942084942084942
E01011755,1554,757,797,0.4871299871299871,0.5128700128700129
E01034262,1360,687,673,0.5051470588235294,0.4948529411764706
E01034263,1524,745,779,0.48884514435695536,0.5111548556430446
E01011873,2082,1012,1070,0.4860710854947166,0.5139289145052833
E01011877,1349,693,656,0.513713862120089,0.48628613787991104
E01011894,1298,617,681,0.47534668721109397,0.524653312788906
E01011895,1417,683,734,0.4820042342978123,0.5179957657021877
E01011875,1444,713,731,0.4937673130193906,0.5062326869806094
E01011876,2402,1188,1214,0.4945878434637802,0.5054121565362198
E01011878,1508,759,749,0.503315649867374,0.496684350132626
E01011880,1574,766,808,0.4866581956797967,0.5133418043202033
E01011881,1371,676,695,0.49307075127644057,0.5069292487235595
E01011887,2572,1229,1343,0.47783825816485226,0.5221617418351477
E01011893,1478,709,769,0.479702300405954,0.520297699594046
E01011896,1520,733,787,0.48223684210526313,0.5177631578947368
E01011897,1557,705,852,0.4527938342967245,0.5472061657032755
E01011874,1573,752,821,0.4780673871582963,0.5219326128417038
E01011879,1433,700,733,0.4884856943475227,0.5115143056524774
E01011882,1410,685,725,0.4858156028368794,0.5141843971631206
E01011883,1511,741,770,0.49040370615486434,0.5095962938451357
E01011805,1347,664,683,0.4929472902746845,0.5070527097253155
E01011807,1390,683,707,0.4913669064748201,0.5086330935251798
E01011808,2014,976,1038,0.4846077457795432,0.5153922542204568
E01011810,1411,681,730,0.48263642806520196,0.517363571934798
E01011803,1964,978,986,0.4979633401221996,0.5020366598778004
E01011804,1527,737,790,0.48264571054354943,0.5173542894564506
E01011806,1410,718,692,0.5092198581560283,0.4907801418439716
E01011809,1493,745,748,0.49899531145344944,0.5010046885465506
E01011811,1695,795,900,0.4690265486725664,0.5309734513274337
E01011835,2159,1068,1091,0.49467345993515516,0.5053265400648448
E01011836,1456,728,728,0.5,0.5
E01011839,2541,1177,1364,0.46320346320346323,0.5367965367965368
E01011843,1713,839,874,0.4897840046701693,0.5102159953298308
E01011844,1944,951,993,0.48919753086419754,0.5108024691358025
E01011758,2553,1284,1269,0.5029377203290247,0.4970622796709753
E01011812,2497,1231,1266,0.4929915899078895,0.5070084100921105
E01011820,1477,755,722,0.5111712931618145,0.4888287068381855
E01011821,1383,676,707,0.48879248011569054,0.5112075198843095
E01011885,1566,735,831,0.46934865900383144,0.5306513409961686
E01011886,2094,1026,1068,0.4899713467048711,0.5100286532951289
E01011888,1385,684,701,0.49386281588447656,0.5061371841155234
E01011890,1391,675,716,0.4852624011502516,0.5147375988497483
E01011891,1519,741,778,0.4878209348255431,0.5121790651744569
E01011834,2007,951,1056,0.47384155455904337,0.5261584454409567
E01011837,1693,868,825,0.5126993502658004,0.4873006497341996
E01011838,1944,1004,940,0.5164609053497943,0.4835390946502058
E01011841,2195,1108,1087,0.5047835990888383,0.49521640091116176
E01011842,1369,665,704,0.48575602629656683,0.5142439737034331
E01011813,1797,849,948,0.4724540901502504,0.5275459098497496
E01011814,1803,888,915,0.4925124792013311,0.5074875207986689
E01011815,1465,740,725,0.5051194539249146,0.4948805460750853
E01011816,1451,704,747,0.48518263266712613,0.5148173673328739
E01011819,1687,871,816,0.5163011262596325,0.4836988737403675
E01011822,1461,731,730,0.5003422313483915,0.4996577686516085
E01011884,2741,1342,1399,0.48960233491426486,0.5103976650857351
E01011912,1884,1032,852,0.5477707006369427,0.45222929936305734
E01011913,1991,1023,968,0.5138121546961326,0.4861878453038674
E01034264,1361,771,590,0.5664952240999265,0.43350477590007347
E01034265,1214,688,526,0.5667215815485996,0.4332784184514003
E01011840,1785,841,944,0.4711484593837535,0.5288515406162465
E01011850,1605,777,828,0.48411214953271026,0.5158878504672897
E01011852,1715,809,906,0.4717201166180758,0.5282798833819242
E01011853,1379,651,728,0.4720812182741117,0.5279187817258884
E01011920,2868,1801,1067,0.6279637377963738,0.37203626220362623
E01011923,1655,843,812,0.5093655589123867,0.4906344410876133
E01011924,1715,887,828,0.5172011661807581,0.482798833819242
E01011925,1830,892,938,0.48743169398907105,0.512568306010929
E01011909,1381,674,707,0.4880521361332368,0.5119478638667632
E01011910,1600,796,804,0.4975,0.5025
E01011911,1646,769,877,0.4671931956257594,0.5328068043742406
E01011914,1629,808,821,0.4960098219766728,0.5039901780233272
E01011915,1689,844,845,0.4997039668442866,0.5002960331557135
E01011823,1433,691,742,0.48220516399162594,0.5177948360083741
E01011824,1686,815,871,0.4833926453143535,0.5166073546856464
E01011825,1833,917,916,0.5002727768685216,0.49972722313147844
E01011826,1492,719,773,0.4819034852546917,0.5180965147453083
E01011827,1184,590,594,0.4983108108108108,0.5016891891891891
E01011828,1453,706,747,0.4858912594631796,0.5141087405368203
E01011889,1566,771,795,0.49233716475095785,0.5076628352490421
E01011892,1871,934,937,0.4991982896846606,0.5008017103153394
E01011919,1898,960,938,0.505795574288725,0.49420442571127504
E01011921,1495,720,775,0.4816053511705686,0.5183946488294314
E01011926,1773,908,865,0.5121263395375071,0.487873660462493
E01011927,1447,692,755,0.4782308223911541,0.5217691776088459
E01011845,1806,848,958,0.4695459579180509,0.530454042081949
E01011846,1349,652,697,0.48332097850259453,0.5166790214974055
E01011847,1416,706,710,0.4985875706214689,0.501412429378531
E01011848,1431,669,762,0.46750524109014674,0.5324947589098532
E01011851,1469,708,761,0.48196051735874745,0.5180394826412525
E01011776,1691,838,853,0.4955647545830869,0.5044352454169131
E01011777,1436,721,715,0.5020891364902507,0.4979108635097493
E01011778,1576,740,836,0.46954314720812185,0.5304568527918782
E01011817,1507,737,770,0.48905109489051096,0.5109489051094891
E01011818,1344,658,686,0.4895833333333333,0.5104166666666666
E01034266,1654,833,821,0.5036275695284159,0.496372430471584
E01034267,1391,681,710,0.4895758447160316,0.5104241552839683
E01034268,1306,635,671,0.48621745788667686,0.5137825421133231
E01011829,1390,687,703,0.49424460431654677,0.5057553956834533
E01011830,1391,665,726,0.47807332854061824,0.5219266714593818
E01011831,1705,852,853,0.4997067448680352,0.5002932551319648
E01011832,1488,715,773,0.48051075268817206,0.519489247311828
E01011833,1465,719,746,0.4907849829351536,0.5092150170648464
E01011899,1622,761,861,0.469173859432799,0.530826140567201
E01011900,1515,759,756,0.500990099009901,0.499009900990099
E01011901,1721,803,918,0.46658919233004065,0.5334108076699593
E01011904,1694,818,876,0.48288075560802834,0.5171192443919717
E01011918,2401,1165,1236,0.48521449396084965,0.5147855060391504
E01011922,1425,682,743,0.4785964912280702,0.5214035087719299
E01011779,1472,717,755,0.48709239130434784,0.5129076086956522
E01011780,1843,888,955,0.48182311448724907,0.518176885512751
E01011781,2413,1169,1244,0.4844591794446747,0.5155408205553254
E01011782,1588,761,827,0.4792191435768262,0.5207808564231738
E01011783,1722,886,836,0.5145180023228804,0.48548199767711964
E01011902,1383,693,690,0.5010845986984815,0.49891540130151846
E01011903,1229,610,619,0.4963384865744508,0.5036615134255492
E01011905,1615,794,821,0.491640866873065,0.508359133126935
E01011907,1864,963,901,0.5166309012875536,0.4833690987124464
E01011793,1647,771,876,0.4681238615664845,0.5318761384335154
E01011794,1366,644,722,0.47144948755490484,0.5285505124450952
E01011795,1308,622,686,0.47553516819571867,0.5244648318042814
E01011796,1638,816,822,0.4981684981684982,0.5018315018315018
E01011799,1479,684,795,0.46247464503042596,0.537525354969574
E01011800,1611,805,806,0.49968963376784603,0.500310366232154
E01011898,1502,796,706,0.5299600532623169,0.47003994673768307
E01011906,1672,862,810,0.5155502392344498,0.48444976076555024
E01011908,2585,1318,1267,0.5098646034816248,0.49013539651837523
E01011917,1779,964,815,0.5418774592467679,0.45812254075323217
E01011944,1452,764,688,0.5261707988980716,0.4738292011019284
E01011797,1854,897,957,0.48381877022653724,0.5161812297734628
E01011798,1356,646,710,0.47640117994100295,0.523598820058997
E01011801,1476,703,773,0.47628726287262874,0.5237127371273713
E01011802,1461,693,768,0.47433264887063653,0.5256673511293635
E01011765,1984,968,1016,0.4879032258064516,0.5120967741935484
E01011766,1640,820,820,0.5,0.5
E01011773,1423,689,734,0.48418833450456783,0.5158116654954322
E01011774,1477,715,762,0.48408937034529453,0.5159106296547055
E01011939,1430,698,732,0.4881118881118881,0.5118881118881119
E01011945,1481,712,769,0.48075624577987847,0.5192437542201216
E01011947,1517,753,764,0.4963744232036915,0.5036255767963085
E01011948,1604,782,822,0.48753117206982544,0.5124688279301746
E01011767,1813,897,916,0.4947600661886376,0.5052399338113623
E01011768,1331,645,686,0.48459804658151767,0.5154019534184824
E01011770,1876,911,965,0.48560767590618337,0.5143923240938166
E01011849,1561,745,816,0.47725816784112746,0.5227418321588725
E01011857,1672,814,858,0.4868421052631579,0.5131578947368421
E01034269,1537,732,805,0.47625243981782694,0.523747560182173
E01034270,1687,837,850,0.4961470065204505,0.5038529934795495
E01011928,1357,655,702,0.48268238761974946,0.5173176123802505
E01011931,1391,675,716,0.4852624011502516,0.5147375988497483
E01011932,1382,678,704,0.4905933429811867,0.5094066570188133
E01011938,1620,666,954,0.4111111111111111,0.5888888888888889
E01011929,2167,1105,1062,0.5099215505306876,0.4900784494693124
E01011930,1654,801,853,0.48428053204353083,0.5157194679564692
E01011933,1597,761,836,0.4765184721352536,0.5234815278647464
E01011937,1296,641,655,0.49459876543209874,0.5054012345679012
E01011934,1618,823,795,0.5086526576019778,0.49134734239802225
E01011936,1579,751,828,0.4756174794173528,0.5243825205826472
E01011940,1659,808,851,0.487040385774563,0.512959614225437
E01011943,2115,1030,1085,0.48699763593380613,0.5130023640661938
E01011935,2033,989,1044,0.4864731923266109,0.5135268076733891
E01011941,1517,715,802,0.4713249835201055,0.5286750164798946
E01011942,1289,641,648,0.4972847168347556,0.5027152831652444
E01011946,1439,692,747,0.4808895066018068,0.5191104933981932
E01011785,2275,1135,1140,0.4989010989010989,0.5010989010989011
E01011789,1435,685,750,0.47735191637630664,0.5226480836236934
E01011791,1518,762,756,0.5019762845849802,0.4980237154150198
E01011792,1460,706,754,0.48356164383561645,0.5164383561643836
E01011771,1351,661,690,0.48926720947446334,0.5107327905255367
E01011772,1635,811,824,0.4960244648318043,0.5039755351681957
E01011784,1751,882,869,0.5037121644774415,0.49628783552255856
E01011786,1556,748,808,0.480719794344473,0.519280205655527
E01011854,1573,741,832,0.47107438016528924,0.5289256198347108
E01011855,1465,712,753,0.48600682593856653,0.5139931740614334
E01011856,1416,708,708,0.5,0.5
E01011858,1794,906,888,0.5050167224080268,0.49498327759197325
E01011787,1626,797,829,0.490159901599016,0.509840098400984
E01011788,1658,816,842,0.49215922798552475,0.5078407720144753
E01011790,1589,797,792,0.5015733165512901,0.4984266834487099
E01011865,1665,802,863,0.4816816816816817,0.5183183183183183
E01011867,1609,773,836,0.48042262274704783,0.5195773772529522
E01011859,1386,647,739,0.4668109668109668,0.5331890331890332
E01011869,1306,683,623,0.5229709035222052,0.4770290964777948
E01011870,1343,652,691,0.4854802680565897,0.5145197319434103
E01011871,1462,749,713,0.512311901504788,0.48768809849521205
E01011860,1499,738,761,0.4923282188125417,0.5076717811874583
E01011861,1944,971,973,0.49948559670781895,0.5005144032921811
E01011862,2348,1132,1216,0.48211243611584326,0.5178875638841567
E01011863,1594,784,810,0.4918444165621079,0.5081555834378921
E01011864,1729,830,899,0.4800462695199537,0.5199537304800462
E01011866,1723,862,861,0.5002901915264074,0.4997098084735926
E01011868,2173,1079,1094,0.4965485503911643,0.5034514496088357
E01011872,1561,772,789,0.4945547725816784,0.5054452274183215
E01013461,1718,859,859,0.5,0.5
E01013462,1545,758,787,0.4906148867313916,0.5093851132686085
E01013463,1512,728,784,0.48148148148148145,0.5185185185185185
E01013464,1406,670,736,0.47652916073968704,0.5234708392603129
E01013465,1611,783,828,0.4860335195530726,0.5139664804469274
E01013466,1503,708,795,0.47105788423153694,0.5289421157684631
E01013467,1381,662,719,0.47936278059377263,0.5206372194062274
E01013468,1591,767,824,0.4820867379006914,0.5179132620993087
E01013469,1272,611,661,0.4803459119496855,0.5196540880503144
E01013574,1942,948,994,0.4881565396498455,0.5118434603501545
E01013575,1490,764,726,0.512751677852349,0.487248322147651
E01013576,1332,653,679,0.49024024024024027,0.5097597597597597
E01013577,1478,727,751,0.4918809201623816,0.5081190798376184
E01013578,1315,634,681,0.48212927756653995,0.5178707224334601
E01013579,1379,646,733,0.4684554024655547,0.5315445975344453
E01013580,1462,710,752,0.4856361149110807,0.5143638850889193
E01013530,1803,898,905,0.4980587909040488,0.5019412090959512
E01013531,1471,721,750,0.49014276002719237,0.5098572399728076
E01013532,1509,752,757,0.4983432736911862,0.5016567263088137
E01013581,1537,736,801,0.47885491216655823,0.5211450878334418
E01013526,1628,815,813,0.5006142506142506,0.49938574938574937
E01013527,1556,783,773,0.5032133676092545,0.4967866323907455
E01013528,1582,785,797,0.49620733249051835,0.5037926675094817
E01013529,2247,1047,1200,0.465954606141522,0.5340453938584779
E01013505,1483,736,747,0.49629130141604855,0.5037086985839514
E01013506,1503,738,765,0.49101796407185627,0.5089820359281437
E01013513,1351,670,681,0.49592894152479644,0.5040710584752035
E01013534,1601,784,817,0.4896939412866958,0.5103060587133041
E01013582,1483,700,783,0.4720161834120027,0.5279838165879973
E01013533,1604,799,805,0.4981296758104738,0.5018703241895262
E01013535,1730,834,896,0.4820809248554913,0.5179190751445086
E01013536,1545,759,786,0.4912621359223301,0.5087378640776699
E01013537,1611,763,848,0.47361887026691496,0.526381129733085
E01013538,1476,755,721,0.5115176151761518,0.48848238482384826
E01013522,1942,979,963,0.504119464469619,0.49588053553038103
E01013523,1802,953,849,0.5288568257491676,0.4711431742508324
E01013524,2599,1405,1194,0.5405925355906118,0.45940746440938823
E01013525,1901,934,967,0.49132035770647026,0.5086796422935297
E01013548,1686,791,895,0.46915776986951363,0.5308422301304864
E01013549,1518,725,793,0.4776021080368906,0.5223978919631094
E01013552,1684,834,850,0.49524940617577196,0.504750593824228
E01013553,1548,738,810,0.47674418604651164,0.5232558139534884
E01013555,2663,1316,1347,0.49417949680811113,0.5058205031918889
E01013592,1394,658,736,0.4720229555236729,0.5279770444763271
E01013594,1294,640,654,0.4945904173106646,0.5054095826893354
E01013596,1510,732,778,0.4847682119205298,0.5152317880794702
E01013599,1398,695,703,0.4971387696709585,0.5028612303290415
E01013547,1829,1026,803,0.5609622744669218,0.4390377255330782
E01013550,1269,641,628,0.5051221434200157,0.49487785657998423
E01013551,1729,902,827,0.5216888374783112,0.4783111625216888
E01013554,1574,880,694,0.5590851334180432,0.4409148665819568
E01013507,1532,758,774,0.49477806788511747,0.5052219321148825
E01013508,1286,619,667,0.4813374805598756,0.5186625194401244
E01013509,1640,805,835,0.49085365853658536,0.5091463414634146
E01013510,1585,770,815,0.48580441640378547,0.5141955835962145
E01013511,1556,770,786,0.4948586118251928,0.5051413881748072
E01013512,1436,673,763,0.46866295264623953,0.5313370473537604
E01013453,2293,1191,1102,0.5194068905364152,0.4805931094635848
E01013454,1446,706,740,0.48824343015214383,0.5117565698478561
E01013456,1795,919,876,0.5119777158774373,0.48802228412256266
E01013457,1768,871,897,0.49264705882352944,0.5073529411764706
E01013460,1783,941,842,0.5277621985417835,0.4722378014582165
E01034256,1578,855,723,0.5418250950570342,0.45817490494296575
E01034257,1604,834,770,0.5199501246882793,0.4800498753117207
E01013593,1438,692,746,0.4812239221140473,0.5187760778859527
E01013595,2451,1220,1231,0.49775601795185637,0.5022439820481436
E01013597,1581,718,863,0.4541429475015813,0.5458570524984188
E01013598,1586,739,847,0.46595208070617905,0.5340479192938209
E01013556,1370,647,723,0.47226277372262776,0.5277372262773723
E01013557,1340,665,675,0.4962686567164179,0.503731343283582
E01013558,2587,1230,1357,0.4754541940471589,0.5245458059528412
E01013559,1335,646,689,0.48389513108614235,0.5161048689138577
E01013564,2530,1247,1283,0.49288537549407113,0.5071146245059288
E01013480,2188,1250,938,0.5712979890310786,0.4287020109689214
E01013483,2019,1074,945,0.5319465081723626,0.46805349182763745
E01013485,2310,1167,1143,0.5051948051948052,0.4948051948051948
E01013565,2041,1068,973,0.5232729054385106,0.4767270945614895
E01013566,2372,1233,1139,0.519814502529511,0.48018549747048905
E01013455,1951,964,987,0.49410558687852385,0.5058944131214762
E01013458,1812,861,951,0.47516556291390727,0.5248344370860927
E01013542,2364,1163,1201,0.4919627749576988,0.5080372250423012
E01013546,1691,819,872,0.48432879952690716,0.5156712004730929
E01013481,2021,1041,980,0.5150915388421573,0.48490846115784264
E01013484,2183,1142,1041,0.5231333027943198,0.47686669720568026
E01013486,2169,1052,1117,0.4850161364684186,0.5149838635315813
E01013487,2636,1312,1324,0.4977238239757208,0.5022761760242792
E01033166,1286,684,602,0.5318818040435459,0.4681181959564541
E01033167,1269,697,572,0.5492513790386131,0.4507486209613869
E01013540,1647,796,851,0.4833029751062538,0.5166970248937462
E01013560,1371,676,695,0.49307075127644057,0.5069292487235595
E01013561,1495,718,777,0.4802675585284281,0.5197324414715719
E01013562,1330,630,700,0.47368421052631576,0.5263157894736842
E01013563,1337,663,674,0.49588631264023936,0.5041136873597607
E01013459,2092,1050,1042,0.5019120458891013,0.4980879541108987
E01013567,2364,1225,1139,0.5181895093062606,0.48181049069373943
E01013568,2639,1393,1246,0.5278514588859416,0.47214854111405835
E01013569,1861,897,964,0.48199892530897365,0.5180010746910263
E01013539,2331,1190,1141,0.5105105105105106,0.4894894894894895
E01013541,1789,815,974,0.45556176634991613,0.5444382336500838
E01013543,1706,826,880,0.48417350527549824,0.5158264947245017
E01013544,1876,932,944,0.4968017057569296,0.5031982942430704
E01013545,1716,848,868,0.49417249417249415,0.5058275058275058
E01013488,1562,747,815,0.47823303457106275,0.5217669654289373
E01013489,1521,732,789,0.4812623274161736,0.5187376725838264
E01013490,1547,745,802,0.48157724628312865,0.5184227537168714
E01013491,1681,819,862,0.48720999405116,0.5127900059488399
E01013570,2570,1374,1196,0.5346303501945525,0.4653696498054475
E01013571,2091,1040,1051,0.49736967957914874,0.5026303204208513
E01013572,1746,845,901,0.48396334478808706,0.516036655211913
E01013573,2126,1021,1105,0.48024459078080906,0.519755409219191
E01013470,1375,659,716,0.4792727272727273,0.5207272727272727
E01013474,1560,803,757,0.5147435897435897,0.48525641025641025
E01013476,1395,710,685,0.5089605734767025,0.4910394265232975
E01033171,1641,831,810,0.506398537477148,0.4936014625228519
E01033172,1591,824,767,0.5179132620993087,0.4820867379006914
E01013471,1878,916,962,0.48775292864749736,0.5122470713525027
E01013473,1611,819,792,0.5083798882681564,0.49162011173184356
E01013475,1686,816,870,0.48398576512455516,0.5160142348754448
E01013477,1704,852,852,0.5,0.5
E01013502,1520,716,804,0.4710526315789474,0.5289473684210526
E01013503,1542,794,748,0.5149156939040207,0.48508430609597925
E01013472,2364,1215,1149,0.5139593908629442,0.4860406091370558
E01013497,1793,836,957,0.4662576687116564,0.5337423312883436
E01013504,1912,929,983,0.4858786610878661,0.5141213389121339
E01013583,1854,922,932,0.49730312837108953,0.5026968716289104
E01013590,2317,1143,1174,0.49331031506258094,0.5066896849374191
E01013591,2203,1083,1120,0.49160236041761235,0.5083976395823877
E01013492,1626,828,798,0.5092250922509225,0.4907749077490775
E01013493,1565,772,793,0.49329073482428115,0.5067092651757189
E01013494,1917,916,1001,0.477829942618675,0.5221700573813249
E01013495,1835,887,948,0.4833787465940054,0.5166212534059945
E01013496,1521,692,829,0.4549638395792242,0.5450361604207759
E01013498,1457,695,762,0.4770075497597804,0.5229924502402197
E01013499,1541,749,792,0.48604802076573655,0.5139519792342635
E01013500,1699,809,890,0.47616244849911715,0.5238375515008828
E01013501,1460,705,755,0.4828767123287671,0.5171232876712328
E01013584,2056,990,1066,0.48151750972762647,0.5184824902723736
E01013585,2038,922,1116,0.4524043179587831,0.5475956820412169
E01013586,1788,848,940,0.4742729306487696,0.5257270693512305
E01013587,1677,848,829,0.505664877757901,0.49433512224209897
E01013588,1564,757,807,0.4840153452685422,0.5159846547314578
E01013589,1675,842,833,0.5026865671641791,0.4973134328358209
E01013517,1447,765,682,0.5286800276434002,0.47131997235659984
E01013518,1518,742,776,0.4888010540184453,0.5111989459815547
E01013521,1344,672,672,0.5,0.5
E01033168,1314,670,644,0.5098934550989346,0.4901065449010654
E01033169,1781,892,889,0.5008422234699607,0.4991577765300393
E01033170,1271,606,665,0.4767899291896145,0.5232100708103855
E01013514,1487,720,767,0.484196368527236,0.515803631472764
E01013515,2078,1008,1070,0.4850818094321463,0.5149181905678537
E01013519,1590,776,814,0.4880503144654088,0.5119496855345912
E01013520,1938,954,984,0.49226006191950467,0.5077399380804953
E01013615,1744,845,899,0.48451834862385323,0.5154816513761468
E01013616,1647,794,853,0.4820886460230723,0.5179113539769278
E01013618,1654,821,833,0.496372430471584,0.5036275695284159
E01013619,1847,870,977,0.47103410936654033,0.5289658906334597
E01013733,2033,1016,1017,0.499754058042302,0.500245941957698
E01013734,1437,724,713,0.5038274182324287,0.49617258176757134
E01013735,1206,570,636,0.472636815920398,0.527363184079602
E01013736,2161,1051,1110,0.4863489125404905,0.5136510874595095
E01013737,1390,666,724,0.479136690647482,0.520863309352518
E01013600,2171,1034,1137,0.4762782128051589,0.5237217871948411
E01013601,1891,950,941,0.5023796932839767,0.49762030671602325
E01013602,1950,983,967,0.5041025641025642,0.4958974358974359
E01013603,1750,842,908,0.48114285714285715,0.5188571428571429
E01013604,1925,945,980,0.4909090909090909,0.509090909090909
E01013605,2091,1032,1059,0.4935437589670014,0.5064562410329986
E01013617,2703,1314,1389,0.48612652608213097,0.5138734739178691
E01013620,1872,878,994,0.469017094017094,0.530982905982906
E01013621,2460,1181,1279,0.48008130081300815,0.5199186991869919
E01013622,1754,869,885,0.49543899657924745,0.5045610034207526
E01013623,2232,1088,1144,0.4874551971326165,0.5125448028673835
E01013732,2534,1299,1235,0.5126282557221784,0.48737174427782165
E01013739,1504,730,774,0.4853723404255319,0.5146276595744681
E01013740,1473,726,747,0.49287169042769857,0.5071283095723014
E01013741,1727,861,866,0.49855240301100173,0.5014475969889982
E01013625,2190,1089,1101,0.49726027397260275,0.5027397260273972
E01013628,1762,842,920,0.4778660612939841,0.5221339387060159
E01013715,1456,719,737,0.49381868131868134,0.5061813186813187
E01013738,1397,700,697,0.5010737294201861,0.49892627057981387
E01034008,1874,940,934,0.5016008537886874,0.4983991462113127
E01034009,1638,792,846,0.4835164835164835,0.5164835164835165
E01013624,1757,846,911,0.4815025611838361,0.518497438816164
E01013626,2043,1004,1039,0.491434165442976,0.508565834557024
E01013627,1348,664,684,0.49258160237388726,0.5074183976261127
E01013629,1815,895,920,0.4931129476584022,0.5068870523415978
E01013630,2036,1020,1016,0.5009823182711198,0.49901768172888017
E01013606,1934,954,980,0.4932781799379524,0.5067218200620476
E01013680,2114,1055,1059,0.4990539262062441,0.5009460737937559
E01013685,1511,722,789,0.47782925215089345,0.5221707478491066
E01013686,1848,917,931,0.4962121212121212,0.5037878787878788
E01034010,1767,868,899,0.49122807017543857,0.5087719298245614
E01034011,1463,770,693,0.5263157894736842,0.47368421052631576
E01034012,1290,683,607,0.5294573643410853,0.47054263565891474
E01013713,1852,920,932,0.49676025917926564,0.5032397408207343
E01013714,1872,911,961,0.48664529914529914,0.5133547008547008
E01013717,1671,858,813,0.5134649910233393,0.4865350089766607
E01013718,1900,911,989,0.47947368421052633,0.5205263157894737
E01013719,2006,990,1016,0.4935194416749751,0.5064805583250249
E01013720,1927,967,960,0.5018162947586923,0.49818370524130773
E01013651,2159,1121,1038,0.5192218619731357,0.4807781380268643
E01013652,2142,1020,1122,0.47619047619047616,0.5238095238095238
E01013653,2970,1412,1558,0.4754208754208754,0.5245791245791246
E01013655,2710,1415,1295,0.522140221402214,0.477859778597786
E01013721,1706,834,872,0.488862837045721,0.511137162954279
E01013723,1506,747,759,0.4960159362549801,0.5039840637450199
E01013725,1689,831,858,0.4920071047957371,0.5079928952042628
E01013726,1914,906,1008,0.47335423197492166,0.5266457680250783
E01013728,1805,880,925,0.48753462603878117,0.5124653739612188
E01013694,2298,1147,1151,0.4991296779808529,0.500870322019147
E01013700,1615,790,825,0.4891640866873065,0.5108359133126935
E01013770,1477,735,742,0.4976303317535545,0.5023696682464455
E01013771,1673,825,848,0.4931261207411835,0.5068738792588166
E01013773,1453,726,727,0.49965588437715075,0.5003441156228493
E01013681,2050,1021,1029,0.4980487804878049,0.5019512195121951
E01013682,1911,937,974,0.4903192046049189,0.5096807953950812
E01013683,2394,1230,1164,0.5137844611528822,0.48621553884711777
E01013684,2395,1170,1225,0.48851774530271397,0.511482254697286
E01013654,2654,1311,1343,0.4939713639788998,0.5060286360211003
E01013656,2213,1126,1087,0.50881156800723,0.49118843199277
E01013657,1940,981,959,0.5056701030927835,0.4943298969072165
E01013658,2857,1451,1406,0.5078753937696885,0.4921246062303115
E01013659,2263,1118,1145,0.49403446752098984,0.5059655324790102
E01013743,2206,1130,1076,0.5122393472348141,0.4877606527651859
E01013745,1702,826,876,0.48531139835487663,0.5146886016451234
E01013742,1819,904,915,0.49697636063771305,0.503023639362287
E01013744,1865,929,936,0.49812332439678286,0.5018766756032171
E01013746,1844,922,922,0.5,0.5
E01013748,1917,962,955,0.5018257694314032,0.4981742305685968
E01013754,2463,1253,1210,0.5087291920422249,0.49127080795777506
E01013755,2453,1192,1261,0.48593558907460255,0.5140644109253975
E01013660,2060,1017,1043,0.4936893203883495,0.5063106796116504
E01013661,1949,956,993,0.4905079527963058,0.5094920472036942
E01013664,1847,895,952,0.484569572279372,0.5154304277206281
E01013665,2345,1122,1223,0.47846481876332625,0.5215351812366738
E01013667,1619,804,815,0.49660284126003706,0.5033971587399629
E01013668,1357,639,718,0.470891672807664,0.529108327192336
E01013729,1289,646,643,0.5011636927851048,0.49883630721489525
E01013780,1597,792,805,0.49592986850344395,0.504070131496556
E01013783,1513,737,776,0.4871116986120291,0.5128883013879709
E01013785,1538,743,795,0.4830949284785436,0.5169050715214565
E01013786,1621,827,794,0.5101789019123998,0.48982109808760027
E01013662,1943,911,1032,0.4688625836335564,0.5311374163664436
E01013663,1819,887,932,0.4876305662451897,0.5123694337548104
E01013747,2002,1017,985,0.5079920079920079,0.492007992007992
E01013749,1600,801,799,0.500625,0.499375
E01013750,1578,776,802,0.4917617237008872,0.5082382762991128
E01013758,1666,816,850,0.4897959183673469,0.5102040816326531
E01013751,1980,995,985,0.5025252525252525,0.49747474747474746
E01013752,1603,802,801,0.5003119151590767,0.49968808484092325
E01013753,1784,888,896,0.4977578475336323,0.5022421524663677
E01013760,1907,1026,881,0.5380178290508653,0.46198217094913474
E01013761,2037,1050,987,0.5154639175257731,0.4845360824742268
E01013762,1813,914,899,0.5041367898510756,0.4958632101489244
E01013774,1876,999,877,0.5325159914712153,0.46748400852878463
E01013776,1886,1024,862,0.542948038176034,0.45705196182396607
E01013779,2074,1102,972,0.5313404050144648,0.4686595949855352
E01013781,1716,947,769,0.5518648018648019,0.44813519813519814
E01013782,1478,733,745,0.4959404600811908,0.5040595399188093
E01013784,1337,711,626,0.531787584143605,0.4682124158563949
E01034013,1935,939,996,0.48527131782945737,0.5147286821705427
E01034014,1512,704,808,0.4656084656084656,0.5343915343915344
E01013666,1702,813,889,0.47767332549941244,0.5223266745005876
E01013669,1525,774,751,0.5075409836065574,0.49245901639344264
E01013670,1994,968,1026,0.485456369107322,0.5145436308926781
E01013671,1959,949,1010,0.484430832057172,0.5155691679428279
E01013672,1538,756,782,0.49154746423927176,0.5084525357607282
E01013631,1604,778,826,0.4850374064837905,0.5149625935162094
E01013632,1907,953,954,0.49973780807551127,0.5002621919244887
E01013638,1760,849,911,0.4823863636363636,0.5176136363636363
E01013640,2117,984,1133,0.46480869154463866,0.5351913084553613
E01013756,2048,1034,1014,0.5048828125,0.4951171875
E01013757,1698,847,851,0.4988221436984688,0.5011778563015312
E01013759,1917,967,950,0.504434011476265,0.495565988523735
E01013763,2243,1179,1064,0.5256353098528757,0.4743646901471244
E01013764,1644,816,828,0.49635036496350365,0.5036496350364964
E01013765,1875,995,880,0.5306666666666666,0.4693333333333333
E01013766,2018,1045,973,0.5178394449950446,0.4821605550049554
E01013633,1706,816,890,0.4783118405627198,0.5216881594372802
E01013634,1498,712,786,0.4753004005340454,0.5246995994659546
E01013637,2095,1038,1057,0.4954653937947494,0.5045346062052506
E01013639,1636,776,860,0.4743276283618582,0.5256723716381418
E01013641,1522,765,757,0.5026281208935611,0.4973718791064389
E01013635,1548,775,773,0.5006459948320413,0.49935400516795864
E01013636,1346,667,679,0.49554234769687966,0.5044576523031203
E01013777,1918,1000,918,0.5213764337851929,0.4786235662148071
E01034015,1429,723,706,0.5059482155353394,0.4940517844646606
E01034016,1904,992,912,0.5210084033613446,0.4789915966386555
E01013642,1710,833,877,0.4871345029239766,0.5128654970760234
E01013643,1856,905,951,0.48760775862068967,0.5123922413793104
E01013649,1318,670,648,0.5083459787556904,0.49165402124430957
E01013650,1759,839,920,0.4769755542922115,0.5230244457077885
E01013702,1644,825,819,0.5018248175182481,0.4981751824817518
E01013710,1409,708,701,0.5024840312278211,0.49751596877217885
E01013711,1637,819,818,0.5003054367745876,0.49969456322541234
E01013613,1874,942,932,0.5026680896478122,0.4973319103521878
E01013614,1726,816,910,0.4727694090382387,0.5272305909617613
E01013687,1658,876,782,0.5283474065138721,0.47165259348612787
E01013688,1996,967,1029,0.4844689378757515,0.5155310621242485
E01013703,1304,651,653,0.49923312883435583,0.5007668711656442
E01013704,1451,676,775,0.4658855961405927,0.5341144038594073
E01013706,1700,838,862,0.4929411764705882,0.5070588235294118
E01013707,1569,749,820,0.47737412364563414,0.5226258763543659
E01013712,1298,648,650,0.49922958397534667,0.5007704160246533
E01013608,1586,802,784,0.5056746532156369,0.4943253467843632
E01013609,1563,762,801,0.4875239923224568,0.5124760076775432
E01013610,1731,842,889,0.48642403235124204,0.5135759676487579
E01013611,1672,821,851,0.4910287081339713,0.5089712918660287
E01013612,1792,920,872,0.5133928571428571,0.48660714285714285
E01013678,1772,878,894,0.49548532731376976,0.5045146726862303
E01013679,1586,772,814,0.48675914249684743,0.5132408575031526
E01013691,1772,804,968,0.45372460496614,0.54627539503386
E01013692,1494,703,791,0.4705488621151272,0.5294511378848729
E01013693,1654,783,871,0.47339782345828296,0.526602176541717
E01013673,1674,832,842,0.4970131421744325,0.5029868578255675
E01013674,1556,732,824,0.4704370179948586,0.5295629820051414
E01013675,1730,787,943,0.4549132947976879,0.5450867052023122
E01013676,2181,1024,1157,0.4695093993580926,0.5304906006419073
E01013677,1510,745,765,0.49337748344370863,0.5066225165562914
E01013698,1711,822,889,0.4804208065458796,0.5195791934541204
E01013767,1672,828,844,0.49521531100478466,0.5047846889952153
E01013768,1945,961,984,0.49408740359897174,0.5059125964010283
E01013772,1677,788,889,0.469886702444842,0.530113297555158
E01032597,1567,742,825,0.47351627313337585,0.5264837268666241
E01034017,1703,825,878,0.4844392248972402,0.5155607751027599
E01034018,1519,708,811,0.4660961158657011,0.5339038841342989
E01013689,2005,1068,937,0.5326683291770573,0.46733167082294264
E01013690,2321,1162,1159,0.5006462731581215,0.4993537268418785
E01013705,1638,794,844,0.48473748473748474,0.5152625152625152
E01013709,1649,828,821,0.5021224984839296,0.49787750151607035
E01032599,1617,800,817,0.49474335188620905,0.505256648113791
E01013722,1981,960,1021,0.4846037354871277,0.5153962645128722
E01013727,1705,840,865,0.49266862170087977,0.5073313782991202
E01013730,1737,858,879,0.4939550949913644,0.5060449050086355
E01013731,1589,743,846,0.4675896790434235,0.5324103209565765
E01032602,1804,856,948,0.4745011086474501,0.5254988913525499
E01013648,3529,1720,1809,0.487390195522811,0.512609804477189
E01034019,1770,890,880,0.5028248587570622,0.4971751412429379
E01034020,3525,1782,1743,0.505531914893617,0.49446808510638296
E01034021,1290,636,654,0.4930232558139535,0.5069767441860465
E01032868,2781,1287,1494,0.4627831715210356,0.5372168284789643
E01032872,1186,620,566,0.5227655986509275,0.4772344013490725
E01032873,2004,1072,932,0.5349301397205589,0.46506986027944114
E01034022,2833,1292,1541,0.4560536533709848,0.5439463466290152
E01034023,1247,634,613,0.5084202085004009,0.491579791499599
E01032862,2296,1123,1173,0.4891114982578397,0.5108885017421603
E01032863,2380,1146,1234,0.4815126050420168,0.5184873949579832
E01032865,2108,1033,1075,0.49003795066413663,0.5099620493358634
E01013696,2498,1216,1282,0.4867894315452362,0.5132105684547638
E01013699,2005,960,1045,0.47880299251870323,0.5211970074812967
E01034024,1916,933,983,0.4869519832985386,0.5130480167014614
E01034025,2053,1040,1013,0.5065757428153921,0.4934242571846079
E01013788,3648,2223,1425,0.609375,0.390625
E01013789,1368,671,697,0.4904970760233918,0.5095029239766082
E01013790,2474,1748,726,0.7065481002425222,0.29345189975747776
E01013796,1461,748,713,0.5119780971937029,0.48802190280629704
E01013793,1400,677,723,0.4835714285714286,0.5164285714285715
E01013800,1502,713,789,0.47470039946737685,0.5252996005326231
E01013809,1245,607,638,0.4875502008032129,0.5124497991967871
E01035102,1562,773,789,0.49487836107554417,0.5051216389244558
E01035103,1202,563,639,0.4683860232945091,0.5316139767054908
E01035104,1369,657,712,0.4799123447772096,0.5200876552227903
E01013798,1331,654,677,0.49135987978963186,0.5086401202103682
E01013799,1667,828,839,0.4967006598680264,0.5032993401319736
E01013803,2258,1089,1169,0.48228520814880427,0.5177147918511957
E01035105,1355,668,687,0.4929889298892989,0.5070110701107011
E01035106,1259,578,681,0.45909451945988883,0.5409054805401112
E01013791,1156,552,604,0.47750865051903113,0.5224913494809689
E01013792,1674,806,868,0.48148148148148145,0.5185185185185185
E01013797,1713,853,860,0.4979568009340339,0.5020431990659662
E01013804,1590,781,809,0.4911949685534591,0.5088050314465409
E01013805,1348,700,648,0.5192878338278932,0.4807121661721068
E01013787,1279,609,670,0.4761532447224394,0.5238467552775606
E01013794,1340,659,681,0.4917910447761194,0.5082089552238805
E01013795,1128,573,555,0.5079787234042553,0.4920212765957447
E01013806,1826,978,848,0.5355969331872946,0.4644030668127054
E01013807,1284,616,668,0.4797507788161994,0.5202492211838006
E01013808,1614,750,864,0.4646840148698885,0.5353159851301115
E01013887,1645,769,876,0.4674772036474164,0.5325227963525836
E01013892,1365,663,702,0.4857142857142857,0.5142857142857142
E01013893,1512,694,818,0.458994708994709,0.541005291005291
E01013894,1494,725,769,0.48527443105756357,0.5147255689424364
E01013879,1311,624,687,0.4759725400457666,0.5240274599542334
E01013880,1545,708,837,0.458252427184466,0.541747572815534
E01013881,1548,732,816,0.4728682170542636,0.5271317829457365
E01013882,1470,699,771,0.47551020408163264,0.5244897959183673
E01013885,1648,768,880,0.46601941747572817,0.5339805825242718
E01013886,1446,688,758,0.47579529737206083,0.5242047026279392
E01013888,1590,765,825,0.4811320754716981,0.5188679245283019
E01013889,1680,795,885,0.4732142857142857,0.5267857142857143
E01013890,1511,694,817,0.45929847782925215,0.5407015221707479
E01013891,1752,790,962,0.4509132420091324,0.5490867579908676
E01013875,1278,641,637,0.5015649452269171,0.4984350547730829
E01013876,1692,799,893,0.4722222222222222,0.5277777777777778
E01013877,1557,723,834,0.464354527938343,0.535645472061657
E01013878,1366,663,703,0.48535871156661786,0.5146412884333821
E01013883,1450,685,765,0.4724137931034483,0.5275862068965518
E01013884,1353,684,669,0.5055432372505543,0.49445676274944567
E01013853,1534,740,794,0.48239895697522817,0.5176010430247718
E01013854,1456,670,786,0.46016483516483514,0.5398351648351648
E01013855,1663,774,889,0.465423932651834,0.534576067348166
E01013856,1627,755,872,0.46404425322679776,0.5359557467732022
E01033397,1963,954,1009,0.4859908303616913,0.5140091696383087
E01033398,1191,603,588,0.5062972292191436,0.49370277078085645
E01013963,1517,720,797,0.47462096242584045,0.5253790375741595
E01013964,1821,874,947,0.47995606809445357,0.5200439319055464
E01013965,1464,680,784,0.4644808743169399,0.5355191256830601
E01013966,1381,663,718,0.48008689355539463,0.5199131064446053
E01013967,1875,1167,708,0.6224,0.3776
E01013827,1425,693,732,0.4863157894736842,0.5136842105263157
E01013828,1804,862,942,0.4778270509977827,0.5221729490022173
E01013834,1594,723,871,0.4535759096612296,0.5464240903387704
E01013835,1614,766,848,0.4745972738537794,0.5254027261462205
E01013836,1999,928,1071,0.464232116058029,0.535767883941971
E01013829,1678,796,882,0.47437425506555425,0.5256257449344458
E01013830,1599,778,821,0.48655409631019386,0.5134459036898061
E01013831,1480,736,744,0.4972972972972973,0.5027027027027027
E01013832,1856,967,889,0.5210129310344828,0.47898706896551724
E01013833,1319,635,684,0.48142532221379836,0.5185746777862017
E01013935,1465,716,749,0.4887372013651877,0.5112627986348123
E01013968,1352,668,684,0.4940828402366864,0.5059171597633136
E01013969,1768,871,897,0.49264705882352944,0.5073529411764706
E01013970,1557,740,817,0.47527296082209375,0.5247270391779062
E01013971,1576,844,732,0.5355329949238579,0.46446700507614214
E01013817,1744,793,951,0.4547018348623853,0.5452981651376146
E01013818,1712,781,931,0.45619158878504673,0.5438084112149533
E01013822,1881,863,1018,0.45879851143009037,0.5412014885699096
E01013825,2032,966,1066,0.47539370078740156,0.5246062992125984
E01013826,1911,890,1021,0.46572475143903713,0.5342752485609629
E01013837,2063,1043,1020,0.5055744062045565,0.49442559379544354
E01013838,1772,881,891,0.4971783295711061,0.5028216704288939
E01013839,2026,973,1053,0.48025666337611056,0.5197433366238894
E01013840,2500,1216,1284,0.4864,0.5136
E01013841,1652,816,836,0.4939467312348668,0.5060532687651331
E01013819,1819,848,971,0.46619021440351843,0.5338097855964816
E01013820,1727,830,897,0.4806022003474233,0.5193977996525767
E01013821,1742,767,975,0.44029850746268656,0.5597014925373134
E01013823,1777,825,952,0.4642656162070906,0.5357343837929094
E01013824,1679,777,902,0.46277546158427635,0.5372245384157236
E01013864,2208,1035,1173,0.46875,0.53125
E01013865,1557,757,800,0.4861913937058446,0.5138086062941555
E01013866,1478,732,746,0.4952638700947226,0.5047361299052774
E01013867,1624,726,898,0.44704433497536944,0.5529556650246306
E01013937,1786,915,871,0.5123180291153415,0.4876819708846585
E01013938,1618,873,745,0.5395550061804697,0.4604449938195303
E01013941,1930,987,943,0.5113989637305699,0.4886010362694301
E01013943,1898,966,932,0.5089567966280295,0.4910432033719705
E01013972,1514,719,795,0.4749009247027741,0.5250990752972259
E01013936,2126,1041,1085,0.4896519285042333,0.5103480714957667
E01013939,1426,722,704,0.5063113604488079,0.49368863955119213
E01013940,1943,972,971,0.5002573340195574,0.4997426659804426
E01013942,2209,1119,1090,0.5065640561339972,0.4934359438660027
E01013843,2142,1079,1063,0.503734827264239,0.496265172735761
E01013844,1744,842,902,0.4827981651376147,0.5172018348623854
E01013845,1956,960,996,0.49079754601226994,0.50920245398773
E01013847,1589,862,727,0.5424795468848332,0.45752045311516676
E01013810,1973,1026,947,0.5200202736948809,0.4799797263051191
E01013811,1350,702,648,0.52,0.48
E01013812,1635,804,831,0.4917431192660551,0.5082568807339449
E01013842,1950,990,960,0.5076923076923077,0.49230769230769234
E01013846,1734,899,835,0.5184544405997693,0.4815455594002307
E01013930,1979,986,993,0.4982314300151592,0.5017685699848409
E01013931,2170,1077,1093,0.4963133640552995,0.5036866359447004
E01013932,2533,1262,1271,0.4982234504540071,0.5017765495459929
E01013933,1998,997,1001,0.498998998998999,0.501001001001001
E01013934,1596,803,793,0.5031328320802005,0.4968671679197995
E01013859,1510,719,791,0.476158940397351,0.523841059602649
E01013861,1578,736,842,0.4664131812420786,0.5335868187579215
E01013868,1549,731,818,0.47191736604260814,0.5280826339573919
E01013929,2050,966,1084,0.4712195121951219,0.5287804878048781
E01013954,1990,963,1027,0.48391959798994977,0.5160804020100502
E01013959,1917,904,1013,0.4715701617110068,0.5284298382889933
E01013960,1837,980,857,0.5334784975503538,0.4665215024496462
E01013962,2113,1017,1096,0.48130619971604355,0.5186938002839565
E01013813,2928,1367,1561,0.46687158469945356,0.5331284153005464
E01013814,2230,1186,1044,0.5318385650224215,0.46816143497757845
E01013815,2140,1139,1001,0.5322429906542057,0.4677570093457944
E01013816,4005,1869,2136,0.4666666666666667,0.5333333333333333
E01013958,1755,888,867,0.505982905982906,0.49401709401709404
E01013961,2440,1088,1352,0.4459016393442623,0.5540983606557377
E01033399,2587,1143,1444,0.4418245071511403,0.5581754928488597
E01033409,1545,804,741,0.5203883495145631,0.4796116504854369
E01033411,1142,631,511,0.5525394045534151,0.44746059544658495
E01035500,2090,1048,1042,0.5014354066985646,0.49856459330143543
E01013913,1758,882,876,0.5017064846416383,0.49829351535836175
E01013914,1687,814,873,0.4825133372851215,0.5174866627148785
E01013915,1511,731,780,0.48378557246856385,0.5162144275314361
E01013916,1561,750,811,0.48046124279308133,0.5195387572069187
E01013917,1942,975,967,0.5020597322348095,0.4979402677651905
E01013858,1438,704,734,0.48956884561891517,0.5104311543810849
E01013860,1696,767,929,0.4522405660377358,0.5477594339622641
E01013862,1544,746,798,0.483160621761658,0.5168393782383419
E01013863,1508,708,800,0.46949602122015915,0.5305039787798409
E01013944,1835,962,873,0.52425068119891,0.4757493188010899
E01013945,2351,1270,1081,0.5401956614206721,0.45980433857932795
E01013947,2035,1017,1018,0.49975429975429975,0.5002457002457003
E01013948,1397,799,598,0.5719398711524696,0.4280601288475304
E01013953,1979,977,1002,0.49368367862556845,0.5063163213744315
E01033395,3246,1678,1568,0.5169439309919901,0.48305606900800985
E01033396,1109,556,553,0.5013525698827773,0.49864743011722273
E01032520,1921,1006,915,0.523685580426861,0.47631441957313897
E01032522,2461,1290,1171,0.5241771637545714,0.4758228362454287
E01035501,2381,1233,1148,0.5178496430071399,0.48215035699286013
E01035502,2908,1407,1501,0.483837689133425,0.5161623108665749
E01013918,1997,990,1007,0.4957436154231347,0.5042563845768653
E01013919,1976,1050,926,0.5313765182186235,0.4686234817813765
E01013920,2260,1206,1054,0.5336283185840708,0.4663716814159292
E01013921,2199,1103,1096,0.5015916325602546,0.4984083674397453
E01013957,1648,834,814,0.5060679611650486,0.49393203883495146
E01013980,1714,845,869,0.49299883313885645,0.5070011668611435
E01013982,1720,826,894,0.48023255813953486,0.5197674418604651
E01013983,1334,649,685,0.48650674662668664,0.5134932533733133
E01013984,1458,697,761,0.4780521262002744,0.5219478737997256
E01013985,1713,831,882,0.4851138353765324,0.5148861646234676
E01013928,1520,761,759,0.5006578947368421,0.4993421052631579
E01033410,2672,1328,1344,0.49700598802395207,0.5029940119760479
E01035503,2075,1080,995,0.5204819277108433,0.4795180722891566
E01035504,1696,861,835,0.5076650943396226,0.49233490566037735
E01035505,3027,1529,1498,0.5051205814337628,0.4948794185662372
E01013895,1447,698,749,0.4823773324118867,0.5176226675881134
E01013896,1281,635,646,0.4957064793130367,0.5042935206869633
E01013901,1515,732,783,0.48316831683168315,0.5168316831683168
E01013902,1886,931,955,0.4936373276776246,0.5063626723223754
E01013897,1509,725,784,0.4804506295559973,0.5195493704440026
E01013898,2300,1207,1093,0.5247826086956522,0.4752173913043478
E01013899,1316,624,692,0.47416413373860183,0.5258358662613982
E01013900,1522,685,837,0.450065703022339,0.5499342969776609
E01013903,1206,577,629,0.478441127694859,0.521558872305141
E01013907,1535,733,802,0.4775244299674267,0.5224755700325733
E01013905,1487,727,760,0.48890383322125086,0.5110961667787491
E01013908,1489,669,820,0.4492948287441236,0.5507051712558765
E01013909,1473,667,806,0.4528173794976239,0.5471826205023761
E01013912,1445,719,726,0.4975778546712803,0.5024221453287198
E01013904,1553,742,811,0.47778493238892467,0.5222150676110754
E01013906,1739,815,924,0.4686601495112133,0.5313398504887866
E01013910,1546,765,781,0.4948253557567917,0.5051746442432082
E01013911,1538,755,783,0.4908972691807542,0.5091027308192457
E01013849,1515,671,844,0.4429042904290429,0.5570957095709571
E01013850,1426,697,729,0.4887798036465638,0.5112201963534362
E01013851,1512,690,822,0.45634920634920634,0.5436507936507936
E01013852,1675,841,834,0.502089552238806,0.49791044776119403
E01032621,1504,748,756,0.4973404255319149,0.5026595744680851
E01013874,1680,867,813,0.5160714285714286,0.48392857142857143
E01033400,2746,1317,1429,0.47960670065549893,0.5203932993445011
E01033402,1369,702,667,0.5127830533235939,0.48721694667640614
E01033407,1204,678,526,0.5631229235880398,0.4368770764119601
E01035506,2214,1253,961,0.565943992773261,0.4340560072267389
E01013870,2365,1234,1131,0.5217758985200845,0.47822410147991545
E01013871,1754,877,877,0.5,0.5
E01013872,2003,1002,1001,0.5002496255616575,0.49975037443834247
E01013873,1785,917,868,0.5137254901960784,0.48627450980392156
E01013977,1938,952,986,0.49122807017543857,0.5087719298245614
E01013978,1829,886,943,0.48441771459814104,0.5155822854018589
E01013979,1707,836,871,0.4897480960749854,0.5102519039250146
E01013981,1754,868,886,0.49486887115165334,0.5051311288483467
E01035507,4743,2296,2447,0.48408180476491675,0.5159181952350833
E01035508,4951,2478,2473,0.5005049484952535,0.4994950515047465
E01026971,1777,859,918,0.48339898705683737,0.5166010129431626
E01026979,1643,790,853,0.4808277541083384,0.5191722458916616
E01026980,1632,791,841,0.4846813725490196,0.5153186274509803
E01026982,2269,1086,1183,0.47862494490965185,0.5213750550903482
E01026969,1782,868,914,0.48709315375982043,0.5129068462401796
E01026970,1710,834,876,0.48771929824561405,0.512280701754386
E01026972,1839,911,928,0.4953779227841218,0.5046220772158782
E01026976,1668,833,835,0.49940047961630696,0.500599520383693
E01026981,1236,626,610,0.5064724919093851,0.4935275080906149
E01026983,1098,574,524,0.5227686703096539,0.4772313296903461
E01026957,1873,903,970,0.48211425520555257,0.5178857447944474
E01026958,1967,1010,957,0.5134722928317235,0.4865277071682766
E01035393,1723,849,874,0.4927452118398143,0.5072547881601858
E01035394,1670,813,857,0.4868263473053892,0.5131736526946108
E01035395,1459,729,730,0.4996572995202193,0.5003427004797807
E01035396,1274,618,656,0.4850863422291994,0.5149136577708007
E01035397,1935,942,993,0.4868217054263566,0.5131782945736434
E01035398,1898,934,964,0.49209694415173866,0.5079030558482613
E01026962,1442,715,727,0.4958391123439667,0.5041608876560333
E01026973,1473,722,751,0.49015614392396467,0.5098438560760353
E01026974,1131,547,584,0.48364279398762156,0.5163572060123784
E01026975,1379,685,694,0.49673676577229875,0.5032632342277013
E01026984,1909,919,990,0.4814038763750655,0.5185961236249346
E01026985,2067,962,1105,0.46540880503144655,0.5345911949685535
E01026949,1429,713,716,0.4989503149055283,0.5010496850944717
E01026950,1634,807,827,0.4938800489596083,0.5061199510403916
E01026951,1355,660,695,0.4870848708487085,0.5129151291512916
E01026952,1445,741,704,0.5128027681660899,0.48719723183391006
E01026959,1534,720,814,0.46936114732724904,0.530638852672751
E01026960,1589,829,760,0.5217117684078036,0.47828823159219636
E01026961,1318,681,637,0.5166919575113809,0.48330804248861914
E01026965,1616,821,795,0.5080445544554455,0.49195544554455445
E01026966,1489,740,749,0.49697783747481533,0.5030221625251847
E01026967,1853,931,922,0.5024284943335132,0.4975715056664868
E01026968,1790,905,885,0.505586592178771,0.49441340782122906
E01027033,1928,964,964,0.5,0.5
E01027043,2406,1197,1209,0.4975062344139651,0.5024937655860349
E01027050,2147,1048,1099,0.488122962272939,0.5118770377270611
E01027031,2142,1036,1106,0.48366013071895425,0.5163398692810458
E01027044,2190,1084,1106,0.4949771689497717,0.5050228310502283
E01027046,1622,795,827,0.49013563501849566,0.5098643649815043
E01027047,1327,651,676,0.4905802562170309,0.5094197437829691
E01027048,2256,1180,1076,0.5230496453900709,0.4769503546099291
E01027049,1048,471,577,0.4494274809160305,0.5505725190839694
E01027032,1847,905,942,0.4899837574445046,0.5100162425554954
E01027045,2029,998,1031,0.49186791522917694,0.5081320847708231
E01027075,1990,1000,990,0.5025125628140703,0.49748743718592964
E01027076,2188,1106,1082,0.5054844606946983,0.4945155393053016
E01035407,1537,774,763,0.5035783994795056,0.49642160052049444
E01035408,1529,746,783,0.48790058862001306,0.5120994113799869
E01027057,2331,1163,1168,0.49892749892749894,0.5010725010725011
E01027074,2101,1028,1073,0.4892908138981437,0.5107091861018562
E01027078,2093,1032,1061,0.4930721452460583,0.5069278547539418
E01027051,2085,1018,1067,0.4882494004796163,0.5117505995203837
E01027052,1523,755,768,0.49573210768220616,0.5042678923177938
E01027053,2201,1097,1104,0.4984098137210359,0.5015901862789641
E01027054,1168,591,577,0.5059931506849316,0.4940068493150685
E01027055,1305,639,666,0.4896551724137931,0.5103448275862069
E01027056,1596,780,816,0.48872180451127817,0.5112781954887218
E01027038,1944,937,1007,0.48199588477366256,0.5180041152263375
E01027039,2098,1033,1065,0.49237368922783603,0.5076263107721639
E01027040,1750,863,887,0.49314285714285716,0.5068571428571429
E01027041,1699,803,896,0.4726309593878752,0.5273690406121248
E01027042,1817,929,888,0.5112823335167859,0.4887176664832141
E01027034,1620,724,896,0.4469135802469136,0.5530864197530864
E01027035,1489,732,757,0.4916051040967092,0.5083948959032908
E01027037,2565,1262,1303,0.49200779727095517,0.5079922027290449
E01033244,2696,1329,1367,0.49295252225519287,0.5070474777448071
E01033245,1077,510,567,0.4735376044568245,0.5264623955431755
E01027061,2692,1321,1371,0.49071322436849923,0.5092867756315007
E01027062,2324,1101,1223,0.4737521514629948,0.5262478485370051
E01027063,1862,937,925,0.5032223415682062,0.4967776584317938
E01027064,1630,807,823,0.4950920245398773,0.5049079754601227
E01027072,1779,868,911,0.48791455874086564,0.5120854412591344
E01027073,2060,971,1089,0.47135922330097085,0.5286407766990291
E01027058,1791,877,914,0.4896705750977108,0.5103294249022893
E01027059,1756,873,883,0.4971526195899772,0.5028473804100227
E01027060,2205,1058,1147,0.4798185941043084,0.5201814058956916
E01027065,1898,972,926,0.512118018967334,0.48788198103266595
E01027069,1708,850,858,0.49765807962529274,0.5023419203747073
E01027066,2080,1027,1053,0.49375,0.50625
E01027067,1733,841,892,0.4852856318522793,0.5147143681477208
E01027070,1533,778,755,0.507501630789302,0.49249836921069795
E01027071,1425,731,694,0.5129824561403509,0.4870175438596491
E01035409,1513,754,759,0.4983476536682089,0.5016523463317911
E01035410,1698,851,847,0.5011778563015312,0.4988221436984688
E01027090,1698,839,859,0.49411071849234395,0.5058892815076561
E01027103,1643,810,833,0.4930006086427267,0.5069993913572732
E01027129,2268,1119,1149,0.4933862433862434,0.5066137566137566
E01027094,1560,753,807,0.4826923076923077,0.5173076923076924
E01027095,1638,833,805,0.5085470085470085,0.49145299145299143
E01027107,1293,640,653,0.49497293116782676,0.5050270688321732
E01027108,1316,644,672,0.48936170212765956,0.5106382978723404
E01027109,1233,613,620,0.49716139497161393,0.5028386050283861
E01032969,1637,809,828,0.49419670128283444,0.5058032987171656
E01032970,2087,1006,1081,0.48203162434115954,0.5179683756588405
E01032971,1138,566,572,0.4973637961335677,0.5026362038664324
E01027123,1647,791,856,0.4802671523982999,0.5197328476017
E01027125,1792,883,909,0.4927455357142857,0.5072544642857143
E01027126,2432,1194,1238,0.4909539473684211,0.509046052631579
E01035411,1490,701,789,0.4704697986577181,0.5295302013422819
E01035412,1260,602,658,0.4777777777777778,0.5222222222222223
E01027079,1860,917,943,0.493010752688172,0.5069892473118279
E01027080,1957,945,1012,0.48288196218702095,0.517118037812979
E01027087,1159,588,571,0.5073339085418465,0.4926660914581536
E01027088,1256,637,619,0.5071656050955414,0.4928343949044586
E01027089,2210,1070,1140,0.4841628959276018,0.5158371040723982
E01027081,1579,763,816,0.4832172260924636,0.5167827739075365
E01027082,1871,938,933,0.501336183858899,0.498663816141101
E01027083,1526,745,781,0.48820445609436436,0.5117955439056356
E01027127,1962,979,983,0.49898063200815496,0.5010193679918451
E01027128,1807,921,886,0.5096845600442723,0.49031543995572774
E01027105,2562,1357,1205,0.529664324746292,0.47033567525370806
E01027106,2123,1072,1051,0.5049458313707018,0.4950541686292982
E01027111,2172,1147,1025,0.5280847145488029,0.47191528545119704
E01027112,2346,1174,1172,0.5004262574595055,0.49957374254049447
E01027104,2459,1217,1242,0.4949166327775518,0.5050833672224482
E01027113,2263,1110,1153,0.4904993371630579,0.5095006628369421
E01027115,2097,977,1120,0.4659036719122556,0.5340963280877444
E01027116,2197,1103,1094,0.5020482476103778,0.4979517523896222
E01027117,1482,713,769,0.48110661268556004,0.5188933873144399
E01035413,1013,511,502,0.5044422507403751,0.49555774925962487
E01035414,1116,562,554,0.503584229390681,0.496415770609319
E01027096,1152,539,613,0.4678819444444444,0.5321180555555556
E01027097,1523,750,773,0.49244911359159554,0.5075508864084045
E01027098,1165,557,608,0.4781115879828326,0.5218884120171674
E01027099,1481,715,766,0.48278190411883865,0.5172180958811614
E01027122,1179,586,593,0.49703138252756573,0.5029686174724343
E01027100,1786,842,944,0.47144456886898095,0.528555431131019
E01027114,1649,839,810,0.5087932080048514,0.49120679199514855
E01027130,1905,921,984,0.48346456692913387,0.5165354330708661
E01027131,2280,1106,1174,0.4850877192982456,0.5149122807017544
E01027084,2352,1130,1222,0.4804421768707483,0.5195578231292517
E01027085,1576,737,839,0.4676395939086294,0.5323604060913706
E01027086,2101,1024,1077,0.48738695859114706,0.5126130414088529
E01027120,1284,664,620,0.5171339563862928,0.48286604361370716
E01027121,2394,1202,1192,0.5020885547201337,0.4979114452798663
E01027326,1552,775,777,0.4993556701030928,0.5006443298969072
E01027327,1557,786,771,0.5048169556840078,0.4951830443159923
E01027328,1447,730,717,0.5044920525224602,0.49550794747753973
E01027338,2429,1224,1205,0.5039110745162618,0.4960889254837382
E01027330,1817,874,943,0.4810126582278481,0.5189873417721519
E01027331,1545,763,782,0.49385113268608416,0.5061488673139158
E01027332,1572,776,796,0.49363867684478374,0.5063613231552163
E01027333,2263,1131,1132,0.49977905435262926,0.5002209456473707
E01027334,1515,728,787,0.48052805280528055,0.5194719471947195
E01027343,1420,683,737,0.48098591549295777,0.5190140845070422
E01027344,1476,736,740,0.4986449864498645,0.5013550135501355
E01027345,1286,650,636,0.505443234836703,0.49455676516329705
E01027346,1494,757,737,0.5066934404283802,0.4933065595716198
E01027347,1878,937,941,0.4989350372736954,0.5010649627263046
E01027313,1785,933,852,0.5226890756302521,0.4773109243697479
E01027314,2278,1185,1093,0.5201931518876207,0.4798068481123793
E01027316,2308,1148,1160,0.49740034662045063,0.5025996533795494
E01035429,1501,745,756,0.49633577614923385,0.5036642238507661
E01035430,2202,1086,1116,0.49318801089918257,0.5068119891008175
E01027339,1469,688,781,0.46834581347855686,0.5316541865214431
E01027340,1607,780,827,0.48537647790914745,0.5146235220908525
E01027341,1705,795,910,0.4662756598240469,0.533724340175953
E01027342,1639,797,842,0.4862721171446004,0.5137278828553996
E01027350,1590,764,826,0.48050314465408805,0.519496855345912
E01027351,1682,833,849,0.495243757431629,0.504756242568371
E01027352,1505,744,761,0.4943521594684385,0.5056478405315614
E01035431,1377,722,655,0.524328249818446,0.4756717501815541
E01035432,1140,557,583,0.4885964912280702,0.5114035087719299
E01027309,1481,710,771,0.47940580688723833,0.5205941931127617
E01027310,1680,815,865,0.4851190476190476,0.5148809523809523
E01027311,1344,649,695,0.48288690476190477,0.5171130952380952
E01027312,1540,717,823,0.4655844155844156,0.5344155844155845
E01027317,1576,756,820,0.4796954314720812,0.5203045685279187
E01027318,1575,732,843,0.46476190476190476,0.5352380952380953
E01027319,1567,751,816,0.47925973197192084,0.5207402680280792
E01027320,2137,1064,1073,0.49789424426766493,0.5021057557323351
E01027321,1762,891,871,0.5056753688989785,0.49432463110102154
E01027322,1221,594,627,0.4864864864864865,0.5135135135135135
E01027323,2059,1000,1059,0.48567265662943176,0.5143273433705683
E01027324,1150,575,575,0.5,0.5
E01027325,1914,914,1000,0.477533960292581,0.522466039707419
E01027329,1792,886,906,0.49441964285714285,0.5055803571428571
E01027353,2075,1003,1072,0.4833734939759036,0.5166265060240964
E01027335,1468,734,734,0.5,0.5
E01027336,1658,830,828,0.5006031363088058,0.49939686369119424
E01027337,1787,908,879,0.5081141578063794,0.4918858421936206
E01027348,2166,1036,1130,0.47830101569713757,0.5216989843028624
E01027354,2474,1194,1280,0.4826192400970089,0.5173807599029911
E01027355,1641,823,818,0.5015234613040829,0.4984765386959171
E01026953,1404,687,717,0.4893162393162393,0.5106837606837606
E01026954,1575,790,785,0.5015873015873016,0.4984126984126984
E01026955,1381,699,682,0.5061549601737871,0.49384503982621286
E01026956,2292,1115,1177,0.48647469458987785,0.5135253054101222
E01026963,1366,639,727,0.4677891654465593,0.5322108345534406
E01032963,1507,747,760,0.49568679495686796,0.504313205043132
E01032964,1888,944,944,0.5,0.5
E01032965,1887,952,935,0.5045045045045045,0.4954954954954955
E01032966,2727,1330,1397,0.48771543821048774,0.5122845617895123
E01032967,2643,1315,1328,0.49754067347710934,0.5024593265228906
E01027119,1687,837,850,0.4961470065204505,0.5038529934795495
E01032972,1556,763,793,0.4903598971722365,0.5096401028277635
E01032973,1709,820,889,0.47981275599765943,0.5201872440023405
E01032974,1455,722,733,0.4962199312714777,0.5037800687285223
E01027091,1920,908,1012,0.47291666666666665,0.5270833333333333
E01027092,1934,960,974,0.4963805584281282,0.5036194415718718
E01027102,1877,935,942,0.4981353223228556,0.5018646776771444
E01035415,2642,1259,1383,0.4765329295987888,0.5234670704012112
E01035416,2070,1023,1047,0.49420289855072463,0.5057971014492754
E01027005,2289,1109,1180,0.4844910441240716,0.5155089558759284
E01027026,2171,1068,1103,0.49193919852602486,0.5080608014739751
E01027030,1873,948,925,0.5061398825413774,0.4938601174586225
E01027000,1489,720,769,0.48354600402955006,0.5164539959704499
E01027001,2051,994,1057,0.48464163822525597,0.515358361774744
E01027002,1760,875,885,0.4971590909090909,0.5028409090909091
E01027003,1444,685,759,0.4743767313019391,0.525623268698061
E01027022,1912,960,952,0.502092050209205,0.497907949790795
E01026994,1123,543,580,0.4835262689225289,0.5164737310774711
E01026999,1820,858,962,0.4714285714285714,0.5285714285714286
E01027006,2533,1250,1283,0.49348598499802604,0.5065140150019739
E01035399,1294,631,663,0.48763523956723337,0.5123647604327666
E01035400,2290,1777,513,0.7759825327510917,0.2240174672489083
E01026998,2412,1193,1219,0.49461028192371476,0.5053897180762852
E01027015,1409,672,737,0.47693399574166073,0.5230660042583393
E01027016,1489,725,764,0.48690396239086636,0.5130960376091337
E01027021,1861,913,948,0.4905964535196131,0.5094035464803869
E01027027,2717,1302,1415,0.479205005520795,0.520794994479205
E01027018,2506,1201,1305,0.47924980047885074,0.5207501995211492
E01027019,2141,1019,1122,0.4759458197104157,0.5240541802895843
E01027020,1812,842,970,0.46467991169977924,0.5353200883002207
E01027023,2101,1028,1073,0.4892908138981437,0.5107091861018562
E01035401,1634,801,833,0.49020807833537333,0.5097919216646267
E01035402,1381,671,710,0.48587979724837077,0.5141202027516293
E01026987,1160,586,574,0.5051724137931034,0.49482758620689654
E01026989,1373,670,703,0.4879825200291333,0.5120174799708667
E01027012,2385,1170,1215,0.49056603773584906,0.5094339622641509
E01035403,1548,770,778,0.4974160206718346,0.5025839793281653
E01035404,1586,788,798,0.4968474148802018,0.5031525851197982
E01035405,1759,845,914,0.48038658328595796,0.519613416714042
E01035406,1710,874,836,0.5111111111111111,0.4888888888888889
E01026986,2950,1477,1473,0.5006779661016949,0.4993220338983051
E01026988,1568,763,805,0.48660714285714285,0.5133928571428571
E01026991,1567,757,810,0.4830887045309509,0.5169112954690491
E01026992,2048,1053,995,0.51416015625,0.48583984375
E01027010,1289,638,651,0.49495733126454616,0.5050426687354539
E01027007,1748,905,843,0.5177345537757437,0.48226544622425627
E01027008,1959,982,977,0.5012761613067892,0.4987238386932108
E01027009,1645,808,837,0.4911854103343465,0.5088145896656535
E01027013,1831,893,938,0.4877116329874386,0.5122883670125614
E01027011,2195,1076,1119,0.49020501138952166,0.5097949886104783
E01027017,1926,929,997,0.48234683281412255,0.5176531671858775
E01027024,1738,884,854,0.5086306098964327,0.49136939010356734
E01027025,1790,873,917,0.4877094972067039,0.5122905027932961
E01026993,2068,1038,1030,0.5019342359767892,0.49806576402321084
E01027004,1899,974,925,0.5129015271195366,0.48709847288046343
E01027028,2118,1064,1054,0.502360717658168,0.4976392823418319
E01027029,2412,1212,1200,0.5024875621890548,0.4975124378109453
E01027145,1574,773,801,0.49110546378653114,0.5088945362134689
E01027148,1476,731,745,0.49525745257452575,0.5047425474254743
E01027149,1369,654,715,0.4777209642074507,0.5222790357925493
E01027232,2552,1213,1339,0.4753134796238245,0.5246865203761756
E01027218,1517,715,802,0.4713249835201055,0.5286750164798946
E01027219,1826,848,978,0.4644030668127054,0.5355969331872946
E01027221,1878,899,979,0.4787007454739084,0.5212992545260916
E01027222,1170,583,587,0.4982905982905983,0.5017094017094017
E01027143,1641,786,855,0.4789762340036563,0.5210237659963437
E01027144,1498,745,753,0.49732977303070763,0.5026702269692924
E01027146,1535,740,795,0.4820846905537459,0.5179153094462541
E01027147,2078,1023,1055,0.49230028873917225,0.5076997112608277
E01027195,1801,897,904,0.4980566352026652,0.5019433647973348
E01027245,1739,860,879,0.4945370902817711,0.5054629097182288
E01027247,1832,909,923,0.49617903930131,0.50382096069869
E01027248,1700,810,890,0.4764705882352941,0.5235294117647059
E01027249,1913,964,949,0.5039205436487193,0.4960794563512807
E01027174,1305,647,658,0.4957854406130268,0.5042145593869731
E01027175,1685,813,872,0.4824925816023739,0.5175074183976262
E01027178,2149,1037,1112,0.48255002326663565,0.5174499767333643
E01027200,1598,762,836,0.47684605757196497,0.523153942428035
E01027246,1981,947,1034,0.4780413932357395,0.5219586067642604
E01027171,1627,771,856,0.47387830362630606,0.5261216963736939
E01027172,1677,827,850,0.49314251639833034,0.5068574836016696
E01027182,1413,673,740,0.47629157820240625,0.5237084217975938
E01027183,1666,810,856,0.48619447779111646,0.5138055222088835
E01027196,1644,800,844,0.48661800486618007,0.51338199513382
E01027197,1604,763,841,0.4756857855361596,0.5243142144638404
E01027198,1916,951,965,0.4963465553235908,0.5036534446764092
E01027199,1506,733,773,0.4867197875166003,0.5132802124833997
E01027190,1587,756,831,0.4763705103969754,0.5236294896030246
E01027191,2122,1082,1040,0.5098963242224317,0.49010367577756836
E01027193,1498,748,750,0.4993324432576769,0.5006675567423231
E01027194,1397,705,692,0.5046528274874732,0.49534717251252686
E01027192,1484,754,730,0.5080862533692723,0.4919137466307278
E01027229,1746,881,865,0.504581901489118,0.49541809851088203
E01027230,1837,903,934,0.49156232988568316,0.5084376701143168
E01027231,1899,969,930,0.5102685624012638,0.48973143759873616
E01027179,2220,1083,1137,0.48783783783783785,0.5121621621621621
E01027180,1992,965,1027,0.48443775100401604,0.5155622489959839
E01027181,1804,852,952,0.4722838137472284,0.5277161862527716
E01027140,1769,884,885,0.49971735443753534,0.5002826455624647
E01027142,1611,795,816,0.4934823091247672,0.5065176908752328
E01027176,1448,709,739,0.48964088397790057,0.5103591160220995
E01027177,1814,852,962,0.4696802646085998,0.5303197353914002
E01027168,1907,933,974,0.48925013109596227,0.5107498689040377
E01027169,1593,782,811,0.4908976773383553,0.5091023226616447
E01027170,1689,816,873,0.48312611012433393,0.5168738898756661
E01027173,1791,890,901,0.496929089893914,0.503070910106086
E01027136,1705,876,829,0.513782991202346,0.48621700879765395
E01027186,1786,883,903,0.4944008958566629,0.5055991041433371
E01027188,1946,938,1008,0.48201438848920863,0.5179856115107914
E01027220,1363,659,704,0.483492296404989,0.516507703595011
E01027208,1431,703,728,0.4912648497554158,0.5087351502445842
E01027209,1187,613,574,0.5164279696714406,0.4835720303285594
E01027211,1389,682,707,0.49100071994240463,0.5089992800575954
E01027212,1534,757,777,0.4934810951760104,0.5065189048239895
E01027184,1689,874,815,0.5174659561870929,0.48253404381290704
E01027185,1330,651,679,0.48947368421052634,0.5105263157894737
E01027187,1378,747,631,0.5420899854862119,0.4579100145137881
E01027189,1797,880,917,0.48970506399554814,0.5102949360044519
E01027137,1642,796,846,0.48477466504263095,0.5152253349573691
E01027138,1575,791,784,0.5022222222222222,0.49777777777777776
E01027139,1597,760,837,0.47589229805886035,0.5241077019411396
E01027141,2102,1036,1066,0.4928639391056137,0.5071360608943863
E01027259,1601,783,818,0.48906933166770766,0.5109306683322923
E01027239,1911,951,960,0.4976452119309262,0.5023547880690737
E01027241,1903,953,950,0.5007882291119286,0.49921177088807145
E01027242,1750,820,930,0.4685714285714286,0.5314285714285715
E01027243,1824,903,921,0.49506578947368424,0.5049342105263158
E01027244,1756,858,898,0.4886104783599089,0.5113895216400911
E01027213,1679,834,845,0.49672424061941634,0.5032757593805837
E01027214,1707,841,866,0.4926772114821324,0.5073227885178676
E01027216,2058,998,1060,0.4849368318756074,0.5150631681243926
E01027240,1335,626,709,0.4689138576779026,0.5310861423220974
E01027207,1409,702,707,0.4982256919801277,0.5017743080198722
E01027210,1187,565,622,0.4759898904802022,0.5240101095197978
E01027215,1500,728,772,0.48533333333333334,0.5146666666666667
E01027217,2474,1138,1336,0.459983831851253,0.540016168148747
E01027255,1581,776,805,0.49082858950031627,0.5091714104996837
E01027256,1532,745,787,0.48629242819843344,0.5137075718015666
E01027258,1351,673,678,0.4981495188749075,0.5018504811250926
E01027260,1593,800,793,0.5021971123666039,0.4978028876333961
E01027152,1925,1040,885,0.5402597402597402,0.4597402597402597
E01027153,2274,1228,1046,0.5400175901495162,0.4599824098504837
E01027154,2134,1138,996,0.5332708528584817,0.46672914714151825
E01032978,1827,927,900,0.5073891625615764,0.49261083743842365
E01032979,1498,815,683,0.5440587449933244,0.4559412550066756
E01027132,2201,1171,1030,0.5320308950477056,0.46796910495229443
E01027133,1977,1029,948,0.5204855842185129,0.4795144157814871
E01027134,1896,949,947,0.5005274261603375,0.4994725738396624
E01027135,1827,933,894,0.5106732348111659,0.48932676518883417
E01027155,2542,1367,1175,0.537765538945712,0.46223446105428795
E01027225,1755,914,841,0.5207977207977208,0.4792022792022792
E01027227,1882,969,913,0.5148777895855473,0.4851222104144527
E01027228,2390,1210,1180,0.5062761506276151,0.49372384937238495
E01027151,1959,1049,910,0.5354772843287392,0.46452271567126086
E01027236,1591,758,833,0.4764299182903834,0.5235700817096166
E01027237,2099,1035,1064,0.4930919485469271,0.5069080514530729
E01027238,2114,1137,977,0.5378429517502366,0.4621570482497635
E01027224,2291,1123,1168,0.4901789611523352,0.5098210388476647
E01027226,2178,1111,1067,0.51010101010101,0.4898989898989899
E01027257,1330,692,638,0.5203007518796993,0.47969924812030074
E01035417,1410,700,710,0.49645390070921985,0.5035460992907801
E01035418,2076,1003,1073,0.48314065510597304,0.516859344894027
E01027233,1443,690,753,0.4781704781704782,0.5218295218295218
E01027234,1719,853,866,0.49621873182082604,0.5037812681791739
E01027235,1665,821,844,0.49309309309309307,0.5069069069069069
E01027252,1604,789,815,0.4918952618453865,0.5081047381546134
E01027156,1382,668,714,0.4833574529667149,0.516642547033285
E01027159,1286,654,632,0.5085536547433903,0.49144634525660963
E01027160,1968,985,983,0.5005081300813008,0.4994918699186992
E01027161,1611,751,860,0.46617008069522037,0.5338299193047796
E01027158,1587,777,810,0.4896030245746692,0.5103969754253308
E01027201,2298,1087,1211,0.4730200174064404,0.5269799825935596
E01027202,1590,781,809,0.4911949685534591,0.5088050314465409
E01032980,1780,920,860,0.5168539325842697,0.48314606741573035
E01032981,2725,1210,1515,0.44403669724770645,0.5559633027522936
E01027162,1679,821,858,0.4889815366289458,0.5110184633710542
E01027163,1417,700,717,0.4940014114326041,0.5059985885673959
E01027164,1559,777,782,0.49839640795381657,0.5016035920461834
E01027165,1343,671,672,0.4996276991809382,0.5003723008190618
E01027166,1631,801,830,0.49110974862047824,0.5088902513795218
E01027167,1423,674,749,0.4736472241742797,0.5263527758257203
E01027203,1643,801,842,0.48752282410225195,0.512477175897748
E01027204,1805,870,935,0.481994459833795,0.518005540166205
E01027205,2233,1091,1142,0.4885803851321093,0.5114196148678908
E01035419,1898,956,942,0.5036880927291886,0.49631190727081137
E01035420,1153,544,609,0.47181266261925414,0.5281873373807459
E01027282,1893,933,960,0.4928684627575277,0.5071315372424723
E01027283,1684,849,835,0.5041567695961995,0.49584323040380046
E01027285,1781,887,894,0.498034811903425,0.501965188096575
E01027286,1543,767,776,0.4970836033700583,0.5029163966299417
E01027287,1708,835,873,0.4888758782201405,0.5111241217798594
E01027273,1845,887,958,0.4807588075880759,0.5192411924119241
E01027274,2637,1283,1354,0.48653773227152064,0.5134622677284794
E01027275,1474,725,749,0.4918588873812754,0.5081411126187245
E01027308,1604,784,820,0.48877805486284287,0.5112219451371571
E01027263,1852,905,947,0.4886609071274298,0.5113390928725702
E01027279,2155,1033,1122,0.4793503480278422,0.5206496519721577
E01027284,1931,970,961,0.5023303987571207,0.49766960124287934
E01027294,2028,1025,1003,0.5054240631163708,0.49457593688362916
E01032982,1431,699,732,0.48846960167714887,0.5115303983228512
E01032983,1623,828,795,0.5101663585951941,0.4898336414048059
E01032984,1681,839,842,0.4991076740035693,0.5008923259964307
E01032985,2336,1140,1196,0.488013698630137,0.511986301369863
E01027262,1734,879,855,0.5069204152249135,0.4930795847750865
E01027277,1791,913,878,0.5097710776102736,0.49022892238972643
E01027289,1827,872,955,0.47728516694033934,0.5227148330596606
E01027300,1580,777,803,0.4917721518987342,0.5082278481012659
E01027303,1754,856,898,0.4880273660205245,0.5119726339794755
E01027297,1840,929,911,0.5048913043478261,0.4951086956521739
E01027298,2956,1442,1514,0.4878213802435724,0.5121786197564276
E01027299,1503,734,769,0.48835662009314706,0.5116433799068529
E01027301,2187,1099,1088,0.5025148605395519,0.4974851394604481
E01027302,1561,731,830,0.46828955797565663,0.5317104420243434
E01027291,1823,917,906,0.5030170049369171,0.49698299506308286
E01027292,1218,606,612,0.4975369458128079,0.5024630541871922
E01027293,1332,608,724,0.45645645645645644,0.5435435435435435
E01027304,1723,860,863,0.4991294254207777,0.5008705745792222
E01027305,1914,921,993,0.48119122257053293,0.5188087774294671
E01027261,2052,1005,1047,0.489766081871345,0.5102339181286549
E01027295,2835,1429,1406,0.5040564373897707,0.49594356261022926
E01027306,1783,882,901,0.49467190128996075,0.5053280987100393
E01027280,2751,1354,1397,0.4921846601235914,0.5078153398764086
E01027281,1708,831,877,0.48653395784543324,0.5134660421545667
E01027307,2208,1106,1102,0.5009057971014492,0.4990942028985507
E01035425,1406,692,714,0.492176386913229,0.5078236130867709
E01035426,1671,815,856,0.48773189706762415,0.5122681029323758
E01027265,1480,705,775,0.47635135135135137,0.5236486486486487
E01027270,1570,788,782,0.5019108280254777,0.4980891719745223
E01027271,1544,756,788,0.4896373056994819,0.5103626943005182
E01027272,1491,739,752,0.4956405097250168,0.5043594902749833
E01035427,2330,1128,1202,0.48412017167381977,0.5158798283261803
E01035428,2269,1110,1159,0.4892022917584839,0.510797708241516
E01027264,1458,716,742,0.49108367626886146,0.5089163237311386
E01027267,1140,549,591,0.48157894736842105,0.5184210526315789
E01027268,1252,622,630,0.4968051118210863,0.5031948881789138
E01027269,1649,837,812,0.5075803517283202,0.49241964827167983
E01027288,2307,1110,1197,0.4811443433029909,0.5188556566970091
E01027290,2431,1300,1131,0.5347593582887701,0.46524064171123
E01027296,1999,971,1028,0.48574287143571787,0.5142571285642822
E01032976,1657,763,894,0.4604707302353651,0.5395292697646349
E01035421,1895,955,940,0.503957783641161,0.49604221635883905
E01035422,1555,742,813,0.47717041800643084,0.5228295819935691
E01035423,2550,1228,1322,0.4815686274509804,0.5184313725490196
E01027250,1355,666,689,0.4915129151291513,0.5084870848708487
E01027253,1829,910,919,0.4975396391470749,0.5024603608529251
E01027254,2143,1069,1074,0.49883341110592627,0.5011665888940737
E01035424,2371,1160,1211,0.4892450442851118,0.5107549557148883
E01019400,1762,894,868,0.5073779795686719,0.492622020431328
E01019401,1712,838,874,0.4894859813084112,0.5105140186915887
E01019402,1887,930,957,0.492845786963434,0.5071542130365659
E01019404,1984,1016,968,0.5120967741935484,0.4879032258064516
E01019406,1067,529,538,0.4957825679475164,0.5042174320524836
E01019423,1542,756,786,0.490272373540856,0.5097276264591439
E01019424,1111,531,580,0.47794779477947796,0.5220522052205221
E01019477,2314,1122,1192,0.4848746758859118,0.5151253241140882
E01019403,1450,691,759,0.476551724137931,0.523448275862069
E01019444,1476,711,765,0.4817073170731707,0.5182926829268293
E01019468,1475,750,725,0.5084745762711864,0.4915254237288136
E01019469,1674,822,852,0.4910394265232975,0.5089605734767025
E01019471,1398,702,696,0.5021459227467812,0.4978540772532189
E01019443,1706,813,893,0.4765533411488863,0.5234466588511137
E01019470,1656,826,830,0.49879227053140096,0.501207729468599
E01019473,1238,617,621,0.4983844911147011,0.5016155088852988
E01019474,1180,600,580,0.5084745762711864,0.4915254237288136
E01019475,1341,635,706,0.4735272184936615,0.5264727815063386
E01019476,1319,642,677,0.48673237300985595,0.513267626990144
E01019420,1373,621,752,0.45229424617625635,0.5477057538237436
E01019442,1470,729,741,0.4959183673469388,0.5040816326530613
E01019445,1497,760,737,0.5076820307281229,0.4923179692718771
E01019455,1326,677,649,0.5105580693815988,0.4894419306184012
E01019456,1853,921,932,0.4970318402590394,0.5029681597409607
E01019457,1406,708,698,0.5035561877667141,0.49644381223328593
E01019429,1515,744,771,0.4910891089108911,0.5089108910891089
E01019454,1283,634,649,0.49415432579890883,0.5058456742010912
E01019460,1518,752,766,0.49538866930171277,0.5046113306982872
E01019461,1358,648,710,0.47717231222385864,0.5228276877761414
E01019462,1152,550,602,0.4774305555555556,0.5225694444444444
E01019405,1514,752,762,0.4966974900924703,0.5033025099075297
E01019414,1600,768,832,0.48,0.52
E01019428,1422,715,707,0.5028129395218003,0.4971870604781997
E01019430,1876,944,932,0.5031982942430704,0.4968017057569296
E01019421,2077,1039,1038,0.5002407318247473,0.4997592681752528
E01019422,1491,742,749,0.49765258215962443,0.5023474178403756
E01019432,1912,919,993,0.48064853556485354,0.5193514644351465
E01019458,1999,994,1005,0.49724862431215605,0.5027513756878439
E01019459,1322,628,694,0.4750378214826021,0.5249621785173979
E01019463,1507,715,792,0.4744525547445255,0.5255474452554745
E01019408,1666,796,870,0.4777911164465786,0.5222088835534213
E01019409,1682,806,876,0.47919143876337694,0.5208085612366231
E01019412,1836,898,938,0.4891067538126362,0.5108932461873639
E01019413,1305,644,661,0.4934865900383142,0.5065134099616858
E01019416,1388,691,697,0.4978386167146974,0.5021613832853026
E01019407,2002,990,1012,0.4945054945054945,0.5054945054945055
E01019415,1644,800,844,0.48661800486618007,0.51338199513382
E01019417,1981,957,1024,0.48308934881373045,0.5169106511862696
E01019419,1896,933,963,0.4920886075949367,0.5079113924050633
E01019410,1383,700,683,0.5061460592913956,0.4938539407086045
E01019411,1382,690,692,0.4992764109985528,0.5007235890014472
E01019418,1768,865,903,0.48925339366515835,0.5107466063348416
E01019447,1465,681,784,0.46484641638225255,0.5351535836177475
E01019449,1745,846,899,0.4848137535816619,0.5151862464183381
E01019431,1372,676,696,0.49271137026239065,0.5072886297376094
E01019433,1851,914,937,0.4937871420853593,0.5062128579146408
E01019438,1590,835,755,0.5251572327044025,0.4748427672955975
E01019451,2112,1058,1054,0.5009469696969697,0.4990530303030303
E01019464,2559,1232,1327,0.4814380617428683,0.5185619382571317
E01019434,1154,565,589,0.4896013864818024,0.5103986135181976
E01019435,1684,842,842,0.5,0.5
E01019436,1364,659,705,0.4831378299120235,0.5168621700879765
E01019439,1565,777,788,0.4964856230031949,0.5035143769968051
E01019440,1598,797,801,0.49874843554443055,0.5012515644555695
E01019446,1166,548,618,0.4699828473413379,0.5300171526586621
E01019448,2006,969,1037,0.4830508474576271,0.5169491525423728
E01019450,1497,726,771,0.4849699398797595,0.5150300601202404
E01019465,1120,553,567,0.49375,0.50625
E01019467,1533,755,778,0.49249836921069795,0.507501630789302
E01019425,1650,791,859,0.4793939393939394,0.5206060606060606
E01019426,1568,733,835,0.4674744897959184,0.5325255102040817
E01019427,1848,872,976,0.47186147186147187,0.5281385281385281
E01034254,2772,1373,1399,0.4953102453102453,0.5046897546897547
E01034255,1283,648,635,0.505066250974279,0.49493374902572096
E01019437,1436,715,721,0.4979108635097493,0.5020891364902507
E01019441,1617,781,836,0.48299319727891155,0.5170068027210885
E01019452,1647,797,850,0.4839101396478446,0.5160898603521554
E01019453,2046,1044,1002,0.5102639296187683,0.4897360703812317
E01032613,1263,633,630,0.501187648456057,0.498812351543943
E01019478,1501,725,776,0.4830113257828115,0.5169886742171885
E01019479,1642,819,823,0.4987819732034105,0.5012180267965896
E01019491,2350,1179,1171,0.5017021276595744,0.49829787234042555
E01019493,1497,748,749,0.49966599866399464,0.5003340013360054
E01034644,1288,621,667,0.48214285714285715,0.5178571428571429
E01034645,1475,710,765,0.48135593220338985,0.5186440677966102
E01019492,1813,871,942,0.480419194704909,0.519580805295091
E01019495,1571,763,808,0.4856779121578612,0.5143220878421387
E01019524,1354,665,689,0.4911373707533235,0.5088626292466765
E01019525,1447,705,742,0.48721492743607464,0.5127850725639254
E01019496,1430,726,704,0.5076923076923077,0.49230769230769234
E01019497,1683,841,842,0.49970291146761736,0.5002970885323826
E01019498,1932,946,986,0.489648033126294,0.510351966873706
E01019523,1121,566,555,0.5049063336306869,0.4950936663693131
E01019483,2041,1008,1033,0.49387555120039195,0.506124448799608
E01019484,2252,1116,1136,0.4955595026642984,0.5044404973357016
E01019485,1302,635,667,0.4877112135176651,0.5122887864823349
E01019488,1450,698,752,0.48137931034482756,0.5186206896551724
E01019486,1017,489,528,0.4808259587020649,0.5191740412979351
E01019487,1699,833,866,0.49028840494408477,0.5097115950559152
E01019489,1217,593,624,0.48726376335250615,0.5127362366474938
E01019490,1093,544,549,0.4977127172918573,0.5022872827081427
E01019502,1561,774,787,0.49583600256245997,0.50416399743754
E01019504,1311,647,664,0.4935163996948894,0.5064836003051106
E01019508,1961,967,994,0.49311575726670065,0.5068842427332994
E01019509,1346,610,736,0.45319465081723626,0.5468053491827637
E01019510,1358,629,729,0.4631811487481591,0.5368188512518409
E01034646,1604,793,811,0.49438902743142144,0.5056109725685786
E01034647,1534,765,769,0.49869621903520206,0.5013037809647979
E01019503,2590,1260,1330,0.4864864864864865,0.5135135135135135
E01019505,1506,760,746,0.5046480743691899,0.4953519256308101
E01019506,1493,715,778,0.47890154052243805,0.521098459477562
E01019507,1858,927,931,0.49892357373519913,0.5010764262648009
E01019511,2233,1105,1128,0.4948499776085983,0.5051500223914017
E01019480,1532,751,781,0.4902088772845953,0.5097911227154047
E01019482,1535,750,785,0.48859934853420195,0.511400651465798
E01019520,2156,1070,1086,0.4962894248608534,0.5037105751391465
E01019521,1759,873,886,0.496304718590108,0.503695281409892
E01019522,1767,851,916,0.4816072439162422,0.5183927560837578
E01019481,1204,600,604,0.4983388704318937,0.5016611295681063
E01019514,1567,813,754,0.5188257817485641,0.48117421825143586
E01019515,1649,830,819,0.5033353547604609,0.4966646452395391
E01019516,1600,820,780,0.5125,0.4875
E01019519,1822,909,913,0.4989023051591657,0.5010976948408342
E01019499,1331,663,668,0.49812171299774605,0.5018782870022539
E01019500,1492,732,760,0.4906166219839142,0.5093833780160858
E01019501,1421,706,715,0.4968332160450387,0.5031667839549613
E01019513,1659,815,844,0.4912597950572634,0.5087402049427366
E01019517,1677,839,838,0.5002981514609421,0.49970184853905786
E01019518,1574,805,769,0.51143583227446,0.48856416772554
E01019526,1265,631,634,0.49881422924901186,0.5011857707509881
E01019528,1465,719,746,0.4907849829351536,0.5092150170648464
E01019572,1333,669,664,0.5018754688672168,0.4981245311327832
E01019573,1559,775,784,0.4971135343168698,0.5028864656831302
E01019574,1293,633,660,0.4895591647331787,0.5104408352668214
E01019563,1755,845,910,0.48148148148148145,0.5185185185185185
E01019564,1667,806,861,0.483503299340132,0.5164967006598681
E01019565,1365,666,699,0.4879120879120879,0.512087912087912
E01019566,1772,859,913,0.4847629796839729,0.5152370203160271
E01019568,1489,725,764,0.48690396239086636,0.5130960376091337
E01019527,1394,678,716,0.48637015781922527,0.5136298421807748
E01019529,1419,714,705,0.5031712473572939,0.49682875264270615
E01019530,1452,760,692,0.5234159779614325,0.4765840220385675
E01019531,1604,793,811,0.49438902743142144,0.5056109725685786
E01019553,1893,941,952,0.497094558901215,0.502905441098785
E01019541,1513,735,778,0.48578982154659617,0.5142101784534039
E01019542,1577,814,763,0.5161699429296132,0.4838300570703868
E01019543,1861,922,939,0.4954325631380978,0.5045674368619022
E01019544,1545,737,808,0.47702265372168284,0.5229773462783172
E01019571,1510,720,790,0.4768211920529801,0.5231788079470199
E01019532,1199,572,627,0.47706422018348627,0.5229357798165137
E01019533,1328,655,673,0.4932228915662651,0.5067771084337349
E01019534,1374,681,693,0.49563318777292575,0.5043668122270742
E01019535,1435,723,712,0.5038327526132405,0.4961672473867596
E01019536,1874,912,962,0.48665955176093917,0.5133404482390609
E01019549,1401,683,718,0.4875089221984297,0.5124910778015703
E01019550,1612,789,823,0.48945409429280395,0.510545905707196
E01019551,1445,705,740,0.48788927335640137,0.5121107266435986
E01019552,1306,650,656,0.49770290964777947,0.5022970903522205
E01019567,1748,864,884,0.494279176201373,0.505720823798627
E01019537,1636,778,858,0.47555012224938875,0.5244498777506112
E01019569,1496,772,724,0.516042780748663,0.4839572192513369
E01019570,1284,636,648,0.4953271028037383,0.5046728971962616
E01019580,1638,790,848,0.4822954822954823,0.5177045177045178
E01019581,1335,670,665,0.50187265917603,0.49812734082397003
E01019557,1501,743,758,0.4950033311125916,0.5049966688874084
E01019558,1275,615,660,0.4823529411764706,0.5176470588235295
E01019559,1069,500,569,0.4677268475210477,0.5322731524789522
E01019560,1337,648,689,0.4846671652954376,0.5153328347045625
E01019561,1210,626,584,0.5173553719008265,0.4826446280991736
E01019562,1193,588,605,0.4928751047778709,0.5071248952221291
E01019539,1564,763,801,0.48785166240409206,0.5121483375959079
E01019540,1413,687,726,0.4861995753715499,0.5138004246284501
E01019555,1453,681,772,0.4686854783207158,0.5313145216792843
E01019590,1796,878,918,0.4888641425389755,0.5111358574610245
E01019591,1513,733,780,0.48446794448116326,0.5155320555188367
E01019538,1982,1026,956,0.5176589303733602,0.48234106962663975
E01019554,1329,667,662,0.5018811136192626,0.49811888638073737
E01019556,1491,737,754,0.494299128101945,0.505700871898055
E01019579,1857,937,920,0.5045772751750135,0.49542272482498656
E01033387,1190,625,565,0.5252100840336135,0.47478991596638653
E01033388,1734,823,911,0.4746251441753172,0.5253748558246828
E01019586,1313,654,659,0.49809596344249807,0.5019040365575019
E01019587,1386,676,710,0.48773448773448774,0.5122655122655123
E01019588,1331,635,696,0.47708489857250186,0.5229151014274981
E01019589,1302,625,677,0.48003072196620583,0.5199692780337941
E01019592,1665,779,886,0.4678678678678679,0.5321321321321322
E01019593,1110,536,574,0.4828828828828829,0.5171171171171172
E01019545,1322,661,661,0.5,0.5
E01019546,1388,663,725,0.4776657060518732,0.5223342939481268
E01019547,1373,633,740,0.461034231609614,0.538965768390386
E01019548,2213,1063,1150,0.48034342521464074,0.5196565747853592
E01019582,1477,747,730,0.5057549085985105,0.4942450914014895
E01019583,1374,672,702,0.4890829694323144,0.5109170305676856
E01019585,2273,1151,1122,0.506379234491861,0.49362076550813905
E01019575,1657,813,844,0.49064574532287264,0.5093542546771274
E01019576,1604,793,811,0.49438902743142144,0.5056109725685786
E01019577,1493,730,763,0.48894842598794375,0.5110515740120563
E01019578,1546,759,787,0.4909443725743855,0.5090556274256145
E01019602,1787,889,898,0.4974818130945719,0.502518186905428
E01019614,1607,794,813,0.4940883634100809,0.5059116365899191
E01019615,2107,987,1120,0.4684385382059801,0.53156146179402
E01019631,1759,854,905,0.4855031267765776,0.5144968732234224
E01019600,1378,652,726,0.4731494920174166,0.5268505079825835
E01019604,1775,842,933,0.4743661971830986,0.5256338028169014
E01019606,1608,754,854,0.4689054726368159,0.5310945273631841
E01019618,1553,768,785,0.49452672247263363,0.5054732775273664
E01019609,2598,1203,1395,0.4630484988452656,0.5369515011547344
E01019621,1399,690,709,0.49320943531093636,0.5067905646890636
E01019622,1419,690,729,0.48625792811839325,0.5137420718816068
E01019624,1225,610,615,0.49795918367346936,0.5020408163265306
E01019627,1176,583,593,0.4957482993197279,0.5042517006802721
E01019628,1574,755,819,0.47966963151207115,0.5203303684879288
E01019619,1392,681,711,0.4892241379310345,0.5107758620689655
E01019620,1447,715,732,0.4941257774706289,0.5058742225293711
E01019623,1375,701,674,0.5098181818181818,0.49018181818181816
E01019625,1601,778,823,0.48594628357276703,0.514053716427233
E01019626,1386,662,724,0.47763347763347763,0.5223665223665224
E01019632,1602,783,819,0.4887640449438202,0.5112359550561798
E01019633,1547,757,790,0.48933419521654814,0.5106658047834518
E01019634,1542,751,791,0.48702983138780803,0.5129701686121919
E01019635,1130,538,592,0.4761061946902655,0.5238938053097345
E01019636,1576,741,835,0.47017766497461927,0.5298223350253807
E01019595,1924,937,987,0.487006237006237,0.512993762993763
E01019605,1770,915,855,0.5169491525423728,0.4830508474576271
E01019611,1578,781,797,0.49493029150823825,0.5050697084917617
E01019616,1857,912,945,0.4911147011308562,0.5088852988691438
E01019594,1798,878,920,0.4883203559510567,0.5116796440489433
E01019596,1834,877,957,0.4781897491821156,0.5218102508178845
E01019597,2134,1023,1111,0.4793814432989691,0.520618556701031
E01019598,1762,849,913,0.481838819523269,0.518161180476731
E01019603,2002,980,1022,0.48951048951048953,0.5104895104895105
E01019607,1844,927,917,0.5027114967462039,0.4972885032537961
E01019612,2683,1561,1122,0.581811405143496,0.4181885948565039
E01019629,1735,868,867,0.5002881844380404,0.49971181556195965
E01019599,1360,647,713,0.47573529411764703,0.524264705882353
E01019601,1520,677,843,0.4453947368421053,0.5546052631578947
E01019608,1700,787,913,0.46294117647058824,0.5370588235294118
E01019610,1483,718,765,0.48415374241402565,0.5158462575859744
E01019613,1654,819,835,0.4951632406287787,0.5048367593712213
E01019617,1519,719,800,0.47333772218564846,0.5266622778143516
E01019630,1818,885,933,0.4867986798679868,0.5132013201320133
E01019644,1411,702,709,0.49751948972360027,0.5024805102763997
E01019646,1439,692,747,0.4808895066018068,0.5191104933981932
E01019663,1550,749,801,0.4832258064516129,0.516774193548387
E01019664,1289,645,644,0.5003878975950349,0.49961210240496506
E01019665,1338,655,683,0.48953662182361735,0.5104633781763827
E01019657,1951,944,1007,0.48385443362378266,0.5161455663762173
E01019660,1860,915,945,0.49193548387096775,0.5080645161290323
E01019661,1365,708,657,0.5186813186813187,0.48131868131868133
E01019662,1529,772,757,0.5049051667756703,0.4950948332243296
E01019672,1764,892,872,0.5056689342403629,0.4943310657596372
E01019690,1268,645,623,0.5086750788643533,0.4913249211356467
E01019670,1764,868,896,0.49206349206349204,0.5079365079365079
E01019671,1820,888,932,0.4879120879120879,0.512087912087912
E01019701,2225,1080,1145,0.4853932584269663,0.5146067415730337
E01019673,1311,658,653,0.501906941266209,0.498093058733791
E01019702,1735,820,915,0.47262247838616717,0.5273775216138329
E01019703,1633,800,833,0.4898958971218616,0.5101041028781383
E01019704,1390,705,685,0.5071942446043165,0.49280575539568344
E01019658,1936,971,965,0.5015495867768595,0.4984504132231405
E01019659,2347,1126,1221,0.4797613975287601,0.5202386024712399
E01019674,1130,561,569,0.4964601769911504,0.5035398230088496
E01019688,1362,667,695,0.4897209985315712,0.5102790014684288
E01019689,1466,734,732,0.5006821282401092,0.49931787175989084
E01019666,1466,718,748,0.4897680763983629,0.5102319236016372
E01019667,1654,812,842,0.4909310761789601,0.5090689238210399
E01019668,1384,649,735,0.4689306358381503,0.5310693641618497
E01019669,1465,734,731,0.5010238907849829,0.49897610921501706
E01019656,1201,558,643,0.4646128226477935,0.5353871773522065
E01019691,1624,802,822,0.4938423645320197,0.5061576354679803
E01019692,1588,762,826,0.47984886649874053,0.5201511335012594
E01019693,1911,930,981,0.48665620094191525,0.5133437990580848
E01019694,1151,588,563,0.5108601216333623,0.4891398783666377
E01019696,1429,681,748,0.47655703289013296,0.523442967109867
E01019683,1293,632,661,0.48878576952822894,0.5112142304717711
E01019684,1639,814,825,0.4966442953020134,0.5033557046979866
E01019685,1469,683,786,0.4649421375085092,0.5350578624914908
E01019686,1326,633,693,0.47737556561085975,0.5226244343891403
E01019687,1441,689,752,0.47814018043025674,0.5218598195697433
E01019648,1509,743,766,0.4923790589794566,0.5076209410205434
E01019649,1741,863,878,0.4956921309592188,0.5043078690407812
E01019650,1651,784,867,0.47486371895820717,0.5251362810417929
E01019651,1440,718,722,0.4986111111111111,0.5013888888888889
E01019695,1420,693,727,0.4880281690140845,0.5119718309859155
E01019641,1448,708,740,0.4889502762430939,0.511049723756906
E01019652,1562,776,786,0.4967989756722151,0.5032010243277849
E01019653,1424,693,731,0.4866573033707865,0.5133426966292135
E01019707,1379,700,679,0.5076142131979695,0.49238578680203043
E01019708,1809,884,925,0.4886677722498618,0.5113322277501382
E01019647,1983,960,1023,0.48411497730711045,0.5158850226928896
E01019675,1534,780,754,0.5084745762711864,0.4915254237288136
E01019679,1645,820,825,0.49848024316109424,0.5015197568389058
E01019682,1689,837,852,0.4955595026642984,0.5044404973357016
E01019642,1348,641,707,0.4755192878338279,0.5244807121661721
E01019643,1574,752,822,0.4777636594663278,0.5222363405336722
E01019654,1499,750,749,0.5003335557038026,0.49966644429619744
E01019655,1525,764,761,0.5009836065573771,0.49901639344262294
E01019676,1446,707,739,0.48893499308437066,0.5110650069156293
E01019677,1391,686,705,0.4931703810208483,0.5068296189791517
E01019678,1694,832,862,0.4911452184179457,0.5088547815820543
E01019680,1946,962,984,0.4943473792394656,0.5056526207605344
E01019681,1448,721,727,0.4979281767955801,0.5020718232044199
E01019698,1385,696,689,0.5025270758122744,0.49747292418772565
E01019697,1402,689,713,0.4914407988587732,0.5085592011412268
E01019699,1505,752,753,0.49966777408637875,0.5003322259136213
E01019700,2174,1065,1109,0.4898804047838086,0.5101195952161913
E01019705,1780,879,901,0.49382022471910114,0.5061797752808989
E01019706,1215,599,616,0.49300411522633747,0.5069958847736625
E01019709,1310,639,671,0.48778625954198473,0.5122137404580153
E01019638,1268,604,664,0.47634069400630913,0.5236593059936908
E01019639,1542,766,776,0.496757457846952,0.503242542153048
E01019640,1373,671,702,0.48871085214857973,0.5112891478514202
E01019645,1708,813,895,0.47599531615925056,0.5240046838407494
E01032614,1213,613,600,0.505358615004122,0.494641384995878
E01019733,1476,702,774,0.47560975609756095,0.524390243902439
E01019752,1340,639,701,0.47686567164179106,0.5231343283582089
E01019753,1329,636,693,0.4785553047404063,0.5214446952595937
E01019763,2223,1119,1104,0.5033738191632928,0.4966261808367072
E01019728,1162,526,636,0.45266781411359724,0.5473321858864028
E01019729,1245,610,635,0.4899598393574297,0.5100401606425703
E01019730,1897,895,1002,0.4717975751186083,0.5282024248813917
E01019731,1242,626,616,0.5040257648953301,0.49597423510466987
E01019732,1482,727,755,0.49055330634278005,0.50944669365722
E01019738,1464,728,736,0.4972677595628415,0.5027322404371585
E01019739,1846,936,910,0.5070422535211268,0.49295774647887325
E01019740,1151,575,576,0.49956559513466553,0.5004344048653345
E01019750,1286,622,664,0.48367029548989116,0.5163297045101088
E01019751,2299,1129,1170,0.491083079599826,0.508916920400174
E01019768,2104,1011,1093,0.48051330798479086,0.5194866920152091
E01019727,2161,1024,1137,0.47385469689958354,0.5261453031004165
E01019749,1152,567,585,0.4921875,0.5078125
E01019754,1871,929,942,0.4965259219668626,0.5034740780331374
E01019756,1736,856,880,0.4930875576036866,0.5069124423963134
E01019757,1337,639,698,0.4779356768885565,0.5220643231114436
E01019758,1531,758,773,0.4951012410189419,0.5048987589810582
E01019746,1563,802,761,0.5131158029430583,0.4868841970569418
E01019747,1151,572,579,0.49695916594265854,0.5030408340573415
E01019748,1469,741,728,0.504424778761062,0.49557522123893805
E01019755,1864,915,949,0.49087982832618027,0.5091201716738197
E01019766,1425,689,736,0.48350877192982455,0.5164912280701754
E01019711,1331,655,676,0.49211119459053343,0.5078888054094666
E01019734,1992,995,997,0.4994979919678715,0.5005020080321285
E01019743,1501,733,768,0.4883411059293804,0.5116588940706196
E01019744,1413,703,710,0.4975230007077141,0.502476999292286
E01019745,1114,550,564,0.49371633752244165,0.5062836624775583
E01019712,1466,720,746,0.49113233287858116,0.5088676671214188
E01019713,1799,876,923,0.4869371873262924,0.5130628126737076
E01019764,1580,787,793,0.4981012658227848,0.5018987341772152
E01019765,1755,860,895,0.49002849002849,0.50997150997151
E01019767,1556,754,802,0.4845758354755784,0.5154241645244216
E01019710,1705,848,857,0.49736070381231673,0.5026392961876833
E01019715,1294,657,637,0.5077279752704791,0.49227202472952086
E01019717,1086,568,518,0.5230202578268877,0.47697974217311234
E01019722,1784,859,925,0.48150224215246634,0.5184977578475336
E01019723,1737,852,885,0.4905008635578584,0.5094991364421416
E01019716,1220,616,604,0.5049180327868853,0.49508196721311476
E01019724,1181,567,614,0.48010160880609654,0.5198983911939035
E01019759,1478,712,766,0.4817320703653586,0.5182679296346414
E01019760,1347,689,658,0.5115070527097253,0.4884929472902747
E01019761,1647,751,896,0.4559805707346691,0.5440194292653309
E01019714,2587,1300,1287,0.5025125628140703,0.49748743718592964
E01019725,1486,699,787,0.47039030955585465,0.5296096904441454
E01019726,1438,725,713,0.5041724617524339,0.4958275382475661
E01019762,1728,856,872,0.49537037037037035,0.5046296296296297
E01019718,2177,1059,1118,0.48644924207625173,0.5135507579237483
E01019719,2064,1023,1041,0.4956395348837209,0.5043604651162791
E01019720,1414,688,726,0.48656294200848654,0.5134370579915134
E01019721,1483,726,757,0.48954821308159135,0.5104517869184086
E01019735,1391,696,695,0.5003594536304816,0.4996405463695183
E01019736,1045,519,526,0.4966507177033493,0.5033492822966508
E01019737,1122,538,584,0.47950089126559714,0.5204991087344029
E01019741,1155,585,570,0.5064935064935064,0.4935064935064935
E01019742,1041,538,503,0.5168107588856868,0.48318924111431316
E01019801,1130,555,575,0.4911504424778761,0.5088495575221239
E01019802,1344,664,680,0.49404761904761907,0.5059523809523809
E01019803,1287,634,653,0.4926184926184926,0.5073815073815073
E01019804,1260,639,621,0.5071428571428571,0.4928571428571429
E01019805,1337,643,694,0.4809274495138369,0.5190725504861631
E01019806,1438,691,747,0.480528511821975,0.519471488178025
E01019807,1463,704,759,0.48120300751879697,0.518796992481203
E01019778,1662,815,847,0.49037304452466907,0.5096269554753309
E01019779,1564,750,814,0.479539641943734,0.520460358056266
E01019790,1789,862,927,0.48183342649524874,0.5181665735047513
E01019816,1747,839,908,0.48025186033199774,0.5197481396680023
E01019780,1401,641,760,0.45753033547466093,0.5424696645253391
E01019781,1430,722,708,0.5048951048951049,0.4951048951048951
E01019782,1359,646,713,0.4753495217071376,0.5246504782928624
E01019786,1551,781,770,0.5035460992907801,0.49645390070921985
E01019827,1814,902,912,0.4972436604189636,0.5027563395810364
E01019770,1974,964,1010,0.48834853090172237,0.5116514690982776
E01019787,1793,857,936,0.47796988287785835,0.5220301171221416
E01019788,1685,821,864,0.4872403560830861,0.512759643916914
E01019794,1337,657,680,0.4913986537023186,0.5086013462976814
E01019783,1251,621,630,0.49640287769784175,0.5035971223021583
E01019784,1205,584,621,0.4846473029045643,0.5153526970954356
E01019785,1244,610,634,0.4903536977491961,0.5096463022508039
E01019793,1411,686,725,0.4861800141743444,0.5138199858256556
E01019795,2266,1086,1180,0.47925860547219773,0.5207413945278023
E01019798,1571,770,801,0.49013367281986,0.50986632718014
E01019821,1257,618,639,0.4916467780429594,0.5083532219570406
E01019822,1637,825,812,0.5039706780696396,0.4960293219303604
E01019823,1082,532,550,0.49168207024029575,0.5083179297597042
E01019771,2065,992,1073,0.4803874092009685,0.5196125907990314
E01019772,1507,740,767,0.49104180491041804,0.508958195089582
E01019828,1380,661,719,0.4789855072463768,0.5210144927536232
E01019829,1319,624,695,0.47308567096285065,0.5269143290371494
E01019796,1172,574,598,0.48976109215017066,0.5102389078498294
E01019797,1814,931,883,0.5132304299889746,0.48676957001102533
E01019799,2397,1185,1212,0.49436795994993743,0.5056320400500626
E01019800,1782,891,891,0.5,0.5
E01019808,1645,803,842,0.48814589665653496,0.511854103343465
E01019826,1409,689,720,0.48899929027679206,0.511000709723208
E01019769,1959,951,1008,0.48545176110260335,0.5145482388973966
E01019774,1773,873,900,0.49238578680203043,0.5076142131979695
E01019824,1863,962,901,0.5163714439076758,0.4836285560923242
E01019830,1533,754,779,0.4918460534898891,0.5081539465101109
E01019831,1343,626,717,0.466120625465376,0.533879374534624
E01019809,1071,533,538,0.4976657329598506,0.5023342670401494
E01019810,1469,728,741,0.49557522123893805,0.504424778761062
E01019811,1447,701,746,0.48445058742225294,0.5155494125777471
E01019812,1809,893,916,0.49364289662797123,0.5063571033720288
E01019813,1657,813,844,0.49064574532287264,0.5093542546771274
E01019825,1360,653,707,0.4801470588235294,0.5198529411764706
E01019775,2329,1126,1203,0.4834693001288107,0.5165306998711894
E01019776,1349,648,701,0.48035581912527797,0.519644180874722
E01019777,2384,1128,1256,0.47315436241610737,0.5268456375838926
E01034648,1407,699,708,0.4968017057569296,0.5031982942430704
E01034649,1077,561,516,0.520891364902507,0.479108635097493
E01019814,1907,928,979,0.48662821185107497,0.513371788148925
E01019817,1350,596,754,0.4414814814814815,0.5585185185185185
E01019818,1651,812,839,0.49182313749242884,0.5081768625075712
E01019819,1706,864,842,0.5064478311840562,0.4935521688159437
E01019820,1468,697,771,0.47479564032697547,0.5252043596730245
E01019791,1961,945,1016,0.4818969913309536,0.5181030086690463
E01019792,2052,972,1080,0.47368421052631576,0.5263157894736842
E01019815,2663,1290,1373,0.4844160720991363,0.5155839279008637
E01032586,1633,769,864,0.4709124311083895,0.5290875688916106
E01019839,2887,1403,1484,0.485971596813301,0.514028403186699
E01019845,1247,593,654,0.4755412991178829,0.5244587008821171
E01019846,1313,632,681,0.48134044173648133,0.5186595582635186
E01019866,2267,1052,1215,0.46404940449933835,0.5359505955006617
E01019840,1764,841,923,0.4767573696145125,0.5232426303854876
E01019841,1858,902,956,0.48546824542518835,0.5145317545748116
E01019847,1355,664,691,0.4900369003690037,0.5099630996309963
E01019848,2710,1330,1380,0.4907749077490775,0.5092250922509225
E01033532,1573,769,804,0.4888747616020343,0.5111252383979656
E01033533,1605,800,805,0.4984423676012461,0.5015576323987538
E01033534,1029,546,483,0.5306122448979592,0.46938775510204084
E01019873,2559,1254,1305,0.4900351699882767,0.5099648300117233
E01019874,1348,667,681,0.4948071216617211,0.505192878338279
E01019875,1342,665,677,0.49552906110283157,0.5044709388971684
E01019882,1920,964,956,0.5020833333333333,0.4979166666666667
E01034650,2461,1192,1269,0.48435595286468913,0.5156440471353109
E01034651,1312,615,697,0.46875,0.53125
E01019832,1652,813,839,0.49213075060532685,0.5078692493946732
E01019833,2120,991,1129,0.4674528301886792,0.5325471698113208
E01019834,2502,1231,1271,0.4920063948840927,0.5079936051159073
E01034652,1492,763,729,0.5113941018766756,0.4886058981233244
E01034653,1522,740,782,0.48620236530880423,0.5137976346911958
E01019867,1726,816,910,0.4727694090382387,0.5272305909617613
E01019868,2016,987,1029,0.4895833333333333,0.5104166666666666
E01019869,1519,774,745,0.5095457537853851,0.49045424621461486
E01019880,1655,830,825,0.5015105740181269,0.4984894259818731
E01019843,1505,712,793,0.47308970099667774,0.5269102990033223
E01019853,1725,847,878,0.4910144927536232,0.5089855072463768
E01019854,2001,964,1037,0.4817591204397801,0.5182408795602199
E01019855,1538,741,797,0.48179453836150843,0.5182054616384916
E01019844,1529,751,778,0.49117069980379335,0.5088293001962066
E01019856,1459,714,745,0.4893762851267992,0.5106237148732008
E01019857,1410,705,705,0.5,0.5
E01019858,1510,710,800,0.47019867549668876,0.5298013245033113
E01019859,1652,802,850,0.4854721549636804,0.5145278450363197
E01019860,1158,581,577,0.501727115716753,0.49827288428324695
E01019861,1740,873,867,0.5017241379310344,0.4982758620689655
E01019862,1642,783,859,0.476857490864799,0.523142509135201
E01019863,1530,745,785,0.4869281045751634,0.5130718954248366
E01019864,1361,684,677,0.5025716385011021,0.49742836149889785
E01019865,1260,633,627,0.5023809523809524,0.4976190476190476
E01019876,1840,874,966,0.475,0.525
E01019877,2076,1038,1038,0.5,0.5
E01019878,1455,708,747,0.4865979381443299,0.51340206185567
E01019879,2078,1051,1027,0.5057747834456208,0.49422521655437923
E01019850,2340,1154,1186,0.4931623931623932,0.5068376068376068
E01019851,1671,819,852,0.49012567324955114,0.5098743267504489
E01019852,2057,1027,1030,0.4992707826932426,0.5007292173067575
E01019870,1642,817,825,0.49756394640682094,0.502436053593179
E01019871,1700,814,886,0.4788235294117647,0.5211764705882352
E01019872,2064,1015,1049,0.49176356589147285,0.5082364341085271
E01019837,2037,988,1049,0.485027000490918,0.5149729995090819
E01019838,1493,732,761,0.4902880107166778,0.5097119892833222
E01033536,1833,882,951,0.48117839607201307,0.5188216039279869
E01033537,1617,815,802,0.5040197897340755,0.49598021026592454
E01034654,1803,903,900,0.5008319467554077,0.49916805324459235
E01034655,1656,818,838,0.4939613526570048,0.5060386473429952
E01019842,1676,801,875,0.4779236276849642,0.5220763723150358
E01019885,1581,794,787,0.502213788741303,0.49778621125869704
E01033535,1497,748,749,0.49966599866399464,0.5003340013360054
E01034656,1630,835,795,0.5122699386503068,0.48773006134969327
E01034657,1689,833,856,0.4931912374185909,0.5068087625814092
E01025631,1567,740,827,0.47223994894703253,0.5277600510529674
E01025632,1364,686,678,0.5029325513196481,0.4970674486803519
E01025633,1870,928,942,0.49625668449197863,0.5037433155080214
E01025635,1265,632,633,0.49960474308300395,0.500395256916996
E01025634,2021,979,1042,0.4844136566056408,0.5155863433943593
E01025638,1472,715,757,0.4857336956521739,0.514266304347826
E01025639,1298,631,667,0.4861325115562404,0.5138674884437596
E01025640,1605,782,823,0.48722741433021804,0.5127725856697819
E01025645,1155,555,600,0.4805194805194805,0.5194805194805194
E01025666,1559,745,814,0.47787042976266836,0.5221295702373316
E01025667,1230,618,612,0.5024390243902439,0.4975609756097561
E01025668,2288,1166,1122,0.5096153846153846,0.49038461538461536
E01025669,2201,1125,1076,0.5111313039527488,0.48886869604725125
E01025636,1352,630,722,0.46597633136094674,0.5340236686390533
E01025637,1333,647,686,0.48537134283570893,0.5146286571642911
E01025652,1358,651,707,0.4793814432989691,0.520618556701031
E01025653,1616,819,797,0.5068069306930693,0.4931930693069307
E01025654,1295,659,636,0.5088803088803089,0.4911196911196911
E01025655,1675,861,814,0.5140298507462686,0.48597014925373133
E01025656,1354,688,666,0.5081240768094535,0.4918759231905465
E01025625,1220,580,640,0.47540983606557374,0.5245901639344263
E01025626,2542,1231,1311,0.48426435877262,0.51573564122738
E01025627,2428,1169,1259,0.4814662273476112,0.5185337726523888
E01025651,1554,775,779,0.49871299871299873,0.5012870012870013
E01025657,1965,957,1008,0.4870229007633588,0.5129770992366413
E01025660,1668,819,849,0.4910071942446043,0.5089928057553957
E01025641,1918,977,941,0.5093847758081335,0.49061522419186654
E01025642,1845,894,951,0.4845528455284553,0.5154471544715448
E01025643,1630,816,814,0.5006134969325153,0.49938650306748467
E01025649,1847,897,950,0.4856524093123985,0.5143475906876015
E01025650,1440,704,736,0.4888888888888889,0.5111111111111111
E01025610,1567,754,813,0.48117421825143586,0.5188257817485641
E01025611,1576,769,807,0.4879441624365482,0.5120558375634517
E01025612,2067,966,1101,0.46734397677793904,0.532656023222061
E01025658,1778,872,906,0.4904386951631046,0.5095613048368954
E01025659,1913,923,990,0.48248823836905386,0.5175117616309461
E01025615,2350,1178,1172,0.5012765957446809,0.49872340425531914
E01025646,1614,782,832,0.48451053283767037,0.5154894671623296
E01025647,1532,744,788,0.4856396866840731,0.5143603133159269
E01025648,2124,1024,1100,0.4821092278719397,0.5178907721280602
E01025613,1531,756,775,0.4937949052906597,0.5062050947093403
E01025614,1614,789,825,0.4888475836431227,0.5111524163568774
E01025620,1213,607,606,0.5004122011541632,0.49958779884583676
E01025621,1296,628,668,0.4845679012345679,0.5154320987654321
E01025644,1775,856,919,0.48225352112676056,0.5177464788732394
E01025616,2000,975,1025,0.4875,0.5125
E01025617,2107,1022,1085,0.4850498338870432,0.5149501661129569
E01025618,1658,795,863,0.4794933655006031,0.5205066344993968
E01025619,2201,1058,1143,0.48069059518400725,0.5193094048159927
E01025661,2481,1221,1260,0.4921402660217654,0.5078597339782346
E01025662,1951,963,988,0.4935930292157868,0.5064069707842133
E01025663,1582,788,794,0.49810366624525915,0.5018963337547409
E01025664,1376,672,704,0.4883720930232558,0.5116279069767442
E01025665,1860,872,988,0.46881720430107526,0.5311827956989247
E01025622,1685,825,860,0.4896142433234421,0.5103857566765578
E01025623,1733,864,869,0.49855741488747835,0.5014425851125216
E01025624,2528,1272,1256,0.5031645569620253,0.49683544303797467
E01025629,1571,760,811,0.48376830044557606,0.5162316995544239
E01025630,1841,916,925,0.4975556762629006,0.5024443237370994
E01032603,1459,714,745,0.4893762851267992,0.5106237148732008
E01025692,2019,992,1027,0.4913323427439326,0.5086676572560673
E01025693,2351,1156,1195,0.4917056571671629,0.5082943428328371
E01033386,2045,1017,1028,0.49731051344743277,0.5026894865525673
E01025699,1506,823,683,0.546480743691899,0.4535192563081009
E01025700,2226,1169,1057,0.5251572327044025,0.4748427672955975
E01025701,1701,886,815,0.520870076425632,0.479129923574368
E01025703,2069,1140,929,0.5509908168197196,0.4490091831802803
E01025704,1670,849,821,0.5083832335329341,0.49161676646706587
E01025705,1628,829,799,0.5092137592137592,0.4907862407862408
E01025706,1855,930,925,0.5013477088948787,0.49865229110512127
E01025720,2552,1419,1133,0.5560344827586207,0.44396551724137934
E01025721,2059,1068,991,0.5186983972802331,0.48130160271976685
E01025722,1088,565,523,0.5193014705882353,0.4806985294117647
E01025723,2409,1382,1027,0.5736820257368203,0.42631797426317974
E01025724,1839,995,844,0.5410549211528004,0.45894507884719954
E01025725,1286,618,668,0.48055987558320373,0.5194401244167963
E01025695,1428,761,667,0.5329131652661064,0.46708683473389356
E01025696,1304,666,638,0.5107361963190185,0.4892638036809816
E01025697,1317,643,674,0.4882308276385725,0.5117691723614275
E01025698,1471,733,738,0.4983004758667573,0.5016995241332427
E01025744,2688,1320,1368,0.49107142857142855,0.5089285714285714
E01025745,1428,691,737,0.4838935574229692,0.5161064425770309
E01025746,2010,961,1049,0.4781094527363184,0.5218905472636816
E01025747,1800,872,928,0.48444444444444446,0.5155555555555555
E01025740,1496,767,729,0.5127005347593583,0.4872994652406417
E01025741,1438,726,712,0.5048678720445062,0.4951321279554937
E01025742,1676,814,862,0.48568019093078757,0.5143198090692124
E01025743,2334,1134,1200,0.48586118251928023,0.5141388174807198
E01025689,3089,1695,1394,0.5487212690191,0.4512787309809
E01025690,4248,2511,1737,0.5911016949152542,0.4088983050847458
E01025707,1645,933,712,0.5671732522796352,0.4328267477203647
E01025709,2291,1278,1013,0.5578350065473592,0.44216499345264076
E01025760,1358,650,708,0.4786450662739323,0.5213549337260678
E01025761,1895,933,962,0.49234828496042216,0.5076517150395778
E01025768,1466,731,735,0.49863574351978174,0.5013642564802183
E01025769,1563,797,766,0.5099168266154831,0.49008317338451696
E01025702,1191,598,593,0.5020990764063812,0.4979009235936188
E01025715,1595,779,816,0.4884012539184953,0.5115987460815047
E01025716,1576,765,811,0.4854060913705584,0.5145939086294417
E01025718,1459,791,668,0.5421521590130226,0.4578478409869774
E01025719,1569,800,769,0.5098789037603569,0.49012109623964306
E01034002,1717,837,880,0.48747815958066393,0.512521840419336
E01034003,1578,782,796,0.4955640050697085,0.5044359949302915
E01025708,1313,652,661,0.49657273419649656,0.5034272658035034
E01025710,1231,592,639,0.4809098294069862,0.5190901705930138
E01025711,1458,707,751,0.4849108367626886,0.5150891632373114
E01025712,1502,732,770,0.4873501997336884,0.5126498002663116
E01025713,1491,770,721,0.5164319248826291,0.4835680751173709
E01034004,1742,846,896,0.4856486796785304,0.5143513203214696
E01034005,1468,725,743,0.4938692098092643,0.5061307901907357
E01025674,1922,905,1017,0.4708636836628512,0.5291363163371487
E01025675,1483,741,742,0.4996628455832771,0.5003371544167229
E01025676,2486,1193,1293,0.47988736926790027,0.5201126307320998
E01025677,1467,702,765,0.4785276073619632,0.5214723926380368
E01025732,1907,931,976,0.48820136339800735,0.5117986366019927
E01025733,1795,854,941,0.47576601671309193,0.5242339832869081
E01025734,1706,813,893,0.4765533411488863,0.5234466588511137
E01025735,1851,905,946,0.48892490545651,0.51107509454349
E01025748,2127,1064,1063,0.5002350728725905,0.4997649271274095
E01025749,2216,1066,1150,0.48104693140794225,0.5189530685920578
E01025750,1917,951,966,0.49608763693270735,0.5039123630672926
E01025751,2158,1060,1098,0.4911955514365153,0.5088044485634847
E01025726,1904,926,978,0.48634453781512604,0.5136554621848739
E01025727,1575,786,789,0.4990476190476191,0.5009523809523809
E01025728,2022,1009,1013,0.4990108803165183,0.5009891196834817
E01025729,1514,737,777,0.4867899603698811,0.5132100396301189
E01025737,2905,1402,1503,0.48261617900172116,0.5173838209982788
E01025739,2338,1130,1208,0.4833190761334474,0.5166809238665526
E01025685,1315,634,681,0.48212927756653995,0.5178707224334601
E01025686,1577,783,794,0.4965123652504756,0.5034876347495244
E01025730,2979,1442,1537,0.48405505203088284,0.5159449479691172
E01025731,1845,890,955,0.4823848238482385,0.5176151761517616
E01025687,1621,833,788,0.5138803207896361,0.486119679210364
E01025688,1739,869,870,0.4997124784358827,0.5002875215641173
E01025736,1429,715,714,0.5003498950314905,0.4996501049685094
E01025738,1583,785,798,0.49589387239418825,0.5041061276058117
E01025756,1893,902,991,0.47649234020073955,0.5235076597992604
E01025757,1328,632,696,0.4759036144578313,0.5240963855421686
E01025758,1706,803,903,0.4706916764361079,0.5293083235638921
E01025759,1400,683,717,0.4878571428571429,0.5121428571428571
E01025752,2974,1512,1462,0.5084061869535978,0.49159381304640215
E01025753,1651,775,876,0.46941247728649305,0.530587522713507
E01025754,1225,602,623,0.49142857142857144,0.5085714285714286
E01025755,1439,697,742,0.48436414176511466,0.5156358582348853
E01025680,1626,802,824,0.4932349323493235,0.5067650676506765
E01025681,1726,855,871,0.49536500579374276,0.5046349942062572
E01025682,1433,686,747,0.47871598046057223,0.5212840195394278
E01034006,2503,1201,1302,0.4798242109468638,0.5201757890531362
E01034007,1770,865,905,0.4887005649717514,0.5112994350282486
E01025678,1751,860,891,0.49114791547687037,0.5088520845231297
E01025683,1647,788,859,0.4784456587735276,0.5215543412264724
E01025684,1862,925,937,0.4967776584317938,0.5032223415682062
E01025762,1581,790,791,0.49968374446552816,0.5003162555344719
E01025763,1703,825,878,0.4844392248972402,0.5155607751027599
E01025764,1404,692,712,0.4928774928774929,0.5071225071225072
E01025765,1509,721,788,0.4777998674618953,0.5222001325381047
E01025766,2064,1007,1057,0.4878875968992248,0.5121124031007752
E01025767,1557,777,780,0.49903660886319845,0.5009633911368016
E01025670,1274,610,664,0.478806907378336,0.521193092621664
E01025671,2397,1141,1256,0.476011681268252,0.523988318731748
E01025672,2296,1099,1197,0.47865853658536583,0.5213414634146342
E01025673,1730,833,897,0.4815028901734104,0.5184971098265896
E01025770,1830,907,923,0.49562841530054647,0.5043715846994535
E01025809,2378,1165,1213,0.4899074852817494,0.5100925147182507
E01025815,2197,1117,1080,0.5084205735093309,0.4915794264906691
E01025781,1721,833,888,0.48402091807088904,0.515979081929111
E01025782,1378,657,721,0.47677793904209,0.52322206095791
E01025783,2360,1142,1218,0.48389830508474574,0.5161016949152543
E01025786,2286,1094,1192,0.4785651793525809,0.5214348206474191
E01025787,1656,804,852,0.4855072463768116,0.5144927536231884
E01035084,1757,878,879,0.49971542401821284,0.5002845759817871
E01035085,1604,755,849,0.4706982543640898,0.5293017456359103
E01025772,2264,1105,1159,0.4880742049469965,0.5119257950530035
E01025773,1575,800,775,0.5079365079365079,0.49206349206349204
E01025774,1672,858,814,0.5131578947368421,0.4868421052631579
E01025775,2201,1083,1118,0.49204906860517944,0.5079509313948205
E01025776,1940,941,999,0.4850515463917526,0.5149484536082474
E01025778,1986,961,1025,0.4838872104733132,0.5161127895266868
E01025779,1466,714,752,0.4870395634379263,0.5129604365620737
E01025780,1472,749,723,0.5088315217391305,0.49116847826086957
E01025784,1406,693,713,0.49288762446657186,0.5071123755334281
E01025788,1321,634,687,0.47993943981831944,0.5200605601816806
E01035086,1676,829,847,0.4946300715990454,0.5053699284009546
E01035087,1461,724,737,0.49555099247091033,0.5044490075290896
E01025777,2342,1198,1144,0.511528608027327,0.4884713919726729
E01025808,2982,1517,1465,0.5087189805499664,0.49128101945003355
E01025810,2351,1184,1167,0.5036154827732879,0.49638451722671206
E01025816,2557,1260,1297,0.49276495893625344,0.5072350410637466
E01025789,2031,1333,698,0.6563269325455441,0.3436730674544559
E01025794,1829,891,938,0.48715144887916895,0.512848551120831
E01025797,2173,1028,1145,0.47307869305108147,0.5269213069489186
E01025802,1344,640,704,0.47619047619047616,0.5238095238095238
E01025803,1772,870,902,0.4909706546275395,0.5090293453724605
E01035088,1644,800,844,0.48661800486618007,0.51338199513382
E01035089,1380,697,683,0.505072463768116,0.49492753623188407
E01025795,1804,940,864,0.5210643015521065,0.4789356984478936
E01025796,1976,947,1029,0.479251012145749,0.520748987854251
E01025801,1208,559,649,0.46274834437086093,0.5372516556291391
E01025806,1564,730,834,0.46675191815856776,0.5332480818414322
E01025798,2336,1133,1203,0.4850171232876712,0.5149828767123288
E01025799,2283,1110,1173,0.48620236530880423,0.5137976346911958
E01025800,1399,688,711,0.49177984274481773,0.5082201572551823
E01025804,1978,964,1014,0.487360970677452,0.512639029322548
E01025807,1385,687,698,0.496028880866426,0.503971119133574
E01025790,2546,1276,1270,0.5011783189316575,0.4988216810683425
E01025791,2921,1431,1490,0.48990071893187265,0.5100992810681274
E01025792,2158,1066,1092,0.4939759036144578,0.5060240963855421
E01035090,1646,806,840,0.4896719319562576,0.5103280680437424
E01035091,1559,810,749,0.5195638229634381,0.4804361770365619
E01025812,1747,831,916,0.475672581568403,0.524327418431597
E01025813,2095,1056,1039,0.5040572792362769,0.49594272076372314
E01025814,1735,854,881,0.49221902017291064,0.5077809798270894
E01035092,1737,849,888,0.48877374784110533,0.5112262521588946
E01035093,1534,751,783,0.4895697522816167,0.5104302477183833
E01025868,1409,685,724,0.48616039744499645,0.5138396025550035
E01025869,1433,690,743,0.48150732728541523,0.5184926727145848
E01025870,1675,802,873,0.47880597014925375,0.5211940298507463
E01025871,1518,719,799,0.4736495388669302,0.5263504611330698
E01035094,1364,658,706,0.48240469208211145,0.5175953079178885
E01035095,1663,833,830,0.5009019843656043,0.49909801563439565
E01025846,2093,1025,1068,0.48972766364070713,0.5102723363592929
E01025847,1658,825,833,0.49758745476477684,0.5024125452352232
E01025848,1573,781,792,0.4965034965034965,0.5034965034965035
E01025845,1486,740,746,0.4979811574697174,0.5020188425302826
E01025877,1701,825,876,0.48500881834215165,0.5149911816578483
E01025879,1206,598,608,0.49585406301824214,0.5041459369817579
E01025880,1672,813,859,0.486244019138756,0.513755980861244
E01025819,1682,818,864,0.4863258026159334,0.5136741973840666
E01025820,1577,763,814,0.4838300570703868,0.5161699429296132
E01025837,2174,1089,1085,0.5009199632014719,0.4990800367985281
E01025838,1510,712,798,0.47152317880794703,0.528476821192053
E01025882,1733,872,861,0.5031736872475476,0.49682631275245237
E01025872,1452,712,740,0.4903581267217631,0.509641873278237
E01025873,1553,780,773,0.5022537025112686,0.4977462974887315
E01025874,2090,992,1098,0.47464114832535886,0.5253588516746411
E01025875,1806,869,937,0.48117386489479513,0.5188261351052049
E01025876,1973,963,1010,0.48808920425747593,0.5119107957425241
E01025839,1649,809,840,0.49060036385688294,0.509399636143117
E01025840,1675,818,857,0.48835820895522386,0.5116417910447761
E01025841,1906,931,975,0.48845750262329485,0.5115424973767051
E01025842,1968,965,1003,0.49034552845528456,0.5096544715447154
E01025843,1804,893,911,0.4950110864745011,0.5049889135254989
E01025844,1628,804,824,0.49385749385749383,0.5061425061425061
E01025821,1732,859,873,0.4959584295612009,0.504041570438799
E01025822,1507,783,724,0.5195753151957532,0.4804246848042468
E01025823,1627,787,840,0.48371235402581436,0.5162876459741856
E01025824,1485,729,756,0.4909090909090909,0.509090909090909
E01025825,1415,697,718,0.4925795053003534,0.5074204946996467
E01025826,1385,711,674,0.5133574007220216,0.4866425992779783
E01025817,2253,1103,1150,0.4895694629383045,0.5104305370616955
E01025818,1509,738,771,0.48906560636182905,0.510934393638171
E01025864,2274,1134,1140,0.49868073878627966,0.5013192612137203
E01025881,1368,684,684,0.5,0.5
E01025859,1580,794,786,0.5025316455696203,0.49746835443037973
E01025860,1365,663,702,0.4857142857142857,0.5142857142857142
E01025861,1788,886,902,0.4955257270693512,0.5044742729306487
E01025862,1908,940,968,0.49266247379454925,0.5073375262054507
E01025850,1500,740,760,0.49333333333333335,0.5066666666666667
E01025852,1992,1057,935,0.5306224899598394,0.46937751004016065
E01025858,2185,1129,1056,0.5167048054919908,0.4832951945080092
E01025863,1694,822,872,0.4852420306965762,0.5147579693034239
E01025865,1745,859,886,0.49226361031518623,0.5077363896848137
E01025854,2191,1089,1102,0.4970333181195801,0.5029666818804199
E01025855,1404,694,710,0.4943019943019943,0.5056980056980057
E01025866,1880,911,969,0.4845744680851064,0.5154255319148936
E01025867,1446,743,703,0.5138312586445366,0.48616874135546334
E01035096,1531,731,800,0.4774657086871326,0.5225342913128674
E01035097,1504,766,738,0.5093085106382979,0.49069148936170215
E01025849,2178,1123,1055,0.5156106519742883,0.48438934802571165
E01025851,1359,688,671,0.5062545989698307,0.49374540103016923
E01025856,1271,630,641,0.4956726986624705,0.5043273013375295
E01025857,1421,716,705,0.5038705137227305,0.49612948627726955
E01025827,1419,658,761,0.46370683579985905,0.536293164200141
E01025828,1513,746,767,0.4930601454064772,0.5069398545935228
E01025829,1551,751,800,0.4842037395228885,0.5157962604771116
E01025830,1566,741,825,0.4731800766283525,0.5268199233716475
E01025831,1247,609,638,0.4883720930232558,0.5116279069767442
E01025832,1937,958,979,0.4945792462570986,0.5054207537429014
E01025833,2054,1010,1044,0.4917234664070107,0.5082765335929893
E01025834,1534,764,770,0.4980443285528031,0.5019556714471969
E01025835,2514,1240,1274,0.4932378679395386,0.5067621320604614
E01025836,1173,564,609,0.48081841432225064,0.5191815856777494
E01025885,1972,982,990,0.49797160243407707,0.5020283975659229
E01025886,1717,831,886,0.48398369248689577,0.5160163075131042
E01025887,1820,884,936,0.4857142857142857,0.5142857142857142
E01025890,1341,646,695,0.4817300521998509,0.5182699478001491
E01025891,1236,595,641,0.4813915857605178,0.5186084142394822
E01025892,1636,781,855,0.4773838630806846,0.5226161369193154
E01025901,2028,985,1043,0.48570019723865876,0.5142998027613412
E01025902,1566,778,788,0.49680715197956576,0.5031928480204342
E01025903,1788,881,907,0.49272930648769575,0.5072706935123042
E01025904,2236,1083,1153,0.48434704830053665,0.5156529516994633
E01025906,1665,805,860,0.48348348348348347,0.5165165165165165
E01025883,1877,904,973,0.48161960575386253,0.5183803942461375
E01025884,1726,849,877,0.4918887601390498,0.5081112398609502
E01025888,1886,920,966,0.4878048780487805,0.5121951219512195
E01025909,1943,945,998,0.4863612969634586,0.5136387030365415
E01025896,1654,800,854,0.4836759371221282,0.5163240628778718
E01025897,2211,1073,1138,0.48530076888285845,0.5146992311171416
E01025898,1328,652,676,0.49096385542168675,0.5090361445783133
E01025899,1312,634,678,0.48323170731707316,0.5167682926829268
E01025900,1480,715,765,0.4831081081081081,0.5168918918918919
E01025905,1638,793,845,0.48412698412698413,0.5158730158730159
E01025893,1925,964,961,0.5007792207792208,0.49922077922077923
E01025894,1613,815,798,0.5052696838189709,0.49473031618102914
E01025895,1650,809,841,0.4903030303030303,0.5096969696969696
E01025907,1845,906,939,0.49105691056910566,0.5089430894308943
E01025908,1790,879,911,0.4910614525139665,0.5089385474860335
E01025889,1703,838,865,0.4920728126834997,0.5079271873165003
E01025910,1812,886,926,0.488962472406181,0.5110375275938189
E01025911,1793,870,923,0.4852203011712214,0.5147796988287786
E01025912,1563,755,808,0.48304542546385154,0.5169545745361485
E01025924,1101,569,532,0.516802906448683,0.48319709355131696
E01025926,2616,1292,1324,0.4938837920489297,0.5061162079510704
E01025927,1597,789,808,0.4940513462742642,0.5059486537257357
E01025928,1431,717,714,0.5010482180293501,0.4989517819706499
E01035098,1128,595,533,0.5274822695035462,0.4725177304964539
E01035099,1387,713,674,0.5140591204037491,0.4859408795962509
E01025923,1417,686,731,0.48412138320395204,0.515878616796048
E01025944,1704,822,882,0.4823943661971831,0.5176056338028169
E01025945,1725,782,943,0.4533333333333333,0.5466666666666666
E01025946,2019,891,1128,0.4413075780089153,0.5586924219910847
E01025915,1184,575,609,0.4856418918918919,0.5143581081081081
E01025916,1731,891,840,0.5147313691507799,0.4852686308492201
E01025918,1678,828,850,0.4934445768772348,0.5065554231227652
E01035100,1824,883,941,0.48410087719298245,0.5158991228070176
E01035101,1904,938,966,0.49264705882352944,0.5073529411764706
E01025960,1443,713,730,0.4941094941094941,0.5058905058905059
E01025961,1419,704,715,0.49612403100775193,0.5038759689922481
E01025962,1702,819,883,0.4811985898942421,0.518801410105758
E01025965,1270,636,634,0.5007874015748032,0.49921259842519683
E01025955,1895,897,998,0.47335092348284963,0.5266490765171504
E01025956,1285,615,670,0.4785992217898833,0.5214007782101168
E01025963,1648,823,825,0.4993932038834951,0.5006067961165048
E01025964,1639,823,816,0.5021354484441732,0.4978645515558267
E01025914,1289,639,650,0.495733126454616,0.504266873545384
E01025919,1506,729,777,0.48406374501992033,0.5159362549800797
E01025920,1983,953,1030,0.48058497226424607,0.5194150277357539
E01025921,2022,996,1026,0.49258160237388726,0.5074183976261127
E01025966,1474,720,754,0.48846675712347354,0.5115332428765265
E01025967,1553,746,807,0.48036059240180295,0.519639407598197
E01025968,1827,927,900,0.5073891625615764,0.49261083743842365
E01025969,1703,839,864,0.4926600117439812,0.5073399882560188
E01025950,2143,1063,1080,0.4960335977601493,0.5039664022398507
E01025951,2045,996,1049,0.48704156479217603,0.5129584352078239
E01025952,1650,799,851,0.48424242424242425,0.5157575757575757
E01025953,1362,681,681,0.5,0.5
E01025954,1523,765,758,0.5022980958634274,0.49770190413657256
E01025932,1521,747,774,0.4911242603550296,0.5088757396449705
E01025933,1328,667,661,0.5022590361445783,0.4977409638554217
E01025934,1964,976,988,0.4969450101832994,0.5030549898167006
E01025935,1164,558,606,0.4793814432989691,0.520618556701031
E01025936,1224,603,621,0.49264705882352944,0.5073529411764706
E01025929,1934,978,956,0.5056876938986556,0.49431230610134436
E01025930,1832,903,929,0.49290393013100436,0.5070960698689956
E01025931,1930,903,1027,0.4678756476683938,0.5321243523316063
E01025957,2208,1093,1115,0.495018115942029,0.5049818840579711
E01025937,2325,1143,1182,0.4916129032258065,0.5083870967741936
E01025958,2202,1119,1083,0.5081743869209809,0.49182561307901906
E01025959,2579,1304,1275,0.5056223342380768,0.4943776657619232
E01033102,1579,804,775,0.5091830272324256,0.4908169727675744
E01033103,2248,1109,1139,0.4933274021352313,0.5066725978647687
E01025913,2470,1244,1226,0.5036437246963563,0.49635627530364373
E01025947,2070,1006,1064,0.4859903381642512,0.5140096618357488
E01025948,1731,891,840,0.5147313691507799,0.4852686308492201
E01025949,1570,792,778,0.5044585987261146,0.49554140127388535
E01025938,1202,599,603,0.4983361064891847,0.5016638935108153
E01025939,2151,1081,1070,0.502556950255695,0.497443049744305
E01025940,2014,992,1022,0.4925521350546177,0.5074478649453823
E01025941,1988,983,1005,0.49446680080482897,0.505533199195171
E01025942,2832,1401,1431,0.4947033898305085,0.5052966101694916
E01025943,1816,884,932,0.486784140969163,0.513215859030837
E01025970,1735,807,928,0.46512968299711815,0.5348703170028818
E01025971,1209,575,634,0.47559966914805624,0.5244003308519437
E01025972,1328,631,697,0.4751506024096386,0.5248493975903614
E01025976,1365,636,729,0.46593406593406594,0.5340659340659341
E01025977,1534,716,818,0.4667535853976532,0.5332464146023468
E01025978,1652,802,850,0.4854721549636804,0.5145278450363197
E01025992,1741,814,927,0.4675473865594486,0.5324526134405514
E01025994,1739,873,866,0.5020126509488212,0.49798734905117886
E01025997,1587,746,841,0.4700693131695022,0.5299306868304978
E01025999,1470,713,757,0.4850340136054422,0.5149659863945578
E01026005,1696,802,894,0.47287735849056606,0.527122641509434
E01025985,1244,609,635,0.4895498392282958,0.5104501607717041
E01025986,1534,756,778,0.49282920469361147,0.5071707953063885
E01025987,1666,792,874,0.47539015606242496,0.524609843937575
E01025988,1898,908,990,0.47839831401475236,0.5216016859852476
E01025989,1773,851,922,0.47997743936830234,0.5200225606316977
E01025990,1306,620,686,0.47473200612557426,0.5252679938744257
E01025991,1408,700,708,0.4971590909090909,0.5028409090909091
E01025993,1419,679,740,0.4785059901338971,0.5214940098661028
E01025998,2239,1076,1163,0.4805716837874051,0.5194283162125949
E01026000,1220,581,639,0.47622950819672133,0.5237704918032787
E01026001,1376,687,689,0.4992732558139535,0.5007267441860465
E01025995,1537,760,777,0.494469746258946,0.505530253741054
E01026003,1630,794,836,0.48711656441717793,0.5128834355828221
E01026004,1777,885,892,0.498030388294879,0.501969611705121
E01032600,2002,974,1028,0.4865134865134865,0.5134865134865135
E01032601,1458,704,754,0.4828532235939643,0.5171467764060357
E01025973,2590,1298,1292,0.5011583011583012,0.4988416988416988
E01025974,2042,1012,1030,0.49559255631733595,0.5044074436826641
E01025975,1420,715,705,0.5035211267605634,0.4964788732394366
E01025980,1391,695,696,0.4996405463695183,0.5003594536304816
E01025979,1418,703,715,0.49576868829337095,0.504231311706629
E01025981,1713,853,860,0.4979568009340339,0.5020431990659662
E01025982,1969,945,1024,0.47993905535804976,0.5200609446419502
E01025983,1255,580,675,0.46215139442231074,0.5378486055776892
E01025984,1410,705,705,0.5,0.5
E01026007,1117,548,569,0.4905998209489705,0.5094001790510295
E01026008,1605,952,653,0.5931464174454829,0.40685358255451715
E01026009,1223,604,619,0.4938675388389207,0.5061324611610794
E01026023,1375,699,676,0.5083636363636364,0.49163636363636365
E01026024,2240,1104,1136,0.4928571428571429,0.5071428571428571
E01026010,1839,897,942,0.48776508972267535,0.5122349102773246
E01026030,2612,1284,1328,0.49157733537519144,0.5084226646248086
E01026032,1948,974,974,0.5,0.5
E01026037,1594,737,857,0.4623588456712672,0.5376411543287327
E01034679,1391,696,695,0.5003594536304816,0.4996405463695183
E01034680,1629,808,821,0.4960098219766728,0.5039901780233272
E01026021,1778,875,903,0.4921259842519685,0.5078740157480315
E01026025,2410,1184,1226,0.4912863070539419,0.5087136929460581
E01026036,1584,794,790,0.5012626262626263,0.49873737373737376
E01034681,1366,709,657,0.5190336749633968,0.48096632503660325
E01034682,1595,822,773,0.5153605015673981,0.4846394984326019
E01026012,1141,539,602,0.4723926380368098,0.5276073619631901
E01026015,1676,827,849,0.493436754176611,0.5065632458233891
E01026026,2280,1061,1219,0.46535087719298246,0.5346491228070176
E01026027,1872,922,950,0.49252136752136755,0.5074786324786325
E01026028,1889,946,943,0.5007940709370037,0.49920592906299627
E01026016,2439,1198,1241,0.4911849118491185,0.5088150881508815
E01026033,2389,1174,1215,0.49141900376726666,0.5085809962327333
E01026034,1862,915,947,0.49140708915145004,0.50859291084855
E01026017,1637,824,813,0.5033598045204642,0.49664019547953575
E01026018,1714,853,861,0.49766627771295213,0.5023337222870479
E01026019,2808,1327,1481,0.4725783475783476,0.5274216524216524
E01026020,2910,1392,1518,0.47835051546391755,0.5216494845360825
E01026041,1382,668,714,0.4833574529667149,0.516642547033285
E01026013,1449,711,738,0.4906832298136646,0.5093167701863354
E01026014,1944,953,991,0.49022633744855965,0.5097736625514403
E01026022,2305,1080,1225,0.4685466377440347,0.5314533622559653
E01026038,1439,690,749,0.4794996525364837,0.5205003474635164
E01026040,1709,856,853,0.5008777062609713,0.49912229373902867
E01026031,1641,803,838,0.4893357708714199,0.5106642291285801
E01026035,2517,1231,1286,0.48907429479539133,0.5109257052046087
E01026039,1194,577,617,0.483249581239531,0.516750418760469
E01034683,1544,745,799,0.48251295336787564,0.5174870466321243
E01034684,1457,718,739,0.49279341111873715,0.5072065888812629
E01026045,1881,944,937,0.5018607123870282,0.4981392876129718
E01026061,1120,546,574,0.4875,0.5125
E01026062,1149,541,608,0.47084421235857266,0.5291557876414273
E01026063,1554,736,818,0.47361647361647363,0.5263835263835264
E01026080,1974,984,990,0.49848024316109424,0.5015197568389058
E01026106,1219,583,636,0.4782608695652174,0.5217391304347826
E01026107,1302,613,689,0.47081413210445466,0.5291858678955453
E01026058,2311,1149,1162,0.49718736477715275,0.5028126352228472
E01026076,2265,1114,1151,0.49183222958057393,0.5081677704194261
E01026079,1939,916,1023,0.4724084579680248,0.5275915420319752
E01026077,1524,730,794,0.479002624671916,0.520997375328084
E01026078,1091,517,574,0.4738771769019248,0.5261228230980751
E01026087,1492,692,800,0.46380697050938335,0.5361930294906166
E01026088,1396,665,731,0.47636103151862463,0.5236389684813754
E01026090,1352,636,716,0.47041420118343197,0.5295857988165681
E01026091,1149,539,610,0.4691035683202785,0.5308964316797214
E01026108,2475,1208,1267,0.48808080808080806,0.5119191919191919
E01026081,2329,1137,1192,0.48819235723486476,0.5118076427651352
E01026089,2004,961,1043,0.47954091816367267,0.5204590818363274
E01032986,1118,543,575,0.4856887298747764,0.5143112701252236
E01032987,1446,707,739,0.48893499308437066,0.5110650069156293
E01026072,2330,1122,1208,0.4815450643776824,0.5184549356223176
E01026073,1934,963,971,0.49793174767321613,0.5020682523267839
E01026074,2161,1041,1120,0.4817214252660805,0.5182785747339195
E01026099,2029,1014,1015,0.49975357318876296,0.5002464268112371
E01026103,2019,969,1050,0.4799405646359584,0.5200594353640416
E01026104,2156,1028,1128,0.47680890538033394,0.5231910946196661
E01026109,2069,1023,1046,0.4944417593040116,0.5055582406959884
E01026071,2101,1043,1058,0.4964302712993812,0.5035697287006188
E01026082,2364,1177,1187,0.4978849407783418,0.5021150592216582
E01026121,2592,1291,1301,0.498070987654321,0.501929012345679
E01026042,1743,844,899,0.48422260470453243,0.5157773952954676
E01026043,1811,873,938,0.4820541137493098,0.5179458862506903
E01026044,1373,672,701,0.48943918426802624,0.5105608157319738
E01026113,1977,984,993,0.4977238239757208,0.5022761760242792
E01026117,1936,966,970,0.4989669421487603,0.5010330578512396
E01026060,1293,637,656,0.49265274555297756,0.5073472544470224
E01026068,2102,1028,1074,0.489058039961941,0.510941960038059
E01026070,2196,1078,1118,0.49089253187613846,0.5091074681238615
E01026105,2181,1070,1111,0.49060064190738195,0.509399358092618
E01026048,1598,787,811,0.4924906132665832,0.5075093867334167
E01026049,1551,777,774,0.5009671179883946,0.4990328820116054
E01026050,1591,767,824,0.4820867379006914,0.5179132620993087
E01026069,2268,1100,1168,0.48500881834215165,0.5149911816578483
E01026064,1656,808,848,0.48792270531400966,0.5120772946859904
E01026065,1922,897,1025,0.4667013527575442,0.5332986472424558
E01026066,2082,1009,1073,0.4846301633045149,0.5153698366954851
E01026067,1894,898,996,0.47412882787750793,0.5258711721224921
E01026084,1585,771,814,0.48643533123028393,0.5135646687697161
E01026115,1695,824,871,0.4861356932153392,0.5138643067846608
E01026116,1688,842,846,0.49881516587677727,0.5011848341232228
E01034685,1238,579,659,0.4676898222940226,0.5323101777059773
E01034686,1652,786,866,0.47578692493946734,0.5242130750605327
E01026046,1337,647,690,0.4839192221391174,0.5160807778608826
E01026047,1265,602,663,0.4758893280632411,0.5241106719367589
E01026055,1139,576,563,0.5057067603160668,0.4942932396839333
E01026059,1206,579,627,0.48009950248756217,0.5199004975124378
E01026100,1836,843,993,0.4591503267973856,0.5408496732026143
E01026101,1389,650,739,0.4679625629949604,0.5320374370050396
E01026092,1459,745,714,0.5106237148732008,0.4893762851267992
E01026093,1812,950,862,0.5242825607064018,0.4757174392935982
E01026095,1340,657,683,0.49029850746268655,0.5097014925373134
E01026114,1632,806,826,0.49387254901960786,0.5061274509803921
E01026083,1767,816,951,0.4617996604414261,0.5382003395585738
E01026094,2258,1072,1186,0.47475642161204606,0.525243578387954
E01026096,1506,722,784,0.47941567065073043,0.5205843293492696
E01026097,1495,710,785,0.47491638795986624,0.5250836120401338
E01026051,1390,710,680,0.5107913669064749,0.4892086330935252
E01026052,2504,1501,1003,0.5994408945686901,0.4005591054313099
E01026053,1996,1002,994,0.5020040080160321,0.49799599198396793
E01026054,1615,785,830,0.48606811145510836,0.5139318885448917
E01026118,1826,877,949,0.48028477546549836,0.5197152245345017
E01026119,1120,538,582,0.48035714285714287,0.5196428571428572
E01026120,1496,702,794,0.4692513368983957,0.5307486631016043
E01026056,1274,654,620,0.5133437990580848,0.48665620094191525
E01026110,1476,709,767,0.4803523035230352,0.5196476964769647
E01026111,1554,757,797,0.4871299871299871,0.5128700128700129
E01026112,1252,609,643,0.48642172523961663,0.5135782747603834
E01026057,1955,988,967,0.5053708439897698,0.49462915601023016
E01026075,2182,1067,1115,0.48900091659028416,0.5109990834097159
E01026098,2033,989,1044,0.4864731923266109,0.5135268076733891
E01026102,2305,1135,1170,0.4924078091106291,0.5075921908893709
E01026149,1704,834,870,0.4894366197183099,0.5105633802816901
E01026150,1765,866,899,0.4906515580736544,0.5093484419263457
E01026166,1439,682,757,0.4739402362751911,0.5260597637248089
E01026168,1736,839,897,0.483294930875576,0.5167050691244239
E01026153,2561,1264,1297,0.4935572042171027,0.5064427957828973
E01026155,1845,903,942,0.4894308943089431,0.510569105691057
E01026157,1410,682,728,0.4836879432624113,0.5163120567375886
E01026165,1686,795,891,0.47153024911032027,0.5284697508896797
E01026125,1495,938,557,0.6274247491638796,0.3725752508361204
E01026144,2265,1132,1133,0.49977924944812363,0.5002207505518764
E01026147,2486,1255,1231,0.504827031375704,0.49517296862429605
E01026148,1884,844,1040,0.44798301486199577,0.5520169851380042
E01026151,2101,982,1119,0.46739647786768207,0.532603522132318
E01026164,1567,689,878,0.4396936821952776,0.5603063178047224
E01026167,1828,895,933,0.4896061269146608,0.5103938730853391
E01026122,2129,1139,990,0.5349929544387036,0.4650070455612964
E01026123,2580,1269,1311,0.49186046511627907,0.5081395348837209
E01026124,1814,969,845,0.5341786108048512,0.4658213891951488
E01026126,1940,1086,854,0.5597938144329897,0.4402061855670103
E01026152,1554,749,805,0.481981981981982,0.5180180180180181
E01026154,1406,699,707,0.4971550497866287,0.5028449502133713
E01026156,1295,602,693,0.4648648648648649,0.5351351351351351
E01026132,3697,1806,1891,0.48850419258858535,0.5114958074114146
E01026145,1668,819,849,0.4910071942446043,0.5089928057553957
E01026146,2024,980,1044,0.4841897233201581,0.5158102766798419
E01034687,1243,624,619,0.50201126307321,0.49798873692679
E01034688,1813,896,917,0.4942084942084942,0.5057915057915058
E01026134,2000,1043,957,0.5215,0.4785
E01026176,2114,1122,992,0.5307473982970672,0.4692526017029328
E01026177,2228,1169,1059,0.524685816876122,0.4753141831238779
E01026178,1972,1052,920,0.5334685598377282,0.4665314401622718
E01026127,1425,660,765,0.4631578947368421,0.5368421052631579
E01026129,1749,841,908,0.4808461978273299,0.51915380217267
E01026131,1390,680,710,0.4892086330935252,0.5107913669064749
E01034689,1186,582,604,0.49072512647554806,0.5092748735244519
E01034690,1571,771,800,0.4907702100572883,0.5092297899427116
E01026135,1756,872,884,0.49658314350797267,0.5034168564920274
E01026136,1769,848,921,0.47936687394007915,0.5206331260599208
E01026174,1516,785,731,0.5178100263852242,0.4821899736147757
E01034691,2915,1303,1612,0.4469982847341338,0.5530017152658662
E01034692,1455,759,696,0.5216494845360825,0.47835051546391755
E01026130,1380,680,700,0.4927536231884058,0.5072463768115942
E01026158,1420,702,718,0.4943661971830986,0.5056338028169014
E01026159,1489,714,775,0.4795164539959704,0.5204835460040296
E01026160,1331,656,675,0.492862509391435,0.507137490608565
E01026162,1498,738,760,0.49265687583444595,0.507343124165554
E01026163,1313,676,637,0.5148514851485149,0.48514851485148514
E01026161,1382,646,736,0.467438494934877,0.532561505065123
E01026170,1531,730,801,0.4768125408229915,0.5231874591770085
E01026172,1636,805,831,0.49205378973105135,0.5079462102689487
E01026173,1665,819,846,0.4918918918918919,0.5081081081081081
E01026175,1838,946,892,0.514689880304679,0.485310119695321
E01026137,1187,566,621,0.476832350463353,0.523167649536647
E01026138,1473,735,738,0.4989816700610998,0.5010183299389002
E01026139,1364,642,722,0.4706744868035191,0.5293255131964809
E01026140,1337,647,690,0.4839192221391174,0.5160807778608826
E01026141,1575,801,774,0.5085714285714286,0.49142857142857144
E01026142,1201,587,614,0.488759367194005,0.511240632805995
E01026169,1674,826,848,0.4934289127837515,0.5065710872162486
E01026171,1540,763,777,0.4954545454545455,0.5045454545454545
E01026186,1670,793,877,0.4748502994011976,0.5251497005988024
E01026187,1918,964,954,0.502606882168926,0.49739311783107404
E01026189,1735,816,919,0.47031700288184436,0.5296829971181556
E01026203,1951,943,1008,0.4833418759610456,0.5166581240389544
E01026204,1595,764,831,0.4789968652037618,0.5210031347962383
E01026206,1852,928,924,0.5010799136069114,0.49892008639308855
E01026182,1510,726,784,0.48079470198675495,0.519205298013245
E01026193,1609,851,758,0.528899937849596,0.47110006215040395
E01026199,2588,1271,1317,0.491112828438949,0.508887171561051
E01026225,1718,827,891,0.48137369033760186,0.5186263096623981
E01026226,1863,891,972,0.4782608695652174,0.5217391304347826
E01032994,1527,738,789,0.48330058939096265,0.5166994106090373
E01034693,1788,881,907,0.49272930648769575,0.5072706935123042
E01034694,1862,878,984,0.4715359828141783,0.5284640171858217
E01026184,1962,1125,837,0.573394495412844,0.42660550458715596
E01026185,2223,1067,1156,0.47998200629779575,0.5200179937022043
E01026188,2202,1062,1140,0.4822888283378747,0.5177111716621253
E01026190,1902,892,1010,0.46898002103049424,0.5310199789695058
E01026237,1132,548,584,0.4840989399293286,0.5159010600706714
E01026238,1511,750,761,0.49636002647253474,0.5036399735274653
E01026191,1868,900,968,0.4817987152034261,0.5182012847965739
E01026205,1693,822,871,0.48552864737152984,0.5144713526284702
E01026211,1987,1002,985,0.5042778057372924,0.4957221942627076
E01026212,1493,727,766,0.4869390488948426,0.5130609511051574
E01026213,1699,831,868,0.4891112419070041,0.5108887580929958
E01026192,1241,631,610,0.508460918614021,0.49153908138597907
E01026194,2124,1020,1104,0.480225988700565,0.519774011299435
E01026195,1895,925,970,0.48812664907651715,0.5118733509234829
E01026196,1476,715,761,0.48441734417344173,0.5155826558265583
E01026180,1447,742,705,0.5127850725639254,0.48721492743607464
E01026183,2776,1380,1396,0.49711815561959655,0.5028818443804035
E01026210,2443,1170,1273,0.4789193614408514,0.5210806385591485
E01026224,1832,872,960,0.4759825327510917,0.5240174672489083
E01026179,1327,720,607,0.5425772418990203,0.45742275810097965
E01026197,1468,733,735,0.4993188010899183,0.5006811989100818
E01026198,1590,924,666,0.5811320754716981,0.4188679245283019
E01026223,1998,967,1031,0.48398398398398396,0.516016016016016
E01026209,2049,981,1068,0.4787701317715959,0.5212298682284041
E01026221,2472,1235,1237,0.49959546925566345,0.5004045307443366
E01026222,1821,842,979,0.4623833058758924,0.5376166941241076
E01026227,1553,785,768,0.5054732775273664,0.49452672247263363
E01026230,1813,875,938,0.4826254826254826,0.5173745173745173
E01026231,2693,1300,1393,0.48273301151132564,0.5172669884886744
E01026232,2110,1024,1086,0.48530805687203793,0.5146919431279621
E01026235,1666,773,893,0.4639855942376951,0.536014405762305
E01026228,1737,832,905,0.4789867587795049,0.5210132412204951
E01026229,1896,910,986,0.479957805907173,0.520042194092827
E01026233,1707,829,878,0.4856473345049795,0.5143526654950205
E01026236,1143,557,586,0.4873140857392826,0.5126859142607174
E01034695,1989,968,1021,0.4866767219708396,0.5133232780291603
E01034696,1505,740,765,0.49169435215946844,0.5083056478405316
E01026200,1721,864,857,0.5020337013364323,0.4979662986635677
E01026201,2062,1016,1046,0.492725509214355,0.507274490785645
E01026202,1913,885,1028,0.4626241505488761,0.5373758494511239
E01026207,1275,646,629,0.5066666666666667,0.49333333333333335
E01026208,1631,803,828,0.49233599019006746,0.5076640098099325
E01026220,2230,1059,1171,0.4748878923766816,0.5251121076233184
E01032988,1883,895,988,0.4753053637812002,0.5246946362187997
E01032989,2086,1046,1040,0.50143815915628,0.49856184084372
E01032993,2499,1214,1285,0.48579431772709086,0.5142056822729092
E01026214,1102,539,563,0.48911070780399274,0.5108892921960072
E01026215,1044,482,562,0.4616858237547893,0.5383141762452107
E01026218,1148,576,572,0.5017421602787456,0.49825783972125437
E01026219,1139,563,576,0.4942932396839333,0.5057067603160668
E01032991,2244,1117,1127,0.4977718360071301,0.5022281639928698
E01032992,1471,702,769,0.4772263766145479,0.5227736233854521
E01026242,1778,866,912,0.4870641169853768,0.5129358830146231
E01026243,1415,679,736,0.47985865724381627,0.5201413427561837
E01026244,1336,648,688,0.48502994011976047,0.5149700598802395
E01026247,1945,960,985,0.493573264781491,0.506426735218509
E01026276,2334,1149,1185,0.4922879177377892,0.5077120822622108
E01026246,2312,1147,1165,0.4961072664359862,0.5038927335640139
E01026248,2293,1132,1161,0.4936764064544265,0.5063235935455734
E01026257,2163,1035,1128,0.478502080443828,0.521497919556172
E01026250,2177,1054,1123,0.48415250344510796,0.515847496554892
E01026251,1816,904,912,0.4977973568281938,0.5022026431718062
E01026252,1774,862,912,0.4859075535512965,0.5140924464487034
E01026253,1975,952,1023,0.4820253164556962,0.5179746835443038
E01026281,1357,671,686,0.49447310243183495,0.505526897568165
E01026282,1859,916,943,0.49273803119956966,0.5072619688004303
E01026283,1757,848,909,0.48264086511098464,0.5173591348890154
E01026285,1421,714,707,0.5024630541871922,0.4975369458128079
E01026286,1244,627,617,0.5040192926045016,0.4959807073954984
E01026241,1974,969,1005,0.4908814589665654,0.5091185410334347
E01026258,2276,1105,1171,0.48550087873462217,0.5144991212653779
E01026259,1736,884,852,0.5092165898617511,0.49078341013824883
E01026260,1998,979,1019,0.48998998998999,0.51001001001001
E01026266,2274,1110,1164,0.48812664907651715,0.5118733509234829
E01026273,1764,864,900,0.4897959183673469,0.5102040816326531
E01026275,2714,1301,1413,0.4793662490788504,0.5206337509211496
E01032995,1479,744,735,0.5030425963488844,0.4969574036511156
E01032996,1369,673,696,0.49159970781592405,0.508400292184076
E01034697,1543,739,804,0.47893713545042127,0.5210628645495787
E01034698,1788,881,907,0.49272930648769575,0.5072706935123042
E01026268,1972,953,1019,0.4832657200811359,0.5167342799188641
E01026269,2125,1038,1087,0.4884705882352941,0.5115294117647059
E01026270,1873,909,964,0.48531767218366256,0.5146823278163374
E01026271,1772,901,871,0.5084650112866818,0.4915349887133183
E01026272,1381,697,684,0.5047067342505431,0.4952932657494569
E01026254,1812,896,916,0.49448123620309054,0.5055187637969095
E01026255,1994,983,1011,0.4929789368104313,0.5070210631895687
E01026256,1648,799,849,0.4848300970873786,0.5151699029126213
E01026277,1709,855,854,0.5002925687536571,0.49970743124634287
E01026278,1456,716,740,0.49175824175824173,0.5082417582417582
E01026279,1367,670,697,0.49012435991221653,0.5098756400877835
E01026262,1464,711,753,0.48565573770491804,0.514344262295082
E01026263,2395,1152,1243,0.4810020876826722,0.5189979123173277
E01026264,1649,806,843,0.4887810794420861,0.5112189205579138
E01026265,1440,710,730,0.4930555555555556,0.5069444444444444
E01034699,1432,714,718,0.49860335195530725,0.5013966480446927
E01034700,1422,708,714,0.4978902953586498,0.5021097046413502
E01026245,2456,1223,1233,0.4979641693811075,0.5020358306188925
E01026249,2010,1017,993,0.5059701492537313,0.49402985074626865
E01026280,2697,1367,1330,0.5068594734890619,0.4931405265109381
E01026239,2095,1022,1073,0.48782816229116943,0.5121718377088306
E01026240,2759,1349,1410,0.4889452700253715,0.5110547299746285
E01026284,2322,1145,1177,0.49310938845822566,0.5068906115417743
E01026313,1479,716,763,0.4841108857336038,0.5158891142663962
E01026314,1345,656,689,0.4877323420074349,0.512267657992565
E01026329,1827,875,952,0.4789272030651341,0.5210727969348659
E01026333,2543,1251,1292,0.4919386551317342,0.5080613448682658
E01026291,2041,987,1054,0.48358647721705045,0.5164135227829495
E01026340,2215,1040,1175,0.46952595936794583,0.5304740406320542
E01026355,2510,1213,1297,0.4832669322709163,0.5167330677290837
E01026365,2301,1145,1156,0.49760973489787047,0.5023902651021295
E01026325,1602,767,835,0.4787765293383271,0.521223470661673
E01026326,1502,716,786,0.4766977363515313,0.5233022636484687
E01026327,1406,679,727,0.4829302987197724,0.5170697012802276
E01026328,1525,734,791,0.48131147540983604,0.5186885245901639
E01026352,1304,649,655,0.4976993865030675,0.5023006134969326
E01026353,1566,710,856,0.45338441890166026,0.5466155810983397
E01026354,1123,537,586,0.4781834372217275,0.5218165627782725
E01026321,1394,661,733,0.47417503586800575,0.5258249641319943
E01026322,1220,597,623,0.489344262295082,0.510655737704918
E01026323,1966,1029,937,0.5233977619532044,0.4766022380467955
E01026324,2069,1011,1058,0.4886418559690672,0.5113581440309328
E01034701,1542,754,788,0.4889753566796368,0.5110246433203631
E01034702,1671,824,847,0.4931178934769599,0.5068821065230401
E01026308,1668,802,866,0.48081534772182255,0.5191846522781774
E01026309,1595,756,839,0.47398119122257054,0.5260188087774295
E01026310,1160,566,594,0.4879310344827586,0.5120689655172413
E01026311,1646,797,849,0.4842041312272175,0.5157958687727825
E01026312,1370,648,722,0.472992700729927,0.527007299270073
E01026317,2318,1200,1118,0.5176876617773943,0.4823123382226057
E01026318,2203,1055,1148,0.47889241942805266,0.5211075805719474
E01026319,2620,1278,1342,0.48778625954198473,0.5122137404580153
E01026343,1834,938,896,0.5114503816793893,0.48854961832061067
E01026344,1491,722,769,0.4842387659289068,0.5157612340710932
E01026345,1801,868,933,0.4819544697390339,0.5180455302609661
E01026292,1380,651,729,0.4717391304347826,0.5282608695652173
E01026293,2040,1027,1013,0.5034313725490196,0.4965686274509804
E01026294,1601,787,814,0.4915677701436602,0.5084322298563397
E01026316,2426,1165,1261,0.4802143446001649,0.5197856553998351
E01026332,2152,1066,1086,0.49535315985130113,0.5046468401486989
E01026290,2242,1129,1113,0.5035682426404996,0.49643175735950046
E01026341,1591,780,811,0.49025769956002513,0.5097423004399748
E01026342,1408,693,715,0.4921875,0.5078125
E01026361,2643,1277,1366,0.48316307226636396,0.516836927733636
E01026315,2201,1095,1106,0.4975011358473421,0.5024988641526579
E01026331,2487,1259,1228,0.5062324085243265,0.4937675914756735
E01026338,1241,611,630,0.492344883158743,0.5076551168412571
E01026339,1249,602,647,0.4819855884707766,0.5180144115292233
E01026299,1675,785,890,0.46865671641791046,0.5313432835820896
E01026300,1455,714,741,0.49072164948453606,0.5092783505154639
E01026302,1144,556,588,0.486013986013986,0.513986013986014
E01034703,1315,625,690,0.4752851711026616,0.5247148288973384
E01034704,1439,729,710,0.5066018068102849,0.49339819318971506
E01034705,1400,668,732,0.47714285714285715,0.5228571428571429
E01026296,1514,748,766,0.4940554821664465,0.5059445178335535
E01026297,1515,691,824,0.4561056105610561,0.5438943894389439
E01026298,2107,1030,1077,0.48884670147128617,0.5111532985287138
E01032997,1310,626,684,0.4778625954198473,0.5221374045801527
E01032998,1864,921,943,0.49409871244635195,0.505901287553648
E01032999,1250,574,676,0.4592,0.5408
E01026330,2184,1056,1128,0.4835164835164835,0.5164835164835165
E01026360,2140,1073,1067,0.5014018691588785,0.4985981308411215
E01026362,1721,834,887,0.484601975595584,0.5153980244044161
E01026363,1879,916,963,0.4874933475252794,0.5125066524747206
E01026364,1865,908,957,0.4868632707774799,0.5131367292225201
E01026334,1537,750,787,0.48796356538711777,0.5120364346128823
E01026335,1543,728,815,0.47180816591056385,0.5281918340894362
E01026336,1752,847,905,0.4834474885844749,0.5165525114155252
E01026337,2272,1093,1179,0.4810739436619718,0.5189260563380281
E01026303,1259,612,647,0.48610007942811756,0.5138999205718825
E01026304,1485,723,762,0.4868686868686869,0.5131313131313131
E01026305,1309,623,686,0.47593582887700536,0.5240641711229946
E01026306,1930,882,1048,0.45699481865284974,0.5430051813471503
E01026307,1271,591,680,0.46498819826907944,0.5350118017309206
E01026287,1327,667,660,0.5026375282592314,0.49736247174076864
E01026288,1611,733,878,0.4549968963376785,0.5450031036623215
E01026289,2297,1072,1225,0.4666956900304745,0.5333043099695255
E01026346,1180,573,607,0.48559322033898306,0.514406779661017
E01026347,1572,735,837,0.4675572519083969,0.5324427480916031
E01026348,1255,607,648,0.48366533864541833,0.5163346613545817
E01026349,1534,724,810,0.47196870925684486,0.5280312907431551
E01026350,1844,819,1025,0.44414316702819956,0.5558568329718004
E01026351,1480,735,745,0.4966216216216216,0.5033783783783784
E01026356,1448,698,750,0.48204419889502764,0.5179558011049724
E01026357,1342,656,686,0.488822652757079,0.511177347242921
E01026358,1357,652,705,0.48047162859248344,0.5195283714075166
E01026359,2502,1210,1292,0.48361310951239006,0.5163868904876099
E01026367,1650,828,822,0.5018181818181818,0.49818181818181817
E01026368,1966,950,1016,0.4832146490335707,0.5167853509664293
E01026387,2676,1314,1362,0.4910313901345291,0.5089686098654709
E01026416,1320,636,684,0.4818181818181818,0.5181818181818182
E01032683,2226,1055,1171,0.47394429469901167,0.5260557053009883
E01026380,2559,1225,1334,0.47870261821023835,0.5212973817897616
E01026401,1611,797,814,0.49472377405338297,0.505276225946617
E01026402,1873,918,955,0.49012279765082756,0.5098772023491724
E01026403,1354,682,672,0.5036927621861153,0.4963072378138848
E01026407,1370,657,713,0.47956204379562045,0.5204379562043796
E01026408,1372,671,701,0.489067055393586,0.510932944606414
E01026389,1796,887,909,0.4938752783964365,0.5061247216035635
E01026390,1817,882,935,0.4854155200880572,0.5145844799119428
E01026391,1976,945,1031,0.4782388663967611,0.5217611336032388
E01026392,3047,1469,1578,0.4821135543157204,0.5178864456842797
E01026415,1089,531,558,0.48760330578512395,0.512396694214876
E01026378,1726,854,872,0.4947856315179606,0.5052143684820394
E01026379,1839,931,908,0.5062533985861881,0.4937466014138119
E01026381,1721,822,899,0.47762928529924464,0.5223707147007554
E01026382,1773,857,916,0.48336153412295546,0.5166384658770445
E01026383,1298,704,594,0.5423728813559322,0.4576271186440678
E01026384,2143,1088,1055,0.5076994867008866,0.4923005132991134
E01026385,1073,541,532,0.5041938490214353,0.4958061509785648
E01026386,1243,639,604,0.5140788415124699,0.48592115848753015
E01026399,1519,752,767,0.4950625411454905,0.5049374588545096
E01026411,2447,1225,1222,0.5006129955046996,0.4993870044953004
E01026374,1524,726,798,0.4763779527559055,0.5236220472440944
E01026375,2046,974,1072,0.4760508308895406,0.5239491691104594
E01026376,1694,811,883,0.4787485242030697,0.5212514757969303
E01026377,2210,1087,1123,0.4918552036199095,0.5081447963800905
E01026388,2116,1021,1095,0.4825141776937618,0.5174858223062382
E01026404,2445,1226,1219,0.5014314928425357,0.4985685071574642
E01026409,1236,622,614,0.5032362459546925,0.4967637540453074
E01026410,1618,825,793,0.5098887515451175,0.4901112484548826
E01026372,2550,1253,1297,0.49137254901960786,0.5086274509803922
E01026412,1978,951,1027,0.480788675429727,0.519211324570273
E01026413,2109,1011,1098,0.4793741109530583,0.5206258890469416
E01026414,1916,950,966,0.49582463465553234,0.5041753653444676
E01026396,1305,620,685,0.47509578544061304,0.524904214559387
E01026398,1573,753,820,0.47870311506675145,0.5212968849332485
E01026400,1597,838,759,0.5247338760175329,0.47526612398246715
E01034706,1656,811,845,0.4897342995169082,0.5102657004830918
E01034707,1205,613,592,0.5087136929460581,0.4912863070539419
E01026393,1535,764,771,0.4977198697068404,0.5022801302931597
E01026394,2353,1179,1174,0.501062473438164,0.49893752656183593
E01026395,1510,687,823,0.4549668874172185,0.5450331125827814
E01026405,1523,751,772,0.4931057124097177,0.5068942875902823
E01026406,1189,569,620,0.4785534062237174,0.5214465937762826
E01026366,2448,1193,1255,0.48733660130718953,0.5126633986928104
E01026369,1357,632,725,0.4657332350773766,0.5342667649226235
E01026370,2541,1230,1311,0.48406139315230223,0.5159386068476978
E01026371,1243,631,612,0.5076427996781979,0.4923572003218021
E01026373,2180,1096,1084,0.5027522935779817,0.4972477064220184
E01027979,1551,734,817,0.4732430689877498,0.5267569310122502
E01027980,1569,801,768,0.5105162523900574,0.4894837476099426
E01027981,1620,798,822,0.4925925925925926,0.5074074074074074
E01027983,1570,779,791,0.4961783439490446,0.5038216560509554
E01027970,1350,656,694,0.48592592592592593,0.5140740740740741
E01027971,1350,665,685,0.4925925925925926,0.5074074074074074
E01027982,1372,681,691,0.4963556851311953,0.5036443148688047
E01027984,1456,726,730,0.49862637362637363,0.5013736263736264
E01027966,1335,650,685,0.4868913857677903,0.5131086142322098
E01027986,1317,670,647,0.5087319665907365,0.4912680334092635
E01027987,2250,1078,1172,0.4791111111111111,0.5208888888888888
E01027990,1794,878,916,0.48940914158305465,0.5105908584169454
E01027967,1696,879,817,0.5182783018867925,0.48172169811320753
E01027972,2384,1155,1229,0.48447986577181207,0.5155201342281879
E01027977,2151,1048,1103,0.4872152487215249,0.5127847512784751
E01027978,1904,947,957,0.49737394957983194,0.5026260504201681
E01027985,2145,1053,1092,0.4909090909090909,0.509090909090909
E01027964,1482,705,777,0.4757085020242915,0.5242914979757085
E01027965,1497,672,825,0.44889779559118237,0.5511022044088176
E01027968,1196,601,595,0.5025083612040134,0.4974916387959866
E01027974,1541,763,778,0.49513303049967555,0.5048669695003245
E01027976,2013,986,1027,0.4898161947342275,0.5101838052657724
E01027969,1304,650,654,0.49846625766871167,0.5015337423312883
E01027975,1597,756,841,0.4733876017532874,0.5266123982467126
E01027988,1456,729,727,0.5006868131868132,0.4993131868131868
E01027989,1582,783,799,0.4949431099873578,0.5050568900126422
E01027991,1215,618,597,0.508641975308642,0.49135802469135803
E01027992,2625,1293,1332,0.49257142857142855,0.5074285714285715
E01027949,1449,703,746,0.48516218081435475,0.5148378191856453
E01027951,1624,789,835,0.4858374384236453,0.5141625615763546
E01027953,1523,750,773,0.49244911359159554,0.5075508864084045
E01027954,1643,815,828,0.4960438222763238,0.5039561777236762
E01027973,1557,767,790,0.49261400128452154,0.5073859987154785
E01027952,1843,904,939,0.4905046120455779,0.5094953879544222
E01027955,1289,606,683,0.47013188518231186,0.5298681148176881
E01027956,1520,707,813,0.4651315789473684,0.5348684210526315
E01027958,1512,749,763,0.49537037037037035,0.5046296296296297
E01027947,1653,830,823,0.5021173623714459,0.49788263762855417
E01027948,2153,1061,1092,0.4928007431490943,0.5071992568509057
E01027950,2318,1133,1185,0.4887834339948231,0.5112165660051768
E01027957,1309,665,644,0.5080213903743316,0.4919786096256685
E01027959,1996,984,1012,0.49298597194388777,0.5070140280561122
E01027995,1497,725,772,0.48430193720774883,0.5156980627922512
E01027996,1988,972,1016,0.48893360160965793,0.5110663983903421
E01027997,2406,1154,1252,0.4796342477140482,0.5203657522859518
E01027998,1806,879,927,0.4867109634551495,0.5132890365448505
E01027960,1563,770,793,0.4926423544465771,0.5073576455534229
E01027961,1841,918,923,0.4986420423682781,0.5013579576317219
E01027962,1501,742,759,0.4943371085942705,0.5056628914057295
E01027963,1677,825,852,0.4919499105545617,0.5080500894454383
E01027945,1656,816,840,0.4927536231884058,0.5072463768115942
E01027946,1383,673,710,0.4866232827187274,0.5133767172812725
E01027993,1458,702,756,0.48148148148148145,0.5185185185185185
E01027994,1380,674,706,0.48840579710144927,0.5115942028985507
E01027934,1300,627,673,0.4823076923076923,0.5176923076923077
E01027935,1211,580,631,0.47894302229562347,0.5210569777043765
E01027936,1423,695,728,0.4884047786366831,0.5115952213633169
E01033778,1367,650,717,0.4754937820043892,0.5245062179956108
E01033779,1303,649,654,0.4980813507290867,0.5019186492709132
E01033781,1234,645,589,0.5226904376012966,0.4773095623987034
E01033782,1377,653,724,0.47421931735657225,0.5257806826434277
E01033783,1412,684,728,0.48441926345609065,0.5155807365439093
E01027927,2116,1014,1102,0.4792060491493384,0.5207939508506616
E01027928,2072,1013,1059,0.4888996138996139,0.5111003861003861
E01027932,2272,1087,1185,0.4784330985915493,0.5215669014084507
E01027933,1518,735,783,0.4841897233201581,0.5158102766798419
E01027937,1322,638,684,0.4826021180030257,0.5173978819969742
E01027925,2217,1131,1086,0.510148849797023,0.489851150202977
E01027938,1213,611,602,0.5037098103874691,0.4962901896125309
E01027940,1316,647,669,0.49164133738601823,0.5083586626139818
E01027943,1431,689,742,0.48148148148148145,0.5185185185185185
E01027944,1455,717,738,0.4927835051546392,0.5072164948453608
E01027926,1477,703,774,0.47596479350033855,0.5240352064996615
E01027930,1768,869,899,0.4915158371040724,0.5084841628959276
E01027939,1531,758,773,0.4951012410189419,0.5048987589810582
E01027941,1251,591,660,0.4724220623501199,0.5275779376498801
E01027942,2845,1404,1441,0.49349736379613357,0.5065026362038665
E01028000,2302,1161,1141,0.5043440486533449,0.4956559513466551
E01028024,2014,981,1033,0.487090367428004,0.5129096325719961
E01028025,1405,690,715,0.49110320284697506,0.5088967971530249
E01028026,1531,762,769,0.4977139124755062,0.5022860875244938
E01028027,1695,823,872,0.4855457227138643,0.5144542772861357
E01028028,2241,1032,1209,0.4605087014725569,0.5394912985274432
E01027999,2495,1218,1277,0.4881763527054108,0.5118236472945892
E01028005,1824,909,915,0.49835526315789475,0.5016447368421053
E01028031,1155,595,560,0.5151515151515151,0.48484848484848486
E01028032,1371,676,695,0.49307075127644057,0.5069292487235595
E01028035,2385,1158,1227,0.48553459119496856,0.5144654088050314
E01028023,2514,1228,1286,0.4884645982498011,0.5115354017501988
E01028034,2404,1190,1214,0.4950083194675541,0.5049916805324459
E01028036,2898,1866,1032,0.6438923395445134,0.35610766045548653
E01028001,1357,644,713,0.4745762711864407,0.5254237288135594
E01028002,1334,657,677,0.49250374812593706,0.507496251874063
E01028003,1424,699,725,0.49087078651685395,0.5091292134831461
E01028004,1547,743,804,0.48028442146089206,0.519715578539108
E01028029,1384,675,709,0.4877167630057804,0.5122832369942196
E01028030,1219,588,631,0.48236259228876127,0.5176374077112387
E01028013,1917,931,986,0.4856546687532603,0.5143453312467396
E01028014,1480,736,744,0.4972972972972973,0.5027027027027027
E01028015,1602,796,806,0.4968789013732834,0.5031210986267166
E01028016,1350,636,714,0.4711111111111111,0.5288888888888889
E01028046,1533,758,775,0.49445531637312456,0.5055446836268754
E01028047,2875,1451,1424,0.504695652173913,0.49530434782608695
E01028048,1635,814,821,0.4978593272171254,0.5021406727828747
E01028049,1779,863,916,0.48510399100618323,0.5148960089938167
E01028050,1859,915,944,0.492200107584723,0.507799892415277
E01028008,1335,607,728,0.45468164794007493,0.5453183520599251
E01028009,1317,642,675,0.4874715261958998,0.5125284738041003
E01028010,1620,807,813,0.4981481481481482,0.5018518518518519
E01028011,1558,765,793,0.4910141206675225,0.5089858793324775
E01028012,1329,637,692,0.47930775018811134,0.5206922498118887
E01028022,1662,831,831,0.5,0.5
E01028055,1645,813,832,0.49422492401215806,0.505775075987842
E01028056,1442,722,720,0.5006934812760055,0.49930651872399445
E01028058,2186,1088,1098,0.4977127172918573,0.5022872827081427
E01028059,1784,873,911,0.48934977578475336,0.5106502242152466
E01028017,2479,1166,1313,0.4703509479628883,0.5296490520371118
E01028018,1378,685,693,0.49709724238026126,0.5029027576197388
E01028019,1419,704,715,0.49612403100775193,0.5038759689922481
E01028020,1781,882,899,0.4952274003368894,0.5047725996631106
E01028021,1739,851,888,0.48936170212765956,0.5106382978723404
E01028057,1314,683,631,0.5197869101978692,0.4802130898021309
E01028065,1798,840,958,0.4671857619577308,0.5328142380422692
E01028066,1767,869,898,0.4917940011318619,0.5082059988681381
E01028068,1874,987,887,0.5266808964781217,0.47331910352187834
E01028060,1894,945,949,0.4989440337909187,0.5010559662090813
E01028061,1404,680,724,0.4843304843304843,0.5156695156695157
E01028062,2065,1028,1037,0.49782082324455207,0.502179176755448
E01028067,1588,803,785,0.5056675062972292,0.49433249370277077
E01028043,1451,726,725,0.5003445899379738,0.4996554100620262
E01028063,1684,829,855,0.49228028503562943,0.5077197149643705
E01028064,1280,627,653,0.48984375,0.51015625
E01033769,1995,975,1020,0.48872180451127817,0.5112781954887218
E01028006,1278,625,653,0.4890453834115806,0.5109546165884195
E01028007,1223,621,602,0.5077677841373671,0.4922322158626329
E01028033,2295,1214,1081,0.5289760348583878,0.4710239651416122
E01028037,1792,880,912,0.49107142857142855,0.5089285714285714
E01028038,1538,767,771,0.4986996098829649,0.5013003901170351
E01028039,1267,633,634,0.4996053670086819,0.500394632991318
E01028042,1412,704,708,0.4985835694050991,0.5014164305949008
E01028044,1661,820,841,0.49367850692354004,0.50632149307646
E01028045,1899,933,966,0.4913112164296998,0.5086887835703001
E01028051,1414,667,747,0.47171145685997173,0.5282885431400283
E01028052,1663,805,858,0.4840649428743235,0.5159350571256764
E01028053,1565,753,812,0.48115015974440895,0.518849840255591
E01028054,1477,725,752,0.49085985104942453,0.5091401489505755
E01028092,1276,636,640,0.49843260188087773,0.5015673981191222
E01028093,1007,481,526,0.47765640516385305,0.522343594836147
E01028107,1500,742,758,0.49466666666666664,0.5053333333333333
E01028108,1408,691,717,0.49076704545454547,0.5092329545454546
E01028114,1488,696,792,0.46774193548387094,0.532258064516129
E01028110,1643,771,872,0.4692635423006695,0.5307364576993305
E01028111,1490,721,769,0.48389261744966444,0.5161073825503356
E01028112,1635,791,844,0.4837920489296636,0.5162079510703363
E01028113,1453,724,729,0.49827942188575364,0.5017205781142464
E01028109,1725,855,870,0.4956521739130435,0.5043478260869565
E01028115,1628,794,834,0.4877149877149877,0.5122850122850123
E01028116,1702,824,878,0.48413631022326675,0.5158636897767332
E01028117,1576,804,772,0.5101522842639594,0.48984771573604063
E01028118,1643,796,847,0.4844796104686549,0.515520389531345
E01028102,1336,646,690,0.48353293413173654,0.5164670658682635
E01028103,1082,530,552,0.4898336414048059,0.5101663585951941
E01028104,1590,778,812,0.48930817610062893,0.5106918238993711
E01028122,1592,770,822,0.4836683417085427,0.5163316582914573
E01028123,1905,928,977,0.48713910761154855,0.5128608923884515
E01028124,1655,800,855,0.48338368580060426,0.5166163141993958
E01028087,1590,777,813,0.48867924528301887,0.5113207547169811
E01028088,1459,716,743,0.49074708704592185,0.5092529129540782
E01028089,1300,629,671,0.48384615384615387,0.5161538461538462
E01028090,1359,672,687,0.49448123620309054,0.5055187637969095
E01028091,1536,739,797,0.4811197916666667,0.5188802083333334
E01028125,1858,918,940,0.4940796555435953,0.5059203444564048
E01028126,1311,622,689,0.4744469870327994,0.5255530129672006
E01028127,1594,776,818,0.4868255959849435,0.5131744040150564
E01028134,1429,698,731,0.48845346396081174,0.5115465360391882
E01028076,1257,614,643,0.4884645982498011,0.5115354017501988
E01028077,1437,710,727,0.4940848990953375,0.5059151009046625
E01028078,1665,813,852,0.4882882882882883,0.5117117117117117
E01028079,2002,948,1054,0.47352647352647353,0.5264735264735265
E01028084,1747,867,880,0.4962793360045793,0.5037206639954207
E01028128,1719,854,865,0.4968004653868528,0.5031995346131471
E01028129,1544,774,770,0.5012953367875648,0.49870466321243523
E01028130,1922,936,986,0.4869927159209157,0.5130072840790842
E01028131,1532,751,781,0.4902088772845953,0.5097911227154047
E01028132,1111,516,595,0.46444644464446444,0.5355535553555355
E01028133,1433,707,726,0.4933705512909979,0.5066294487090021
E01028073,1640,835,805,0.5091463414634146,0.49085365853658536
E01028074,2076,1093,983,0.5264932562620424,0.4735067437379576
E01028075,1655,881,774,0.5323262839879154,0.4676737160120846
E01028085,2159,1074,1085,0.49745252431681336,0.5025474756831867
E01028086,1552,745,807,0.4800257731958763,0.5199742268041238
E01028080,1789,874,915,0.48854108440469535,0.5114589155953047
E01028081,1081,534,547,0.4939870490286771,0.5060129509713228
E01028082,1207,586,621,0.4855012427506214,0.5144987572493787
E01028083,1299,670,629,0.5157813702848345,0.4842186297151655
E01028097,1361,666,695,0.4893460690668626,0.5106539309331374
E01028098,1559,735,824,0.47145606157793457,0.5285439384220654
E01028099,1313,650,663,0.49504950495049505,0.504950495049505
E01028100,1810,893,917,0.49337016574585635,0.5066298342541437
E01028101,1548,715,833,0.46188630490956073,0.5381136950904393
E01028069,1127,560,567,0.4968944099378882,0.5031055900621118
E01028070,1068,514,554,0.4812734082397004,0.5187265917602997
E01028094,1767,830,937,0.46972269383135257,0.5302773061686474
E01028095,1443,723,720,0.501039501039501,0.498960498960499
E01028096,2033,992,1041,0.4879488440727988,0.5120511559272012
E01028135,1380,665,715,0.48188405797101447,0.5181159420289855
E01028136,1661,804,857,0.48404575556893437,0.5159542444310656
E01028137,2436,1223,1213,0.5020525451559934,0.49794745484400654
E01028138,1175,568,607,0.48340425531914893,0.516595744680851
E01028139,1412,696,716,0.49291784702549574,0.5070821529745042
E01028105,1183,571,612,0.4826711749788673,0.5173288250211328
E01028106,1402,682,720,0.4864479315263909,0.5135520684736091
E01028119,2047,1044,1003,0.5100146555935515,0.4899853444064485
E01028120,1721,845,876,0.49099360836722833,0.5090063916327716
E01028121,1441,716,725,0.49687716863289383,0.5031228313671062
E01033412,2287,1121,1166,0.49016178399650195,0.509838216003498
E01033413,2166,1073,1093,0.4953831948291782,0.5046168051708217
E01028189,2712,1361,1351,0.5018436578171092,0.49815634218289084
E01028198,1427,689,738,0.48283111422564823,0.5171688857743518
E01028199,1475,707,768,0.4793220338983051,0.5206779661016949
E01028200,1832,899,933,0.49072052401746724,0.5092794759825328
E01028201,1157,579,578,0.5004321521175453,0.4995678478824546
E01028150,1350,650,700,0.48148148148148145,0.5185185185185185
E01028151,1123,538,585,0.4790739091718611,0.5209260908281389
E01028152,1843,897,946,0.48670645686380903,0.513293543136191
E01028153,1325,632,693,0.4769811320754717,0.5230188679245283
E01028154,1679,781,898,0.4651578320428827,0.5348421679571174
E01028213,1909,990,919,0.5185961236249346,0.4814038763750655
E01028143,1353,651,702,0.4811529933481153,0.5188470066518847
E01028205,1776,888,888,0.5,0.5
E01028206,1397,675,722,0.4831782390837509,0.5168217609162491
E01028207,1670,819,851,0.49041916167664673,0.5095808383233533
E01028208,1102,534,568,0.484573502722323,0.515426497277677
E01028173,1051,522,529,0.4966698382492864,0.5033301617507137
E01028174,1658,790,868,0.4764776839565742,0.5235223160434258
E01028175,1755,844,911,0.4809116809116809,0.5190883190883191
E01028209,1412,642,770,0.4546742209631728,0.5453257790368272
E01028144,1494,686,808,0.45917001338688085,0.5408299866131191
E01028165,1496,737,759,0.49264705882352944,0.5073529411764706
E01028166,1762,831,931,0.4716231555051078,0.5283768444948922
E01028167,1925,940,985,0.4883116883116883,0.5116883116883116
E01028179,1373,635,738,0.46249089584850694,0.5375091041514931
E01028180,1475,705,770,0.47796610169491527,0.5220338983050847
E01028181,1449,650,799,0.44858523119392685,0.5514147688060732
E01028182,1509,742,767,0.4917163684559311,0.508283631544069
E01028183,1252,605,647,0.48322683706070285,0.5167731629392971
E01028148,2474,1181,1293,0.4773645917542441,0.5226354082457558
E01028149,1627,773,854,0.47510755992624465,0.5248924400737554
E01028178,2493,1220,1273,0.48937023666265544,0.5106297633373446
E01028176,1485,708,777,0.4767676767676768,0.5232323232323233
E01028177,1564,725,839,0.4635549872122762,0.5364450127877238
E01028214,1408,672,736,0.4772727272727273,0.5227272727272727
E01028215,1347,658,689,0.4884929472902747,0.5115070527097253
E01028216,1276,626,650,0.49059561128526646,0.5094043887147336
E01028217,1382,673,709,0.4869753979739508,0.5130246020260492
E01028218,1563,787,776,0.5035188739603327,0.4964811260396673
E01028193,1514,722,792,0.47688243064729197,0.523117569352708
E01028194,1445,722,723,0.4996539792387543,0.5003460207612457
E01028195,1404,685,719,0.4878917378917379,0.5121082621082621
E01028196,1376,689,687,0.5007267441860465,0.4992732558139535
E01028197,1367,660,707,0.48280907095830283,0.5171909290416972
E01028204,1321,650,671,0.49205147615442846,0.5079485238455715
E01028172,2205,1075,1130,0.4875283446712018,0.5124716553287982
E01028190,1553,741,812,0.4771410173857051,0.5228589826142949
E01028202,1440,678,762,0.4708333333333333,0.5291666666666667
E01028203,1352,673,679,0.4977810650887574,0.5022189349112426
E01028212,1636,812,824,0.4963325183374083,0.5036674816625917
E01028168,1272,623,649,0.48977987421383645,0.5102201257861635
E01028169,1401,684,717,0.48822269807280516,0.5117773019271948
E01028170,1517,731,786,0.4818721160184575,0.5181278839815425
E01028171,1346,662,684,0.4918276374442793,0.5081723625557206
E01028191,1732,845,887,0.48787528868360275,0.5121247113163973
E01028192,1559,791,768,0.5073765234124439,0.4926234765875561
E01028160,1464,718,746,0.49043715846994534,0.5095628415300546
E01028161,1550,742,808,0.47870967741935483,0.5212903225806451
E01028162,1576,733,843,0.4651015228426396,0.5348984771573604
E01028163,1483,759,724,0.5118004045853001,0.4881995954146999
E01028211,1312,630,682,0.4801829268292683,0.5198170731707317
E01028155,1392,674,718,0.48419540229885055,0.5158045977011494
E01028156,1337,680,657,0.5086013462976814,0.4913986537023186
E01028157,1266,630,636,0.4976303317535545,0.5023696682464455
E01028158,1640,819,821,0.499390243902439,0.500609756097561
E01028159,1319,639,680,0.4844579226686884,0.5155420773313116
E01028164,1275,633,642,0.4964705882352941,0.5035294117647059
E01028210,1430,640,790,0.44755244755244755,0.5524475524475524
E01028184,1123,542,581,0.4826357969723954,0.5173642030276047
E01028185,1828,854,974,0.4671772428884026,0.5328227571115973
E01028186,1542,763,779,0.49481193255512324,0.5051880674448768
E01028187,1406,665,741,0.47297297297297297,0.527027027027027
E01028188,1425,705,720,0.49473684210526314,0.5052631578947369
E01028142,2253,1114,1139,0.4944518419884598,0.5055481580115402
E01028146,1419,683,736,0.4813248766737139,0.5186751233262861
E01028147,1078,512,566,0.4749536178107607,0.5250463821892394
E01032622,1341,658,683,0.4906785980611484,0.5093214019388516
E01028224,1417,678,739,0.4784756527875794,0.5215243472124206
E01028257,1581,763,818,0.48260594560404807,0.5173940543959519
E01028258,1637,793,844,0.4844227244960293,0.5155772755039707
E01028259,1776,894,882,0.5033783783783784,0.4966216216216216
E01028223,1438,692,746,0.4812239221140473,0.5187760778859527
E01028225,1553,749,804,0.4822923374114617,0.5177076625885383
E01028226,1487,720,767,0.484196368527236,0.515803631472764
E01028260,1756,840,916,0.4783599088838269,0.5216400911161732
E01028251,1534,754,780,0.4915254237288136,0.5084745762711864
E01028252,1895,924,971,0.48759894459102904,0.512401055408971
E01028253,1656,818,838,0.4939613526570048,0.5060386473429952
E01028277,1373,692,681,0.5040058266569556,0.4959941733430444
E01028278,1372,665,707,0.4846938775510204,0.5153061224489796
E01028271,1743,858,885,0.49225473321858865,0.5077452667814114
E01028279,1473,697,776,0.47318397827562797,0.526816021724372
E01028280,1368,664,704,0.4853801169590643,0.5146198830409356
E01028281,1480,710,770,0.4797297297297297,0.5202702702702703
E01028283,2253,1112,1141,0.4935641367066134,0.5064358632933866
E01028242,1452,729,723,0.5020661157024794,0.49793388429752067
E01028250,1392,684,708,0.49137931034482757,0.5086206896551724
E01028272,1790,854,936,0.4770949720670391,0.5229050279329609
E01028273,1452,710,742,0.4889807162534435,0.5110192837465565
E01028229,1365,689,676,0.5047619047619047,0.49523809523809526
E01028232,1499,723,776,0.48232154769846564,0.5176784523015343
E01028267,2201,1063,1138,0.4829622898682417,0.5170377101317583
E01028282,1201,569,632,0.47377185678601164,0.5262281432139884
E01033392,2640,1324,1316,0.5015151515151515,0.4984848484848485
E01028237,1592,776,816,0.48743718592964824,0.5125628140703518
E01028238,1519,726,793,0.477946017116524,0.5220539828834759
E01028239,1717,822,895,0.47874199184624344,0.5212580081537566
E01028240,1442,707,735,0.49029126213592233,0.5097087378640777
E01028243,1925,910,1015,0.4727272727272727,0.5272727272727272
E01033775,1703,846,857,0.4967704051673517,0.5032295948326483
E01033776,1529,749,780,0.4898626553302812,0.5101373446697187
E01028227,1367,659,708,0.4820775420629115,0.5179224579370885
E01028228,1285,593,692,0.4614785992217899,0.5385214007782101
E01028247,1724,893,831,0.5179814385150812,0.4820185614849188
E01028268,2216,1173,1043,0.5293321299638989,0.4706678700361011
E01028269,1749,877,872,0.501429388221841,0.4985706117781589
E01028284,1838,923,915,0.5021762785636561,0.49782372143634385
E01028233,1988,1019,969,0.5125754527162978,0.4874245472837022
E01028234,1711,811,900,0.4739918176504968,0.5260081823495032
E01028274,1496,796,700,0.5320855614973262,0.4679144385026738
E01028275,1599,776,823,0.48530331457160725,0.5146966854283928
E01028276,1642,829,813,0.5048721071863581,0.4951278928136419
E01028230,1530,776,754,0.5071895424836601,0.4928104575163399
E01028231,1498,724,774,0.4833110814419226,0.5166889185580774
E01028244,1521,744,777,0.4891518737672584,0.5108481262327417
E01028245,1360,660,700,0.4852941176470588,0.5147058823529411
E01028246,1667,833,834,0.4997000599880024,0.5002999400119976
E01028248,1646,818,828,0.49696233292831105,0.503037667071689
E01028249,1459,715,744,0.4900616860863605,0.5099383139136395
E01028235,1551,786,765,0.5067698259187621,0.4932301740812379
E01028236,1776,902,874,0.5078828828828829,0.49211711711711714
E01028262,1389,678,711,0.48812095032397407,0.5118790496760259
E01028264,1850,889,961,0.4805405405405405,0.5194594594594595
E01028254,1327,642,685,0.48379804069329313,0.5162019593067069
E01028256,1831,931,900,0.5084653194975424,0.4915346805024577
E01028261,1641,792,849,0.4826325411334552,0.5173674588665448
E01028263,1554,802,752,0.5160875160875161,0.4839124839124839
E01028219,1483,721,762,0.4861766689143628,0.5138233310856373
E01028220,1836,922,914,0.5021786492374728,0.49782135076252726
E01028222,2524,1242,1282,0.4920760697305864,0.5079239302694136
E01028255,1323,659,664,0.4981103552532124,0.5018896447467877
E01028270,1553,732,821,0.4713457823567289,0.5286542176432711
E01033389,1439,733,706,0.5093815149409312,0.4906184850590688
E01033390,1699,833,866,0.49028840494408477,0.5097115950559152
E01033391,1191,599,592,0.5029387069689337,0.49706129303106633
E01028301,1944,973,971,0.5005144032921811,0.49948559670781895
E01028302,1515,767,748,0.5062706270627063,0.49372937293729374
E01028338,1795,872,923,0.48579387186629525,0.5142061281337047
E01028339,1884,928,956,0.49256900212314225,0.5074309978768577
E01028340,1579,773,806,0.4895503483217226,0.5104496516782774
E01033770,1298,663,635,0.5107858243451464,0.48921417565485364
E01033771,1257,600,657,0.477326968973747,0.522673031026253
E01028313,2021,947,1074,0.4685799109351806,0.5314200890648194
E01028321,1544,750,794,0.48575129533678757,0.5142487046632125
E01028322,2066,1023,1043,0.4951597289448209,0.504840271055179
E01028323,1713,816,897,0.4763572679509632,0.5236427320490368
E01033772,1403,677,726,0.48253741981468284,0.5174625801853172
E01033773,1571,778,793,0.4952259707192871,0.5047740292807129
E01033774,1450,710,740,0.4896551724137931,0.5103448275862069
E01028303,1485,736,749,0.49562289562289563,0.5043771043771044
E01028312,2314,1144,1170,0.4943820224719101,0.5056179775280899
E01028337,1486,739,747,0.49730820995962316,0.5026917900403769
E01028349,1529,751,778,0.49117069980379335,0.5088293001962066
E01028350,1246,589,657,0.4727126805778491,0.5272873194221509
E01028315,1530,725,805,0.4738562091503268,0.5261437908496732
E01028316,1701,806,895,0.4738389182833627,0.5261610817166372
E01028317,1616,811,805,0.5018564356435643,0.49814356435643564
E01028353,2733,1350,1383,0.49396267837541163,0.5060373216245884
E01028295,1901,955,946,0.5023671751709626,0.49763282482903737
E01028297,1987,959,1028,0.482637141419225,0.517362858580775
E01028327,1994,990,1004,0.49648946840521563,0.5035105315947843
E01028328,1788,859,929,0.4804250559284116,0.5195749440715883
E01028329,1616,809,807,0.5006188118811881,0.4993811881188119
E01028296,1801,898,903,0.498611882287618,0.501388117712382
E01028298,1509,758,751,0.5023194168323393,0.49768058316766073
E01028299,1331,652,679,0.4898572501878287,0.5101427498121713
E01028300,1454,717,737,0.4931224209078404,0.5068775790921596
E01028342,1484,691,793,0.465633423180593,0.534366576819407
E01028343,2446,1170,1276,0.4783319705641864,0.5216680294358136
E01028344,1341,659,682,0.49142431021625654,0.5085756897837435
E01028294,1944,957,987,0.49228395061728397,0.5077160493827161
E01028304,1444,711,733,0.49238227146814406,0.5076177285318559
E01028305,1552,767,785,0.49420103092783507,0.5057989690721649
E01028306,1700,857,843,0.5041176470588236,0.4958823529411765
E01028307,1206,588,618,0.48756218905472637,0.5124378109452736
E01028310,2190,1175,1015,0.5365296803652968,0.4634703196347032
E01028311,1650,840,810,0.509090909090909,0.4909090909090909
E01028345,2196,1043,1153,0.4749544626593807,0.5250455373406193
E01028346,2137,1010,1127,0.4726251754796444,0.5273748245203557
E01028347,1457,675,782,0.46328071379547014,0.5367192862045299
E01028348,1768,743,1025,0.42024886877828055,0.5797511312217195
E01028292,2735,1348,1387,0.4928702010968921,0.5071297989031078
E01028293,1951,957,994,0.49051768323936445,0.5094823167606356
E01028333,1475,705,770,0.47796610169491527,0.5220338983050847
E01028334,1626,796,830,0.48954489544895446,0.5104551045510455
E01028335,1875,926,949,0.4938666666666667,0.5061333333333333
E01028308,1551,751,800,0.4842037395228885,0.5157962604771116
E01028309,1394,664,730,0.4763271162123386,0.5236728837876614
E01028318,1538,743,795,0.4830949284785436,0.5169050715214565
E01028319,2011,954,1057,0.47439085032322226,0.5256091496767777
E01028320,1722,812,910,0.4715447154471545,0.5284552845528455
E01028285,1192,566,626,0.4748322147651007,0.5251677852348994
E01028286,1316,670,646,0.5091185410334347,0.4908814589665654
E01028287,1508,737,771,0.4887267904509284,0.5112732095490716
E01028288,1466,721,745,0.4918144611186903,0.5081855388813097
E01028289,1361,664,697,0.4878765613519471,0.5121234386480529
E01028290,1429,691,738,0.483554933519944,0.516445066480056
E01028291,2074,1029,1045,0.4961427193828351,0.503857280617165
E01028325,1293,630,663,0.4872389791183295,0.5127610208816705
E01028326,1313,656,657,0.49961919268849964,0.5003808073115004
E01028336,1139,562,577,0.4934152765583846,0.5065847234416154
E01028352,1145,562,583,0.4908296943231441,0.509170305676856
E01033394,1451,701,750,0.48311509303928324,0.5168849069607168
E01033777,1484,743,741,0.5006738544474394,0.49932614555256066
E01033780,1623,787,836,0.4849044978434997,0.5150955021565004
E01028330,1519,720,799,0.4739960500329164,0.5260039499670837
E01028331,2291,1568,723,0.6844172850283718,0.3155827149716281
E01028332,1613,808,805,0.5009299442033478,0.4990700557966522
E01028351,1285,616,669,0.4793774319066148,0.5206225680933853
E01028371,2979,1851,1128,0.62134944612286,0.37865055387714
E01028403,2144,1026,1118,0.478544776119403,0.5214552238805971
E01028411,2152,1068,1084,0.4962825278810409,0.5037174721189591
E01028357,1450,705,745,0.4862068965517241,0.5137931034482759
E01028358,1318,632,686,0.4795144157814871,0.5204855842185129
E01028359,1891,901,990,0.476467477525119,0.523532522474881
E01028360,2851,1376,1475,0.48263767099263416,0.5173623290073658
E01028361,1279,599,680,0.4683346364347146,0.5316653635652854
E01028362,1320,626,694,0.47424242424242424,0.5257575757575758
E01028393,1097,528,569,0.4813126709206928,0.5186873290793071
E01028394,1486,707,779,0.4757738896366083,0.5242261103633916
E01028395,1321,645,676,0.4882664647993944,0.5117335352006056
E01028413,1691,790,901,0.4671791839148433,0.5328208160851567
E01028414,1593,761,832,0.47771500313873194,0.5222849968612681
E01028415,2064,1008,1056,0.4883720930232558,0.5116279069767442
E01028354,1518,744,774,0.4901185770750988,0.5098814229249012
E01028355,1549,764,785,0.4932214331826985,0.5067785668173015
E01028384,1809,908,901,0.5019347705914871,0.498065229408513
E01028385,1748,886,862,0.5068649885583524,0.4931350114416476
E01028386,1713,856,857,0.4997081144191477,0.5002918855808524
E01028396,1494,724,770,0.48460508701472554,0.5153949129852744
E01028398,1398,672,726,0.48068669527896996,0.51931330472103
E01028399,1374,649,725,0.4723435225618632,0.5276564774381368
E01028416,1628,819,809,0.5030712530712531,0.49692874692874694
E01028417,1565,841,724,0.5373801916932908,0.4626198083067093
E01028418,1499,753,746,0.5023348899266178,0.49766511007338227
E01028356,1435,689,746,0.4801393728222996,0.5198606271777003
E01028375,1881,940,941,0.49973418394471025,0.5002658160552897
E01028376,1545,784,761,0.5074433656957928,0.4925566343042071
E01028377,1883,921,962,0.48911311736590546,0.5108868826340945
E01028397,1765,874,891,0.4951841359773371,0.5048158640226629
E01028363,1343,654,689,0.4869694713328369,0.513030528667163
E01028364,1718,834,884,0.48544819557625146,0.5145518044237486
E01028365,2054,1000,1054,0.48685491723466406,0.5131450827653359
E01028391,2086,1010,1076,0.4841802492809204,0.5158197507190796
E01028392,2134,1018,1116,0.47703842549203374,0.5229615745079662
E01028372,1303,653,650,0.501151189562548,0.49884881043745205
E01028374,1361,629,732,0.46216017634092577,0.5378398236590742
E01028400,1554,773,781,0.4974259974259974,0.5025740025740025
E01028401,1258,632,626,0.5023847376788553,0.49761526232114467
E01035509,1370,697,673,0.5087591240875913,0.4912408759124088
E01035510,1739,844,895,0.48533640023001723,0.5146635997699828
E01028366,1287,622,665,0.48329448329448327,0.5167055167055167
E01028367,2579,1253,1326,0.48584722760759985,0.5141527723924002
E01028368,1494,748,746,0.500669344042838,0.499330655957162
E01028369,1465,711,754,0.4853242320819113,0.5146757679180888
E01028370,1379,669,710,0.4851341551849166,0.5148658448150834
E01028402,1943,986,957,0.5074626865671642,0.4925373134328358
E01028419,2450,1177,1273,0.4804081632653061,0.5195918367346939
E01028420,1318,669,649,0.507587253414264,0.49241274658573597
E01028404,1606,756,850,0.47073474470734744,0.5292652552926526
E01028405,2210,1057,1153,0.47828054298642536,0.5217194570135747
E01028406,1680,804,876,0.4785714285714286,0.5214285714285715
E01028407,2179,1075,1104,0.49334557136301055,0.5066544286369894
E01028379,1739,839,900,0.4824611845888442,0.5175388154111559
E01028412,1976,976,1000,0.4939271255060729,0.5060728744939271
E01028421,2223,1088,1135,0.48942869995501576,0.5105713000449843
E01028380,1280,643,637,0.50234375,0.49765625
E01028381,1305,620,685,0.47509578544061304,0.524904214559387
E01028382,1434,672,762,0.4686192468619247,0.5313807531380753
E01028383,1064,510,554,0.4793233082706767,0.5206766917293233
E01028378,2000,981,1019,0.4905,0.5095
E01028387,2524,1230,1294,0.4873217115689382,0.5126782884310618
E01028408,2786,1202,1584,0.4314429289303661,0.5685570710696339
E01028388,1691,837,854,0.4949733885274985,0.5050266114725015
E01028389,1877,904,973,0.48161960575386253,0.5183803942461375
E01028390,2588,1241,1347,0.4795208655332303,0.5204791344667697
E01028409,1287,615,672,0.47785547785547783,0.5221445221445221
E01028410,1347,669,678,0.49665924276169265,0.5033407572383074
E01013998,1417,696,721,0.4911785462244178,0.5088214537755822
E01014051,1835,947,888,0.5160762942779291,0.48392370572207083
E01014052,1483,730,753,0.49224544841537426,0.5077545515846258
E01014096,1529,778,751,0.5088293001962066,0.49117069980379335
E01014041,1489,703,786,0.47212894560107455,0.5278710543989255
E01014042,1602,783,819,0.4887640449438202,0.5112359550561798
E01014043,1035,496,539,0.4792270531400966,0.5207729468599034
E01014044,1539,739,800,0.4801819363222872,0.5198180636777128
E01014045,1635,810,825,0.4954128440366973,0.5045871559633027
E01014046,1549,764,785,0.4932214331826985,0.5067785668173015
E01014047,1452,691,761,0.4758953168044077,0.5241046831955923
E01014048,1651,800,851,0.48455481526347666,0.5154451847365233
E01013999,1591,778,813,0.48900062853551224,0.5109993714644877
E01014017,1472,700,772,0.47554347826086957,0.5244565217391305
E01014024,1283,621,662,0.48402182385035075,0.5159781761496492
E01014025,1515,769,746,0.5075907590759076,0.4924092409240924
E01014055,1695,828,867,0.48849557522123893,0.511504424778761
E01014097,1277,619,658,0.48472983555207516,0.5152701644479248
E01014000,1311,664,647,0.5064836003051106,0.4935163996948894
E01014001,1616,804,812,0.4975247524752475,0.5024752475247525
E01014002,1405,665,740,0.47330960854092524,0.5266903914590747
E01014003,1590,794,796,0.49937106918238994,0.5006289308176101
E01014004,1437,696,741,0.48434237995824636,0.5156576200417536
E01014005,1696,810,886,0.47759433962264153,0.5224056603773585
E01014015,1627,788,839,0.4843269821757836,0.5156730178242164
E01014008,1609,809,800,0.5027967681789932,0.49720323182100684
E01014009,1540,771,769,0.5006493506493507,0.4993506493506494
E01014033,1768,849,919,0.4802036199095023,0.5197963800904978
E01014034,1452,713,739,0.49104683195592286,0.5089531680440771
E01014056,1481,728,753,0.49155975692099935,0.5084402430790007
E01014006,1557,781,776,0.5016056518946692,0.4983943481053308
E01014012,1675,809,866,0.4829850746268657,0.5170149253731343
E01014013,2023,1062,961,0.5249629263470094,0.4750370736529906
E01014016,1544,724,820,0.4689119170984456,0.5310880829015544
E01014100,1775,873,902,0.49183098591549296,0.508169014084507
E01014101,1011,491,520,0.4856577645895153,0.5143422354104846
E01014022,2327,1171,1156,0.5032230339492909,0.4967769660507091
E01014023,1971,982,989,0.49822425164890916,0.5017757483510908
E01014081,1479,731,748,0.4942528735632184,0.5057471264367817
E01014082,1805,889,916,0.4925207756232687,0.5074792243767313
E01014027,1433,726,707,0.5066294487090021,0.4933705512909979
E01014028,1484,708,776,0.477088948787062,0.522911051212938
E01014029,1484,723,761,0.4871967654986523,0.5128032345013477
E01014030,1398,679,719,0.48569384835479257,0.5143061516452074
E01014083,1566,758,808,0.4840357598978289,0.5159642401021711
E01014084,1577,806,771,0.5110970196575777,0.4889029803424223
E01014085,1638,795,843,0.48534798534798534,0.5146520146520146
E01014087,1416,736,680,0.519774011299435,0.480225988700565
E01014088,1342,626,716,0.46646795827123694,0.533532041728763
E01014089,1397,661,736,0.47315676449534716,0.5268432355046528
E01013987,1594,751,843,0.4711417816813049,0.5288582183186951
E01013988,1815,892,923,0.4914600550964187,0.5085399449035812
E01014095,1397,674,723,0.4824624194702935,0.5175375805297066
E01035055,1596,776,820,0.48621553884711777,0.5137844611528822
E01035056,1525,758,767,0.4970491803278689,0.5029508196721312
E01013986,1626,791,835,0.486469864698647,0.513530135301353
E01013989,1547,788,759,0.5093729799612152,0.4906270200387847
E01014010,1832,964,868,0.5262008733624454,0.4737991266375546
E01014011,1475,731,744,0.49559322033898306,0.504406779661017
E01014086,1474,762,712,0.5169606512890095,0.4830393487109905
E01014092,1811,895,916,0.4942020982882385,0.5057979017117614
E01014075,1769,876,893,0.4951950254381006,0.5048049745618994
E01014076,2106,1076,1030,0.5109211775878443,0.4890788224121557
E01014077,1569,769,800,0.49012109623964306,0.5098789037603569
E01014078,1410,711,699,0.5042553191489362,0.4957446808510638
E01014090,1460,719,741,0.49246575342465754,0.5075342465753425
E01014091,1525,724,801,0.47475409836065574,0.5252459016393443
E01014093,1372,641,731,0.467201166180758,0.532798833819242
E01014094,1441,689,752,0.47814018043025674,0.5218598195697433
E01014068,1423,709,714,0.4982431482782853,0.5017568517217147
E01014070,2304,1140,1164,0.4947916666666667,0.5052083333333334
E01014072,1959,968,991,0.4941296579887698,0.5058703420112303
E01014073,1912,948,964,0.49581589958158995,0.50418410041841
E01014074,1484,756,728,0.5094339622641509,0.49056603773584906
E01013996,1538,757,781,0.49219765929778936,0.5078023407022106
E01013997,1871,934,937,0.4991982896846606,0.5008017103153394
E01014079,1631,820,811,0.5027590435315757,0.49724095646842426
E01014080,1517,750,767,0.4943968358602505,0.5056031641397495
E01013992,1542,754,788,0.4889753566796368,0.5110246433203631
E01013993,1565,768,797,0.4907348242811502,0.5092651757188499
E01013994,1443,668,775,0.46292446292446293,0.5370755370755371
E01013995,1846,902,944,0.4886240520043337,0.5113759479956663
E01014071,1466,731,735,0.49863574351978174,0.5013642564802183
E01013990,2099,995,1104,0.47403525488327775,0.5259647451167222
E01013991,1329,646,683,0.4860797592174567,0.5139202407825433
E01014014,1849,906,943,0.4899945916711736,0.5100054083288263
E01014054,1323,684,639,0.5170068027210885,0.48299319727891155
E01014035,1714,823,891,0.48016336056009334,0.5198366394399067
E01014036,1681,809,872,0.4812611540749554,0.5187388459250446
E01014037,1433,662,771,0.4619678995115143,0.5380321004884857
E01014038,1408,678,730,0.4815340909090909,0.5184659090909091
E01014039,1647,804,843,0.48816029143898,0.51183970856102
E01014040,1553,741,812,0.4771410173857051,0.5228589826142949
E01014018,1521,754,767,0.49572649572649574,0.5042735042735043
E01014019,1522,740,782,0.48620236530880423,0.5137976346911958
E01014020,1590,791,799,0.49748427672955975,0.5025157232704403
E01014021,1426,711,715,0.49859747545582045,0.5014025245441796
E01014026,2050,1041,1009,0.5078048780487805,0.4921951219512195
E01014059,1918,958,960,0.4994786235662148,0.5005213764337852
E01014060,1565,768,797,0.4907348242811502,0.5092651757188499
E01014069,1820,872,948,0.47912087912087914,0.5208791208791209
E01014098,1676,845,831,0.5041766109785203,0.4958233890214797
E01014099,1828,894,934,0.4890590809628009,0.5109409190371991
E01014061,1852,885,967,0.47786177105831534,0.5221382289416847
E01014062,1756,860,896,0.489749430523918,0.510250569476082
E01014063,1743,822,921,0.47160068846815834,0.5283993115318416
E01014064,1579,762,817,0.4825839138695377,0.5174160861304623
E01014065,1476,700,776,0.4742547425474255,0.5257452574525745
E01014066,1203,602,601,0.5004156275976724,0.4995843724023275
E01014067,1379,656,723,0.4757070340826686,0.5242929659173314
E01014031,1585,786,799,0.49589905362776027,0.5041009463722398
E01014032,1507,743,764,0.4930325149303251,0.5069674850696748
E01014049,1553,769,784,0.4951706374758532,0.5048293625241468
E01014050,1805,905,900,0.5013850415512465,0.4986149584487535
E01014053,1784,851,933,0.47701793721973096,0.522982062780269
E01014057,1899,911,988,0.47972617166929965,0.5202738283307003
E01014058,1628,810,818,0.4975429975429975,0.5024570024570024
E01014171,1410,650,760,0.46099290780141844,0.5390070921985816
E01014172,1340,654,686,0.4880597014925373,0.5119402985074627
E01014173,1722,786,936,0.4564459930313589,0.5435540069686411
E01014174,1592,784,808,0.49246231155778897,0.507537688442211
E01014112,1804,884,920,0.49002217294900224,0.5099778270509978
E01014131,2545,1196,1349,0.46994106090373283,0.5300589390962672
E01014132,1068,532,536,0.49812734082397003,0.50187265917603
E01014135,1249,645,604,0.5164131305044035,0.4835868694955965
E01014175,1602,779,823,0.48626716604244696,0.5137328339575531
E01014176,1533,706,827,0.46053489889106325,0.5394651011089368
E01014177,2091,979,1112,0.4681970349115256,0.5318029650884745
E01014178,1768,867,901,0.49038461538461536,0.5096153846153846
E01014111,1575,779,796,0.4946031746031746,0.5053968253968254
E01014167,2186,1062,1124,0.48581884720951507,0.5141811527904849
E01014168,1347,676,671,0.5018559762435041,0.4981440237564959
E01014170,1457,703,754,0.48249828414550444,0.5175017158544956
E01014125,1429,747,682,0.5227431770468859,0.47725682295311406
E01014126,1515,757,758,0.4996699669966997,0.5003300330033004
E01014127,1742,842,900,0.4833524684270953,0.5166475315729047
E01014128,2397,1168,1229,0.48727576136837714,0.5127242386316229
E01014169,1876,918,958,0.48933901918976547,0.5106609808102346
E01014129,1094,547,547,0.5,0.5
E01014130,1489,721,768,0.4842175957018133,0.5157824042981867
E01014179,1191,557,634,0.46767422334172964,0.5323257766582704
E01014180,1311,623,688,0.475209763539283,0.524790236460717
E01014189,1402,682,720,0.4864479315263909,0.5135520684736091
E01014190,1515,732,783,0.48316831683168315,0.5168316831683168
E01014102,1914,920,994,0.48066875653082547,0.5193312434691745
E01014103,1177,577,600,0.49022939677145283,0.5097706032285472
E01014138,1673,780,893,0.46622833233711897,0.5337716676628811
E01014140,1410,709,701,0.5028368794326241,0.4971631205673759
E01014205,1325,659,666,0.49735849056603776,0.5026415094339622
E01014206,1309,653,656,0.4988540870893812,0.5011459129106188
E01014207,1294,652,642,0.5038639876352395,0.49613601236476046
E01014208,1354,666,688,0.4918759231905465,0.5081240768094535
E01014209,1498,736,762,0.49132176234979974,0.5086782376502003
E01014137,2097,1028,1069,0.4902241297091082,0.5097758702908918
E01014139,1409,715,694,0.5074520936834634,0.49254790631653655
E01014142,1375,710,665,0.5163636363636364,0.48363636363636364
E01014143,1654,834,820,0.5042321644498187,0.4957678355501814
E01035073,1524,772,752,0.5065616797900262,0.49343832020997375
E01035074,1951,1018,933,0.521783700666325,0.47821629933367504
E01035075,1149,581,568,0.5056570931244561,0.49434290687554394
E01014136,1808,872,936,0.4823008849557522,0.5176991150442478
E01014148,1475,761,714,0.5159322033898305,0.48406779661016947
E01014149,1117,538,579,0.4816472694717995,0.5183527305282005
E01014202,2753,1370,1383,0.497638939338903,0.502361060661097
E01014203,1615,832,783,0.5151702786377709,0.4848297213622291
E01014204,1977,972,1005,0.49165402124430957,0.5083459787556904
E01014104,1747,863,884,0.4939896966227819,0.5060103033772181
E01014105,2369,1120,1249,0.47277332207682565,0.5272266779231743
E01014113,1795,959,836,0.5342618384401114,0.46573816155988856
E01014114,1411,708,703,0.5017717930545712,0.4982282069454288
E01014133,2192,1093,1099,0.49863138686131386,0.5013686131386861
E01014134,1545,722,823,0.4673139158576052,0.5326860841423948
E01014144,1831,916,915,0.5002730748225014,0.4997269251774986
E01014145,2001,1045,956,0.5222388805597201,0.4777611194402799
E01014185,1662,782,880,0.470517448856799,0.529482551143201
E01014186,1367,652,715,0.4769568397951719,0.5230431602048281
E01014187,1450,713,737,0.4917241379310345,0.5082758620689655
E01014188,1374,686,688,0.4992721979621543,0.5007278020378457
E01014150,1595,826,769,0.5178683385579937,0.48213166144200625
E01014151,1406,688,718,0.48933143669985774,0.5106685633001422
E01014152,1919,927,992,0.48306409588327254,0.5169359041167274
E01014153,1923,994,929,0.516900676027041,0.4830993239729589
E01014154,1721,862,859,0.5008715862870424,0.4991284137129576
E01014155,1901,899,1002,0.47290899526564967,0.5270910047343503
E01014181,2320,1132,1188,0.4879310344827586,0.5120689655172413
E01014182,1450,716,734,0.49379310344827587,0.5062068965517241
E01014183,2023,1034,989,0.5111220958971824,0.4888779041028176
E01014184,2251,1090,1161,0.4842292314526877,0.5157707685473123
E01014124,1545,757,788,0.4899676375404531,0.510032362459547
E01014163,2088,1026,1062,0.49137931034482757,0.5086206896551724
E01014164,1688,804,884,0.476303317535545,0.523696682464455
E01014165,1491,759,732,0.5090543259557344,0.4909456740442656
E01014166,1522,735,787,0.48291721419185285,0.5170827858081471
E01014191,1732,892,840,0.5150115473441108,0.48498845265588914
E01014192,1502,807,695,0.53728362183755,0.4627163781624501
E01014193,1679,848,831,0.5050625372245384,0.4949374627754616
E01014194,1603,804,799,0.5015595757953837,0.4984404242046163
E01014195,1413,685,728,0.4847841472045294,0.5152158527954707
E01014196,1513,723,790,0.47785855915399866,0.5221414408460013
E01014119,1570,792,778,0.5044585987261146,0.49554140127388535
E01014120,1750,867,883,0.49542857142857144,0.5045714285714286
E01014121,1301,669,632,0.5142198308993082,0.48578016910069177
E01014122,1539,781,758,0.5074723846653671,0.49252761533463285
E01014123,1422,684,738,0.4810126582278481,0.5189873417721519
E01014106,1479,765,714,0.5172413793103449,0.4827586206896552
E01014107,1139,571,568,0.5013169446883231,0.4986830553116769
E01014108,1485,751,734,0.5057239057239057,0.49427609427609426
E01014109,1259,601,658,0.47736298649722003,0.52263701350278
E01014110,1768,859,909,0.4858597285067873,0.5141402714932126
E01014197,1931,938,993,0.4857586742620404,0.5142413257379596
E01014198,1423,666,757,0.4680252986647927,0.5319747013352073
E01014199,1639,752,887,0.4588163514338011,0.5411836485661989
E01014200,1363,654,709,0.4798239178283199,0.5201760821716801
E01014201,1241,614,627,0.49476228847703463,0.5052377115229654
E01014159,1241,600,641,0.48348106365834004,0.5165189363416599
E01014160,1217,576,641,0.4732949876746097,0.5267050123253904
E01014161,1055,524,531,0.4966824644549763,0.5033175355450237
E01014162,1809,901,908,0.498065229408513,0.5019347705914871
E01014115,1512,746,766,0.4933862433862434,0.5066137566137566
E01014116,1750,829,921,0.4737142857142857,0.5262857142857142
E01014117,1192,577,615,0.48406040268456374,0.5159395973154363
E01014118,1398,686,712,0.4907010014306152,0.5092989985693849
E01014157,1389,678,711,0.48812095032397407,0.5118790496760259
E01014158,1935,915,1020,0.4728682170542636,0.5271317829457365
E01035076,1964,1019,945,0.5188391038696538,0.48116089613034624
E01035077,1333,653,680,0.4898724681170293,0.5101275318829708
E01035078,1736,848,888,0.48847926267281105,0.511520737327189
E01035079,1429,698,731,0.48845346396081174,0.5115465360391882
E01035080,1432,696,736,0.4860335195530726,0.5139664804469274
E01035081,1500,751,749,0.5006666666666667,0.49933333333333335
E01035082,1874,929,945,0.4957310565635005,0.5042689434364994
E01035083,2323,1140,1183,0.4907447266465777,0.5092552733534222
E01014257,1476,728,748,0.4932249322493225,0.5067750677506775
E01014258,1505,749,756,0.49767441860465117,0.5023255813953489
E01014259,1547,721,826,0.4660633484162896,0.5339366515837104
E01014260,1397,660,737,0.47244094488188976,0.5275590551181102
E01014264,1919,932,987,0.4856696195935383,0.5143303804064617
E01014357,1548,735,813,0.4748062015503876,0.5251937984496124
E01014358,1329,622,707,0.4680210684725357,0.5319789315274642
E01014359,1871,951,920,0.5082843399251737,0.4917156600748263
E01014360,2806,1373,1433,0.48930862437633643,0.5106913756236636
E01014261,1620,804,816,0.4962962962962963,0.5037037037037037
E01014262,1336,652,684,0.4880239520958084,0.5119760479041916
E01014263,1672,803,869,0.48026315789473684,0.5197368421052632
E01014333,1390,674,716,0.4848920863309353,0.5151079136690647
E01014334,1328,601,727,0.45256024096385544,0.5474397590361446
E01014331,1586,800,786,0.5044136191677175,0.49558638083228246
E01014332,1615,768,847,0.47554179566563465,0.5244582043343653
E01014335,1717,809,908,0.4711706464764123,0.5288293535235876
E01014336,1665,839,826,0.5039039039039039,0.4960960960960961
E01014337,1728,834,894,0.4826388888888889,0.5173611111111112
E01014354,1799,888,911,0.4936075597554197,0.5063924402445803
E01014355,2046,1043,1003,0.5097751710654936,0.49022482893450636
E01014356,1842,934,908,0.507057546145494,0.49294245385450597
E01014361,1770,923,847,0.5214689265536723,0.47853107344632767
E01014241,1569,786,783,0.5009560229445507,0.49904397705544934
E01014242,1546,734,812,0.47477360931435963,0.5252263906856404
E01014243,1423,720,703,0.5059732958538299,0.49402670414617006
E01014244,1685,817,868,0.48486646884273,0.51513353115727
E01014245,1652,828,824,0.5012106537530266,0.49878934624697335
E01014248,1361,683,678,0.5018368846436444,0.4981631153563556
E01014214,1481,729,752,0.4922349763673194,0.5077650236326806
E01014215,1496,724,772,0.4839572192513369,0.516042780748663
E01014216,1342,670,672,0.4992548435171386,0.5007451564828614
E01014265,1485,729,756,0.4909090909090909,0.509090909090909
E01014267,2329,1166,1163,0.5006440532417347,0.49935594675826533
E01014272,1440,656,784,0.45555555555555555,0.5444444444444444
E01014246,1612,826,786,0.5124069478908189,0.48759305210918114
E01014266,1235,573,662,0.46396761133603237,0.5360323886639676
E01014268,2565,1261,1304,0.4916179337231969,0.5083820662768032
E01014270,1521,736,785,0.4838921761998685,0.5161078238001315
E01014271,1527,734,793,0.48068107400130977,0.5193189259986902
E01014247,1608,828,780,0.5149253731343284,0.48507462686567165
E01014250,1286,648,638,0.5038880248833593,0.49611197511664074
E01014252,1581,821,760,0.519291587602783,0.48070841239721696
E01014255,1952,990,962,0.507172131147541,0.492827868852459
E01034052,1174,604,570,0.514480408858603,0.4855195911413969
E01034053,1441,702,739,0.4871616932685635,0.5128383067314365
E01014269,1657,804,853,0.4852142426071213,0.5147857573928787
E01014324,1424,717,707,0.5035112359550562,0.4964887640449438
E01014325,1280,651,629,0.50859375,0.49140625
E01014326,1362,682,680,0.5007342143906021,0.49926578560939794
E01014249,1780,939,841,0.5275280898876404,0.47247191011235956
E01014253,1593,793,800,0.4978028876333961,0.5021971123666039
E01014254,1904,1020,884,0.5357142857142857,0.4642857142857143
E01014256,2016,1025,991,0.5084325396825397,0.4915674603174603
E01014210,1549,761,788,0.49128469980632666,0.5087153001936734
E01014211,1599,744,855,0.4652908067542214,0.5347091932457786
E01014212,1956,928,1028,0.47443762781186094,0.5255623721881391
E01014213,1322,647,675,0.48940998487140697,0.510590015128593
E01014217,1452,700,752,0.4820936639118457,0.5179063360881543
E01014323,1295,650,645,0.5019305019305019,0.4980694980694981
E01014327,1421,705,716,0.49612948627726955,0.5038705137227305
E01014328,1486,759,727,0.5107671601615074,0.4892328398384926
E01014329,1555,773,782,0.49710610932475885,0.5028938906752412
E01014330,1334,730,604,0.5472263868065967,0.4527736131934033
E01014218,1650,811,839,0.4915151515151515,0.5084848484848485
E01014219,1267,624,643,0.4925019731649566,0.5074980268350434
E01014225,1489,728,761,0.4889187374076561,0.5110812625923439
E01014226,1450,637,813,0.4393103448275862,0.5606896551724138
E01014228,1217,609,608,0.5004108463434676,0.49958915365653245
E01014230,1577,800,777,0.507292327203551,0.49270767279644895
E01014281,2101,1146,955,0.5454545454545454,0.45454545454545453
E01014285,2393,1236,1157,0.5165064772252402,0.4834935227747597
E01014286,1717,916,801,0.5334886429819452,0.46651135701805474
E01014287,2131,1169,962,0.5485687470671047,0.4514312529328954
E01014282,1581,957,624,0.6053130929791272,0.3946869070208729
E01014283,1988,1172,816,0.5895372233400402,0.4104627766599598
E01014284,1367,798,569,0.5837600585223116,0.4162399414776884
E01034054,1088,561,527,0.515625,0.484375
E01034055,1294,735,559,0.5680061823802164,0.4319938176197836
E01034056,1546,762,784,0.49288486416558863,0.5071151358344114
E01034057,1468,749,719,0.5102179836512262,0.48978201634877383
E01014220,1724,832,892,0.48259860788863107,0.5174013921113689
E01014221,1660,775,885,0.46686746987951805,0.5331325301204819
E01014222,1575,731,844,0.4641269841269841,0.5358730158730158
E01014223,1779,923,856,0.5188308038223721,0.4811691961776279
E01014224,1700,801,899,0.4711764705882353,0.5288235294117647
E01014229,2011,942,1069,0.4684236698160119,0.5315763301839881
E01014288,1548,783,765,0.5058139534883721,0.4941860465116279
E01014289,1525,747,778,0.4898360655737705,0.5101639344262295
E01014290,1462,725,737,0.49589603283173733,0.5041039671682627
E01014291,2070,1039,1031,0.5019323671497584,0.4980676328502415
E01014292,1507,755,752,0.5009953550099535,0.49900464499004643
E01014294,1384,671,713,0.4848265895953757,0.5151734104046243
E01014293,1585,833,752,0.5255520504731861,0.4744479495268139
E01014295,1669,829,840,0.49670461354104256,0.5032953864589574
E01014339,1897,963,934,0.5076436478650501,0.49235635213494994
E01014340,2149,1052,1097,0.4895300139599814,0.5104699860400186
E01014345,2143,1208,935,0.5636957536164255,0.4363042463835744
E01014274,1772,817,955,0.46106094808126413,0.5389390519187359
E01014275,1446,687,759,0.475103734439834,0.524896265560166
E01014276,1510,739,771,0.48940397350993375,0.5105960264900662
E01014277,1437,720,717,0.5010438413361169,0.4989561586638831
E01014279,1791,922,869,0.5147962032384142,0.4852037967615857
E01014338,1421,715,706,0.5031667839549613,0.4968332160450387
E01014341,1780,892,888,0.501123595505618,0.49887640449438203
E01014342,1548,766,782,0.49483204134366926,0.5051679586563308
E01014343,1787,937,850,0.5243424734191382,0.4756575265808618
E01014344,1577,752,825,0.476854787571338,0.523145212428662
E01014363,1296,641,655,0.49459876543209874,0.5054012345679012
E01014364,1537,748,789,0.4866623292127521,0.5133376707872479
E01014365,1485,747,738,0.503030303030303,0.49696969696969695
E01014369,1826,899,927,0.4923329682365827,0.5076670317634173
E01014299,1343,668,675,0.4973938942665674,0.5026061057334326
E01014301,1653,822,831,0.49727767695099817,0.5027223230490018
E01014303,1414,695,719,0.4915134370579915,0.5084865629420084
E01014304,1455,724,731,0.49759450171821307,0.5024054982817869
E01014362,1282,628,654,0.48985959438377535,0.5101404056162246
E01014233,1391,681,710,0.4895758447160316,0.5104241552839683
E01014234,1556,727,829,0.4672236503856041,0.5327763496143959
E01014239,1479,702,777,0.4746450304259635,0.5253549695740365
E01014240,1544,749,795,0.4851036269430052,0.5148963730569949
E01014308,1531,749,782,0.4892227302416721,0.5107772697583279
E01014309,1231,594,637,0.4825345247766044,0.5174654752233956
E01014311,1302,635,667,0.4877112135176651,0.5122887864823349
E01014313,1502,706,796,0.47003994673768307,0.5299600532623169
E01014321,1353,666,687,0.49223946784922396,0.5077605321507761
E01014366,1865,957,908,0.5131367292225201,0.4868632707774799
E01014367,1805,879,926,0.48698060941828253,0.5130193905817174
E01014368,1752,886,866,0.5057077625570776,0.4942922374429224
E01014305,1616,807,809,0.4993811881188119,0.5006188118811881
E01014306,1518,745,773,0.49077733860342554,0.5092226613965745
E01014307,1570,790,780,0.5031847133757962,0.4968152866242038
E01014312,1415,703,712,0.49681978798586574,0.5031802120141343
E01014346,1528,731,797,0.47840314136125656,0.5215968586387435
E01014348,1430,663,767,0.4636363636363636,0.5363636363636364
E01014349,1368,673,695,0.4919590643274854,0.5080409356725146
E01014353,1681,818,863,0.4866151100535396,0.5133848899464605
E01014310,2105,1031,1074,0.4897862232779097,0.5102137767220902
E01014314,1412,711,701,0.5035410764872521,0.4964589235127479
E01014316,1722,817,905,0.47444831591173053,0.5255516840882695
E01014317,1634,731,903,0.4473684210526316,0.5526315789473685
E01014322,1723,856,867,0.4968078932095183,0.5031921067904818
E01014235,1631,804,827,0.49294911097486205,0.507050889025138
E01014237,1677,824,853,0.4913536076326774,0.5086463923673226
E01014238,1627,817,810,0.5021511985248924,0.49784880147510757
E01034058,1737,880,857,0.5066206102475532,0.4933793897524468
E01034059,2031,1015,1016,0.499753815854259,0.5002461841457411
E01014315,1273,607,666,0.47682639434406915,0.5231736056559309
E01014318,1364,687,677,0.5036656891495601,0.4963343108504399
E01014319,1445,703,742,0.4865051903114187,0.5134948096885813
E01014320,1230,606,624,0.4926829268292683,0.5073170731707317
E01014347,1360,672,688,0.49411764705882355,0.5058823529411764
E01014350,1326,652,674,0.4917043740573152,0.5082956259426847
E01014351,1434,699,735,0.4874476987447699,0.5125523012552301
E01014352,1350,667,683,0.49407407407407405,0.5059259259259259
E01014273,1264,671,593,0.5308544303797469,0.46914556962025317
E01014278,1205,591,614,0.4904564315352697,0.5095435684647303
E01014280,1196,601,595,0.5025083612040134,0.4974916387959866
E01014296,1374,697,677,0.507278020378457,0.49272197962154296
E01014297,1135,556,579,0.48986784140969164,0.5101321585903084
E01014298,1559,767,792,0.4919820397690827,0.5080179602309173
E01014300,1428,683,745,0.47829131652661067,0.5217086834733894
E01014302,1818,898,920,0.49394939493949397,0.506050605060506
E01028853,1363,675,688,0.49523110785033014,0.5047688921496698
E01028854,1398,680,718,0.4864091559370529,0.5135908440629471
E01028855,2798,1382,1416,0.49392423159399573,0.5060757684060043
E01028856,1607,785,822,0.4884878655880523,0.5115121344119478
E01035069,1520,762,758,0.5013157894736842,0.4986842105263158
E01035070,1773,848,925,0.47828539199097575,0.5217146080090242
E01028826,1801,868,933,0.4819544697390339,0.5180455302609661
E01028827,1513,707,806,0.46728354263053534,0.5327164573694646
E01028844,2689,1994,695,0.7415396058014132,0.25846039419858685
E01028845,1931,919,1012,0.47591921284308647,0.5240807871569135
E01028838,1645,801,844,0.4869300911854103,0.5130699088145897
E01028839,1412,690,722,0.4886685552407932,0.5113314447592068
E01028840,1422,704,718,0.49507735583684953,0.5049226441631505
E01028841,1499,702,797,0.4683122081387592,0.5316877918612408
E01028850,2460,1212,1248,0.4926829268292683,0.5073170731707317
E01028851,1827,819,1008,0.4482758620689655,0.5517241379310345
E01028852,1609,758,851,0.47110006215040395,0.528899937849596
E01028830,1416,647,769,0.4569209039548023,0.5430790960451978
E01028831,1519,724,795,0.47662936142198814,0.5233706385780118
E01028836,1401,664,737,0.4739471805852962,0.5260528194147038
E01028837,1324,651,673,0.4916918429003021,0.5083081570996979
E01028832,1592,793,799,0.4981155778894472,0.5018844221105527
E01028833,1412,671,741,0.4752124645892351,0.5247875354107648
E01028834,1627,819,808,0.503380454824831,0.49661954517516904
E01028835,1563,795,768,0.508637236084453,0.491362763915547
E01028828,1700,861,839,0.5064705882352941,0.4935294117647059
E01028829,1253,610,643,0.4868316041500399,0.5131683958499601
E01028842,1737,858,879,0.4939550949913644,0.5060449050086355
E01028847,1480,733,747,0.49527027027027026,0.5047297297297297
E01028859,1708,847,861,0.4959016393442623,0.5040983606557377
E01028843,1703,817,886,0.47974163241338813,0.5202583675866118
E01028846,2326,1157,1169,0.49742046431642306,0.5025795356835769
E01028848,1787,884,903,0.49468382764409624,0.5053161723559038
E01028849,1945,958,987,0.49254498714652956,0.5074550128534704
E01028858,2148,1092,1056,0.5083798882681564,0.49162011173184356
E01028891,1654,822,832,0.4969770253929867,0.5030229746070133
E01028892,1807,873,934,0.4831211953514112,0.5168788046485888
E01028894,1365,690,675,0.5054945054945055,0.4945054945054945
E01028895,1689,830,859,0.49141503848431023,0.5085849615156898
E01028896,2135,1019,1116,0.4772833723653396,0.5227166276346604
E01028897,1491,723,768,0.48490945674044267,0.5150905432595574
E01028880,1712,817,895,0.4772196261682243,0.5227803738317757
E01028881,1348,667,681,0.4948071216617211,0.505192878338279
E01028882,1630,813,817,0.49877300613496933,0.5012269938650307
E01028893,1609,780,829,0.4847731510254817,0.5152268489745183
E01028899,1852,898,954,0.48488120950323976,0.5151187904967602
E01028864,1510,768,742,0.5086092715231788,0.4913907284768212
E01028865,1823,872,951,0.47833241908941304,0.521667580910587
E01028866,1396,695,701,0.4978510028653295,0.5021489971346705
E01028867,1756,868,888,0.49430523917995445,0.5056947608200456
E01028872,1584,794,790,0.5012626262626263,0.49873737373737376
E01028873,2206,1086,1120,0.49229374433363554,0.5077062556663645
E01028874,1528,794,734,0.5196335078534031,0.4803664921465969
E01028875,2717,1349,1368,0.4965034965034965,0.5034965034965035
E01028876,1803,866,937,0.4803105934553522,0.5196894065446478
E01028877,1267,614,653,0.4846093133385951,0.5153906866614049
E01028878,1518,749,769,0.49341238471673254,0.5065876152832675
E01028879,1548,777,771,0.501937984496124,0.49806201550387597
E01028886,1682,821,861,0.4881093935790725,0.5118906064209274
E01028887,1648,780,868,0.4733009708737864,0.5266990291262136
E01028889,1624,853,771,0.5252463054187192,0.4747536945812808
E01028890,1328,669,659,0.5037650602409639,0.49623493975903615
E01028868,1425,705,720,0.49473684210526314,0.5052631578947369
E01028869,1731,861,870,0.49740034662045063,0.5025996533795494
E01028871,1384,668,716,0.48265895953757226,0.5173410404624278
E01035057,1438,925,513,0.6432545201668984,0.3567454798331015
E01035058,1766,1226,540,0.6942242355605889,0.3057757644394111
E01028860,2333,1105,1228,0.473639091298757,0.5263609087012431
E01028862,1760,880,880,0.5,0.5
E01028863,1369,677,692,0.49452154857560265,0.5054784514243974
E01028888,1745,889,856,0.5094555873925501,0.49054441260744985
E01028898,1560,789,771,0.5057692307692307,0.49423076923076925
E01028861,1441,708,733,0.4913254684247051,0.508674531575295
E01028870,1469,731,738,0.49761742682096666,0.5023825731790333
E01028883,1650,856,794,0.5187878787878788,0.4812121212121212
E01028884,1503,720,783,0.47904191616766467,0.5209580838323353
E01028910,1392,668,724,0.47988505747126436,0.5201149425287356
E01028911,1269,625,644,0.4925137903861308,0.5074862096138691
E01028912,1455,687,768,0.47216494845360824,0.5278350515463918
E01028920,1256,598,658,0.47611464968152867,0.5238853503184714
E01028921,1841,901,940,0.48940793047256925,0.5105920695274307
E01028925,1447,625,822,0.43192812715964063,0.5680718728403593
E01028926,1381,651,730,0.4713975380159305,0.5286024619840695
E01028902,1243,585,658,0.47063555913113436,0.5293644408688657
E01028903,1209,546,663,0.45161290322580644,0.5483870967741935
E01028904,1708,807,901,0.4724824355971897,0.5275175644028103
E01028905,1978,952,1026,0.48129423660262893,0.5187057633973711
E01028909,1424,671,753,0.47120786516853935,0.5287921348314607
E01033528,2354,1130,1224,0.4800339847068819,0.5199660152931181
E01028906,1325,708,617,0.5343396226415095,0.4656603773584906
E01028907,1862,951,911,0.5107411385606875,0.4892588614393126
E01028908,1509,740,769,0.49039098740888004,0.5096090125911199
E01028916,1472,703,769,0.47758152173913043,0.5224184782608695
E01028917,1424,692,732,0.4859550561797753,0.5140449438202247
E01028924,1976,948,1028,0.4797570850202429,0.520242914979757
E01028913,1671,828,843,0.4955116696588869,0.5044883303411131
E01028918,1601,817,784,0.5103060587133041,0.4896939412866958
E01028919,1264,649,615,0.5134493670886076,0.4865506329113924
E01028927,1174,566,608,0.48211243611584326,0.5178875638841567
E01028928,1665,791,874,0.47507507507507507,0.5249249249249249
E01028914,1048,528,520,0.5038167938931297,0.4961832061068702
E01028915,1552,759,793,0.4890463917525773,0.5109536082474226
E01028922,1252,623,629,0.4976038338658147,0.5023961661341853
E01028923,1600,797,803,0.498125,0.501875
E01028929,1362,652,710,0.4787077826725404,0.5212922173274597
E01028969,1534,745,789,0.48565840938722293,0.5143415906127771
E01028970,1497,711,786,0.4749498997995992,0.5250501002004008
E01028971,2322,1132,1190,0.48751076658053405,0.512489233419466
E01028978,1931,1019,912,0.5277058518902124,0.47229414810978765
E01028979,1164,564,600,0.4845360824742268,0.5154639175257731
E01028933,1494,768,726,0.5140562248995983,0.4859437751004016
E01028934,1624,825,799,0.5080049261083743,0.4919950738916256
E01028956,1516,754,762,0.4973614775725594,0.5026385224274407
E01028957,1831,796,1035,0.4347351174221737,0.5652648825778264
E01028958,1720,858,862,0.49883720930232556,0.5011627906976744
E01028981,1780,859,921,0.48258426966292134,0.5174157303370787
E01028982,1612,791,821,0.49069478908188585,0.5093052109181141
E01028983,1981,983,998,0.4962140333165068,0.5037859666834932
E01035059,2060,1118,942,0.5427184466019418,0.45728155339805826
E01035060,1660,904,756,0.5445783132530121,0.45542168674698796
E01028930,1813,870,943,0.4798676227247656,0.5201323772752344
E01028931,2185,1072,1113,0.49061784897025174,0.5093821510297483
E01028944,1970,1012,958,0.5137055837563452,0.4862944162436548
E01028945,1987,932,1055,0.46904881731253145,0.5309511826874685
E01028965,1318,622,696,0.47192716236722304,0.5280728376327769
E01028966,1271,651,620,0.5121951219512195,0.4878048780487805
E01028967,1499,738,761,0.4923282188125417,0.5076717811874583
E01028968,1369,656,713,0.47918188458729,0.5208181154127101
E01028988,1615,783,832,0.4848297213622291,0.5151702786377709
E01028989,1582,784,798,0.49557522123893805,0.504424778761062
E01028972,1922,943,979,0.4906347554630593,0.5093652445369407
E01028973,1952,968,984,0.4959016393442623,0.5040983606557377
E01035061,1052,583,469,0.5541825095057035,0.4458174904942966
E01035062,1362,657,705,0.48237885462555063,0.5176211453744494
E01035063,1188,606,582,0.51010101010101,0.4898989898989899
E01035064,1009,471,538,0.466798810703667,0.533201189296333
E01028942,1626,810,816,0.4981549815498155,0.5018450184501845
E01028943,2152,1062,1090,0.49349442379182157,0.5065055762081785
E01028951,2027,999,1028,0.49284657128761716,0.5071534287123828
E01028953,1562,762,800,0.4878361075544174,0.5121638924455826
E01035065,1462,680,782,0.46511627906976744,0.5348837209302325
E01035066,1833,876,957,0.4779050736497545,0.5220949263502455
E01028947,1712,814,898,0.47546728971962615,0.5245327102803738
E01028948,1380,664,716,0.4811594202898551,0.518840579710145
E01028949,1508,746,762,0.4946949602122016,0.5053050397877984
E01028985,1262,574,688,0.4548335974643423,0.5451664025356577
E01028938,1537,718,819,0.4671437865972674,0.5328562134027326
E01028939,1567,792,775,0.5054243777919591,0.49457562220804085
E01028984,1296,597,699,0.46064814814814814,0.5393518518518519
E01028986,2173,1057,1116,0.4864242982052462,0.5135757017947538
E01028940,1554,722,832,0.4646074646074646,0.5353925353925354
E01028952,1590,754,836,0.4742138364779874,0.5257861635220126
E01028962,1573,793,780,0.5041322314049587,0.49586776859504134
E01028963,1598,767,831,0.4799749687108886,0.5200250312891114
E01028964,1909,900,1009,0.4714510214772132,0.5285489785227868
E01028974,1746,948,798,0.5429553264604811,0.4570446735395189
E01028935,1589,782,807,0.4921334172435494,0.5078665827564506
E01028936,2196,1094,1102,0.4981785063752277,0.5018214936247724
E01028937,1433,683,750,0.47662247034194,0.5233775296580601
E01035067,1641,814,827,0.4960390006093845,0.5039609993906154
E01035068,1562,772,790,0.4942381562099872,0.5057618437900128
E01028954,1301,635,666,0.4880860876249039,0.5119139123750961
E01028955,1257,606,651,0.4821002386634845,0.5178997613365155
E01028975,1979,961,1018,0.48559878726629613,0.5144012127337039
E01028976,1706,827,879,0.4847596717467761,0.515240328253224
E01028977,1991,964,1027,0.48417880462079355,0.5158211953792065
E01028950,2622,1263,1359,0.4816933638443936,0.5183066361556065
E01028960,1491,737,754,0.494299128101945,0.505700871898055
E01028961,1486,718,768,0.4831763122476447,0.5168236877523553
E01028980,2182,1081,1101,0.49541704857928504,0.504582951420715
E01028992,1501,725,776,0.4830113257828115,0.5169886742171885
E01033530,1899,963,936,0.5071090047393365,0.4928909952606635
E01035071,2250,1118,1132,0.4968888888888889,0.5031111111111111
E01028990,1159,579,580,0.4995685936151855,0.5004314063848145
E01028997,2344,1101,1243,0.4697098976109215,0.5302901023890785
E01028998,2249,1054,1195,0.46865273454868833,0.5313472654513117
E01028993,1490,719,771,0.4825503355704698,0.5174496644295302
E01029013,1691,844,847,0.4991129509166174,0.5008870490833827
E01029014,1180,568,612,0.48135593220338985,0.5186440677966102
E01035072,2356,1168,1188,0.49575551782682514,0.5042444821731749
E01028994,1231,600,631,0.487408610885459,0.512591389114541
E01029003,2199,1098,1101,0.49931787175989084,0.5006821282401092
E01029005,1208,595,613,0.4925496688741722,0.5074503311258278
E01029016,1468,727,741,0.4952316076294278,0.5047683923705722
E01029006,1521,684,837,0.44970414201183434,0.5502958579881657
E01029007,1130,532,598,0.47079646017699117,0.5292035398230088
E01029009,1230,641,589,0.5211382113821138,0.4788617886178862
E01029010,1271,599,672,0.47128245476003144,0.5287175452399685
E01029011,1363,656,707,0.4812912692589875,0.5187087307410124
E01029012,1901,922,979,0.4850078905839032,0.5149921094160967
E01033526,1046,503,543,0.4808795411089866,0.5191204588910134
E01033527,1255,570,685,0.4541832669322709,0.545816733067729
E01028995,1445,718,727,0.49688581314878894,0.5031141868512111
E01028996,1287,631,656,0.4902874902874903,0.5097125097125097
E01028999,1527,780,747,0.5108055009823183,0.48919449901768175
E01029000,1157,590,567,0.5099394987035436,0.49006050129645634
E01029001,2093,1036,1057,0.49498327759197325,0.5050167224080268
E01029002,1408,703,705,0.4992897727272727,0.5007102272727273
E01029368,1201,584,617,0.48626144879267275,0.5137385512073273
E01029369,1203,593,610,0.4929343308395677,0.5070656691604323
E01029370,1372,670,702,0.48833819241982507,0.5116618075801749
E01029371,1489,758,731,0.5090664875755541,0.49093351242444594
E01029402,2140,1044,1096,0.48785046728971965,0.5121495327102804
E01029372,1329,650,679,0.4890895410082769,0.510910458991723
E01029373,2284,1138,1146,0.4982486865148862,0.5017513134851138
E01029401,1528,713,815,0.4666230366492147,0.5333769633507853
E01029403,1385,688,697,0.4967509025270758,0.5032490974729242
E01029404,1660,824,836,0.4963855421686747,0.5036144578313253
E01029345,2003,977,1026,0.48776834747878184,0.5122316525212182
E01029346,1772,832,940,0.46952595936794583,0.5304740406320542
E01029347,1506,747,759,0.4960159362549801,0.5039840637450199
E01029348,1740,867,873,0.4982758620689655,0.5017241379310344
E01029374,2265,1123,1142,0.4958057395143488,0.5041942604856512
E01029383,1900,952,948,0.5010526315789474,0.49894736842105264
E01029385,1555,773,782,0.49710610932475885,0.5028938906752412
E01029388,1370,680,690,0.49635036496350365,0.5036496350364964
E01029390,1044,511,533,0.48946360153256707,0.5105363984674329
E01029386,1432,703,729,0.4909217877094972,0.5090782122905028
E01029387,1445,699,746,0.48373702422145326,0.5162629757785467
E01029389,1658,834,824,0.503015681544029,0.4969843184559711
E01034097,1162,580,582,0.4991394148020654,0.5008605851979346
E01034098,2356,1174,1182,0.49830220713073003,0.50169779286927
E01029379,1745,862,883,0.49398280802292266,0.5060171919770774
E01029398,1635,817,818,0.4996941896024465,0.5003058103975535
E01029399,1430,712,718,0.4979020979020979,0.5020979020979021
E01029400,1651,800,851,0.48455481526347666,0.5154451847365233
E01029354,1472,718,754,0.48777173913043476,0.5122282608695652
E01029355,1404,694,710,0.4943019943019943,0.5056980056980057
E01029356,1454,728,726,0.5006877579092159,0.49931224209078406
E01029357,1671,788,883,0.471573907839617,0.528426092160383
E01029358,1340,639,701,0.47686567164179106,0.5231343283582089
E01029349,1375,655,720,0.4763636363636364,0.5236363636363637
E01029350,1506,748,758,0.49667994687915007,0.5033200531208499
E01029351,1572,745,827,0.47391857506361323,0.5260814249363868
E01029352,1284,634,650,0.4937694704049844,0.5062305295950156
E01029393,1572,767,805,0.48791348600508905,0.5120865139949109
E01029380,1449,723,726,0.4989648033126294,0.5010351966873706
E01029381,1419,695,724,0.4897815362931642,0.5102184637068358
E01029382,1666,851,815,0.5108043217286915,0.4891956782713085
E01029391,1698,827,871,0.4870435806831567,0.5129564193168433
E01029392,2148,1080,1068,0.5027932960893855,0.4972067039106145
E01029375,2386,1204,1182,0.5046102263202011,0.4953897736797988
E01029376,1749,854,895,0.4882790165809034,0.5117209834190967
E01029377,1370,672,698,0.4905109489051095,0.5094890510948905
E01029378,1629,801,828,0.49171270718232046,0.5082872928176796
E01029353,1363,660,703,0.4842259721203228,0.5157740278796772
E01029364,1649,827,822,0.501516070345664,0.49848392965433597
E01029365,1530,756,774,0.49411764705882355,0.5058823529411764
E01029366,1717,827,890,0.481654047757717,0.5183459522422831
E01029367,2213,1080,1133,0.48802530501581565,0.5119746949841844
E01029359,2393,1195,1198,0.49937317175094026,0.5006268282490598
E01029360,1520,760,760,0.5,0.5
E01029361,1399,715,684,0.5110793423874196,0.4889206576125804
E01029362,1645,825,820,0.5015197568389058,0.49848024316109424
E01029363,1343,648,695,0.4825018615040953,0.5174981384959046
E01029394,1513,726,787,0.47984137475214805,0.520158625247852
E01029395,2567,1285,1282,0.5005843396961434,0.49941566030385665
E01029396,1609,815,794,0.5065257924176507,0.4934742075823493
E01029397,2632,1267,1365,0.48138297872340424,0.5186170212765957
E01029405,1617,795,822,0.49165120593692024,0.5083487940630798
E01029406,1277,654,623,0.5121378230227095,0.4878621769772905
E01029422,1291,636,655,0.49264136328427577,0.5073586367157242
E01029423,1541,746,795,0.48410123296560675,0.5158987670343933
E01029467,2018,1004,1014,0.4975222993062438,0.5024777006937562
E01029430,2517,1247,1270,0.4954310687326182,0.5045689312673818
E01029431,1633,805,828,0.49295774647887325,0.5070422535211268
E01029432,1387,679,708,0.48954578226387885,0.5104542177361211
E01029433,1545,753,792,0.487378640776699,0.512621359223301
E01029459,1544,769,775,0.49805699481865284,0.5019430051813472
E01029460,1735,869,866,0.500864553314121,0.49913544668587895
E01029461,1979,964,1015,0.48711470439615967,0.5128852956038403
E01029462,1679,820,859,0.48838594401429425,0.5116140559857058
E01029443,1679,808,871,0.4812388326384753,0.5187611673615247
E01029444,1540,747,793,0.4850649350649351,0.5149350649350649
E01029463,1238,598,640,0.48303715670436187,0.5169628432956381
E01029464,1535,738,797,0.48078175895765474,0.5192182410423453
E01029465,2139,1038,1101,0.485273492286115,0.514726507713885
E01029466,2309,1130,1179,0.48938934603724554,0.5106106539627544
E01029454,1545,767,778,0.4964401294498382,0.5035598705501618
E01029455,1717,831,886,0.48398369248689577,0.5160163075131042
E01029456,1407,666,741,0.47334754797441364,0.5266524520255863
E01029457,1276,626,650,0.49059561128526646,0.5094043887147336
E01029458,1818,872,946,0.47964796479647964,0.5203520352035204
E01029411,1443,736,707,0.51004851004851,0.48995148995148996
E01029412,1331,650,681,0.4883546205860255,0.5116453794139745
E01029424,1030,494,536,0.4796116504854369,0.5203883495145631
E01029425,2473,1704,769,0.6890416498180347,0.3109583501819652
E01029473,1576,773,803,0.49048223350253806,0.5095177664974619
E01029474,1173,538,635,0.45865302642796246,0.5413469735720375
E01029434,1618,809,809,0.5,0.5
E01029435,1496,721,775,0.481951871657754,0.518048128342246
E01029436,1838,932,906,0.5070729053318824,0.4929270946681175
E01029437,2772,1295,1477,0.4671717171717172,0.5328282828282829
E01029438,1435,705,730,0.4912891986062718,0.5087108013937283
E01029426,2343,1185,1158,0.5057618437900128,0.4942381562099872
E01029427,1777,907,870,0.5104108047270681,0.48958919527293193
E01029428,2454,1224,1230,0.49877750611246946,0.5012224938875306
E01029429,1483,773,710,0.5212407282535402,0.4787592717464599
E01029445,2598,1334,1264,0.5134719014626636,0.4865280985373364
E01029446,2181,1098,1083,0.5034387895460798,0.4965612104539202
E01029447,1800,944,856,0.5244444444444445,0.47555555555555556
E01029448,1891,938,953,0.49603384452670546,0.5039661554732946
E01029468,1659,812,847,0.48945147679324896,0.510548523206751
E01029469,1791,883,908,0.49302065884980456,0.5069793411501954
E01029470,1606,806,800,0.50186799501868,0.49813200498132004
E01029471,1757,904,853,0.514513375071144,0.485486624928856
E01029472,1576,766,810,0.4860406091370558,0.5139593908629442
E01029407,1655,871,784,0.5262839879154079,0.47371601208459213
E01029408,2387,1215,1172,0.5090071219103477,0.4909928780896523
E01029409,2059,1069,990,0.5191840699368625,0.48081593006313744
E01029410,1743,913,830,0.5238095238095238,0.47619047619047616
E01032896,1432,775,657,0.5412011173184358,0.45879888268156427
E01032897,1600,798,802,0.49875,0.50125
E01032898,1275,685,590,0.5372549019607843,0.4627450980392157
E01029418,2025,1012,1013,0.4997530864197531,0.5002469135802469
E01029419,1561,739,822,0.4734144778987828,0.5265855221012171
E01029420,1678,818,860,0.48748510131108463,0.5125148986889154
E01029413,1432,696,736,0.4860335195530726,0.5139664804469274
E01029414,1722,875,847,0.508130081300813,0.491869918699187
E01029415,1653,794,859,0.48033877797943136,0.5196612220205686
E01029416,2466,1221,1245,0.4951338199513382,0.5048661800486618
E01029417,2106,1034,1072,0.49097815764482433,0.5090218423551757
E01029449,1695,861,834,0.5079646017699115,0.4920353982300885
E01029450,1589,814,775,0.512271869100063,0.48772813089993705
E01029451,1778,858,920,0.48256467941507314,0.5174353205849269
E01029452,1601,825,776,0.5153029356652092,0.48469706433479076
E01029453,1531,757,774,0.49444807315480077,0.5055519268451992
E01029439,1389,676,713,0.4866810655147588,0.5133189344852411
E01029440,1284,627,657,0.4883177570093458,0.5116822429906542
E01029441,1591,744,847,0.4676304211187932,0.5323695788812068
E01029442,1696,860,836,0.5070754716981132,0.49292452830188677
E01029480,1925,969,956,0.5033766233766234,0.49662337662337663
E01029482,1575,772,803,0.4901587301587302,0.5098412698412699
E01029498,1978,980,998,0.4954499494438827,0.5045500505561172
E01034099,1774,844,930,0.47576099210823,0.52423900789177
E01034100,1542,765,777,0.4961089494163424,0.5038910505836576
E01029477,1585,788,797,0.4971608832807571,0.5028391167192429
E01029478,1516,717,799,0.4729551451187335,0.5270448548812665
E01029509,1695,828,867,0.48849557522123893,0.511504424778761
E01034101,1918,934,984,0.4869655891553702,0.5130344108446299
E01034102,1695,801,894,0.4725663716814159,0.5274336283185841
E01029486,1419,727,692,0.5123326286116984,0.48766737138830163
E01029507,1624,811,813,0.49938423645320196,0.500615763546798
E01029508,2264,1132,1132,0.5,0.5
E01029515,1848,898,950,0.48593073593073594,0.5140692640692641
E01029492,1982,946,1036,0.4772956609485368,0.5227043390514632
E01029499,1662,813,849,0.4891696750902527,0.5108303249097473
E01029501,1600,793,807,0.495625,0.504375
E01029526,1652,838,814,0.5072639225181598,0.4927360774818402
E01032899,1792,821,971,0.45814732142857145,0.5418526785714286
E01032900,2037,993,1044,0.48748159057437407,0.5125184094256259
E01029483,1512,742,770,0.49074074074074076,0.5092592592592593
E01029484,1695,825,870,0.48672566371681414,0.5132743362831859
E01029485,1424,703,721,0.4936797752808989,0.5063202247191011
E01029500,1606,794,812,0.4943960149439601,0.5056039850560399
E01029520,1560,769,791,0.492948717948718,0.507051282051282
E01029524,1782,883,899,0.49551066217732886,0.5044893378226711
E01029525,1874,911,963,0.48612593383137676,0.5138740661686233
E01029487,1619,792,827,0.4891908585546634,0.5108091414453366
E01029493,1881,918,963,0.4880382775119617,0.5119617224880383
E01029494,1556,742,814,0.4768637532133676,0.5231362467866324
E01029495,1604,800,804,0.49875311720698257,0.5012468827930174
E01034103,1271,662,609,0.5208497246262785,0.47915027537372146
E01034104,1845,928,917,0.5029810298102981,0.49701897018970187
E01029491,1756,865,891,0.49259681093394075,0.5074031890660592
E01029511,1572,755,817,0.4802798982188295,0.5197201017811705
E01029512,2164,1025,1139,0.47365988909426987,0.5263401109057301
E01029518,2769,1372,1397,0.49548573492235465,0.5045142650776454
E01029519,2143,1014,1129,0.47316845543630426,0.5268315445636957
E01029516,2019,1001,1018,0.495789995047053,0.504210004952947
E01029517,2083,1039,1044,0.4987998079692751,0.501200192030725
E01029531,1678,814,864,0.48510131108462456,0.5148986889153755
E01034105,1586,778,808,0.4905422446406053,0.5094577553593947
E01034106,1798,892,906,0.4961067853170189,0.5038932146829811
E01029475,2035,992,1043,0.48746928746928747,0.5125307125307126
E01029476,1361,642,719,0.47171197648787655,0.5282880235121235
E01029489,1515,757,758,0.4996699669966997,0.5003300330033004
E01029490,1416,701,715,0.4950564971751412,0.5049435028248588
E01029505,1583,789,794,0.4984207201516109,0.5015792798483891
E01029506,1729,841,888,0.48640832851359167,0.5135916714864083
E01029496,1929,917,1012,0.4753758424053914,0.5246241575946086
E01029527,1210,585,625,0.4834710743801653,0.5165289256198347
E01029528,1315,655,660,0.49809885931558934,0.5019011406844106
E01029529,1274,621,653,0.48744113029827313,0.5125588697017268
E01029513,1426,707,719,0.4957924263674614,0.5042075736325385
E01029514,1632,818,814,0.5012254901960784,0.4987745098039216
E01029521,1725,843,882,0.48869565217391303,0.5113043478260869
E01029522,1614,744,870,0.46096654275092935,0.5390334572490706
E01029523,1567,774,793,0.49393746011486916,0.5060625398851308
E01029488,2321,1420,901,0.6118052563550194,0.38819474364498063
E01029502,1663,841,822,0.5057125676488274,0.49428743235117256
E01029503,1587,773,814,0.4870825456836799,0.5129174543163201
E01029504,1663,835,828,0.50210463018641,0.4978953698135899
E01029562,1216,591,625,0.48601973684210525,0.5139802631578947
E01029565,1136,575,561,0.5061619718309859,0.49383802816901406
E01029581,1578,795,783,0.5038022813688213,0.49619771863117873
E01029582,1831,913,918,0.4986346258874932,0.5013653741125068
E01029586,1175,589,586,0.5012765957446809,0.49872340425531914
E01029587,1155,564,591,0.4883116883116883,0.5116883116883116
E01029561,1456,669,787,0.45947802197802196,0.540521978021978
E01029563,1290,642,648,0.49767441860465117,0.5023255813953489
E01029564,1346,648,698,0.4814264487369985,0.5185735512630015
E01029588,1617,791,826,0.48917748917748916,0.5108225108225108
E01029540,1316,644,672,0.48936170212765956,0.5106382978723404
E01029541,1839,879,960,0.47797716150081565,0.5220228384991843
E01029542,1584,773,811,0.4880050505050505,0.5119949494949495
E01029543,1233,602,631,0.4882400648824006,0.5117599351175993
E01029595,1189,606,583,0.5096719932716569,0.49032800672834315
E01029597,1478,736,742,0.4979702300405954,0.5020297699594046
E01029536,1434,703,731,0.4902370990237099,0.5097629009762901
E01029544,1350,660,690,0.4888888888888889,0.5111111111111111
E01029545,1478,732,746,0.4952638700947226,0.5047361299052774
E01029546,1289,648,641,0.5027152831652444,0.4972847168347556
E01029596,1026,498,528,0.4853801169590643,0.5146198830409356
E01029532,1490,742,748,0.49798657718120803,0.5020134228187919
E01029533,1469,709,760,0.48264125255275697,0.517358747447243
E01029534,1454,727,727,0.5,0.5
E01029535,1396,678,718,0.48567335243553006,0.5143266475644699
E01029556,2516,1245,1271,0.49483306836248014,0.5051669316375199
E01029537,1527,764,763,0.5003274394237066,0.4996725605762934
E01029538,1672,802,870,0.4796650717703349,0.5203349282296651
E01029539,1472,727,745,0.4938858695652174,0.5061141304347826
E01029552,1463,748,715,0.5112781954887218,0.48872180451127817
E01029558,1733,845,888,0.4875937680323139,0.5124062319676861
E01029547,1495,734,761,0.4909698996655518,0.5090301003344482
E01029548,1304,644,660,0.4938650306748466,0.5061349693251533
E01029559,1470,729,741,0.4959183673469388,0.5040816326530613
E01029560,1579,753,826,0.47688410386320457,0.5231158961367954
E01029568,1381,674,707,0.4880521361332368,0.5119478638667632
E01029583,1380,669,711,0.48478260869565215,0.5152173913043478
E01029584,1229,626,603,0.5093572009764036,0.4906427990235964
E01029585,1346,686,660,0.5096582466567607,0.4903417533432392
E01029609,1589,796,793,0.500943989930774,0.49905601006922595
E01029611,1869,909,960,0.48635634028892455,0.5136436597110754
E01029577,1480,740,740,0.5,0.5
E01029579,1640,805,835,0.49085365853658536,0.5091463414634146
E01029580,1368,677,691,0.49488304093567254,0.5051169590643275
E01029610,1336,648,688,0.48502994011976047,0.5149700598802395
E01029612,1156,562,594,0.486159169550173,0.513840830449827
E01029553,1678,819,859,0.48808104886769965,0.5119189511323003
E01029554,1851,925,926,0.4997298757428417,0.5002701242571583
E01029566,1247,591,656,0.4739374498797113,0.5260625501202887
E01029567,1643,826,817,0.5027388922702374,0.4972611077297626
E01029598,2057,994,1063,0.4832280019445795,0.5167719980554205
E01029599,1529,732,797,0.4787442773054284,0.5212557226945717
E01029555,1795,853,942,0.47520891364902507,0.5247910863509749
E01029578,1653,838,815,0.5069570477918935,0.49304295220810646
E01029602,1685,795,890,0.47181008902077154,0.5281899109792285
E01029603,1413,751,662,0.5314932767162066,0.46850672328379334
E01029604,1802,895,907,0.49667036625971145,0.5033296337402886
E01029576,3172,1377,1795,0.43411097099621687,0.5658890290037831
E01029593,2588,1287,1301,0.4972952086553323,0.5027047913446677
E01029594,1809,891,918,0.4925373134328358,0.5074626865671642
E01029557,1242,607,635,0.4887278582930757,0.5112721417069244
E01029573,1414,688,726,0.48656294200848654,0.5134370579915134
E01029574,1469,732,737,0.4982981620149762,0.5017018379850239
E01029575,1043,492,551,0.47171620325982744,0.5282837967401726
E01029549,1626,804,822,0.4944649446494465,0.5055350553505535
E01029551,1603,777,826,0.4847161572052402,0.5152838427947598
E01029591,1515,752,763,0.49636963696369635,0.5036303630363036
E01029600,1497,711,786,0.4749498997995992,0.5250501002004008
E01029605,1352,672,680,0.4970414201183432,0.5029585798816568
E01029607,1436,697,739,0.4853760445682451,0.5146239554317549
E01029589,1162,559,603,0.4810671256454389,0.5189328743545611
E01029590,1376,662,714,0.4811046511627907,0.5188953488372093
E01029601,1485,726,759,0.4888888888888889,0.5111111111111111
E01029606,1449,714,735,0.4927536231884058,0.5072463768115942
E01029608,1496,748,748,0.5,0.5
E01033257,2447,1183,1264,0.4834491213731099,0.5165508786268901
E01029569,1436,725,711,0.504874651810585,0.49512534818941506
E01029570,2675,1330,1345,0.497196261682243,0.502803738317757
E01029571,1241,606,635,0.48831587429492346,0.5116841257050766
E01029572,1582,798,784,0.504424778761062,0.49557522123893805
E01029655,1928,947,981,0.49118257261410786,0.5088174273858921
E01029656,1781,894,887,0.501965188096575,0.498034811903425
E01029657,1680,841,839,0.5005952380952381,0.4994047619047619
E01029658,2062,1006,1056,0.48787584869059164,0.5121241513094084
E01029659,1309,621,688,0.4744079449961803,0.5255920550038197
E01029660,2164,1080,1084,0.49907578558225507,0.5009242144177449
E01029621,1484,726,758,0.48921832884097033,0.5107816711590296
E01029646,1555,758,797,0.487459807073955,0.512540192926045
E01029647,2412,1179,1233,0.48880597014925375,0.5111940298507462
E01029648,1396,668,728,0.4785100286532951,0.5214899713467048
E01029617,1608,780,828,0.48507462686567165,0.5149253731343284
E01029618,1548,711,837,0.45930232558139533,0.5406976744186046
E01029668,1308,641,667,0.4900611620795107,0.5099388379204893
E01029669,1336,648,688,0.48502994011976047,0.5149700598802395
E01029670,1528,738,790,0.4829842931937173,0.5170157068062827
E01029620,1248,613,635,0.4911858974358974,0.5088141025641025
E01029622,1610,809,801,0.5024844720496895,0.49751552795031057
E01029623,1148,586,562,0.5104529616724739,0.4895470383275261
E01029624,1306,646,660,0.4946401225114854,0.5053598774885145
E01029625,1026,493,533,0.48050682261208577,0.5194931773879142
E01029641,1987,990,997,0.49823855057876193,0.501761449421238
E01029642,1459,743,716,0.5092529129540782,0.49074708704592185
E01029638,1972,968,1004,0.4908722109533469,0.5091277890466531
E01029639,1330,633,697,0.47593984962406016,0.5240601503759399
E01029640,1329,654,675,0.49209932279909707,0.5079006772009029
E01029643,1500,737,763,0.49133333333333334,0.5086666666666667
E01029644,1375,667,708,0.4850909090909091,0.5149090909090909
E01029616,1477,716,761,0.4847664184157075,0.5152335815842924
E01029619,1934,930,1004,0.4808686659772492,0.5191313340227508
E01029636,1406,690,716,0.4907539118065434,0.5092460881934566
E01029637,4721,3869,852,0.8195297606439313,0.18047023935606862
E01029632,1718,832,886,0.4842840512223516,0.5157159487776485
E01029633,1885,915,970,0.4854111405835544,0.5145888594164456
E01029634,1612,785,827,0.4869727047146402,0.5130272952853598
E01029635,1734,824,910,0.47520184544405997,0.52479815455594
E01029613,1304,647,657,0.49616564417177916,0.5038343558282209
E01029614,1656,765,891,0.46195652173913043,0.5380434782608695
E01029615,1206,586,620,0.4859038142620232,0.5140961857379768
E01029627,1394,645,749,0.46269727403156385,0.5373027259684362
E01029626,1546,763,783,0.4935316946959897,0.5064683053040103
E01029628,1645,768,877,0.4668693009118541,0.5331306990881459
E01029629,1190,570,620,0.4789915966386555,0.5210084033613446
E01029630,1368,677,691,0.49488304093567254,0.5051169590643275
E01029631,1395,679,716,0.4867383512544803,0.5132616487455197
E01029671,1518,707,811,0.4657444005270092,0.5342555994729907
E01029673,1514,754,760,0.49801849405548215,0.5019815059445178
E01029676,1090,519,571,0.4761467889908257,0.5238532110091743
E01029679,1479,706,773,0.47734956051386074,0.5226504394861393
E01029680,1520,738,782,0.4855263157894737,0.5144736842105263
E01029645,2523,1183,1340,0.46888624653190647,0.5311137534680935
E01029667,2269,1142,1127,0.50330542089026,0.49669457910973996
E01029672,1597,799,798,0.5003130870381967,0.4996869129618034
E01029674,1705,856,849,0.5020527859237537,0.4979472140762463
E01029675,1457,676,781,0.4639670555936857,0.5360329444063143
E01029677,1367,664,703,0.4857351865398683,0.5142648134601316
E01029678,1574,776,798,0.49301143583227447,0.5069885641677255
E01029649,1164,554,610,0.47594501718213056,0.5240549828178694
E01029650,1474,716,758,0.48575305291723203,0.514246947082768
E01029651,1458,708,750,0.48559670781893005,0.51440329218107
E01029652,1767,872,895,0.49349179400113186,0.5065082059988681
E01029653,1241,576,665,0.46414182111200647,0.5358581788879936
E01029654,2261,1090,1171,0.4820875718708536,0.5179124281291464
E01029661,1916,916,1000,0.4780793319415449,0.5219206680584552
E01029662,2031,1022,1009,0.5032003938946332,0.49679960610536683
E01029663,1392,698,694,0.5014367816091954,0.4985632183908046
E01029664,1453,703,750,0.48382656572608396,0.516173434273916
E01029665,1670,827,843,0.49520958083832334,0.5047904191616767
E01029666,1452,668,784,0.46005509641873277,0.5399449035812672
E01029702,1546,771,775,0.4987063389391979,0.5012936610608021
E01029703,1623,805,818,0.4959950708564387,0.5040049291435613
E01029704,1398,671,727,0.4799713876967096,0.5200286123032904
E01029705,1409,712,697,0.5053229240596168,0.49467707594038324
E01029681,1216,606,610,0.49835526315789475,0.5016447368421053
E01029682,1597,749,848,0.46900438321853477,0.5309956167814652
E01029683,1239,581,658,0.4689265536723164,0.5310734463276836
E01029748,1302,646,656,0.49615975422427033,0.5038402457757296
E01029749,1818,873,945,0.4801980198019802,0.5198019801980198
E01029740,1542,745,797,0.48313878080415046,0.5168612191958496
E01029744,2413,1185,1228,0.4910899295482801,0.5089100704517199
E01029745,1722,854,868,0.4959349593495935,0.5040650406504065
E01029746,1486,731,755,0.4919246298788694,0.5080753701211306
E01029753,1987,976,1011,0.49119275289380976,0.5088072471061902
E01029756,1930,976,954,0.505699481865285,0.49430051813471504
E01029733,1919,930,989,0.484627410109432,0.515372589890568
E01029739,1503,753,750,0.500998003992016,0.499001996007984
E01029741,1565,793,772,0.5067092651757189,0.49329073482428115
E01029754,1799,877,922,0.4874930516953863,0.5125069483046136
E01029755,1332,607,725,0.45570570570570573,0.5442942942942943
E01029695,2331,1132,1199,0.48562848562848565,0.5143715143715144
E01029696,1394,713,681,0.5114777618364419,0.4885222381635581
E01029697,1572,662,910,0.4211195928753181,0.5788804071246819
E01029698,1750,852,898,0.4868571428571429,0.5131428571428571
E01029747,2145,1074,1071,0.5006993006993007,0.4993006993006993
E01029690,1467,723,744,0.49284253578732107,0.5071574642126789
E01029718,1895,950,945,0.5013192612137203,0.49868073878627966
E01029743,2499,1256,1243,0.5026010404161665,0.4973989595838335
E01029751,1627,770,857,0.4732636754763368,0.5267363245236631
E01029719,1554,738,816,0.4749034749034749,0.525096525096525
E01029720,1528,725,803,0.4744764397905759,0.525523560209424
E01029721,1618,777,841,0.48022249690976515,0.5197775030902348
E01029750,2453,1230,1223,0.5014268242967794,0.4985731757032206
E01029752,1230,579,651,0.47073170731707314,0.5292682926829269
E01029687,1970,980,990,0.49746192893401014,0.5025380710659898
E01029710,1370,648,722,0.472992700729927,0.527007299270073
E01029711,1533,765,768,0.49902152641878667,0.5009784735812133
E01029712,2081,992,1089,0.4766938971648246,0.5233061028351754
E01029713,1796,866,930,0.4821826280623608,0.5178173719376392
E01029692,1411,657,754,0.46562721474131824,0.5343727852586818
E01029693,1466,700,766,0.47748976807639837,0.5225102319236017
E01029722,1666,799,867,0.47959183673469385,0.5204081632653061
E01029725,2712,1758,954,0.6482300884955752,0.35176991150442477
E01029689,1645,845,800,0.513677811550152,0.48632218844984804
E01029691,1353,695,658,0.5136733185513673,0.48632668144863267
E01029694,2325,1213,1112,0.5217204301075269,0.4782795698924731
E01029699,1968,971,997,0.49339430894308944,0.5066056910569106
E01034047,1117,620,497,0.5550581915846016,0.4449418084153984
E01034048,1032,533,499,0.5164728682170543,0.48352713178294576
E01029686,1329,642,687,0.48306997742663654,0.5169300225733634
E01029700,1210,579,631,0.47851239669421486,0.5214876033057851
E01029723,1473,744,729,0.505091649694501,0.49490835030549896
E01029724,1661,827,834,0.49789283564118003,0.50210716435882
E01034049,1533,734,799,0.47879973907371165,0.5212002609262884
E01034050,1744,972,772,0.5573394495412844,0.4426605504587156
E01029714,1469,727,742,0.4948944860449285,0.5051055139550715
E01029736,1704,841,863,0.4935446009389671,0.5064553990610329
E01029737,1738,877,861,0.5046029919447641,0.4953970080552359
E01029738,1328,650,678,0.4894578313253012,0.5105421686746988
E01029742,2081,1034,1047,0.4968765016818837,0.5031234983181163
E01029715,1447,679,768,0.4692467173462336,0.5307532826537664
E01029716,1593,762,831,0.4783427495291902,0.5216572504708098
E01029717,1757,848,909,0.48264086511098464,0.5173591348890154
E01029727,1489,729,760,0.4895903290799194,0.5104096709200806
E01029728,1446,696,750,0.48132780082987553,0.5186721991701245
E01029684,1450,698,752,0.48137931034482756,0.5186206896551724
E01029685,1517,726,791,0.47857613711272246,0.5214238628872775
E01029757,1464,709,755,0.4842896174863388,0.5157103825136612
E01029758,1578,751,827,0.4759188846641318,0.5240811153358682
E01029759,1715,836,879,0.48746355685131193,0.5125364431486881
E01029760,1780,882,898,0.49550561797752807,0.5044943820224719
E01034051,2614,1292,1322,0.49426166794185156,0.5057383320581484
E01029688,2402,1211,1191,0.5041631973355537,0.4958368026644463
E01029706,1794,902,892,0.5027870680044593,0.4972129319955407
E01029707,1424,691,733,0.48525280898876405,0.514747191011236
E01029708,2119,1056,1063,0.49834827748938176,0.5016517225106182
E01029709,1469,711,758,0.48400272294077606,0.5159972770592239
E01029726,1710,829,881,0.4847953216374269,0.5152046783625731
E01029729,1552,783,769,0.5045103092783505,0.4954896907216495
E01029734,2221,1075,1146,0.4840162089149032,0.5159837910850968
E01029735,2202,1071,1131,0.48637602179836514,0.5136239782016349
E01029797,1592,827,765,0.5194723618090452,0.4805276381909548
E01029806,1465,707,758,0.4825938566552901,0.5174061433447099
E01029808,1514,729,785,0.4815059445178336,0.5184940554821664
E01029809,1503,723,780,0.4810379241516966,0.5189620758483033
E01029810,1407,685,722,0.48685145700071075,0.5131485429992892
E01029767,1563,786,777,0.5028790786948176,0.4971209213051823
E01029769,1772,882,890,0.49774266365688485,0.5022573363431151
E01029770,2061,1017,1044,0.49344978165938863,0.5065502183406113
E01029802,1845,923,922,0.5002710027100271,0.4997289972899729
E01029763,1541,738,803,0.4789097988319273,0.5210902011680727
E01029764,1774,854,920,0.4813979706877114,0.5186020293122886
E01029765,1324,630,694,0.47583081570996977,0.5241691842900302
E01029766,1422,729,693,0.5126582278481012,0.4873417721518987
E01029774,1933,935,998,0.4837040869115365,0.5162959130884636
E01029768,1553,771,782,0.49645846748229233,0.5035415325177076
E01029771,1590,757,833,0.4761006289308176,0.5238993710691824
E01029772,1611,821,790,0.5096213531967722,0.4903786468032278
E01029773,1485,746,739,0.5023569023569023,0.49764309764309766
E01029804,1775,903,872,0.5087323943661972,0.49126760563380284
E01029807,1115,508,607,0.4556053811659193,0.5443946188340807
E01029811,1511,744,767,0.4923891462607545,0.5076108537392455
E01029812,1994,1011,983,0.5070210631895687,0.4929789368104313
E01029814,1597,799,798,0.5003130870381967,0.4996869129618034
E01029792,2361,1122,1239,0.47522236340533675,0.5247776365946633
E01029793,1534,763,771,0.4973924380704042,0.5026075619295959
E01029805,1675,816,859,0.4871641791044776,0.5128358208955224
E01029813,2231,1094,1137,0.49036306588973555,0.5096369341102645
E01029815,1440,703,737,0.48819444444444443,0.5118055555555555
E01029816,1376,666,710,0.48401162790697677,0.5159883720930233
E01029801,1743,866,877,0.4968445209409065,0.5031554790590935
E01029803,1751,874,877,0.49914334665905197,0.500856653340948
E01029817,1724,885,839,0.5133410672853829,0.4866589327146172
E01029762,1626,786,840,0.4833948339483395,0.5166051660516605
E01029775,1428,694,734,0.48599439775910364,0.5140056022408963
E01029776,1751,860,891,0.49114791547687037,0.5088520845231297
E01029777,1548,736,812,0.4754521963824289,0.524547803617571
E01029779,1593,784,809,0.4921531701192718,0.5078468298807282
E01029780,1609,791,818,0.4916096954630205,0.5083903045369795
E01029794,1424,716,708,0.5028089887640449,0.49719101123595505
E01029818,1455,704,751,0.4838487972508591,0.516151202749141
E01029819,1659,823,836,0.4960819770946353,0.5039180229053647
E01029761,1356,672,684,0.49557522123893805,0.504424778761062
E01029782,1976,993,983,0.5025303643724697,0.4974696356275304
E01029795,1694,848,846,0.500590318772137,0.49940968122786306
E01029796,1499,728,771,0.485657104736491,0.514342895263509
E01029781,1425,698,727,0.4898245614035088,0.5101754385964913
E01029783,1448,729,719,0.5034530386740331,0.4965469613259669
E01029786,1384,675,709,0.4877167630057804,0.5122832369942196
E01029787,1929,989,940,0.5127008812856402,0.48729911871435977
E01029778,1776,869,907,0.48930180180180183,0.5106981981981982
E01029789,1001,501,500,0.5004995004995005,0.4995004995004995
E01029798,1617,801,816,0.49536178107606677,0.5046382189239332
E01029799,1836,903,933,0.4918300653594771,0.5081699346405228
E01029800,1619,797,822,0.4922791846819024,0.5077208153180975
E01029784,2102,1052,1050,0.5004757373929591,0.4995242626070409
E01029785,1763,863,900,0.4895065229722065,0.5104934770277936
E01029788,1300,653,647,0.5023076923076923,0.4976923076923077
E01029790,1800,885,915,0.49166666666666664,0.5083333333333333
E01029791,1445,713,732,0.4934256055363322,0.5065743944636678
E01029846,1677,824,853,0.4913536076326774,0.5086463923673226
E01029847,1362,676,686,0.49632892804698975,0.5036710719530103
E01029848,1187,578,609,0.4869418702611626,0.5130581297388374
E01029852,1754,846,908,0.4823261117445838,0.5176738882554162
E01029853,1740,809,931,0.4649425287356322,0.5350574712643679
E01029854,2488,1212,1276,0.4871382636655949,0.5128617363344051
E01029835,1698,871,827,0.5129564193168433,0.4870435806831567
E01029836,1701,818,883,0.4808935920047031,0.5191064079952968
E01029849,1558,746,812,0.47881899871630296,0.521181001283697
E01029850,1333,641,692,0.4808702175543886,0.5191297824456114
E01029851,2159,1053,1106,0.4877257989810097,0.5122742010189902
E01029820,2328,1183,1145,0.5081615120274914,0.49183848797250856
E01029821,1377,682,695,0.495279593318809,0.504720406681191
E01029822,1490,765,725,0.5134228187919463,0.4865771812080537
E01029824,1739,854,885,0.49108683151236343,0.5089131684876366
E01029841,1385,697,688,0.5032490974729242,0.4967509025270758
E01029823,1421,686,735,0.4827586206896552,0.5172413793103449
E01029831,1512,759,753,0.501984126984127,0.498015873015873
E01029832,1598,785,813,0.49123904881101377,0.5087609511889862
E01029834,1623,798,825,0.49168207024029575,0.5083179297597042
E01029844,1183,580,603,0.4902789518174134,0.5097210481825867
E01029833,1617,812,805,0.5021645021645021,0.49783549783549785
E01029837,1522,766,756,0.5032851511169514,0.4967148488830486
E01029838,1539,785,754,0.5100714749837557,0.4899285250162443
E01029839,1135,564,571,0.49691629955947136,0.5030837004405286
E01029825,1256,637,619,0.5071656050955414,0.4928343949044586
E01029826,1729,857,872,0.4956622325043378,0.5043377674956623
E01029827,1490,710,780,0.47651006711409394,0.5234899328859061
E01029828,1269,625,644,0.4925137903861308,0.5074862096138691
E01029830,1157,549,608,0.47450302506482284,0.5254969749351772
E01029840,1355,673,682,0.4966789667896679,0.5033210332103321
E01029842,1249,606,643,0.4851881505204163,0.5148118494795837
E01029843,1446,697,749,0.48201936376210236,0.5179806362378977
E01029845,1069,499,570,0.4667913938260056,0.5332086061739943
E01029859,1742,877,865,0.5034443168771527,0.4965556831228473
E01029855,1506,734,772,0.48738379814077026,0.5126162018592297
E01029856,1430,738,692,0.5160839160839161,0.48391608391608393
E01029857,1472,708,764,0.48097826086956524,0.5190217391304348
E01029858,1476,746,730,0.505420054200542,0.494579945799458
E01029865,1603,803,800,0.5009357454772302,0.4990642545227698
E01029860,1319,652,667,0.4943138741470811,0.5056861258529188
E01029861,1331,632,699,0.47483095416979715,0.5251690458302029
E01029862,1293,619,674,0.47873163186388246,0.5212683681361175
E01029863,1810,905,905,0.5,0.5
E01029864,1586,789,797,0.4974779319041614,0.5025220680958385
E01029829,2167,1068,1099,0.49284725426857406,0.5071527457314259
E01029867,1627,773,854,0.47510755992624465,0.5248924400737554
E01029868,1374,683,691,0.49708879184861715,0.5029112081513828
E01029869,1585,789,796,0.49779179810725555,0.5022082018927445
E01032901,1846,909,937,0.4924160346695558,0.5075839653304443
E01032902,1332,665,667,0.49924924924924924,0.5007507507507507
E01031035,1975,953,1022,0.48253164556962025,0.5174683544303798
E01031036,1728,845,883,0.48900462962962965,0.5109953703703703
E01031037,2001,980,1021,0.4897551224387806,0.5102448775612194
E01031038,1955,944,1011,0.48286445012787726,0.5171355498721227
E01031039,1551,743,808,0.47904577691811734,0.5209542230818827
E01031040,1746,842,904,0.4822451317296678,0.5177548682703322
E01031016,1550,753,797,0.4858064516129032,0.5141935483870967
E01031025,1662,820,842,0.49338146811071,0.50661853188929
E01031026,1553,755,798,0.4861558274307791,0.5138441725692209
E01031031,2592,1262,1330,0.4868827160493827,0.5131172839506173
E01031032,1420,688,732,0.48450704225352115,0.5154929577464789
E01031009,2190,1087,1103,0.4963470319634703,0.5036529680365297
E01031010,1981,996,985,0.502776375567895,0.497223624432105
E01031011,2236,1135,1101,0.5076028622540251,0.49239713774597493
E01031012,1509,737,772,0.48840291583830353,0.5115970841616965
E01031013,1019,490,529,0.48086359175662413,0.5191364082433758
E01031014,1218,617,601,0.506568144499179,0.493431855500821
E01031015,1582,780,802,0.49304677623261695,0.506953223767383
E01031023,1618,815,803,0.5037082818294191,0.496291718170581
E01031024,1800,905,895,0.5027777777777778,0.49722222222222223
E01031033,1787,850,937,0.4756575265808618,0.5243424734191382
E01031034,1762,860,902,0.4880817253121453,0.5119182746878547
E01031005,1614,788,826,0.4882280049566295,0.5117719950433705
E01031008,1551,722,829,0.4655061250805932,0.5344938749194068
E01031017,1717,858,859,0.49970879440885263,0.5002912055911474
E01031018,1116,550,566,0.492831541218638,0.507168458781362
E01031029,1526,749,777,0.4908256880733945,0.5091743119266054
E01031030,2302,1151,1151,0.5,0.5
E01031019,1717,862,855,0.5020384391380315,0.4979615608619686
E01031020,1517,705,812,0.46473302570863545,0.5352669742913645
E01031021,1795,865,930,0.4818941504178273,0.5181058495821727
E01031022,1867,914,953,0.4895554365291912,0.5104445634708088
E01031041,1634,787,847,0.48164014687882495,0.518359853121175
E01031042,1848,922,926,0.4989177489177489,0.5010822510822511
E01031006,1481,739,742,0.4989871708305199,0.5010128291694801
E01031007,1281,629,652,0.49102263856362216,0.5089773614363778
E01031027,1726,857,869,0.49652375434530704,0.503476245654693
E01031028,1902,956,946,0.5026288117770767,0.49737118822292326
E01031110,1596,791,805,0.4956140350877193,0.5043859649122807
E01031111,1008,508,500,0.503968253968254,0.49603174603174605
E01031112,1561,758,803,0.4855861627162076,0.5144138372837924
E01031114,1533,758,775,0.49445531637312456,0.5055446836268754
E01035014,2192,1085,1107,0.4949817518248175,0.5050182481751825
E01035015,1693,802,891,0.4737152982870644,0.5262847017129356
E01031073,2062,995,1067,0.482541222114452,0.5174587778855481
E01031074,1574,776,798,0.49301143583227447,0.5069885641677255
E01031075,2230,1090,1140,0.48878923766816146,0.5112107623318386
E01035016,1802,857,945,0.4755826859045505,0.5244173140954494
E01035017,1930,955,975,0.4948186528497409,0.5051813471502591
E01031100,1304,656,648,0.5030674846625767,0.49693251533742333
E01031101,1349,681,668,0.5048183839881394,0.4951816160118606
E01031102,1292,662,630,0.5123839009287926,0.48761609907120745
E01031104,1404,659,745,0.46937321937321935,0.5306267806267806
E01035018,1754,864,890,0.4925883694412771,0.507411630558723
E01035019,1636,775,861,0.4737163814180929,0.5262836185819071
E01031081,1644,808,836,0.49148418491484186,0.5085158150851582
E01031082,1408,706,702,0.5014204545454546,0.49857954545454547
E01031083,1811,878,933,0.484815019326339,0.5151849806736609
E01031084,2205,1099,1106,0.4984126984126984,0.5015873015873016
E01031085,1336,667,669,0.49925149700598803,0.500748502994012
E01031043,1765,934,831,0.5291784702549575,0.4708215297450425
E01031044,1738,858,880,0.4936708860759494,0.5063291139240507
E01031045,1893,921,972,0.4865293185419968,0.5134706814580031
E01031046,1755,872,883,0.49686609686609684,0.5031339031339032
E01031047,1991,1006,985,0.5052737317930688,0.49472626820693116
E01031057,1553,758,795,0.4880875724404379,0.5119124275595621
E01031058,1468,711,757,0.4843324250681199,0.5156675749318801
E01031059,1639,806,833,0.4917632702867602,0.5082367297132397
E01031060,1380,691,689,0.5007246376811594,0.49927536231884057
E01031061,1452,716,736,0.4931129476584022,0.5068870523415978
E01031090,1653,770,883,0.46581972171808833,0.5341802782819117
E01031091,1643,803,840,0.4887401095556908,0.5112598904443092
E01031092,1500,757,743,0.5046666666666667,0.49533333333333335
E01031093,1307,645,662,0.4934965570007651,0.5065034429992349
E01031094,1214,616,598,0.5074135090609555,0.4925864909390445
E01031048,1265,646,619,0.5106719367588933,0.4893280632411067
E01031049,2819,1379,1440,0.4891805604824406,0.5108194395175594
E01031050,1852,953,899,0.5145788336933045,0.48542116630669546
E01031051,1320,640,680,0.48484848484848486,0.5151515151515151
E01031115,1794,891,903,0.49665551839464883,0.5033444816053512
E01031116,1731,812,919,0.4690930098209128,0.5309069901790873
E01031117,1555,741,814,0.47652733118971063,0.5234726688102894
E01031118,1199,596,603,0.4970809007506255,0.5029190992493745
E01031119,1681,867,814,0.5157644259369423,0.4842355740630577
E01031052,1499,751,748,0.5010006671114076,0.4989993328885924
E01031053,1399,692,707,0.49463902787705505,0.505360972122945
E01031054,1583,763,820,0.4819962097283639,0.5180037902716361
E01031055,1662,805,857,0.4843561973525872,0.5156438026474127
E01031056,1509,727,782,0.48177601060304837,0.5182239893969516
E01031120,1330,658,672,0.49473684210526314,0.5052631578947369
E01031121,1138,577,561,0.5070298769771528,0.4929701230228471
E01031122,1392,680,712,0.4885057471264368,0.5114942528735632
E01031123,1215,576,639,0.4740740740740741,0.5259259259259259
E01031124,1513,732,781,0.4838070059484468,0.5161929940515532
E01031105,1539,759,780,0.49317738791423,0.50682261208577
E01031106,1442,721,721,0.5,0.5
E01031107,1134,554,580,0.48853615520282184,0.5114638447971781
E01031108,1403,702,701,0.5003563791874555,0.49964362081254454
E01031109,1562,769,793,0.49231754161331626,0.5076824583866837
E01031062,1185,579,606,0.48860759493670886,0.5113924050632911
E01031063,1257,604,653,0.4805091487669053,0.5194908512330947
E01031064,1324,626,698,0.472809667673716,0.527190332326284
E01031065,1602,775,827,0.4837702871410737,0.5162297128589264
E01031066,1579,775,804,0.4908169727675744,0.5091830272324256
E01031067,1438,682,756,0.47426981919332406,0.5257301808066759
E01031068,1742,842,900,0.4833524684270953,0.5166475315729047
E01031069,1491,724,767,0.48558014755197854,0.5144198524480215
E01031070,1409,705,704,0.5003548616039745,0.49964513839602553
E01031095,1295,637,658,0.4918918918918919,0.5081081081081081
E01031096,1354,664,690,0.49039881831610044,0.5096011816838996
E01031097,1704,822,882,0.4823943661971831,0.5176056338028169
E01031098,1429,695,734,0.48635409377186845,0.5136459062281316
E01031099,2275,1146,1129,0.5037362637362638,0.49626373626373627
E01031086,2083,1037,1046,0.4978396543446951,0.5021603456553049
E01031087,2220,1080,1140,0.4864864864864865,0.5135135135135135
E01031088,2011,977,1034,0.48582794629537546,0.5141720537046246
E01031089,1427,679,748,0.4758234057463209,0.524176594253679
E01031077,1800,860,940,0.4777777777777778,0.5222222222222223
E01031078,2150,1051,1099,0.4888372093023256,0.5111627906976745
E01031079,1568,768,800,0.4897959183673469,0.5102040816326531
E01031080,1634,780,854,0.4773561811505508,0.5226438188494492
E01032588,1408,715,693,0.5078125,0.4921875
E01031137,1184,594,590,0.5016891891891891,0.4983108108108108
E01031138,1147,554,593,0.48299912816041846,0.5170008718395815
E01031139,1717,852,865,0.49621432731508447,0.5037856726849156
E01031140,1350,656,694,0.48592592592592593,0.5140740740740741
E01031142,1737,857,880,0.4933793897524468,0.5066206102475532
E01035020,1674,845,829,0.504778972520908,0.49522102747909197
E01035021,1882,962,920,0.5111583421891605,0.48884165781083955
E01031171,1466,746,720,0.5088676671214188,0.49113233287858116
E01031172,1672,805,867,0.48145933014354064,0.5185406698564593
E01031173,1919,998,921,0.5200625325690463,0.4799374674309536
E01031174,2215,1122,1093,0.5065462753950338,0.4934537246049661
E01031151,1530,752,778,0.4915032679738562,0.5084967320261438
E01031152,1040,507,533,0.4875,0.5125
E01031153,1648,812,836,0.49271844660194175,0.5072815533980582
E01031154,1724,846,878,0.49071925754060325,0.5092807424593968
E01031181,1829,912,917,0.4986331328594861,0.5013668671405139
E01031130,1930,996,934,0.5160621761658031,0.48393782383419687
E01031131,1842,1000,842,0.5428881650380022,0.4571118349619978
E01031132,1946,1014,932,0.5210688591983555,0.4789311408016444
E01031133,1423,711,712,0.49964862965565704,0.500351370344343
E01031167,1369,669,700,0.48867786705624544,0.5113221329437546
E01031168,2893,1447,1446,0.50017283097131,0.49982716902868995
E01031169,2107,1109,998,0.5263407688656858,0.4736592311343142
E01031170,1720,898,822,0.522093023255814,0.47790697674418603
E01031125,1483,730,753,0.49224544841537426,0.5077545515846258
E01031127,1686,820,866,0.4863582443653618,0.5136417556346382
E01031165,1609,789,820,0.490366687383468,0.509633312616532
E01032893,2017,1000,1017,0.495785820525533,0.504214179474467
E01032894,2209,1085,1124,0.49117247623358984,0.5088275237664102
E01032895,1487,754,733,0.5070611970410221,0.4929388029589778
E01035022,1683,793,890,0.471182412358883,0.5288175876411171
E01035023,1686,875,811,0.5189798339264532,0.48102016607354686
E01031155,1391,691,700,0.49676491732566497,0.503235082674335
E01031156,1522,738,784,0.48488830486202367,0.5151116951379764
E01031157,2415,1235,1180,0.5113871635610766,0.4886128364389234
E01031158,1107,551,556,0.4977416440831075,0.5022583559168925
E01031143,1460,731,729,0.5006849315068493,0.49931506849315066
E01031144,1502,748,754,0.4980026631158455,0.5019973368841545
E01031145,1541,829,712,0.5379623621025308,0.46203763789746916
E01031146,1600,778,822,0.48625,0.51375
E01031161,2107,1040,1067,0.49359278595158995,0.50640721404841
E01031162,2186,1061,1125,0.4853613906678865,0.5146386093321135
E01031163,1678,805,873,0.4797377830750894,0.5202622169249106
E01031179,2134,1059,1075,0.49625117150890347,0.5037488284910965
E01031180,2109,1059,1050,0.5021337126600285,0.49786628733997157
E01031134,1636,802,834,0.4902200488997555,0.5097799511002445
E01031135,1554,745,809,0.4794079794079794,0.5205920205920206
E01031136,1839,869,970,0.4725394235997825,0.5274605764002175
E01031175,1477,712,765,0.4820582261340555,0.5179417738659445
E01031176,1564,784,780,0.5012787723785166,0.49872122762148335
E01031177,1542,739,803,0.4792477302204929,0.5207522697795072
E01031178,1440,684,756,0.475,0.525
E01031148,1957,961,996,0.4910577414409811,0.5089422585590189
E01031149,1531,756,775,0.4937949052906597,0.5062050947093403
E01031150,1176,571,605,0.48554421768707484,0.5144557823129252
E01031166,2000,965,1035,0.4825,0.5175
E01035024,2053,967,1086,0.4710180224062348,0.5289819775937652
E01035025,1455,689,766,0.4735395189003436,0.5264604810996564
E01031159,1564,778,786,0.49744245524296676,0.5025575447570333
E01031160,2100,1045,1055,0.4976190476190476,0.5023809523809524
E01031182,2377,1281,1096,0.5389145982330669,0.46108540176693313
E01035026,1484,738,746,0.4973045822102426,0.5026954177897575
E01031129,1215,599,616,0.49300411522633747,0.5069958847736625
E01032891,1962,1017,945,0.518348623853211,0.481651376146789
E01035027,1493,758,735,0.5077026121902211,0.49229738780977894
E01035028,1586,779,807,0.4911727616645649,0.5088272383354351
E01035029,1777,876,901,0.49296567248171075,0.5070343275182893
E01031213,1961,955,1006,0.48699643039265683,0.5130035696073432
E01031243,2042,1023,1019,0.5009794319294809,0.4990205680705191
E01031244,1875,942,933,0.5024,0.4976
E01031195,2290,1099,1191,0.4799126637554585,0.5200873362445415
E01031202,1620,763,857,0.47098765432098766,0.5290123456790123
E01031203,1609,746,863,0.4636420136730889,0.5363579863269111
E01031204,1443,676,767,0.46846846846846846,0.5315315315315315
E01031239,1655,817,838,0.4936555891238671,0.5063444108761329
E01031240,1368,656,712,0.47953216374269003,0.52046783625731
E01031241,1485,745,740,0.5016835016835017,0.4983164983164983
E01031242,1528,748,780,0.4895287958115183,0.5104712041884817
E01031219,2277,1065,1212,0.46772068511198944,0.5322793148880105
E01031220,1440,713,727,0.4951388888888889,0.5048611111111111
E01031221,1900,899,1001,0.4731578947368421,0.5268421052631579
E01031222,2492,1242,1250,0.4983948635634029,0.5016051364365971
E01031223,1505,762,743,0.506312292358804,0.493687707641196
E01031224,1417,704,713,0.49682427664079043,0.5031757233592096
E01031197,1257,617,640,0.4908512330946698,0.5091487669053302
E01031198,1336,689,647,0.5157185628742516,0.4842814371257485
E01031199,2167,1054,1113,0.4863867097369635,0.5136132902630365
E01031200,1750,879,871,0.5022857142857143,0.4977142857142857
E01031201,1623,781,842,0.48120764017252005,0.51879235982748
E01031210,1204,574,630,0.47674418604651164,0.5232558139534884
E01031211,1816,900,916,0.4955947136563877,0.5044052863436124
E01031183,1578,777,801,0.4923954372623574,0.5076045627376425
E01031184,1431,682,749,0.47658979734451434,0.5234102026554857
E01031185,1320,608,712,0.46060606060606063,0.5393939393939394
E01031186,1540,750,790,0.487012987012987,0.512987012987013
E01031187,1863,917,946,0.49221685453569514,0.5077831454643049
E01031188,2588,1259,1329,0.4864760432766615,0.5135239567233385
E01031208,2399,1134,1265,0.47269695706544396,0.5273030429345561
E01031217,1286,609,677,0.4735614307931571,0.526438569206843
E01031218,1229,607,622,0.49389747762408465,0.5061025223759154
E01031249,1110,530,580,0.4774774774774775,0.5225225225225225
E01031251,1103,535,568,0.485040797824116,0.514959202175884
E01031252,1305,602,703,0.46130268199233715,0.5386973180076629
E01031253,1419,668,751,0.47075405214940097,0.529245947850599
E01035030,1472,729,743,0.4952445652173913,0.5047554347826086
E01035031,1732,867,865,0.5005773672055427,0.49942263279445726
E01031228,1564,764,800,0.4884910485933504,0.5115089514066496
E01031229,2097,1035,1062,0.49356223175965663,0.5064377682403434
E01031231,2376,1187,1189,0.49957912457912457,0.5004208754208754
E01031236,1540,757,783,0.4915584415584416,0.5084415584415585
E01031238,1280,614,666,0.4796875,0.5203125
E01035032,1673,815,858,0.4871488344291692,0.5128511655708309
E01035033,1769,857,912,0.4844544940644432,0.5155455059355568
E01031225,1773,852,921,0.4805414551607445,0.5194585448392555
E01031227,2148,989,1159,0.46042830540037244,0.5395716945996276
E01033250,1324,653,671,0.493202416918429,0.506797583081571
E01033251,1700,807,893,0.4747058823529412,0.5252941176470588
E01033252,1392,667,725,0.4791666666666667,0.5208333333333334
E01031232,2082,971,1111,0.4663784822286263,0.5336215177713737
E01031233,1687,818,869,0.4848844101956135,0.5151155898043864
E01031234,1739,774,965,0.44508338125359403,0.554916618746406
E01031235,1837,837,1000,0.4556341861731083,0.5443658138268916
E01031237,1520,760,760,0.5,0.5
E01031189,1746,855,891,0.4896907216494845,0.5103092783505154
E01031190,2486,1210,1276,0.48672566371681414,0.5132743362831859
E01031191,2070,1005,1065,0.4855072463768116,0.5144927536231884
E01031192,2424,1173,1251,0.4839108910891089,0.5160891089108911
E01031248,2455,1219,1236,0.4965376782077393,0.5034623217922607
E01031194,2338,1167,1171,0.4991445680068435,0.5008554319931565
E01031205,1834,899,935,0.49018538713195203,0.509814612868048
E01031206,1576,790,786,0.501269035532995,0.4987309644670051
E01031207,1424,698,726,0.4901685393258427,0.5098314606741573
E01031247,2421,1203,1218,0.4969021065675341,0.5030978934324659
E01031196,2487,1231,1256,0.4949738640932851,0.505026135906715
E01031245,1252,599,653,0.4784345047923323,0.5215654952076677
E01031246,1364,657,707,0.48167155425219943,0.5183284457478006
E01035034,1450,708,742,0.4882758620689655,0.5117241379310344
E01035035,1821,887,934,0.4870950027457441,0.5129049972542559
E01035036,1446,710,736,0.49100968188105115,0.5089903181189488
E01031193,2120,1025,1095,0.4834905660377358,0.5165094339622641
E01031209,2222,1060,1162,0.47704770477047703,0.5229522952295229
E01031214,2434,1181,1253,0.48520953163516845,0.5147904683648316
E01031215,1813,863,950,0.4760066188637617,0.5239933811362383
E01031216,1604,754,850,0.470074812967581,0.529925187032419
E01031254,1705,856,849,0.5020527859237537,0.4979472140762463
E01031255,1442,693,749,0.48058252427184467,0.5194174757281553
E01031256,1663,822,841,0.49428743235117256,0.5057125676488274
E01031257,1492,724,768,0.48525469168900803,0.514745308310992
E01031258,1690,790,900,0.46745562130177515,0.5325443786982249
E01031296,1516,751,765,0.4953825857519789,0.5046174142480211
E01031297,2028,1006,1022,0.4960552268244576,0.5039447731755424
E01031298,1637,760,877,0.46426389737324375,0.5357361026267563
E01031299,1382,676,706,0.48914616497829233,0.5108538350217077
E01031300,1878,933,945,0.4968051118210863,0.5031948881789138
E01031303,1488,734,754,0.4932795698924731,0.5067204301075269
E01031304,1509,764,745,0.5062955599734924,0.4937044400265076
E01031305,1480,703,777,0.475,0.525
E01031306,1430,701,729,0.4902097902097902,0.5097902097902098
E01031307,1398,689,709,0.4928469241773963,0.5071530758226037
E01031281,1610,804,806,0.4993788819875776,0.5006211180124224
E01031282,1652,818,834,0.49515738498789347,0.5048426150121066
E01031283,1291,644,647,0.4988381099922541,0.5011618900077459
E01031284,1253,629,624,0.5019952114924182,0.4980047885075818
E01031277,1529,742,787,0.48528449967298887,0.5147155003270111
E01031278,1737,866,871,0.4985607369027058,0.5014392630972941
E01031279,1381,665,716,0.48153511947863864,0.5184648805213613
E01031280,1267,618,649,0.4877663772691397,0.5122336227308603
E01031301,1879,910,969,0.48430015965939327,0.5156998403406067
E01031302,1030,502,528,0.487378640776699,0.512621359223301
E01031308,4079,2019,2060,0.49497425839666587,0.5050257416033341
E01031273,1292,629,663,0.4868421052631579,0.5131578947368421
E01031274,1540,747,793,0.4850649350649351,0.5149350649350649
E01031275,1223,596,627,0.4873262469337694,0.5126737530662305
E01031276,1470,738,732,0.5020408163265306,0.49795918367346936
E01031272,1729,875,854,0.5060728744939271,0.4939271255060729
E01031285,2282,1119,1163,0.4903593339176161,0.5096406660823839
E01031286,1418,683,735,0.48166431593794073,0.5183356840620592
E01031287,1521,731,790,0.4806048652202498,0.5193951347797502
E01031288,1742,850,892,0.48794489092996557,0.5120551090700345
E01031289,1601,760,841,0.47470331043098063,0.5252966895690193
E01033253,1475,775,700,0.5254237288135594,0.4745762711864407
E01033256,1266,641,625,0.5063191153238547,0.49368088467614535
E01031309,2029,1022,1007,0.5036964021685559,0.49630359783144407
E01031310,1328,634,694,0.47740963855421686,0.5225903614457831
E01031311,1372,645,727,0.47011661807580174,0.5298833819241983
E01031312,1306,637,669,0.4877488514548239,0.5122511485451761
E01031313,1330,676,654,0.5082706766917293,0.4917293233082707
E01031314,1288,627,661,0.48680124223602483,0.5131987577639752
E01031290,1663,872,791,0.5243535778713169,0.4756464221286831
E01031291,1930,1025,905,0.5310880829015544,0.4689119170984456
E01031292,1517,761,756,0.5016479894528675,0.4983520105471325
E01031293,1575,788,787,0.5003174603174603,0.4996825396825397
E01031294,1475,743,732,0.5037288135593221,0.49627118644067797
E01031295,1197,574,623,0.47953216374269003,0.52046783625731
E01031271,1824,934,890,0.5120614035087719,0.48793859649122806
E01031332,1332,672,660,0.5045045045045045,0.4954954954954955
E01031333,1353,683,670,0.5048041389504804,0.49519586104951957
E01031334,1462,733,729,0.5013679890560876,0.49863201094391246
E01031335,1425,773,652,0.5424561403508772,0.4575438596491228
E01031336,2018,1090,928,0.5401387512388504,0.45986124876114964
E01031337,1828,940,888,0.5142231947483589,0.48577680525164113
E01031321,1297,630,667,0.48573631457208943,0.5142636854279106
E01031322,1961,989,972,0.5043345232024478,0.4956654767975523
E01031323,1676,819,857,0.4886634844868735,0.5113365155131265
E01031324,2108,1062,1046,0.5037950664136622,0.49620493358633777
E01031325,1434,713,721,0.49721059972105996,0.50278940027894
E01033254,1427,695,732,0.48703573931324456,0.5129642606867554
E01033255,2794,1345,1449,0.48138869005010737,0.5186113099498926
E01031315,2450,1226,1224,0.5004081632653061,0.4995918367346939
E01031316,1456,719,737,0.49381868131868134,0.5061813186813187
E01031317,1545,793,752,0.5132686084142395,0.4867313915857605
E01031319,1983,977,1006,0.49268784669692384,0.5073121533030761
E01031320,1357,689,668,0.5077376565954311,0.4922623434045689
E01035037,1421,674,747,0.47431386347642507,0.525686136523575
E01035038,1690,855,835,0.5059171597633136,0.4940828402366864
E01035039,1334,638,696,0.4782608695652174,0.5217391304347826
E01031261,1948,1048,900,0.5379876796714579,0.4620123203285421
E01031262,1378,722,656,0.5239477503628447,0.4760522496371553
E01031263,1747,937,810,0.5363480251860332,0.4636519748139668
E01031264,1703,856,847,0.5026423957721667,0.49735760422783326
E01031265,1720,867,853,0.5040697674418605,0.49593023255813956
E01031266,1835,1003,832,0.5465940054495912,0.4534059945504087
E01031259,2902,1424,1478,0.4906960716747071,0.5093039283252929
E01031260,2304,1105,1199,0.4796006944444444,0.5203993055555556
E01031267,1746,859,887,0.4919816723940435,0.5080183276059564
E01031268,2612,1270,1342,0.48621745788667686,0.5137825421133231
E01031269,2079,1002,1077,0.481962481962482,0.5180375180375181
E01031327,1465,725,740,0.4948805460750853,0.5051194539249146
E01031328,2951,1460,1491,0.494747543205693,0.505252456794307
E01031329,2536,1296,1240,0.5110410094637224,0.4889589905362776
E01031330,1509,761,748,0.5043074884029158,0.49569251159708416
E01031331,1828,892,936,0.487964989059081,0.5120350109409191
E01032138,1630,799,831,0.4901840490797546,0.5098159509202455
E01032139,2359,1114,1245,0.47223399745654937,0.5277660025434506
E01032140,1806,847,959,0.4689922480620155,0.5310077519379846
E01032141,1519,768,751,0.5055957867017775,0.49440421329822254
E01032136,1314,652,662,0.4961948249619482,0.5038051750380518
E01032137,1588,754,834,0.4748110831234257,0.5251889168765743
E01032168,1154,570,584,0.49393414211438474,0.5060658578856152
E01032169,1155,571,584,0.49437229437229435,0.5056277056277056
E01032176,2207,1100,1107,0.49841413683733576,0.5015858631626643
E01032126,2062,992,1070,0.481086323957323,0.518913676042677
E01032170,1376,678,698,0.49273255813953487,0.5072674418604651
E01032171,1450,726,724,0.5006896551724138,0.4993103448275862
E01032172,1532,741,791,0.48368146214099217,0.5163185378590078
E01032133,1599,687,912,0.42964352720450283,0.5703564727954972
E01032135,1568,775,793,0.4942602040816326,0.5057397959183674
E01032145,1527,755,772,0.49443352979698757,0.5055664702030125
E01032147,1226,595,631,0.48531810766721045,0.5146818923327896
E01032134,1631,772,859,0.4733292458614347,0.5266707541385653
E01032146,1655,810,845,0.48942598187311176,0.5105740181268882
E01032177,1855,890,965,0.4797843665768194,0.5202156334231806
E01032178,1215,600,615,0.49382716049382713,0.5061728395061729
E01032142,2435,1221,1214,0.5014373716632443,0.49856262833675563
E01032143,1613,795,818,0.49287042777433354,0.5071295722256665
E01032144,2036,960,1076,0.4715127701375246,0.5284872298624754
E01032149,1270,622,648,0.48976377952755906,0.510236220472441
E01032127,1745,846,899,0.4848137535816619,0.5151862464183381
E01032128,1441,693,748,0.48091603053435117,0.5190839694656488
E01032129,1397,695,702,0.49749463135289906,0.5025053686471009
E01032152,1375,642,733,0.4669090909090909,0.5330909090909091
E01032148,1195,547,648,0.4577405857740586,0.5422594142259414
E01032150,1452,716,736,0.4931129476584022,0.5068870523415978
E01032151,1448,700,748,0.48342541436464087,0.5165745856353591
E01032153,2254,1085,1169,0.4813664596273292,0.5186335403726708
E01032155,1687,848,839,0.5026674570243035,0.4973325429756965
E01032122,2310,1134,1176,0.4909090909090909,0.509090909090909
E01032123,1569,780,789,0.497131931166348,0.502868068833652
E01032124,1570,731,839,0.4656050955414013,0.5343949044585987
E01032125,1484,695,789,0.4683288409703504,0.5316711590296496
E01032154,1747,867,880,0.4962793360045793,0.5037206639954207
E01032159,1933,924,1009,0.47801345059493017,0.5219865494050698
E01032160,1700,833,867,0.49,0.51
E01032161,2000,956,1044,0.478,0.522
E01032156,2038,1006,1032,0.49362119725220804,0.5063788027477919
E01032157,1667,758,909,0.4547090581883623,0.5452909418116376
E01032173,1668,823,845,0.4934052757793765,0.5065947242206235
E01032175,1575,780,795,0.49523809523809526,0.5047619047619047
E01032158,1513,728,785,0.48116325181758096,0.518836748182419
E01032162,1904,914,990,0.4800420168067227,0.5199579831932774
E01033059,1546,765,781,0.4948253557567917,0.5051746442432082
E01033061,1855,910,945,0.49056603773584906,0.5094339622641509
E01032131,1618,787,831,0.48640296662546356,0.5135970333745364
E01032132,2011,957,1054,0.47588264545002484,0.5241173545499751
E01032174,1648,791,857,0.4799757281553398,0.5200242718446602
E01034316,1317,653,664,0.49582384206529995,0.5041761579347
E01034317,1430,691,739,0.48321678321678324,0.5167832167832168
E01033060,1137,569,568,0.5004397537379067,0.4995602462620932
E01033062,2264,1125,1139,0.49690812720848054,0.5030918727915195
E01033243,2210,1354,856,0.6126696832579186,0.38733031674208146
E01034318,1424,737,687,0.5175561797752809,0.4824438202247191
E01034319,1272,618,654,0.4858490566037736,0.5141509433962265
E01032193,2294,1126,1168,0.4908456843940715,0.5091543156059285
E01032212,2202,1094,1108,0.49682107175295187,0.5031789282470481
E01032213,1743,854,889,0.4899598393574297,0.5100401606425703
E01032214,2181,1029,1152,0.4718019257221458,0.5281980742778541
E01032181,2208,1095,1113,0.49592391304347827,0.5040760869565217
E01032190,2067,984,1083,0.4760522496371553,0.5239477503628447
E01032199,1992,980,1012,0.4919678714859438,0.5080321285140562
E01032223,2256,1132,1124,0.50177304964539,0.49822695035460995
E01032179,1601,811,790,0.5065584009993754,0.4934415990006246
E01032180,2116,1053,1063,0.4976370510396975,0.5023629489603024
E01032182,2382,1180,1202,0.49538203190596136,0.5046179680940386
E01032183,1568,773,795,0.492984693877551,0.5070153061224489
E01032194,1631,755,876,0.46290619251992643,0.5370938074800736
E01032195,1515,736,779,0.4858085808580858,0.5141914191419142
E01032196,1700,820,880,0.4823529411764706,0.5176470588235295
E01032197,1455,703,752,0.4831615120274914,0.5168384879725086
E01032205,1050,518,532,0.49333333333333335,0.5066666666666667
E01032206,1256,618,638,0.49203821656050956,0.5079617834394905
E01032207,1861,910,951,0.48898441698011824,0.5110155830198818
E01032217,1687,808,879,0.47895672791938354,0.5210432720806165
E01032188,1907,931,976,0.48820136339800735,0.5117986366019927
E01032189,2804,1362,1442,0.48573466476462196,0.514265335235378
E01032220,1400,723,677,0.5164285714285715,0.4835714285714286
E01032221,1216,606,610,0.49835526315789475,0.5016447368421053
E01032222,1367,688,679,0.5032918800292612,0.4967081199707388
E01032201,1675,788,887,0.47044776119402987,0.5295522388059701
E01032202,1681,815,866,0.48483045806067815,0.5151695419393219
E01032203,1447,706,741,0.4879060124395301,0.51209398756047
E01032204,1651,798,853,0.483343428225318,0.516656571774682
E01032191,2896,1395,1501,0.4816988950276243,0.5183011049723757
E01032192,2147,1013,1134,0.47182114578481604,0.528178854215184
E01032211,1886,911,975,0.48303287380699894,0.5169671261930011
E01032184,1462,695,767,0.47537619699042405,0.5246238030095759
E01032185,1487,707,780,0.4754539340954943,0.5245460659045057
E01032186,1350,610,740,0.45185185185185184,0.5481481481481482
E01032187,1689,785,904,0.46477205447010067,0.5352279455298994
E01032208,1499,745,754,0.4969979986657772,0.5030020013342228
E01032209,1606,795,811,0.4950186799501868,0.5049813200498132
E01032210,1137,535,602,0.47053649956024624,0.5294635004397538
E01032218,1529,719,810,0.4702419882275997,0.5297580117724002
E01032219,1634,789,845,0.4828641370869033,0.5171358629130967
E01032198,2156,1075,1081,0.49860853432282004,0.50139146567718
E01032200,2433,1172,1261,0.48170982326346073,0.5182901767365392
E01032215,1064,515,549,0.48402255639097747,0.5159774436090225
E01032216,1595,777,818,0.4871473354231975,0.5128526645768025
E01032226,2806,1366,1440,0.4868139700641482,0.5131860299358517
E01032227,1059,514,545,0.48536355051935787,0.5146364494806421
E01032243,1310,651,659,0.49694656488549616,0.5030534351145038
E01032244,1463,726,737,0.49624060150375937,0.5037593984962406
E01032240,1244,610,634,0.4903536977491961,0.5096463022508039
E01032241,1302,609,693,0.46774193548387094,0.532258064516129
E01032242,1367,665,702,0.4864667154352597,0.5135332845647403
E01032245,1536,744,792,0.484375,0.515625
E01032232,1527,775,752,0.5075311067452521,0.49246889325474785
E01032234,1900,920,980,0.4842105263157895,0.5157894736842106
E01032235,1792,861,931,0.48046875,0.51953125
E01034320,1533,751,782,0.48988910632746246,0.5101108936725375
E01034321,1148,556,592,0.4843205574912892,0.5156794425087108
E01034322,1438,724,714,0.5034770514603616,0.4965229485396384
E01032224,1927,1006,921,0.5220550077841204,0.4779449922158796
E01032225,1152,580,572,0.5034722222222222,0.4965277777777778
E01032239,1870,960,910,0.5133689839572193,0.48663101604278075
E01032262,2068,1068,1000,0.5164410058027079,0.4835589941972921
E01032273,1319,655,664,0.4965883244882487,0.5034116755117514
E01032275,1414,706,708,0.49929278642149927,0.5007072135785007
E01032277,1237,616,621,0.49797898140662894,0.502021018593371
E01032278,1556,763,793,0.4903598971722365,0.5096401028277635
E01032236,1839,938,901,0.5100598151169113,0.48994018488308866
E01032237,1404,678,726,0.4829059829059829,0.5170940170940171
E01032238,1360,700,660,0.5147058823529411,0.4852941176470588
E01032264,1767,875,892,0.4951895868704018,0.5048104131295982
E01032255,1395,718,677,0.5146953405017921,0.4853046594982079
E01032263,1741,846,895,0.4859276278001149,0.5140723721998851
E01032266,1550,776,774,0.5006451612903225,0.4993548387096774
E01032274,1254,634,620,0.5055821371610846,0.4944178628389155
E01032259,1399,661,738,0.47248034310221587,0.5275196568977841
E01032269,1599,783,816,0.4896810506566604,0.5103189493433395
E01032270,1444,712,732,0.4930747922437673,0.5069252077562327
E01032271,2112,1072,1040,0.5075757575757576,0.49242424242424243
E01032272,1197,576,621,0.48120300751879697,0.518796992481203
E01032253,1604,785,819,0.48940149625935164,0.5105985037406484
E01032265,1624,772,852,0.4753694581280788,0.5246305418719212
E01032267,1785,903,882,0.5058823529411764,0.49411764705882355
E01032268,1161,578,583,0.49784668389319553,0.5021533161068045
E01032276,1463,737,726,0.5037593984962406,0.49624060150375937
E01032250,1371,688,683,0.5018234865061999,0.49817651349380015
E01032251,1772,875,897,0.4937923250564334,0.5062076749435666
E01032252,1404,715,689,0.5092592592592593,0.49074074074074076
E01032254,2236,1072,1164,0.47942754919499103,0.5205724508050089
E01032256,1348,649,699,0.4814540059347181,0.5185459940652819
E01032257,1388,704,684,0.5072046109510087,0.49279538904899134
E01032258,1469,715,754,0.48672566371681414,0.5132743362831859
E01032260,1363,639,724,0.46881878209831257,0.5311812179016875
E01032246,1368,662,706,0.48391812865497075,0.5160818713450293
E01032247,1370,649,721,0.4737226277372263,0.5262773722627737
E01032248,1352,679,673,0.5022189349112426,0.4977810650887574
E01032249,1485,752,733,0.5063973063973064,0.4936026936026936
E01032261,1396,697,699,0.4992836676217765,0.5007163323782235
E01032228,1307,649,658,0.49655700076511095,0.5034429992348891
E01032229,1386,661,725,0.4769119769119769,0.523088023088023
E01032230,1500,708,792,0.472,0.528
E01032231,1856,904,952,0.4870689655172414,0.5129310344827587
E01032296,1558,772,786,0.49550706033376124,0.5044929396662388
E01032297,1604,792,812,0.4937655860349127,0.5062344139650873
E01032298,1852,911,941,0.4919006479481641,0.5080993520518359
E01032299,1553,789,764,0.5080489375402447,0.49195106245975534
E01032300,1652,786,866,0.47578692493946734,0.5242130750605327
E01032303,1312,636,676,0.4847560975609756,0.5152439024390244
E01032304,1518,761,757,0.5013175230566534,0.4986824769433465
E01032331,1386,679,707,0.4898989898989899,0.51010101010101
E01032332,1314,617,697,0.469558599695586,0.530441400304414
E01032330,1184,586,598,0.49493243243243246,0.5050675675675675
E01032334,2307,1122,1185,0.48634590377113135,0.5136540962288687
E01032335,1527,771,756,0.5049115913555993,0.4950884086444008
E01032336,1481,713,768,0.4814314652261985,0.5185685347738015
E01032279,1280,625,655,0.48828125,0.51171875
E01032312,1435,699,736,0.4871080139372822,0.5128919860627178
E01032327,2126,1010,1116,0.47507055503292567,0.5249294449670743
E01032328,1463,697,766,0.4764183185235817,0.5235816814764184
E01032329,1998,994,1004,0.4974974974974975,0.5025025025025025
E01032301,1408,687,721,0.48792613636363635,0.5120738636363636
E01032302,1410,737,673,0.5226950354609929,0.4773049645390071
E01032310,1550,783,767,0.5051612903225806,0.49483870967741933
E01032311,1532,762,770,0.49738903394255873,0.5026109660574413
E01032313,1326,636,690,0.4796380090497738,0.5203619909502263
E01032333,1988,970,1018,0.4879275653923541,0.5120724346076458
E01032314,1179,539,640,0.457167090754877,0.542832909245123
E01032315,1926,799,1127,0.4148494288681205,0.5851505711318795
E01032316,1143,541,602,0.47331583552055995,0.5266841644794401
E01032317,1486,705,781,0.47442799461641993,0.5255720053835801
E01032280,1677,807,870,0.481216457960644,0.518783542039356
E01032281,1377,691,686,0.5018155410312273,0.49818445896877267
E01032282,1782,917,865,0.5145903479236813,0.48540965207631875
E01033246,1263,652,611,0.5162311955661124,0.4837688044338876
E01033247,1238,654,584,0.5282714054927302,0.4717285945072698
E01032337,2571,1223,1348,0.47569039284325165,0.5243096071567483
E01032338,1976,981,995,0.4964574898785425,0.5035425101214575
E01032339,1734,827,907,0.47693194925028837,0.5230680507497116
E01032318,1733,831,902,0.47951529140219273,0.5204847085978073
E01032319,1874,917,957,0.48932764140875135,0.5106723585912487
E01032320,1668,777,891,0.4658273381294964,0.5341726618705036
E01032321,1924,924,1000,0.4802494802494803,0.5197505197505198
E01032322,1784,865,919,0.4848654708520179,0.5151345291479821
E01032305,1716,845,871,0.49242424242424243,0.5075757575757576
E01032306,1539,776,763,0.5042235217673814,0.49577647823261856
E01032307,1948,995,953,0.5107802874743327,0.48921971252566737
E01032309,1734,853,881,0.49192618223760093,0.5080738177623991
E01032285,1704,848,856,0.49765258215962443,0.5023474178403756
E01032292,1647,874,773,0.5306618093503339,0.4693381906496661
E01032294,1526,749,777,0.4908256880733945,0.5091743119266054
E01033248,1225,640,585,0.5224489795918368,0.4775510204081633
E01033249,1357,739,618,0.5445836403831983,0.45541635961680177
E01032286,2680,1250,1430,0.4664179104477612,0.5335820895522388
E01032287,1617,772,845,0.4774273345701917,0.5225726654298083
E01032288,1559,770,789,0.4939063502245029,0.5060936497754971
E01032289,1466,722,744,0.4924965893587995,0.5075034106412005
E01032290,1415,698,717,0.49328621908127207,0.5067137809187279
E01032283,1746,853,893,0.488545246277205,0.5114547537227949
E01032284,1984,988,996,0.49798387096774194,0.5020161290322581
E01032308,2018,960,1058,0.4757185332011893,0.5242814667988107
E01034323,1716,853,863,0.4970862470862471,0.502913752913753
E01034324,1529,756,773,0.4944408109875736,0.5055591890124265
E01032323,1511,737,774,0.4877564526803441,0.5122435473196558
E01032324,1307,624,683,0.4774292272379495,0.5225707727620506
E01032325,1482,712,770,0.48043184885290147,0.5195681511470985
E01032326,1347,675,672,0.5011135857461024,0.49888641425389757
E01032386,1437,684,753,0.4759916492693111,0.524008350730689
E01032387,1647,834,813,0.5063752276867031,0.4936247723132969
E01032401,2725,1294,1431,0.4748623853211009,0.5251376146788991
E01034325,1607,798,809,0.49657747355320475,0.5034225264467953
E01034326,1379,696,683,0.504713560551124,0.495286439448876
E01032368,1283,642,641,0.5003897116134061,0.49961028838659394
E01032369,1569,767,802,0.4888463989802422,0.5111536010197578
E01032370,1242,586,656,0.4718196457326892,0.5281803542673108
E01032371,1315,647,668,0.4920152091254753,0.5079847908745247
E01032359,1823,853,970,0.46791003839824463,0.5320899616017554
E01032360,1926,901,1025,0.46780893042575283,0.5321910695742471
E01032361,1679,807,872,0.4806432400238237,0.5193567599761763
E01032357,1111,549,562,0.49414941494149417,0.5058505850585059
E01032358,1387,703,684,0.5068493150684932,0.4931506849315068
E01032365,1826,849,977,0.4649507119386637,0.5350492880613362
E01032367,1546,716,830,0.463130659767141,0.536869340232859
E01032363,1540,764,776,0.4961038961038961,0.5038961038961038
E01032364,1676,810,866,0.48329355608591884,0.5167064439140812
E01032366,1578,764,814,0.4841571609632446,0.5158428390367554
E01034327,1723,822,901,0.4770748694138131,0.5229251305861868
E01034328,1814,882,932,0.4862183020948181,0.5137816979051819
E01032399,2383,1154,1229,0.4842635333613093,0.5157364666386908
E01032400,2536,1234,1302,0.4865930599369085,0.5134069400630915
E01032404,2466,1237,1229,0.5016220600162206,0.4983779399837794
E01032345,1505,734,771,0.4877076411960133,0.5122923588039867
E01032346,1449,698,751,0.48171152518978605,0.5182884748102139
E01032395,1327,661,666,0.4981160512434062,0.5018839487565938
E01032417,1525,736,789,0.48262295081967216,0.5173770491803279
E01032392,1654,816,838,0.49334945586457074,0.5066505441354293
E01032393,1818,884,934,0.48624862486248627,0.5137513751375138
E01032394,1214,621,593,0.5115321252059308,0.48846787479406917
E01032416,1178,578,600,0.4906621392190153,0.5093378607809848
E01032355,1563,791,772,0.5060780550223928,0.49392194497760716
E01032356,1184,566,618,0.4780405405405405,0.5219594594594594
E01032402,1592,794,798,0.49874371859296485,0.5012562814070352
E01032403,2367,1124,1243,0.4748626953950148,0.5251373046049852
E01032375,1163,586,577,0.5038693035253654,0.4961306964746346
E01032382,1304,640,664,0.49079754601226994,0.50920245398773
E01032383,1486,719,767,0.4838492597577389,0.5161507402422612
E01032410,1400,719,681,0.5135714285714286,0.48642857142857143
E01032411,1842,928,914,0.503800217155266,0.496199782844734
E01032390,1694,810,884,0.4781582054309327,0.5218417945690673
E01032391,1356,667,689,0.4918879056047198,0.5081120943952803
E01032414,1542,769,773,0.4987029831387808,0.5012970168612192
E01032415,1879,1173,706,0.6242682277807344,0.37573177221926557
E01032405,1824,897,927,0.4917763157894737,0.5082236842105263
E01032406,1335,626,709,0.4689138576779026,0.5310861423220974
E01032407,1446,723,723,0.5,0.5
E01032408,1364,660,704,0.4838709677419355,0.5161290322580645
E01032409,2432,1133,1299,0.46587171052631576,0.5341282894736842
E01032340,1908,922,986,0.4832285115303983,0.5167714884696016
E01032341,1386,692,694,0.49927849927849927,0.5007215007215007
E01032349,1761,843,918,0.4787052810902896,0.5212947189097104
E01032350,1190,558,632,0.4689075630252101,0.5310924369747899
E01032388,1381,680,701,0.49239681390296886,0.5076031860970311
E01032389,1393,669,724,0.48025843503230436,0.5197415649676956
E01032377,1902,993,909,0.5220820189274448,0.47791798107255523
E01032378,1780,861,919,0.4837078651685393,0.5162921348314606
E01034329,1289,674,615,0.5228859581070597,0.47711404189294027
E01034330,1307,662,645,0.5065034429992349,0.4934965570007651
E01032376,1517,747,770,0.4924192485168095,0.5075807514831905
E01032384,1595,795,800,0.49843260188087773,0.5015673981191222
E01032385,2222,1071,1151,0.481998199819982,0.518001800180018
E01032396,1786,896,890,0.5016797312430011,0.49832026875699886
E01032342,2969,1436,1533,0.48366453351296734,0.5163354664870327
E01032344,2285,1147,1138,0.5019693654266958,0.49803063457330415
E01032379,1750,871,879,0.4977142857142857,0.5022857142857143
E01032380,1491,721,770,0.4835680751173709,0.5164319248826291
E01032381,1843,918,925,0.4981009224091156,0.5018990775908845
E01032397,2321,1122,1199,0.4834123222748815,0.5165876777251185
E01032398,1627,791,836,0.4861708666256915,0.5138291333743086
E01032351,1878,884,994,0.47071352502662406,0.5292864749733759
E01032352,1477,736,741,0.4983073798239675,0.5016926201760324
E01032353,1604,771,833,0.48067331670822944,0.5193266832917706
E01032374,1355,658,697,0.48560885608856086,0.5143911439114391
E01032347,1309,637,672,0.48663101604278075,0.5133689839572193
E01032348,1347,649,698,0.48181143281366,0.51818856718634
E01032372,1480,721,759,0.4871621621621622,0.5128378378378379
E01032373,1285,650,635,0.5058365758754864,0.49416342412451364
E01032412,1244,611,633,0.49115755627009644,0.5088424437299035
E01032413,1149,559,590,0.4865100087032202,0.5134899912967799
E01032431,1556,777,779,0.4993573264781491,0.5006426735218509
E01032432,1565,880,685,0.5623003194888179,0.43769968051118213
E01032433,1505,722,783,0.479734219269103,0.520265780730897
E01032439,1349,659,690,0.48851000741289846,0.5114899925871016
E01032440,1184,564,620,0.47635135135135137,0.5236486486486487
E01032479,2422,1173,1249,0.4843104872006606,0.5156895127993394
E01032441,1211,594,617,0.49050371593724196,0.509496284062758
E01032442,1627,786,841,0.4830977258758451,0.5169022741241549
E01032443,1317,635,682,0.48215641609719057,0.5178435839028094
E01032444,1251,618,633,0.4940047961630695,0.5059952038369304
E01032445,1594,773,821,0.4849435382685069,0.5150564617314931
E01032436,1509,760,749,0.5036447978793903,0.4963552021206097
E01032438,1519,749,770,0.4930875576036866,0.5069124423963134
E01032446,1413,672,741,0.47558386411889597,0.524416135881104
E01032447,1480,727,753,0.4912162162162162,0.5087837837837837
E01032448,1148,563,585,0.490418118466899,0.509581881533101
E01032434,2322,1145,1177,0.49310938845822566,0.5068906115417743
E01032435,1476,738,738,0.5,0.5
E01032437,1845,909,936,0.4926829268292683,0.5073170731707317
E01034331,1085,577,508,0.5317972350230414,0.4682027649769585
E01034332,1649,817,832,0.4954517889630079,0.5045482110369921
E01032430,1814,906,908,0.4994487320837927,0.5005512679162073
E01032480,1733,852,881,0.4916330063473745,0.5083669936526255
E01032481,1848,879,969,0.47564935064935066,0.5243506493506493
E01032482,1362,661,701,0.4853157121879589,0.5146842878120411
E01032451,1499,745,754,0.4969979986657772,0.5030020013342228
E01032452,1562,771,791,0.49359795134443024,0.5064020486555698
E01032453,1820,853,967,0.4686813186813187,0.5313186813186813
E01032454,1800,884,916,0.4911111111111111,0.5088888888888888
E01032449,1599,823,776,0.5146966854283928,0.48530331457160725
E01032464,1480,687,793,0.46418918918918917,0.5358108108108108
E01032465,1526,736,790,0.48230668414154654,0.5176933158584535
E01032466,1350,637,713,0.47185185185185186,0.5281481481481481
E01032467,1172,578,594,0.4931740614334471,0.5068259385665529
E01032468,1099,519,580,0.47224749772520475,0.5277525022747953
E01032474,1802,937,865,0.5199778024417314,0.4800221975582686
E01032475,1665,838,827,0.5033033033033033,0.4966966966966967
E01032476,1396,673,723,0.4820916905444126,0.5179083094555874
E01032477,1178,580,598,0.4923599320882852,0.5076400679117148
E01032478,1524,763,761,0.5006561679790026,0.49934383202099736
E01032469,1693,849,844,0.5014766686355582,0.4985233313644418
E01032471,1631,784,847,0.48068669527896996,0.51931330472103
E01034333,1344,672,672,0.5,0.5
E01034334,1430,685,745,0.479020979020979,0.5209790209790209
E01032418,1300,681,619,0.5238461538461539,0.47615384615384615
E01032419,1269,603,666,0.475177304964539,0.524822695035461
E01032420,1231,608,623,0.4939073923639318,0.5060926076360682
E01032421,1156,569,587,0.4922145328719723,0.5077854671280276
E01032422,1438,678,760,0.4714881780250348,0.5285118219749653
E01032427,1527,756,771,0.4950884086444008,0.5049115913555993
E01032428,1548,772,776,0.49870801033591733,0.5012919896640827
E01032429,1458,690,768,0.4732510288065844,0.5267489711934157
E01032472,1251,637,614,0.5091926458832934,0.4908073541167066
E01032473,1421,703,718,0.49472202674173116,0.5052779732582688
E01032455,1437,691,746,0.48086290883785665,0.5191370911621433
E01032456,1249,577,672,0.46196957566052843,0.5380304243394716
E01032457,1498,700,798,0.4672897196261682,0.5327102803738317
E01032458,1513,762,751,0.5036351619299405,0.4963648380700595
E01032459,1480,727,753,0.4912162162162162,0.5087837837837837
E01032460,1817,863,954,0.47495872317006055,0.5250412768299395
E01032461,1969,966,1003,0.4906043676993398,0.5093956323006602
E01032462,2175,1045,1130,0.4804597701149425,0.5195402298850574
E01032463,1613,768,845,0.47613143211407316,0.5238685678859268
E01032423,1699,827,872,0.48675691583284286,0.5132430841671571
E01032424,1403,689,714,0.49109052031361367,0.5089094796863863
E01032425,1395,675,720,0.4838709677419355,0.5161290322580645
E01032426,1406,683,723,0.48577524893314367,0.5142247510668563
E01009417,1612,785,827,0.4869727047146402,0.5130272952853598
E01009418,1586,726,860,0.45775535939470363,0.5422446406052963
E01009419,1464,717,747,0.48975409836065575,0.5102459016393442
E01009433,1789,855,934,0.47792062604807156,0.5220793739519285
E01009415,1747,869,878,0.497424155695478,0.5025758443045221
E01009422,2001,962,1039,0.48075962018990503,0.519240379810095
E01009423,1672,788,884,0.47129186602870815,0.5287081339712919
E01009425,1722,820,902,0.47619047619047616,0.5238095238095238
E01009416,2795,1346,1449,0.4815742397137746,0.5184257602862254
E01009420,1702,813,889,0.47767332549941244,0.5223266745005876
E01009426,1477,711,766,0.4813811780636425,0.5186188219363574
E01009429,1496,739,757,0.4939839572192513,0.5060160427807486
E01009431,1689,826,863,0.48904677323860274,0.5109532267613973
E01009421,1715,820,895,0.478134110787172,0.521865889212828
E01009424,1582,772,810,0.4879898862199747,0.5120101137800253
E01009427,1489,761,728,0.5110812625923439,0.4889187374076561
E01009428,1681,828,853,0.4925639500297442,0.5074360499702558
E01009430,1724,857,867,0.4970997679814385,0.5029002320185615
E01009468,1495,715,780,0.4782608695652174,0.5217391304347826
E01009445,1892,829,1063,0.4381606765327696,0.5618393234672304
E01009446,2488,1163,1325,0.467443729903537,0.532556270096463
E01009447,1651,809,842,0.4900060569351908,0.5099939430648092
E01009448,1651,788,863,0.47728649303452453,0.5227135069654755
E01009452,1706,807,899,0.4730363423212192,0.5269636576787807
E01009455,1295,637,658,0.4918918918918919,0.5081081081081081
E01009432,1499,736,763,0.49099399599733157,0.5090060040026685
E01009435,1717,820,897,0.4775771694816541,0.5224228305183459
E01009437,1792,872,920,0.48660714285714285,0.5133928571428571
E01009444,1499,758,741,0.5056704469646431,0.4943295530353569
E01009454,1424,703,721,0.4936797752808989,0.5063202247191011
E01009221,1527,760,767,0.4977079240340537,0.5022920759659463
E01009464,1411,715,696,0.5067328136073707,0.49326718639262934
E01009465,1434,707,727,0.4930264993026499,0.50697350069735
E01009467,1564,771,793,0.4929667519181586,0.5070332480818415
E01009220,1557,733,824,0.4707771355170199,0.5292228644829801
E01009222,1522,739,783,0.4855453350854139,0.514454664914586
E01009224,1408,671,737,0.4765625,0.5234375
E01009233,1623,769,854,0.4738139248305607,0.5261860751694393
E01009449,2156,1058,1098,0.4907235621521336,0.5092764378478665
E01009451,1434,696,738,0.48535564853556484,0.5146443514644351
E01009453,1373,686,687,0.4996358339402768,0.5003641660597232
E01009466,1691,802,889,0.4742755765819042,0.5257244234180958
E01009471,1819,880,939,0.4837822979659153,0.5162177020340847
E01009135,1406,711,695,0.5056899004267426,0.49431009957325744
E01009469,1461,702,759,0.4804928131416838,0.5195071868583162
E01009470,1439,708,731,0.49200833912439196,0.5079916608756081
E01009472,1670,806,864,0.48263473053892214,0.5173652694610779
E01009473,1563,764,799,0.4888035828534869,0.5111964171465131
E01009474,1565,772,793,0.49329073482428115,0.5067092651757189
E01009127,1543,739,804,0.47893713545042127,0.5210628645495787
E01009128,1376,679,697,0.4934593023255814,0.5065406976744186
E01009130,1501,730,771,0.48634243837441704,0.513657561625583
E01009131,1471,728,743,0.49490142760027195,0.5050985723997281
E01009133,1485,705,780,0.47474747474747475,0.5252525252525253
E01009134,1683,831,852,0.49376114081996436,0.5062388591800356
E01009137,1606,762,844,0.47447073474470736,0.5255292652552926
E01009434,1652,794,858,0.48062953995157387,0.5193704600484261
E01009436,1382,684,698,0.49493487698986977,0.5050651230101303
E01009438,1355,661,694,0.4878228782287823,0.5121771217712177
E01009440,1576,731,845,0.46383248730964466,0.5361675126903553
E01009450,1605,793,812,0.4940809968847352,0.5059190031152648
E01009223,1591,738,853,0.46385920804525455,0.5361407919547454
E01009225,1632,758,874,0.4644607843137255,0.5355392156862745
E01009227,1659,809,850,0.48764315852923446,0.5123568414707655
E01009228,1558,761,797,0.4884467265725289,0.5115532734274711
E01009122,1635,775,860,0.4740061162079511,0.5259938837920489
E01009129,1600,776,824,0.485,0.515
E01009132,1547,767,780,0.4957983193277311,0.5042016806722689
E01009136,1759,824,935,0.46844798180784536,0.5315520181921546
E01034913,1160,523,637,0.4508620689655172,0.5491379310344827
E01034914,1901,866,1035,0.45554971067859024,0.5444502893214098
E01009457,1506,731,775,0.4853917662682603,0.5146082337317397
E01009459,1591,770,821,0.48397234443746073,0.5160276555625393
E01009461,1305,649,656,0.49731800766283524,0.5026819923371647
E01009463,1560,746,814,0.4782051282051282,0.5217948717948718
E01009235,1662,821,841,0.49398315282791816,0.5060168471720818
E01009243,1815,856,959,0.4716253443526171,0.528374655647383
E01009245,1472,751,721,0.5101902173913043,0.4898097826086957
E01009246,1559,765,794,0.490699166132136,0.5093008338678641
E01009247,1558,738,820,0.47368421052631576,0.5263157894736842
E01009226,1459,726,733,0.4976010966415353,0.5023989033584647
E01009229,1590,786,804,0.49433962264150944,0.5056603773584906
E01009230,1654,802,852,0.4848851269649335,0.5151148730350665
E01009231,1936,938,998,0.484504132231405,0.515495867768595
E01009001,1679,803,876,0.4782608695652174,0.5217391304347826
E01009003,1765,881,884,0.4991501416430595,0.5008498583569405
E01009456,1718,853,865,0.49650756693830034,0.5034924330616997
E01009458,1385,628,757,0.45342960288808665,0.5465703971119134
E01009460,1585,791,794,0.49905362776025236,0.5009463722397476
E01009462,1583,768,815,0.48515476942514213,0.5148452305748579
E01009234,1465,672,793,0.45870307167235497,0.5412969283276451
E01009236,1553,764,789,0.49195106245975534,0.5080489375402447
E01009244,1885,896,989,0.4753315649867374,0.5246684350132625
E01009248,1759,852,907,0.48436611711199545,0.5156338828880046
E01009403,1578,767,811,0.48605830164765523,0.5139416983523447
E01009404,1593,761,832,0.47771500313873194,0.5222849968612681
E01009405,1487,714,773,0.4801613987895091,0.519838601210491
E01009406,1750,849,901,0.48514285714285715,0.5148571428571429
E01009407,1749,869,880,0.4968553459119497,0.5031446540880503
E01009439,1446,713,733,0.4930843706777317,0.5069156293222683
E01009441,1476,749,727,0.5074525745257452,0.49254742547425473
E01009442,1461,716,745,0.49007529089664614,0.5099247091033539
E01009443,1213,571,642,0.47073371805441055,0.5292662819455894
E01009123,1625,771,854,0.47446153846153843,0.5255384615384615
E01009124,2097,916,1181,0.4368144969003338,0.5631855030996662
E01009125,2037,991,1046,0.48649975454099165,0.5135002454590083
E01009232,1561,742,819,0.47533632286995514,0.5246636771300448
E01009002,2050,946,1104,0.46146341463414636,0.5385365853658537
E01009006,1556,796,760,0.5115681233933161,0.4884318766066838
E01009007,1820,966,854,0.5307692307692308,0.46923076923076923
E01034915,1871,842,1029,0.450026723677178,0.549973276322822
E01034916,1495,766,729,0.5123745819397993,0.48762541806020065
E01009237,1472,703,769,0.47758152173913043,0.5224184782608695
E01009238,1756,874,882,0.4977220956719818,0.5022779043280182
E01009240,1524,730,794,0.479002624671916,0.520997375328084
E01009241,1781,884,897,0.49635036496350365,0.5036496350364964
E01009242,2072,1071,1001,0.5168918918918919,0.4831081081081081
E01009005,1755,866,889,0.49344729344729343,0.5065527065527066
E01009009,1487,739,748,0.4969737726967048,0.5030262273032953
E01009098,2112,1019,1093,0.4824810606060606,0.5175189393939394
E01009100,1934,902,1032,0.46639089968976216,0.5336091003102379
E01009105,1796,872,924,0.48552338530066813,0.5144766146993318
E01009126,1487,721,766,0.48486886348352387,0.5151311365164761
E01009408,1777,855,922,0.4811480022509848,0.5188519977490152
E01009409,1847,968,879,0.5240931239848403,0.47590687601515974
E01009410,1919,949,970,0.4945284002084419,0.5054715997915581
E01009096,1675,817,858,0.48776119402985074,0.5122388059701493
E01009097,2048,934,1114,0.4560546875,0.5439453125
E01009099,1759,785,974,0.44627629334849345,0.5537237066515065
E01009101,1520,668,852,0.4394736842105263,0.5605263157894737
E01009103,1575,709,866,0.45015873015873015,0.5498412698412698
E01009106,1358,643,715,0.4734904270986745,0.5265095729013255
E01008915,1781,888,893,0.4985962942167322,0.5014037057832679
E01009411,1899,898,1001,0.4728804634017904,0.5271195365982095
E01009412,1788,937,851,0.5240492170022372,0.4759507829977629
E01009413,1812,926,886,0.5110375275938189,0.488962472406181
E01009414,2358,1160,1198,0.4919423240033927,0.5080576759966073
E01008998,1914,922,992,0.48171368861024033,0.5182863113897597
E01008999,1586,800,786,0.5044136191677175,0.49558638083228246
E01009000,1738,908,830,0.522439585730725,0.47756041426927504
E01009013,2018,1007,1011,0.4990089197224975,0.5009910802775025
E01009400,1687,855,832,0.5068168346176645,0.49318316538233553
E01009401,1854,973,881,0.5248112189859763,0.47518878101402373
E01033630,1227,636,591,0.5183374083129584,0.48166259168704156
E01033646,1831,960,871,0.5243036592026216,0.4756963407973785
E01009049,1642,811,831,0.4939098660170524,0.5060901339829477
E01009056,2251,1125,1126,0.49977787649933364,0.5002221235006664
E01009263,1631,820,811,0.5027590435315757,0.49724095646842426
E01009264,1829,848,981,0.46364133406232916,0.5363586659376709
E01009265,1795,917,878,0.5108635097493036,0.4891364902506964
E01009051,1814,912,902,0.5027563395810364,0.4972436604189636
E01009053,1628,821,807,0.5042997542997543,0.4957002457002457
E01009054,1641,791,850,0.48202315661182205,0.517976843388178
E01009058,1975,1033,942,0.5230379746835443,0.4769620253164557
E01009061,1868,886,982,0.4743040685224839,0.525695931477516
E01009239,1472,761,711,0.516983695652174,0.4830163043478261
E01009266,1781,889,892,0.4991577765300393,0.5008422234699607
E01009269,1474,750,724,0.508819538670285,0.49118046132971505
E01009270,2009,1012,997,0.5037332005973121,0.4962667994026879
E01009271,1621,788,833,0.486119679210364,0.5138803207896361
E01009273,1587,790,797,0.49779458097038437,0.5022054190296156
E01009050,2264,1099,1165,0.48542402826855124,0.5145759717314488
E01009057,1984,978,1006,0.49294354838709675,0.5070564516129032
E01009059,1796,963,833,0.5361915367483296,0.46380846325167036
E01009060,1753,903,850,0.5151169423844837,0.48488305761551626
E01034917,1673,845,828,0.5050806933652122,0.4949193066347878
E01034918,1738,901,837,0.5184119677790564,0.4815880322209436
E01009268,1471,723,748,0.49150237933378654,0.5084976206662135
E01009272,1394,653,741,0.4684361549497848,0.5315638450502153
E01009274,2065,1055,1010,0.5108958837772397,0.4891041162227603
E01009349,1665,802,863,0.4816816816816817,0.5183183183183183
E01009351,1723,855,868,0.4962275101567034,0.5037724898432966
E01009354,1559,778,781,0.4990378447722899,0.50096215522771
E01008899,1295,654,641,0.505019305019305,0.49498069498069497
E01008901,1811,937,874,0.5173937051352844,0.4826062948647156
E01008916,1754,889,865,0.5068415051311288,0.49315849486887114
E01034919,1663,832,831,0.5003006614552015,0.49969933854479853
E01034920,1883,974,909,0.5172596919808816,0.48274030801911844
E01009275,1789,905,884,0.5058692006707658,0.4941307993292342
E01009350,1632,824,808,0.5049019607843137,0.4950980392156863
E01009352,1808,943,865,0.521570796460177,0.478429203539823
E01009353,1711,869,842,0.5078901227352426,0.49210987726475747
E01009355,1435,719,716,0.5010452961672474,0.4989547038327526
E01034921,1426,745,681,0.5224403927068724,0.47755960729312763
E01034922,1600,777,823,0.485625,0.514375
E01008905,1946,990,956,0.5087358684480987,0.49126413155190135
E01008907,1804,927,877,0.5138580931263859,0.4861419068736142
E01009047,1798,927,871,0.5155728587319244,0.4844271412680756
E01009048,2048,1146,902,0.5595703125,0.4404296875
E01009062,1856,908,948,0.4892241379310345,0.5107758620689655
E01008909,2124,1002,1122,0.4717514124293785,0.5282485875706214
E01034923,1757,909,848,0.5173591348890154,0.48264086511098464
E01034924,1558,820,738,0.5263157894736842,0.47368421052631576
E01034925,1689,830,859,0.49141503848431023,0.5085849615156898
E01034926,1540,755,785,0.4902597402597403,0.5097402597402597
E01009084,1987,959,1028,0.482637141419225,0.517362858580775
E01009085,2098,1012,1086,0.48236415633937085,0.5176358436606292
E01009087,1792,895,897,0.4994419642857143,0.5005580357142857
E01009089,1791,933,858,0.5209380234505863,0.47906197654941374
E01009090,2150,1073,1077,0.4990697674418605,0.5009302325581395
E01009201,1951,954,997,0.48898001025115323,0.5110199897488468
E01009202,1783,838,945,0.4699943914750421,0.5300056085249579
E01034927,1770,816,954,0.4610169491525424,0.5389830508474577
E01034928,1505,720,785,0.47840531561461797,0.521594684385382
E01009082,1514,717,797,0.47357992073976224,0.5264200792602378
E01009086,2210,1112,1098,0.5031674208144796,0.4968325791855204
E01009480,2092,1022,1070,0.48852772466539196,0.511472275334608
E01009481,2752,1383,1369,0.5025436046511628,0.49745639534883723
E01009486,2229,1073,1156,0.48138178555406014,0.5186182144459399
E01009487,2196,1066,1130,0.4854280510018215,0.5145719489981785
E01009088,1592,733,859,0.46042713567839194,0.539572864321608
E01009091,1677,792,885,0.47227191413237923,0.5277280858676208
E01009305,1676,797,879,0.4755369928400955,0.5244630071599046
E01009307,1561,758,803,0.4855861627162076,0.5144138372837924
E01009309,1833,847,986,0.46208401527550463,0.5379159847244953
E01009304,1847,885,962,0.47915538711423933,0.5208446128857607
E01009306,1684,806,878,0.47862232779097386,0.5213776722090261
E01009308,1895,856,1039,0.45171503957783643,0.5482849604221636
E01009310,1997,888,1109,0.44466700050075114,0.5553329994992489
E01009348,2097,989,1108,0.4716261325703386,0.5283738674296614
E01009358,2248,1188,1060,0.5284697508896797,0.47153024911032027
E01009359,2067,1036,1031,0.5012094823415578,0.4987905176584422
E01009360,2785,1310,1475,0.4703770197486535,0.5296229802513465
E01009361,2192,1086,1106,0.4954379562043796,0.5045620437956204
E01009478,2116,1025,1091,0.4844045368620038,0.5155954631379962
E01009479,2236,1100,1136,0.4919499105545617,0.5080500894454383
E01009482,1745,865,880,0.49570200573065903,0.504297994269341
E01009484,1814,922,892,0.5082690187431091,0.49173098125689085
E01009485,2052,996,1056,0.4853801169590643,0.5146198830409356
E01008906,1987,989,998,0.49773527931555106,0.5022647206844489
E01008911,1943,941,1002,0.4843026248069995,0.5156973751930005
E01009347,1581,746,835,0.47185325743200507,0.528146742567995
E01033559,1482,846,636,0.5708502024291497,0.4291497975708502
E01033638,1968,976,992,0.4959349593495935,0.5040650406504065
E01008910,1755,858,897,0.4888888888888889,0.5111111111111111
E01008913,2257,1075,1182,0.4762959680992468,0.5237040319007532
E01033561,2592,1212,1380,0.4675925925925926,0.5324074074074074
E01033617,5671,2507,3164,0.44207370834068066,0.5579262916593194
E01034929,1584,748,836,0.4722222222222222,0.5277777777777778
E01034930,2226,1131,1095,0.5080862533692723,0.4919137466307278
E01009483,2071,1061,1010,0.5123128923225495,0.4876871076774505
E01009488,2561,1271,1290,0.49629051151893794,0.5037094884810621
E01009489,2118,1042,1076,0.4919735599622285,0.5080264400377715
E01009491,2201,1099,1102,0.4993184915947297,0.5006815084052704
E01034931,1917,943,974,0.4919144496609285,0.5080855503390714
E01034932,1528,739,789,0.4836387434554974,0.5163612565445026
E01009192,2777,1387,1390,0.49945984875765215,0.5005401512423479
E01009199,1439,710,729,0.49339819318971506,0.5066018068102849
E01009204,2168,1044,1124,0.48154981549815495,0.518450184501845
E01034933,1499,764,735,0.5096731154102735,0.4903268845897265
E01034934,1639,813,826,0.4960341671751068,0.5039658328248933
E01009151,2146,1014,1132,0.4725069897483691,0.527493010251631
E01009152,1942,1018,924,0.5242018537590113,0.47579814624098865
E01009153,2103,1115,988,0.5301949595815502,0.46980504041844984
E01009345,2099,1242,857,0.5917103382563126,0.40828966174368747
E01009346,1736,844,892,0.4861751152073733,0.5138248847926268
E01009092,1762,822,940,0.46651532349602726,0.5334846765039728
E01009093,1731,810,921,0.4679376083188908,0.5320623916811091
E01009094,1611,741,870,0.45996275605214154,0.5400372439478585
E01009298,1632,760,872,0.46568627450980393,0.5343137254901961
E01009311,1617,781,836,0.48299319727891155,0.5170068027210885
E01009511,1684,863,821,0.5124703087885986,0.48752969121140144
E01009475,2325,1118,1207,0.4808602150537634,0.5191397849462366
E01009476,2101,1065,1036,0.5069014754878629,0.4930985245121371
E01009477,1883,905,978,0.48061603823685606,0.5193839617631439
E01009490,2161,1082,1079,0.5006941230911615,0.4993058769088385
E01009492,2025,1033,992,0.5101234567901235,0.48987654320987656
E01009095,1842,906,936,0.49185667752442996,0.50814332247557
E01009507,1621,812,809,0.5009253547193091,0.49907464528069095
E01009508,1647,785,862,0.47662416514875533,0.5233758348512447
E01009509,2053,1051,1002,0.5119337554797857,0.4880662445202143
E01009510,1754,813,941,0.4635119726339795,0.5364880273660205
E01009297,1820,872,948,0.47912087912087914,0.5208791208791209
E01009299,1582,757,825,0.47850821744627053,0.5214917825537294
E01009300,1935,955,980,0.4935400516795866,0.5064599483204134
E01009301,1671,791,880,0.47336923997606223,0.5266307600239377
E01009303,1507,734,773,0.4870603848706038,0.5129396151293961
E01009195,2759,1326,1433,0.4806089162740123,0.5193910837259876
E01009197,1922,945,977,0.4916753381893861,0.508324661810614
E01033649,2100,1045,1055,0.4976190476190476,0.5023809523809524
E01034935,3407,1716,1691,0.5036689169357206,0.4963310830642794
E01009138,2216,1093,1123,0.49323104693140796,0.506768953068592
E01009139,1602,802,800,0.5006242197253433,0.4993757802746567
E01009140,2201,1184,1017,0.5379373012267151,0.4620626987732849
E01009145,1968,982,986,0.49898373983739835,0.5010162601626016
E01009147,1908,1063,845,0.5571278825995807,0.44287211740041926
E01009512,2016,972,1044,0.48214285714285715,0.5178571428571429
E01009514,1734,808,926,0.4659746251441753,0.5340253748558247
E01009516,1438,695,743,0.48331015299026425,0.5166898470097357
E01009517,1993,970,1023,0.48670346211741095,0.5132965378825891
E01009325,1997,961,1036,0.48122183274912367,0.5187781672508763
E01009342,1826,949,877,0.5197152245345017,0.48028477546549836
E01009343,1852,936,916,0.5053995680345572,0.4946004319654428
E01033642,3378,1686,1692,0.4991119005328597,0.5008880994671403
E01008986,1550,797,753,0.5141935483870967,0.4858064516129032
E01008987,1595,783,812,0.4909090909090909,0.509090909090909
E01008988,2077,1101,976,0.530091478093404,0.46990852190659604
E01008989,1693,863,830,0.509746012994684,0.490253987005316
E01008990,1178,598,580,0.5076400679117148,0.4923599320882852
E01008991,1881,911,970,0.48431685273790537,0.5156831472620946
E01008882,2055,991,1064,0.4822384428223844,0.5177615571776155
E01008896,1897,935,962,0.4928835002635741,0.5071164997364259
E01008898,1789,863,926,0.4823923979877026,0.5176076020122974
E01009326,2110,1034,1076,0.4900473933649289,0.5099526066350711
E01009341,1648,797,851,0.4836165048543689,0.5163834951456311
E01009513,2088,1006,1082,0.4818007662835249,0.5181992337164751
E01008881,1747,851,896,0.4871207784773898,0.5128792215226102
E01008897,1980,968,1012,0.4888888888888889,0.5111111111111111
E01009515,1701,844,857,0.49617871840094063,0.5038212815990594
E01009518,1738,886,852,0.5097813578826237,0.4902186421173763
E01009521,1658,822,836,0.4957780458383595,0.5042219541616405
E01009302,1460,703,757,0.4815068493150685,0.5184931506849315
E01009314,1945,915,1030,0.4704370179948586,0.5295629820051414
E01009321,1963,912,1051,0.46459500764136524,0.5354049923586347
E01009322,1753,847,906,0.4831717056474615,0.5168282943525385
E01009323,1832,849,983,0.4634279475982533,0.5365720524017468
E01009329,2683,1329,1354,0.49534103615355946,0.5046589638464406
E01009334,1837,935,902,0.5089820359281437,0.49101796407185627
E01009337,1979,983,996,0.4967155128852956,0.5032844871147044
E01009338,1807,850,957,0.4703929164360819,0.5296070835639181
E01009380,1854,919,935,0.49568500539374327,0.5043149946062567
E01009362,1444,696,748,0.481994459833795,0.518005540166205
E01009363,1781,892,889,0.5008422234699607,0.4991577765300393
E01009364,1655,784,871,0.47371601208459213,0.5262839879154079
E01009365,1850,899,951,0.4859459459459459,0.514054054054054
E01009379,1899,1008,891,0.5308056872037915,0.46919431279620855
E01009312,1590,782,808,0.4918238993710692,0.5081761006289308
E01009324,1735,831,904,0.4789625360230548,0.5210374639769453
E01009519,1461,725,736,0.49623545516769335,0.5037645448323066
E01009520,1772,900,872,0.5079006772009029,0.49209932279909707
E01009066,1938,949,989,0.48968008255933954,0.5103199174406605
E01009070,1629,768,861,0.4714548802946593,0.5285451197053407
E01009252,1627,794,833,0.4880147510755993,0.5119852489244008
E01009260,1592,780,812,0.4899497487437186,0.5100502512562815
E01009261,1747,839,908,0.48025186033199774,0.5197481396680023
E01008984,1705,892,813,0.52316715542522,0.47683284457478003
E01008994,1587,821,766,0.5173282923755513,0.48267170762444866
E01008996,1880,982,898,0.5223404255319148,0.4776595744680851
E01008997,1538,765,773,0.49739921976592977,0.5026007802340702
E01009065,1633,840,793,0.5143906919779547,0.4856093080220453
E01009067,1506,721,785,0.47875166002656044,0.5212483399734396
E01009068,1586,712,874,0.4489281210592686,0.5510718789407314
E01009069,1641,772,869,0.4704448507007922,0.5295551492992078
E01009072,1776,866,910,0.48761261261261263,0.5123873873873874
E01008885,1352,644,708,0.47633136094674555,0.5236686390532544
E01008886,1599,823,776,0.5146966854283928,0.48530331457160725
E01008888,1645,816,829,0.496048632218845,0.503951367781155
E01009313,1661,803,858,0.48344370860927155,0.5165562913907285
E01009368,1522,795,727,0.5223390275952694,0.4776609724047306
E01009371,1946,991,955,0.5092497430626927,0.4907502569373073
E01009397,1775,851,924,0.47943661971830986,0.5205633802816901
E01033650,2832,1400,1432,0.4943502824858757,0.5056497175141242
E01008883,1998,985,1013,0.492992992992993,0.507007007007007
E01008884,2209,1065,1144,0.48211860570393844,0.5178813942960616
E01008887,1730,826,904,0.4774566473988439,0.522543352601156
E01008889,1790,916,874,0.511731843575419,0.488268156424581
E01008982,1677,815,862,0.48598688133571855,0.5140131186642815
E01008992,1685,776,909,0.4605341246290801,0.5394658753709198
E01009283,1766,875,891,0.49546998867497166,0.5045300113250283
E01034936,2702,1180,1522,0.43671354552183567,0.5632864544781643
E01034937,2444,1124,1320,0.45990180032733224,0.5400981996726678
E01009249,1595,772,823,0.48401253918495296,0.515987460815047
E01009250,1715,831,884,0.4845481049562682,0.5154518950437318
E01009251,1490,721,769,0.48389261744966444,0.5161073825503356
E01009253,1602,781,821,0.4875156054931336,0.5124843945068664
E01009255,1543,686,857,0.44458846403110824,0.5554115359688918
E01009257,1624,802,822,0.4938423645320197,0.5061576354679803
E01009315,1727,851,876,0.49276201505500866,0.5072379849449913
E01009316,1900,966,934,0.508421052631579,0.49157894736842106
E01009317,2072,1016,1056,0.49034749034749037,0.5096525096525096
E01009318,1537,775,762,0.5042290175666884,0.49577098243331164
E01009319,1550,768,782,0.49548387096774194,0.5045161290322581
E01009320,1627,834,793,0.51259987707437,0.48740012292563
E01009372,1736,885,851,0.5097926267281107,0.4902073732718894
E01009373,1763,869,894,0.49290981281905843,0.5070901871809416
E01009396,2148,1091,1057,0.5079143389199255,0.4920856610800745
E01033643,3307,1688,1619,0.510432416087088,0.489567583912912
E01009367,1791,924,867,0.5159128978224455,0.48408710217755446
E01009375,1972,976,996,0.4949290060851927,0.5050709939148073
E01009377,1470,710,760,0.48299319727891155,0.5170068027210885
E01009383,1413,747,666,0.5286624203821656,0.4713375796178344
E01009399,1644,790,854,0.4805352798053528,0.5194647201946472
E01009366,1708,870,838,0.509367681498829,0.49063231850117095
E01009374,1215,604,611,0.497119341563786,0.502880658436214
E01009376,1561,847,714,0.5426008968609866,0.45739910313901344
E01033648,2748,1384,1364,0.5036390101892285,0.4963609898107715
E01009073,1824,835,989,0.45778508771929827,0.5422149122807017
E01009074,1772,888,884,0.5011286681715575,0.49887133182844245
E01009254,1941,946,995,0.48737764039155074,0.5126223596084493
E01009256,1677,813,864,0.4847942754919499,0.5152057245080501
E01009258,1524,735,789,0.4822834645669291,0.5177165354330708
E01009071,1695,861,834,0.5079646017699115,0.4920353982300885
E01009075,1663,814,849,0.48947684906794947,0.5105231509320505
E01009078,1534,723,811,0.47131681877444587,0.5286831812255541
E01033562,2550,1248,1302,0.4894117647058824,0.5105882352941177
E01009183,1659,843,816,0.5081374321880651,0.4918625678119349
E01009186,1786,916,870,0.5128779395296752,0.48712206047032475
E01034938,1937,965,972,0.4981930820856995,0.5018069179143004
E01034939,1678,850,828,0.5065554231227652,0.4934445768772348
E01008890,1849,925,924,0.5002704164413196,0.49972958355868036
E01008891,1578,777,801,0.4923954372623574,0.5076045627376425
E01008892,1484,742,742,0.5,0.5
E01008893,1706,881,825,0.5164126611957796,0.4835873388042204
E01008894,1597,847,750,0.530369442705072,0.469630557294928
E01008895,1895,921,974,0.48601583113456465,0.5139841688654354
E01009015,1850,915,935,0.4945945945945946,0.5054054054054054
E01009014,2612,1271,1341,0.48660030627871365,0.5133996937212864
E01009018,1862,1021,841,0.5483351235230934,0.45166487647690656
E01009026,1988,996,992,0.5010060362173038,0.49899396378269617
E01009028,1867,880,987,0.47134440278521694,0.5286555972147831
E01009029,1567,734,833,0.46841097638800255,0.5315890236119974
E01009182,1607,826,781,0.5140012445550716,0.48599875544492843
E01009184,1535,774,761,0.5042345276872964,0.49576547231270357
E01009187,1487,769,718,0.5171486213853396,0.4828513786146604
E01009188,1479,735,744,0.4969574036511156,0.5030425963488844
E01009384,1355,696,659,0.5136531365313654,0.4863468634686347
E01009385,1188,622,566,0.5235690235690236,0.4764309764309764
E01009185,1729,833,896,0.4817813765182186,0.5182186234817814
E01009389,1877,961,916,0.5119872136387853,0.4880127863612147
E01009390,1580,806,774,0.5101265822784811,0.489873417721519
E01009394,1755,886,869,0.5048433048433049,0.49515669515669514
E01008918,1748,758,990,0.43363844393592677,0.5663615560640732
E01008920,1312,638,674,0.48628048780487804,0.5137195121951219
E01008921,1446,700,746,0.48409405255878285,0.5159059474412172
E01008931,1448,676,772,0.46685082872928174,0.5331491712707183
E01009259,1700,846,854,0.4976470588235294,0.5023529411764706
E01008919,1640,798,842,0.4865853658536585,0.5134146341463415
E01009064,1499,708,791,0.4723148765843896,0.5276851234156104
E01009077,1609,799,810,0.49658172778123055,0.5034182722187694
E01009291,1476,706,770,0.47831978319783197,0.521680216802168
E01009500,1515,709,806,0.467986798679868,0.532013201320132
E01009284,4344,2002,2342,0.460865561694291,0.5391344383057091
E01009286,2405,1051,1354,0.43700623700623703,0.562993762993763
E01009289,2523,1157,1366,0.458581054300436,0.5414189456995641
E01009290,2434,1121,1313,0.46055875102711585,0.5394412489728841
E01034940,2182,934,1248,0.42804766269477545,0.5719523373052245
E01034941,2100,972,1128,0.46285714285714286,0.5371428571428571
E01009017,1799,852,947,0.4735964424680378,0.5264035575319622
E01009043,1995,991,1004,0.4967418546365915,0.5032581453634085
E01009044,1764,877,887,0.4971655328798186,0.5028344671201814
E01009045,2046,982,1064,0.47996089931573804,0.520039100684262
E01009046,1819,892,927,0.49037932930181416,0.5096206706981858
E01009395,1695,857,838,0.5056047197640118,0.4943952802359882
E01009016,1652,823,829,0.49818401937046003,0.5018159806295399
E01009022,1830,910,920,0.4972677595628415,0.5027322404371585
E01009023,1710,828,882,0.4842105263157895,0.5157894736842106
E01009030,1885,899,986,0.47692307692307695,0.5230769230769231
E01009281,1544,734,810,0.47538860103626945,0.5246113989637305
E01009292,1567,806,761,0.5143586470963625,0.4856413529036375
E01009294,1933,952,981,0.49249870667356443,0.5075012933264356
E01009295,1691,773,918,0.4571259609698403,0.5428740390301596
E01009280,1726,825,901,0.4779837775202781,0.5220162224797219
E01009282,1712,907,805,0.5297897196261683,0.4702102803738318
E01009288,1346,657,689,0.48811292719167904,0.5118870728083209
E01009293,1546,727,819,0.4702457956015524,0.5297542043984476
E01009296,1499,778,721,0.5190126751167445,0.4809873248832555
E01008924,1491,748,743,0.5016767270288397,0.4983232729711603
E01009501,1521,716,805,0.4707429322813938,0.5292570677186061
E01009502,1447,661,786,0.4568071872840359,0.5431928127159641
E01009503,1568,748,820,0.4770408163265306,0.5229591836734694
E01009505,1639,745,894,0.45454545454545453,0.5454545454545454
E01008917,1247,610,637,0.48917401764234164,0.5108259823576584
E01008923,1516,695,821,0.45844327176781,0.5415567282321899
E01008925,1176,566,610,0.4812925170068027,0.5187074829931972
E01008927,1303,608,695,0.46661550268610896,0.533384497313891
E01008928,1576,731,845,0.46383248730964466,0.5361675126903553
E01009019,1799,911,888,0.5063924402445803,0.4936075597554197
E01009020,1590,742,848,0.4666666666666667,0.5333333333333333
E01009021,1757,851,906,0.48434832100170744,0.5156516789982926
E01009024,1832,882,950,0.4814410480349345,0.5185589519650655
E01009025,1607,749,858,0.46608587429993775,0.5339141257000622
E01009033,1922,933,989,0.4854318418314256,0.5145681581685744
E01009175,1451,728,723,0.5017229496898691,0.4982770503101309
E01009177,1535,731,804,0.4762214983713355,0.5237785016286645
E01009178,1648,792,856,0.48058252427184467,0.5194174757281553
E01009179,1659,822,837,0.49547920433996384,0.5045207956600362
E01009189,1412,677,735,0.4794617563739377,0.5205382436260623
E01008933,1620,807,813,0.4981481481481482,0.5018518518518519
E01008934,1502,727,775,0.4840213049267643,0.5159786950732357
E01009031,1817,904,913,0.49752339020363234,0.5024766097963677
E01009037,1909,951,958,0.49816657936092196,0.5018334206390781
E01009176,1740,831,909,0.47758620689655173,0.5224137931034483
E01008929,1596,720,876,0.45112781954887216,0.5488721804511278
E01008930,1965,969,996,0.49312977099236643,0.5068702290076336
E01009495,1312,625,687,0.4763719512195122,0.5236280487804879
E01033629,2549,1151,1398,0.4515496273048254,0.5484503726951746
E01008953,1574,745,829,0.4733163913595934,0.5266836086404066
E01008963,1489,720,769,0.48354600402955006,0.5164539959704499
E01008964,1452,686,766,0.4724517906336088,0.5275482093663911
E01008965,1459,698,761,0.47840986977381766,0.5215901302261823
E01008966,1745,866,879,0.4962750716332378,0.5037249283667622
E01009032,1902,922,980,0.48475289169295477,0.5152471083070452
E01009034,1772,849,923,0.4791196388261851,0.5208803611738149
E01009035,1888,928,960,0.4915254237288136,0.5084745762711864
E01009036,1584,814,770,0.5138888888888888,0.4861111111111111
E01009494,1689,737,952,0.4363528715216104,0.5636471284783896
E01009496,1474,720,754,0.48846675712347354,0.5115332428765265
E01009497,1794,856,938,0.47714604236343366,0.5228539576365663
E01009504,1628,786,842,0.4828009828009828,0.5171990171990172
E01009506,1492,718,774,0.4812332439678284,0.5187667560321716
E01008967,1588,784,804,0.49370277078085645,0.5062972292191436
E01008968,1804,903,901,0.5005543237250555,0.49944567627494457
E01008970,1456,673,783,0.46222527472527475,0.5377747252747253
E01008981,1534,741,793,0.4830508474576271,0.5169491525423728
E01008932,1609,754,855,0.46861404599129897,0.531385954008701
E01008935,1771,860,911,0.48560135516657255,0.5143986448334275
E01008936,1647,829,818,0.5033394049787493,0.49666059502125076
E01008938,1692,826,866,0.48817966903073284,0.5118203309692672
E01008939,1665,798,867,0.47927927927927927,0.5207207207207207
E01008951,1410,679,731,0.48156028368794324,0.5184397163120568
E01008952,1768,902,866,0.5101809954751131,0.48981900452488686
E01008955,1675,810,865,0.4835820895522388,0.5164179104477612
E01008956,1414,670,744,0.4738330975954738,0.5261669024045261
E01008957,1604,791,813,0.493142144638404,0.506857855361596
E01008950,1428,678,750,0.47478991596638653,0.5252100840336135
E01008954,1432,695,737,0.48533519553072624,0.5146648044692738
E01008958,1551,667,884,0.4300451321727917,0.5699548678272083
E01009493,1883,882,1001,0.4684014869888476,0.5315985130111525
E01008937,1604,718,886,0.4476309226932668,0.5523690773067331
E01008940,1610,764,846,0.4745341614906832,0.5254658385093167
E01008941,1592,804,788,0.5050251256281407,0.4949748743718593
E01008944,1741,864,877,0.49626651349798967,0.5037334865020103
E01008959,1732,795,937,0.4590069284064665,0.5409930715935335
E01008960,1545,765,780,0.49514563106796117,0.5048543689320388
E01008961,1411,716,695,0.5074415308291992,0.49255846917080087
E01008962,2093,975,1118,0.4658385093167702,0.5341614906832298
E01008942,1613,800,813,0.49597024178549287,0.5040297582145071
E01008943,1457,701,756,0.48112560054907344,0.5188743994509266
E01008969,1667,830,837,0.4979004199160168,0.5020995800839833
E01008971,1738,846,892,0.48676639815880324,0.5132336018411968
E01008972,1871,902,969,0.4820951362907536,0.5179048637092464
E01008973,1923,951,972,0.49453978159126366,0.5054602184087363
E01008974,2795,1331,1464,0.4762075134168157,0.5237924865831842
E01008975,1479,719,760,0.4861392832995267,0.5138607167004733
E01009172,1466,700,766,0.47748976807639837,0.5225102319236017
E01009173,1754,852,902,0.48574686431014824,0.5142531356898518
E01009174,1221,580,641,0.475020475020475,0.5249795249795249
E01009498,1707,838,869,0.4909197422378442,0.5090802577621558
E01009499,1745,839,906,0.4808022922636103,0.5191977077363897
E01009205,1535,752,783,0.48990228013029313,0.5100977198697069
E01009206,1517,766,751,0.5049439683586026,0.4950560316413975
E01009211,1443,723,720,0.501039501039501,0.498960498960499
E01009218,1623,796,827,0.4904497843499692,0.5095502156500308
E01009219,1465,700,765,0.4778156996587031,0.5221843003412969
E01008976,1539,712,827,0.46263807667316437,0.5373619233268356
E01008978,1406,675,731,0.4800853485064011,0.5199146514935988
E01008979,1581,751,830,0.4750158127767236,0.5249841872232764
E01008980,1713,828,885,0.48336252189141854,0.5166374781085814
E01008945,1813,862,951,0.47545504688361834,0.5245449531163817
E01008946,1542,782,760,0.5071335927367056,0.49286640726329445
E01008947,1363,667,696,0.48936170212765956,0.5106382978723404
E01008948,1439,685,754,0.4760250173731758,0.5239749826268242
E01008949,1189,585,604,0.4920100925147183,0.5079899074852817
E01008977,1560,728,832,0.4666666666666667,0.5333333333333333
E01009109,1408,659,749,0.4680397727272727,0.5319602272727273
E01009119,1430,683,747,0.47762237762237764,0.5223776223776224
E01009120,1763,833,930,0.47249007373794666,0.5275099262620533
E01009162,1604,770,834,0.4800498753117207,0.5199501246882793
E01009207,1624,774,850,0.4766009852216749,0.5233990147783252
E01009208,1689,825,864,0.48845470692717585,0.5115452930728241
E01009209,2044,974,1070,0.4765166340508806,0.5234833659491194
E01009213,1608,774,834,0.48134328358208955,0.5186567164179104
E01009155,1325,638,687,0.48150943396226414,0.5184905660377358
E01009157,1448,681,767,0.4703038674033149,0.5296961325966851
E01009160,1632,770,862,0.47181372549019607,0.5281862745098039
E01009161,1443,686,757,0.4753984753984754,0.5246015246015246
E01034942,1864,848,1016,0.45493562231759654,0.5450643776824035
E01034943,1718,817,901,0.4755529685681024,0.5244470314318975
E01009117,2073,952,1121,0.4592378195851423,0.5407621804148577
E01009210,1818,861,957,0.4735973597359736,0.5264026402640264
E01009212,1774,856,918,0.48252536640360766,0.5174746335963923
E01009214,1648,802,846,0.4866504854368932,0.5133495145631068
E01009215,1815,915,900,0.5041322314049587,0.49586776859504134
E01009108,1023,499,524,0.48778103616813295,0.512218963831867
E01009111,1545,745,800,0.48220064724919093,0.517799352750809
E01009112,1617,770,847,0.47619047619047616,0.5238095238095238
E01009116,1369,652,717,0.4762600438276114,0.5237399561723886
E01009118,1558,761,797,0.4884467265725289,0.5115532734274711
E01009107,1675,748,927,0.44656716417910447,0.5534328358208955
E01009110,1362,667,695,0.4897209985315712,0.5102790014684288
E01009113,1709,801,908,0.4686951433586893,0.5313048566413107
E01009114,1411,651,760,0.46137491141034725,0.5386250885896527
E01009115,1424,682,742,0.4789325842696629,0.5210674157303371
E01009158,2256,1071,1185,0.4747340425531915,0.5252659574468085
E01009165,1382,694,688,0.5021707670043415,0.49782923299565845
E01009169,1670,847,823,0.5071856287425149,0.492814371257485
E01034944,1297,559,738,0.4309946029298381,0.569005397070162
E01034945,1488,736,752,0.4946236559139785,0.5053763440860215
E01009159,2282,1093,1189,0.478965819456617,0.521034180543383
E01009164,1424,696,728,0.4887640449438202,0.5112359550561798
E01009167,1494,720,774,0.4819277108433735,0.5180722891566265
E01009171,1648,816,832,0.49514563106796117,0.5048543689320388
E01009166,1320,650,670,0.49242424242424243,0.5075757575757576
E01009168,1440,692,748,0.48055555555555557,0.5194444444444445
E01009170,1483,715,768,0.48213081591368845,0.5178691840863116
E01009216,2066,941,1125,0.4554695062923524,0.5445304937076476
E01009217,1569,772,797,0.49203314212874444,0.5079668578712556
E01009039,1790,898,892,0.5016759776536313,0.4983240223463687
E01009040,1817,905,912,0.4980737479361585,0.5019262520638414
E01009041,1708,842,866,0.4929742388758782,0.5070257611241218
E01009042,1363,661,702,0.48495964783565665,0.5150403521643434
E01032589,1529,729,800,0.47678221059516024,0.5232177894048398
E01009262,1787,908,879,0.5081141578063794,0.4918858421936206
E01009267,1796,889,907,0.49498886414253895,0.505011135857461
E01009276,1659,788,871,0.47498493068113323,0.5250150693188668
E01009278,1737,864,873,0.49740932642487046,0.5025906735751295
E01009279,1591,774,817,0.4864864864864865,0.5135135135135135
E01032591,1583,791,792,0.4996841440303222,0.5003158559696779
E01008995,2431,1160,1271,0.47716988893459483,0.5228301110654052
E01033557,2119,1064,1055,0.5021236432279377,0.49787635677206227
E01033624,1594,829,765,0.5200752823086575,0.47992471769134254
E01033626,1214,604,610,0.4975288303130148,0.5024711696869851
E01033640,2001,997,1004,0.49825087456271866,0.5017491254372813
E01033567,1109,576,533,0.5193868349864743,0.4806131650135257
E01033615,1105,590,515,0.5339366515837104,0.4660633484162896
E01033616,1277,741,536,0.5802662490211433,0.4197337509788567
E01034946,1051,578,473,0.5499524262607041,0.45004757373929594
E01034947,1582,808,774,0.5107458912768648,0.4892541087231353
E01009143,1884,908,976,0.4819532908704883,0.5180467091295117
E01009146,2304,1135,1169,0.4926215277777778,0.5073784722222222
E01033564,1172,633,539,0.5401023890784983,0.4598976109215017
E01034948,1787,900,887,0.5036373810856184,0.49636261891438166
E01034949,1308,691,617,0.5282874617737003,0.4717125382262997
E01009141,1922,965,957,0.5020811654526535,0.49791883454734653
E01033565,1405,716,689,0.5096085409252669,0.4903914590747331
E01033618,1220,687,533,0.5631147540983606,0.43688524590163935
E01033627,1126,600,526,0.5328596802841918,0.46714031971580816
E01034950,1124,570,554,0.5071174377224199,0.4928825622775801
E01034951,1107,600,507,0.5420054200542005,0.45799457994579945
E01033620,1073,578,495,0.5386766076421249,0.4613233923578751
E01033622,1894,1043,851,0.5506863780359028,0.44931362196409713
E01033623,1465,853,612,0.5822525597269624,0.41774744027303756
E01033625,1713,877,836,0.5119673088149446,0.48803269118505543
E01009200,1844,885,959,0.47993492407809113,0.5200650759219089
E01009327,1662,824,838,0.49578820697954273,0.5042117930204573
E01009328,2419,1152,1267,0.47622984704423316,0.5237701529557669
E01009331,2437,1214,1223,0.49815346737792365,0.5018465326220763
E01009332,1931,983,948,0.509062661833247,0.490937338166753
E01009333,1619,782,837,0.4830142063001853,0.5169857936998147
E01009335,1982,980,1002,0.4944500504540868,0.5055499495459133
E01009344,1828,954,874,0.5218818380743983,0.47811816192560175
E01009008,1426,687,739,0.48176718092566617,0.5182328190743338
E01009011,1738,871,867,0.501150747986191,0.498849252013809
E01009012,1501,750,751,0.4996668887408394,0.5003331112591606
E01009079,1371,689,682,0.5025528811086798,0.4974471188913202
E01009080,1349,637,712,0.47220163083765754,0.5277983691623425
E01009081,1371,692,679,0.5047410649161196,0.49525893508388036
E01009083,1608,782,826,0.486318407960199,0.513681592039801
E01009102,1615,765,850,0.47368421052631576,0.5263157894736842
E01009104,1712,815,897,0.4760514018691589,0.5239485981308412
E01009339,1669,813,856,0.48711803475134813,0.5128819652486519
E01009382,2004,1016,988,0.5069860279441117,0.4930139720558882
E01009392,1723,842,881,0.4886825304701103,0.5113174695298898
E01034952,1290,645,645,0.5,0.5
E01034953,1619,815,804,0.5033971587399629,0.49660284126003706
E01009391,1915,917,998,0.47885117493472584,0.5211488250652742
E01009393,1799,907,892,0.5041689827682045,0.49583101723179546
E01034954,1735,887,848,0.5112391930835735,0.48876080691642654
E01034955,2149,1060,1089,0.4932526756630991,0.5067473243369008
E01009589,1699,832,867,0.4896998234255444,0.5103001765744556
E01032536,2171,1101,1070,0.5071395670198066,0.49286043298019344
E01032537,1975,957,1018,0.48455696202531645,0.5154430379746835
E01032538,2227,1120,1107,0.5029187247418051,0.4970812752581949
E01009590,1533,771,762,0.50293542074364,0.49706457925636005
E01009591,1589,779,810,0.49024543738200127,0.5097545626179988
E01009593,1665,801,864,0.4810810810810811,0.518918918918919
E01009598,2142,1040,1102,0.48552754435107376,0.5144724556489262
E01009604,1438,722,716,0.502086230876217,0.49791376912378305
E01009605,1749,835,914,0.4774156660949114,0.5225843339050886
E01009607,1621,815,806,0.5027760641579272,0.4972239358420728
E01009608,1634,802,832,0.4908200734394125,0.5091799265605875
E01009610,1525,749,776,0.4911475409836066,0.5088524590163934
E01009564,2093,1021,1072,0.4878165312947922,0.5121834687052078
E01009575,1311,665,646,0.5072463768115942,0.4927536231884058
E01009606,2237,1089,1148,0.48681269557443,0.5131873044255699
E01009609,1571,750,821,0.47740292807129214,0.5225970719287079
E01009524,1523,747,776,0.49047931713722914,0.5095206828627709
E01009525,1519,770,749,0.5069124423963134,0.4930875576036866
E01009527,1619,795,824,0.49104385423100677,0.5089561457689932
E01009594,1479,728,751,0.49222447599729546,0.5077755240027045
E01009577,1734,855,879,0.4930795847750865,0.5069204152249135
E01009579,2257,1048,1209,0.46433318564466103,0.5356668143553389
E01009581,1761,867,894,0.49233390119250425,0.5076660988074957
E01009584,2136,1027,1109,0.48080524344569286,0.5191947565543071
E01009585,1861,862,999,0.4631918323481999,0.5368081676518001
E01009709,1262,584,678,0.46275752773375595,0.5372424722662441
E01009576,1605,797,808,0.4965732087227414,0.5034267912772585
E01009578,1385,696,689,0.5025270758122744,0.49747292418772565
E01009582,1678,808,870,0.48152562574493446,0.5184743742550656
E01009583,1582,766,816,0.48419721871049304,0.515802781289507
E01009586,1830,889,941,0.48579234972677593,0.514207650273224
E01009565,1783,866,917,0.485698261357263,0.514301738642737
E01009566,1987,1010,977,0.5083039758429794,0.49169602415702063
E01009567,1723,848,875,0.4921648287869994,0.5078351712130006
E01009568,1862,943,919,0.5064446831364124,0.49355531686358756
E01009523,1640,809,831,0.49329268292682926,0.5067073170731707
E01009526,1563,725,838,0.4638515674984005,0.5361484325015995
E01009528,2165,1089,1076,0.5030023094688222,0.4969976905311778
E01009531,1594,775,819,0.486198243412798,0.513801756587202
E01009587,2318,1122,1196,0.4840379637618637,0.5159620362381363
E01009624,1544,739,805,0.4786269430051813,0.5213730569948186
E01009625,2408,1230,1178,0.510797342192691,0.489202657807309
E01009626,1689,836,853,0.49496743635287155,0.5050325636471285
E01009622,1836,838,998,0.4564270152505447,0.5435729847494554
E01009623,1563,786,777,0.5028790786948176,0.4971209213051823
E01009627,1813,895,918,0.4936569222283508,0.5063430777716492
E01009628,1563,756,807,0.4836852207293666,0.5163147792706334
E01009599,1089,529,560,0.4857667584940312,0.5142332415059688
E01009663,1442,706,736,0.4895977808599168,0.5104022191400832
E01009710,1299,644,655,0.49576597382602,0.5042340261739799
E01009711,1925,933,992,0.48467532467532465,0.5153246753246753
E01009522,1910,891,1019,0.4664921465968586,0.5335078534031413
E01009529,1523,765,758,0.5022980958634274,0.49770190413657256
E01009530,1405,674,731,0.4797153024911032,0.5202846975088968
E01009645,1450,710,740,0.4896551724137931,0.5103448275862069
E01009569,1360,669,691,0.4919117647058823,0.5080882352941176
E01009570,2282,1137,1145,0.4982471516213848,0.5017528483786152
E01009571,1590,820,770,0.5157232704402516,0.48427672955974843
E01009573,1500,744,756,0.496,0.504
E01009574,1610,795,815,0.4937888198757764,0.5062111801242236
E01034735,1658,827,831,0.4987937273823884,0.5012062726176115
E01034736,1719,883,836,0.5136707388016288,0.48632926119837117
E01009655,2040,994,1046,0.4872549019607843,0.5127450980392156
E01009656,1627,831,796,0.5107559926244623,0.4892440073755378
E01009659,1870,913,957,0.48823529411764705,0.5117647058823529
E01009662,1416,735,681,0.5190677966101694,0.4809322033898305
E01009664,1582,788,794,0.49810366624525915,0.5018963337547409
E01009643,1410,687,723,0.48723404255319147,0.5127659574468085
E01009644,1606,782,824,0.48692403486924035,0.5130759651307597
E01009647,1882,943,939,0.5010626992561105,0.4989373007438895
E01009648,1504,734,770,0.488031914893617,0.511968085106383
E01009652,1464,730,734,0.49863387978142076,0.5013661202185792
E01009653,1595,781,814,0.4896551724137931,0.5103448275862069
E01009613,1303,629,674,0.4827321565617805,0.5172678434382195
E01009657,1629,830,799,0.5095150399017803,0.4904849600982198
E01009712,1524,774,750,0.5078740157480315,0.4921259842519685
E01009714,1493,695,798,0.4655056932350971,0.5344943067649028
E01009716,1688,831,857,0.49229857819905215,0.5077014218009479
E01009580,1336,641,695,0.47979041916167664,0.5202095808383234
E01009713,1450,721,729,0.49724137931034484,0.5027586206896552
E01009715,1411,679,732,0.481218993621545,0.518781006378455
E01009717,1472,724,748,0.49184782608695654,0.5081521739130435
E01009718,1830,915,915,0.5,0.5
E01009630,1845,894,951,0.4845528455284553,0.5154471544715448
E01009631,1567,778,789,0.4964901084875558,0.5035098915124442
E01009632,1810,982,828,0.5425414364640884,0.4574585635359116
E01009650,1517,869,648,0.5728411338167436,0.42715886618325644
E01034737,1841,969,872,0.5263443780554047,0.4736556219445953
E01034738,1434,735,699,0.5125523012552301,0.4874476987447699
E01009614,1456,683,773,0.4690934065934066,0.5309065934065934
E01009654,1839,945,894,0.5138662316476346,0.48613376835236544
E01009658,1783,957,826,0.5367358384744813,0.4632641615255188
E01009660,1732,869,863,0.5017321016166282,0.4982678983833718
E01009646,1514,758,756,0.5006605019815059,0.49933949801849403
E01009692,1178,558,620,0.47368421052631576,0.5263157894736842
E01009693,1484,700,784,0.4716981132075472,0.5283018867924528
E01009694,1428,698,730,0.4887955182072829,0.511204481792717
E01009695,1584,782,802,0.4936868686868687,0.5063131313131313
E01009696,1438,705,733,0.4902642559109875,0.5097357440890126
E01009704,1418,688,730,0.48519040902679833,0.5148095909732017
E01009705,1352,671,681,0.496301775147929,0.503698224852071
E01009636,2530,1312,1218,0.5185770750988142,0.48142292490118577
E01009637,1853,921,932,0.4970318402590394,0.5029681597409607
E01009638,1886,989,897,0.524390243902439,0.47560975609756095
E01009639,1741,896,845,0.514646754738656,0.48535324526134405
E01009640,2146,1062,1084,0.49487418452935694,0.5051258154706431
E01009641,3286,1719,1567,0.5231284236153378,0.4768715763846622
E01009697,2045,1030,1015,0.5036674816625917,0.4963325183374083
E01009698,1479,723,756,0.48884381338742394,0.5111561866125761
E01009706,1476,717,759,0.48577235772357724,0.5142276422764228
E01034739,1600,795,805,0.496875,0.503125
E01034740,1808,859,949,0.47511061946902655,0.5248893805309734
E01009649,1430,704,726,0.49230769230769234,0.5076923076923077
E01009684,1482,733,749,0.49460188933873145,0.5053981106612686
E01009685,1619,810,809,0.5003088326127239,0.4996911673872761
E01009686,1683,847,836,0.5032679738562091,0.49673202614379086
E01009687,1397,701,696,0.5017895490336435,0.49821045096635647
E01009615,1703,907,796,0.5325895478567234,0.4674104521432766
E01009616,1559,772,787,0.49518922386144965,0.5048107761385503
E01009617,1258,635,623,0.5047694753577107,0.49523052464228934
E01009618,1676,824,852,0.4916467780429594,0.5083532219570406
E01009620,2801,1352,1449,0.48268475544448414,0.5173152445555159
E01009621,1474,643,831,0.4362279511533243,0.5637720488466758
E01009633,2044,1171,873,0.5728962818003914,0.42710371819960863
E01009634,2095,1232,863,0.5880668257756563,0.41193317422434367
E01009661,2031,1131,900,0.5568685376661743,0.4431314623338257
E01034741,1922,1111,811,0.5780437044745057,0.4219562955254943
E01034742,1149,684,465,0.5953002610966057,0.4046997389033943
E01009674,1733,883,850,0.5095210617426428,0.49047893825735717
E01009699,1433,707,726,0.4933705512909979,0.5066294487090021
E01009700,1665,834,831,0.5009009009009009,0.4990990990990991
E01009701,1498,729,769,0.48664886515353806,0.513351134846462
E01009702,1652,819,833,0.4957627118644068,0.5042372881355932
E01009688,1501,807,694,0.5376415722851432,0.46235842771485675
E01009689,1658,818,840,0.49336550060313633,0.5066344993968637
E01009690,1461,740,721,0.5065023956194388,0.4934976043805613
E01009691,1291,688,603,0.5329202168861348,0.4670797831138652
E01009548,2774,1418,1356,0.5111751982696467,0.48882480173035325
E01009553,1927,1103,824,0.5723923196678775,0.4276076803321225
E01009651,1538,828,710,0.5383615084525357,0.4616384915474642
E01034743,2043,1124,919,0.5501713166911405,0.4498286833088595
E01034744,2870,1490,1380,0.519163763066202,0.4808362369337979
E01009676,1639,811,828,0.49481391092129345,0.5051860890787065
E01009681,1315,639,676,0.4859315589353612,0.5140684410646388
E01009682,1435,729,706,0.50801393728223,0.49198606271777
E01009683,1906,950,956,0.49842602308499473,0.5015739769150053
E01009532,1345,626,719,0.4654275092936803,0.5345724907063197
E01009535,1369,664,705,0.4850255661066472,0.5149744338933528
E01009536,1463,742,721,0.507177033492823,0.49282296650717705
E01009543,1789,903,886,0.504751257685858,0.49524874231414195
E01009707,1811,887,924,0.4897846493649917,0.5102153506350083
E01009708,1406,666,740,0.47368421052631576,0.5263157894736842
E01009554,1344,666,678,0.4955357142857143,0.5044642857142857
E01009555,1474,731,743,0.49592944369063774,0.5040705563093623
E01009556,1522,770,752,0.5059132720105125,0.4940867279894875
E01009557,1384,698,686,0.5043352601156069,0.4956647398843931
E01009558,1408,729,679,0.5177556818181818,0.4822443181818182
E01009559,1343,669,674,0.498138495904691,0.501861504095309
E01009537,1494,728,766,0.48728246318607765,0.5127175368139224
E01009538,1535,750,785,0.48859934853420195,0.511400651465798
E01009612,1533,741,792,0.48336594911937375,0.5166340508806262
E01032527,1610,794,816,0.493167701863354,0.506832298136646
E01032528,1566,751,815,0.47956577266922096,0.520434227330779
E01034745,1388,665,723,0.47910662824207495,0.520893371757925
E01034746,1660,752,908,0.4530120481927711,0.5469879518072289
E01009679,2223,1175,1048,0.5285650022492128,0.47143499775078723
E01032532,1495,770,725,0.5150501672240803,0.48494983277591974
E01032533,1913,960,953,0.501829587036069,0.498170412963931
E01034747,1999,1022,977,0.511255627813907,0.48874437218609307
E01034748,1355,653,702,0.4819188191881919,0.5180811808118081
E01009549,1621,789,832,0.48673658235657,0.51326341764343
E01009550,1718,888,830,0.5168800931315483,0.4831199068684517
E01009552,1578,762,816,0.4828897338403042,0.5171102661596958
E01032534,1796,880,916,0.48997772828507796,0.5100222717149221
E01032535,1248,614,634,0.49198717948717946,0.5080128205128205
E01009544,1556,787,769,0.5057840616966581,0.49421593830334193
E01032529,1259,599,660,0.47577442414614773,0.5242255758538522
E01032530,1887,954,933,0.505564387917329,0.4944356120826709
E01034749,1925,899,1026,0.467012987012987,0.532987012987013
E01034750,2797,1410,1387,0.5041115480872363,0.49588845191276365
E01009539,2076,1019,1057,0.4908477842003854,0.5091522157996147
E01009540,2033,962,1071,0.4731923266109198,0.5268076733890802
E01009541,1675,847,828,0.5056716417910447,0.4943283582089552
E01009542,1904,939,965,0.49317226890756305,0.506827731092437
E01009560,1482,717,765,0.48380566801619435,0.5161943319838057
E01009561,1602,797,805,0.4975031210986267,0.5024968789013733
E01009562,1590,785,805,0.4937106918238994,0.5062893081761006
E01009563,1711,830,881,0.48509643483343073,0.5149035651665692
E01009672,2124,1046,1078,0.4924670433145009,0.507532956685499
E01009666,1388,707,681,0.5093659942363112,0.49063400576368876
E01009667,1313,640,673,0.48743335872048743,0.5125666412795126
E01009668,1654,803,851,0.48548972188633616,0.5145102781136639
E01009670,1683,854,829,0.5074272133095663,0.49257278669043375
E01009665,1271,638,633,0.5019669551534225,0.4980330448465775
E01009669,1284,646,638,0.5031152647975078,0.4968847352024922
E01009671,4120,2035,2085,0.49393203883495146,0.5060679611650486
E01033058,2430,1255,1175,0.5164609053497943,0.4835390946502058
E01009588,1585,770,815,0.48580441640378547,0.5141955835962145
E01009592,1723,854,869,0.4956471271038886,0.5043528728961114
E01009596,2083,1052,1031,0.5050408065290446,0.49495919347095535
E01009597,1884,925,959,0.49097664543524416,0.5090233545647559
E01032587,1813,902,911,0.49751792608935463,0.5024820739106454
E01009763,2239,1013,1226,0.45243412237606073,0.5475658776239393
E01009764,1481,730,751,0.49291019581363943,0.5070898041863605
E01009767,1530,734,796,0.4797385620915033,0.5202614379084968
E01009769,1841,903,938,0.49049429657794674,0.5095057034220533
E01009770,1458,726,732,0.49794238683127573,0.5020576131687243
E01009773,1536,751,785,0.4889322916666667,0.5110677083333334
E01009777,1565,786,779,0.5022364217252396,0.49776357827476037
E01009778,1583,798,785,0.5041061276058117,0.49589387239418825
E01009895,1380,683,697,0.49492753623188407,0.505072463768116
E01009896,1447,707,740,0.48859709744298546,0.5114029025570145
E01009897,1408,710,698,0.5042613636363636,0.49573863636363635
E01009898,1447,686,761,0.47408431237042153,0.5259156876295784
E01009901,1391,683,708,0.4910136592379583,0.5089863407620417
E01009902,1210,584,626,0.4826446280991736,0.5173553719008265
E01009765,1601,797,804,0.4978138663335415,0.5021861336664585
E01009766,1558,783,775,0.5025673940949936,0.49743260590500643
E01009768,1378,686,692,0.49782293178519593,0.502177068214804
E01009771,1420,682,738,0.4802816901408451,0.5197183098591549
E01009775,1500,740,760,0.49333333333333335,0.5066666666666667
E01009776,1562,801,761,0.5128040973111395,0.4871959026888604
E01009758,1778,868,910,0.4881889763779528,0.5118110236220472
E01009760,1334,659,675,0.49400299850074963,0.5059970014992504
E01009772,1283,595,688,0.4637568199532346,0.5362431800467654
E01009774,1608,744,864,0.4626865671641791,0.5373134328358209
E01009788,1577,759,818,0.48129359543436906,0.518706404565631
E01009756,1538,706,832,0.459037711313394,0.540962288686606
E01009757,2165,1068,1097,0.49330254041570437,0.5066974595842956
E01009759,1264,630,634,0.49841772151898733,0.5015822784810127
E01009762,1476,700,776,0.4742547425474255,0.5257452574525745
E01034306,1712,822,890,0.48014018691588783,0.5198598130841121
E01034307,1733,836,897,0.482400461627236,0.517599538372764
E01009781,1981,964,1017,0.48662291771832406,0.5133770822816759
E01009786,1456,706,750,0.4848901098901099,0.5151098901098901
E01009789,1442,730,712,0.5062413314840499,0.49375866851595007
E01009790,1602,800,802,0.4993757802746567,0.5006242197253433
E01009779,1412,678,734,0.4801699716713881,0.5198300283286119
E01009782,1871,938,933,0.501336183858899,0.498663816141101
E01009783,1479,714,765,0.4827586206896552,0.5172413793103449
E01009785,1487,737,750,0.49562878278412914,0.5043712172158709
E01009899,1381,691,690,0.500362056480811,0.499637943519189
E01009900,1396,681,715,0.4878223495702006,0.5121776504297995
E01009780,2153,1072,1081,0.4979098931723177,0.5020901068276823
E01009784,1563,785,778,0.5022392834293026,0.49776071657069737
E01009787,1480,711,769,0.4804054054054054,0.5195945945945946
E01009880,1537,753,784,0.48991541964866625,0.5100845803513337
E01009882,1430,678,752,0.47412587412587415,0.5258741258741259
E01009891,1865,895,970,0.47989276139410186,0.5201072386058981
E01009892,1628,817,811,0.5018427518427518,0.49815724815724816
E01009893,1908,911,997,0.47746331236897277,0.5225366876310272
E01009894,1713,853,860,0.4979568009340339,0.5020431990659662
E01009844,1605,837,768,0.5214953271028038,0.4785046728971963
E01009879,2383,1207,1176,0.5065044062106588,0.49349559378934116
E01009885,1615,821,794,0.508359133126935,0.491640866873065
E01034308,1475,722,753,0.4894915254237288,0.5105084745762711
E01034309,1294,725,569,0.5602782071097373,0.43972179289026275
E01009816,1662,824,838,0.49578820697954273,0.5042117930204573
E01009817,1250,608,642,0.4864,0.5136
E01009819,1495,736,759,0.49230769230769234,0.5076923076923077
E01009820,1498,737,761,0.49198931909212285,0.5080106809078772
E01009748,1658,800,858,0.4825090470446321,0.517490952955368
E01009839,1821,902,919,0.4953322350356947,0.5046677649643053
E01009883,1548,720,828,0.46511627906976744,0.5348837209302325
E01009884,1430,708,722,0.4951048951048951,0.5048951048951049
E01009886,1956,949,1007,0.48517382413087934,0.5148261758691206
E01009814,1284,615,669,0.47897196261682246,0.5210280373831776
E01009815,1272,630,642,0.49528301886792453,0.5047169811320755
E01009818,1226,595,631,0.48531810766721045,0.5146818923327896
E01009821,1303,635,668,0.4873369148119724,0.5126630851880276
E01009822,1487,707,780,0.4754539340954943,0.5245460659045057
E01009887,1840,937,903,0.5092391304347826,0.4907608695652174
E01009888,1767,872,895,0.49349179400113186,0.5065082059988681
E01009889,2856,1403,1453,0.49124649859943975,0.5087535014005602
E01009890,1849,916,933,0.49540292049756623,0.5045970795024337
E01009749,2374,1191,1183,0.5016849199663016,0.4983150800336984
E01009750,1485,750,735,0.5050505050505051,0.494949494949495
E01009823,1303,640,663,0.4911742133537989,0.508825786646201
E01009824,1897,913,984,0.4812862414338429,0.5187137585661571
E01009751,1513,744,769,0.4917382683410443,0.5082617316589557
E01009752,1642,783,859,0.476857490864799,0.523142509135201
E01009753,1593,768,825,0.4821092278719397,0.5178907721280602
E01009754,1716,811,905,0.4726107226107226,0.5273892773892774
E01009841,1583,757,826,0.47820593809222994,0.52179406190777
E01009840,1510,757,753,0.5013245033112583,0.4986754966887417
E01009842,1534,774,760,0.5045632333767927,0.4954367666232073
E01009843,1487,722,765,0.4855413584398117,0.5144586415601883
E01009871,1988,985,1003,0.4954728370221328,0.5045271629778671
E01009875,1551,729,822,0.4700193423597679,0.5299806576402321
E01009825,1438,718,720,0.4993045897079277,0.5006954102920723
E01009826,1428,690,738,0.4831932773109244,0.5168067226890757
E01009827,1624,806,818,0.4963054187192118,0.5036945812807881
E01009828,1291,615,676,0.4763749031758327,0.5236250968241674
E01009829,1492,696,796,0.46648793565683644,0.5335120643431636
E01009830,1658,798,860,0.4813027744270205,0.5186972255729795
E01009872,1351,648,703,0.47964470762398226,0.5203552923760177
E01009873,1538,760,778,0.494148244473342,0.505851755526658
E01009874,1609,810,799,0.5034182722187694,0.49658172778123055
E01009876,1641,801,840,0.48811700182815354,0.5118829981718465
E01009877,1659,815,844,0.4912597950572634,0.5087402049427366
E01009911,1231,610,621,0.49553208773354995,0.50446791226645
E01009912,2022,1004,1018,0.49653808110781406,0.503461918892186
E01009913,1526,735,791,0.481651376146789,0.518348623853211
E01009914,1337,653,684,0.48840688107703817,0.5115931189229619
E01009915,1683,802,881,0.47653000594177064,0.5234699940582294
E01009916,1686,828,858,0.49110320284697506,0.5088967971530249
E01009741,2038,1108,930,0.5436702649656526,0.4563297350343474
E01009744,2150,1050,1100,0.4883720930232558,0.5116279069767442
E01009746,1980,996,984,0.503030303030303,0.49696969696969695
E01009747,1541,760,781,0.49318624269954575,0.5068137573004543
E01009731,1595,838,757,0.5253918495297806,0.4746081504702194
E01009740,2175,1054,1121,0.4845977011494253,0.5154022988505748
E01009742,1578,734,844,0.46514575411913817,0.5348542458808618
E01009743,1817,888,929,0.4887176664832141,0.5112823335167859
E01009745,1714,842,872,0.4912485414235706,0.5087514585764294
E01009917,1186,592,594,0.4991568296795953,0.5008431703204047
E01009918,1430,672,758,0.4699300699300699,0.5300699300699301
E01009919,1138,577,561,0.5070298769771528,0.4929701230228471
E01009920,1604,791,813,0.493142144638404,0.506857855361596
E01009864,1531,747,784,0.4879163945133899,0.51208360548661
E01009865,1585,748,837,0.47192429022082016,0.5280757097791798
E01009866,1665,817,848,0.4906906906906907,0.5093093093093093
E01009867,1720,879,841,0.5110465116279069,0.488953488372093
E01009878,2240,1113,1127,0.496875,0.503125
E01009791,1546,777,769,0.5025873221216042,0.4974126778783959
E01009792,1591,788,803,0.4952859836580767,0.5047140163419234
E01009795,1717,840,877,0.48922539312754804,0.5107746068724519
E01009796,1640,793,847,0.48353658536585364,0.5164634146341464
E01009798,2402,1200,1202,0.4995836802664446,0.5004163197335554
E01009719,1393,702,691,0.5039483129935391,0.49605168700646085
E01009722,1293,647,646,0.5003866976024749,0.49961330239752516
E01009727,1324,628,696,0.4743202416918429,0.525679758308157
E01009728,1226,622,604,0.5073409461663948,0.4926590538336052
E01009729,1549,773,776,0.49903163331181405,0.5009683666881859
E01009720,1293,619,674,0.47873163186388246,0.5212683681361175
E01009723,1182,603,579,0.5101522842639594,0.48984771573604063
E01009724,1442,709,733,0.49167822468793343,0.5083217753120666
E01009730,1462,748,714,0.5116279069767442,0.4883720930232558
E01009903,1400,671,729,0.47928571428571426,0.5207142857142857
E01009904,1366,658,708,0.4816983894582723,0.5183016105417276
E01009909,1422,704,718,0.49507735583684953,0.5049226441631505
E01009910,1548,770,778,0.4974160206718346,0.5025839793281653
E01009793,1575,768,807,0.4876190476190476,0.5123809523809524
E01009794,1519,726,793,0.477946017116524,0.5220539828834759
E01009797,1373,663,710,0.482884195193008,0.517115804806992
E01009801,1761,817,944,0.46394094264622376,0.5360590573537762
E01009721,2384,1229,1155,0.5155201342281879,0.48447986577181207
E01009725,1511,726,785,0.4804765056254136,0.5195234943745863
E01009726,1265,646,619,0.5106719367588933,0.4893280632411067
E01009834,1655,819,836,0.49486404833836856,0.5051359516616314
E01009833,1567,808,759,0.5156349712827059,0.4843650287172942
E01009835,1727,858,869,0.4968152866242038,0.5031847133757962
E01009869,1531,741,790,0.4839973873285434,0.5160026126714565
E01009870,1439,751,688,0.5218902015288395,0.47810979847116053
E01009809,1695,811,884,0.4784660766961652,0.5215339233038349
E01009813,1585,766,819,0.4832807570977918,0.5167192429022082
E01009861,1639,819,820,0.4996949359365467,0.5003050640634533
E01009862,1848,881,967,0.47673160173160173,0.5232683982683982
E01009863,1951,950,1001,0.486929779600205,0.513070220399795
E01009868,1495,738,757,0.4936454849498328,0.5063545150501673
E01009734,1578,759,819,0.48098859315589354,0.5190114068441065
E01009735,1649,785,864,0.47604608853850816,0.5239539114614918
E01009736,1386,686,700,0.494949494949495,0.5050505050505051
E01009737,1519,772,747,0.5082290980908493,0.49177090190915074
E01009738,1683,826,857,0.49079025549613786,0.5092097445038621
E01009856,2018,1036,982,0.5133795837462835,0.48662041625371655
E01009905,1426,701,725,0.49158485273492286,0.5084151472650772
E01009906,1696,878,818,0.5176886792452831,0.482311320754717
E01009907,1457,686,771,0.4708304735758408,0.5291695264241593
E01009908,1571,778,793,0.4952259707192871,0.5047740292807129
E01009800,1512,718,794,0.4748677248677249,0.5251322751322751
E01009802,1755,855,900,0.48717948717948717,0.5128205128205128
E01009803,1589,777,812,0.4889867841409692,0.5110132158590308
E01009804,1259,620,639,0.4924543288324067,0.5075456711675933
E01009831,1446,740,706,0.5117565698478561,0.48824343015214383
E01009836,1926,1058,868,0.54932502596054,0.45067497403946
E01009837,1602,807,795,0.5037453183520599,0.49625468164794007
E01009838,1694,859,835,0.5070838252656434,0.49291617473435656
E01009847,1477,707,770,0.4786729857819905,0.5213270142180095
E01009848,1358,663,695,0.4882179675994109,0.5117820324005891
E01009849,1590,776,814,0.4880503144654088,0.5119496855345912
E01009851,1498,720,778,0.48064085447263016,0.5193591455273698
E01009732,1865,945,920,0.5067024128686327,0.4932975871313673
E01009733,1849,909,940,0.4916170903190914,0.5083829096809086
E01009739,1530,726,804,0.4745098039215686,0.5254901960784314
E01009799,1460,718,742,0.4917808219178082,0.5082191780821917
E01009805,1443,726,717,0.5031185031185031,0.4968814968814969
E01009806,1469,731,738,0.49761742682096666,0.5023825731790333
E01009854,1505,737,768,0.48970099667774086,0.5102990033222591
E01009857,1689,815,874,0.48253404381290704,0.5174659561870929
E01009858,1475,831,644,0.5633898305084746,0.4366101694915254
E01009859,1538,742,796,0.48244473342002603,0.517555266579974
E01009845,1550,767,783,0.49483870967741933,0.5051612903225806
E01009846,1496,739,757,0.4939839572192513,0.5060160427807486
E01009850,1477,724,753,0.4901828029790115,0.5098171970209885
E01009852,1410,686,724,0.48652482269503544,0.5134751773049645
E01009832,1744,772,972,0.4426605504587156,0.5573394495412844
E01009853,1374,645,729,0.46943231441048033,0.5305676855895196
E01009855,1652,802,850,0.4854721549636804,0.5145278450363197
E01009860,1501,720,781,0.47968021319120585,0.5203197868087941
E01009807,1871,906,965,0.484233030464992,0.515766969535008
E01009808,1360,666,694,0.48970588235294116,0.5102941176470588
E01009810,1805,859,946,0.4759002770083102,0.5240997229916897
E01009811,1482,711,771,0.4797570850202429,0.520242914979757
E01009812,1511,771,740,0.5102581072137657,0.48974189278623426
E01010085,1841,934,907,0.5073329712112982,0.4926670287887018
E01010086,1761,848,913,0.48154457694491765,0.5184554230550823
E01010087,1664,840,824,0.5048076923076923,0.4951923076923077
E01010088,1619,808,811,0.4990735021618283,0.5009264978381717
E01010089,1875,918,957,0.4896,0.5104
E01009969,2125,1020,1105,0.48,0.52
E01009970,1816,893,923,0.4917400881057269,0.5082599118942731
E01009971,1709,788,921,0.46108835576360446,0.5389116442363956
E01009973,2402,1151,1251,0.4791840133222315,0.5208159866777685
E01009960,1584,733,851,0.46275252525252525,0.5372474747474747
E01009961,1244,630,614,0.5064308681672026,0.49356913183279744
E01009966,1225,599,626,0.4889795918367347,0.5110204081632653
E01009967,1880,882,998,0.46914893617021275,0.5308510638297872
E01010092,1877,905,972,0.4821523708044752,0.5178476291955247
E01009962,1363,648,715,0.47542186353631694,0.524578136463683
E01009963,1371,678,693,0.49452954048140046,0.5054704595185996
E01009964,1628,786,842,0.4828009828009828,0.5171990171990172
E01009965,1352,654,698,0.48372781065088755,0.5162721893491125
E01010090,2125,1074,1051,0.5054117647058823,0.49458823529411766
E01010091,1707,899,808,0.526654950205038,0.47334504979496195
E01010096,1822,903,919,0.495609220636663,0.504390779363337
E01010097,1901,929,972,0.4886901630720673,0.5113098369279326
E01009968,1535,724,811,0.4716612377850163,0.5283387622149837
E01009972,1919,910,1009,0.47420531526836895,0.525794684731631
E01009974,1681,796,885,0.47352766210588937,0.5264723378941106
E01009975,1694,843,851,0.49763872491145217,0.5023612750885478
E01010030,1738,842,896,0.4844649021864212,0.5155350978135789
E01010034,1239,626,613,0.5052461662631155,0.4947538337368846
E01010035,1331,653,678,0.4906085649887303,0.5093914350112697
E01010036,2002,987,1015,0.493006993006993,0.506993006993007
E01009982,1590,790,800,0.4968553459119497,0.5031446540880503
E01009983,1595,743,852,0.4658307210031348,0.5341692789968652
E01010029,1650,768,882,0.46545454545454545,0.5345454545454545
E01010037,1334,644,690,0.4827586206896552,0.5172413793103449
E01009991,2358,1145,1213,0.4855810008481764,0.5144189991518235
E01009994,1772,863,909,0.48702031602708806,0.5129796839729119
E01009995,1623,774,849,0.47689463955637706,0.5231053604436229
E01009996,1637,788,849,0.4813683567501527,0.5186316432498472
E01009997,1801,885,916,0.49139367018323155,0.5086063298167685
E01009998,2171,1037,1134,0.4776600644864118,0.5223399355135883
E01010008,1649,794,855,0.48150394178289874,0.5184960582171013
E01010010,1485,707,778,0.47609427609427607,0.5239057239057239
E01010011,1756,847,909,0.48234624145785876,0.5176537585421412
E01010012,1438,691,747,0.480528511821975,0.519471488178025
E01010007,1373,628,745,0.4573925710123816,0.5426074289876184
E01010009,1450,696,754,0.48,0.52
E01010013,1340,662,678,0.49402985074626865,0.5059701492537313
E01010014,1655,775,880,0.46827794561933533,0.5317220543806647
E01010093,1617,826,791,0.5108225108225108,0.48917748917748916
E01010094,1677,797,880,0.4752534287418008,0.5247465712581991
E01010095,2094,984,1110,0.4699140401146132,0.5300859598853869
E01010098,1884,913,971,0.4846072186836518,0.5153927813163482
E01010099,1821,889,932,0.48819330038440417,0.5118066996155958
E01010100,2033,997,1036,0.49040826364977863,0.5095917363502214
E01009978,1850,904,946,0.48864864864864865,0.5113513513513513
E01010031,1542,770,772,0.4993514915693904,0.5006485084306096
E01010032,1658,807,851,0.4867310012062726,0.5132689987937273
E01010033,1651,819,832,0.49606299212598426,0.5039370078740157
E01033886,1645,781,864,0.47477203647416416,0.5252279635258359
E01033887,1535,772,763,0.5029315960912052,0.4970684039087948
E01010066,1708,856,852,0.5011709601873536,0.49882903981264637
E01010067,1761,894,867,0.5076660988074957,0.49233390119250425
E01010068,1868,903,965,0.48340471092077086,0.5165952890792291
E01010070,1772,900,872,0.5079006772009029,0.49209932279909707
E01010075,1547,771,776,0.49838396897220427,0.5016160310277957
E01010076,2066,1010,1056,0.4888673765730881,0.5111326234269119
E01009976,2745,1351,1394,0.49216757741347905,0.507832422586521
E01009977,2025,998,1027,0.4928395061728395,0.5071604938271604
E01009979,2041,1016,1025,0.4977951984321411,0.5022048015678588
E01009980,2344,1148,1196,0.48976109215017066,0.5102389078498294
E01010069,2648,1361,1287,0.5139728096676737,0.4860271903323263
E01010071,1767,891,876,0.5042444821731749,0.49575551782682514
E01009947,2393,1174,1219,0.49059757626410366,0.5094024237358964
E01009992,1800,880,920,0.4888888888888889,0.5111111111111111
E01009993,1953,950,1003,0.4864311315924219,0.5135688684075781
E01010103,2235,1164,1071,0.5208053691275167,0.4791946308724832
E01010104,1756,855,901,0.4869020501138952,0.5130979498861048
E01010105,1654,868,786,0.524788391777509,0.4752116082224909
E01009981,2069,1039,1030,0.5021749637506041,0.49782503624939584
E01009985,1817,901,916,0.49587231700605394,0.5041276829939461
E01033888,1522,766,756,0.5032851511169514,0.4967148488830486
E01033889,1949,970,979,0.4976911236531555,0.5023088763468445
E01009986,1682,832,850,0.4946492271105826,0.5053507728894173
E01009987,1483,760,723,0.5124747134187457,0.4875252865812542
E01009989,1979,968,1011,0.48913592723597776,0.5108640727640222
E01010106,1915,919,996,0.47989556135770234,0.5201044386422976
E01009988,2830,1388,1442,0.49045936395759715,0.5095406360424029
E01010101,2058,1039,1019,0.5048590864917396,0.49514091350826045
E01010102,1883,968,915,0.514073287307488,0.485926712692512
E01010107,2187,1071,1116,0.4897119341563786,0.5102880658436214
E01010015,2030,1035,995,0.5098522167487685,0.49014778325123154
E01010016,1840,930,910,0.5054347826086957,0.4945652173913043
E01010018,2441,1215,1226,0.49774682507169193,0.5022531749283081
E01010072,2352,1252,1100,0.532312925170068,0.467687074829932
E01010073,1664,780,884,0.46875,0.53125
E01010077,1631,780,851,0.47823421213979156,0.5217657878602084
E01010079,1493,780,713,0.522438044206296,0.477561955793704
E01010080,1990,1013,977,0.5090452261306533,0.4909547738693467
E01010081,1563,769,794,0.49200255918106206,0.5079974408189379
E01010082,2315,1145,1170,0.4946004319654428,0.5053995680345572
E01010083,1869,936,933,0.5008025682182986,0.49919743178170145
E01010084,1635,808,827,0.4941896024464832,0.5058103975535169
E01010046,2941,1412,1529,0.4801088065283917,0.5198911934716083
E01010047,2150,1106,1044,0.5144186046511627,0.4855813953488372
E01010048,1869,969,900,0.5184590690208668,0.48154093097913325
E01010049,1719,871,848,0.5066899360093078,0.49331006399069227
E01010050,1739,883,856,0.5077630822311673,0.49223691776883266
E01010052,1481,726,755,0.4902093180283592,0.5097906819716408
E01010053,2270,1127,1143,0.49647577092511014,0.5035242290748899
E01010017,1976,1055,921,0.5339068825910931,0.4660931174089069
E01010019,1999,1036,963,0.5182591295647824,0.4817408704352176
E01010020,2257,1082,1175,0.47939743021710235,0.5206025697828977
E01010021,2026,973,1053,0.48025666337611056,0.5197433366238894
E01010039,2153,1059,1094,0.4918718067812355,0.5081281932187646
E01010043,1401,684,717,0.48822269807280516,0.5117773019271948
E01010044,1544,735,809,0.47603626943005184,0.5239637305699482
E01010078,1222,580,642,0.4746317512274959,0.5253682487725041
E01009934,1448,688,760,0.47513812154696133,0.5248618784530387
E01009935,2369,1197,1172,0.5052764879696074,0.49472351203039255
E01009936,1557,767,790,0.49261400128452154,0.5073859987154785
E01010004,1870,934,936,0.4994652406417112,0.5005347593582887
E01010054,2077,1107,970,0.5329802599903707,0.46701974000962926
E01010055,2018,995,1023,0.4930624380574827,0.5069375619425174
E01010056,1887,930,957,0.492845786963434,0.5071542130365659
E01010057,2240,1136,1104,0.5071428571428571,0.4928571428571429
E01010060,2116,1026,1090,0.4848771266540643,0.5151228733459358
E01010038,1849,914,935,0.4943212547322877,0.5056787452677123
E01010040,1424,680,744,0.47752808988764045,0.5224719101123596
E01010041,1744,821,923,0.47075688073394495,0.529243119266055
E01010045,1700,834,866,0.49058823529411766,0.5094117647058823
E01010000,1822,912,910,0.5005488474204172,0.4994511525795829
E01010002,2197,1084,1113,0.49340009103322713,0.5065999089667729
E01010003,1529,743,786,0.48593852190974496,0.514061478090255
E01010005,1643,825,818,0.5021302495435179,0.497869750456482
E01010006,1733,857,876,0.49451817657241776,0.5054818234275822
E01009938,1835,908,927,0.4948228882833787,0.5051771117166213
E01009943,1629,756,873,0.46408839779005523,0.5359116022099447
E01009944,1846,896,950,0.48537378114842905,0.514626218851571
E01010051,1423,694,729,0.4877020379479972,0.5122979620520028
E01010058,1678,834,844,0.4970202622169249,0.5029797377830751
E01009937,1631,786,845,0.4819129368485592,0.5180870631514408
E01009939,1705,841,864,0.49325513196480936,0.5067448680351906
E01009940,1538,742,796,0.48244473342002603,0.517555266579974
E01009941,1575,789,786,0.5009523809523809,0.4990476190476191
E01009942,1755,842,913,0.47977207977207975,0.5202279202279202
E01009929,1752,827,925,0.4720319634703196,0.5279680365296804
E01009930,1555,708,847,0.4553054662379421,0.5446945337620579
E01009931,2371,1181,1190,0.4981020666385491,0.5018979333614508
E01009932,1598,821,777,0.513767209011264,0.4862327909887359
E01009999,1457,723,734,0.4962251201098147,0.5037748798901853
E01009921,1783,880,903,0.49355019629837354,0.5064498037016265
E01009922,1366,673,693,0.49267935578330896,0.5073206442166911
E01009924,1415,675,740,0.47703180212014135,0.5229681978798587
E01009925,1453,704,749,0.4845147969717825,0.5154852030282174
E01009926,1408,682,726,0.484375,0.515625
E01009927,1513,762,751,0.5036351619299405,0.4963648380700595
E01009928,1730,814,916,0.4705202312138728,0.5294797687861271
E01009933,1422,690,732,0.48523206751054854,0.5147679324894515
E01009952,2185,1026,1159,0.46956521739130436,0.5304347826086957
E01009955,2329,1244,1085,0.5341348218119365,0.46586517818806356
E01009956,1643,815,828,0.4960438222763238,0.5039561777236762
E01009959,1430,707,723,0.4944055944055944,0.5055944055944056
E01010042,1875,930,945,0.496,0.504
E01009923,1520,742,778,0.4881578947368421,0.5118421052631579
E01010024,1585,771,814,0.48643533123028393,0.5135646687697161
E01010026,1846,884,962,0.4788732394366197,0.5211267605633803
E01010027,1619,772,847,0.4768375540457072,0.5231624459542927
E01010001,1933,944,989,0.4883600620796689,0.5116399379203311
E01010022,1575,795,780,0.5047619047619047,0.49523809523809526
E01010023,1829,913,916,0.4991798797156916,0.5008201202843083
E01010025,1736,830,906,0.478110599078341,0.521889400921659
E01010028,1586,743,843,0.46847414880201765,0.5315258511979823
E01009953,2094,1063,1031,0.5076408787010506,0.4923591212989494
E01009954,1854,901,953,0.4859762675296656,0.5140237324703344
E01009957,1850,850,1000,0.4594594594594595,0.5405405405405406
E01009958,1582,778,804,0.4917825537294564,0.5082174462705437
E01009946,1809,894,915,0.494195688225539,0.5058043117744611
E01009948,1494,755,739,0.5053547523427041,0.49464524765729584
E01009949,1613,787,826,0.4879107253564786,0.5120892746435214
E01009950,1718,877,841,0.510477299185099,0.48952270081490107
E01009951,2267,1127,1140,0.49713277459197175,0.5028672254080282
E01032592,1786,871,915,0.4876819708846585,0.5123180291153415
E01010062,2279,1148,1131,0.5037297060114085,0.49627029398859146
E01010064,2170,1045,1125,0.4815668202764977,0.5184331797235023
E01033890,1477,731,746,0.4949221394719025,0.5050778605280974
E01033891,1670,840,830,0.5029940119760479,0.49700598802395207
E01010059,2290,1172,1118,0.5117903930131005,0.4882096069868996
E01010061,2041,1027,1014,0.5031847133757962,0.4968152866242038
E01033892,2054,995,1059,0.4844206426484908,0.5155793573515093
E01033893,1690,850,840,0.5029585798816568,0.4970414201183432
E01010118,1214,587,627,0.48352553542009885,0.5164744645799012
E01010120,1254,580,674,0.4625199362041467,0.5374800637958532
E01010121,1539,775,764,0.5035737491877843,0.4964262508122157
E01010122,1427,702,725,0.49194113524877364,0.5080588647512263
E01010235,1478,703,775,0.47564276048714477,0.5243572395128552
E01010236,1421,691,730,0.48627726952850103,0.513722730471499
E01010239,1553,728,825,0.4687701223438506,0.5312298776561494
E01010240,1388,648,740,0.4668587896253602,0.5331412103746398
E01010117,1455,718,737,0.4934707903780069,0.5065292096219931
E01010119,1538,756,782,0.49154746423927176,0.5084525357607282
E01010123,1516,733,783,0.48350923482849606,0.5164907651715039
E01010124,1520,742,778,0.4881578947368421,0.5118421052631579
E01010146,1689,782,907,0.46299585553582,0.53700414446418
E01010234,1807,844,963,0.46707249584947425,0.5329275041505257
E01010237,1859,896,963,0.48197955890263583,0.5180204410973642
E01010238,1391,665,726,0.47807332854061824,0.5219266714593818
E01010145,1674,806,868,0.48148148148148145,0.5185185185185185
E01010147,1601,734,867,0.4584634603372892,0.5415365396627108
E01010148,1845,867,978,0.46991869918699186,0.5300813008130081
E01010149,1538,730,808,0.47464239271781533,0.5253576072821846
E01010125,1880,912,968,0.4851063829787234,0.5148936170212766
E01010129,1646,770,876,0.46780072904009723,0.5321992709599028
E01010139,1086,511,575,0.4705340699815838,0.5294659300184162
E01010141,1311,640,671,0.4881769641495042,0.5118230358504958
E01010140,1466,694,772,0.4733969986357435,0.5266030013642565
E01010142,1493,684,809,0.4581379772270596,0.5418620227729404
E01010143,1610,753,857,0.46770186335403724,0.5322981366459627
E01010144,1728,838,890,0.4849537037037037,0.5150462962962963
E01010111,1448,699,749,0.48273480662983426,0.5172651933701657
E01010126,1454,670,784,0.4607977991746905,0.5392022008253095
E01010127,1850,909,941,0.49135135135135133,0.5086486486486487
E01010128,1495,697,798,0.4662207357859532,0.5337792642140469
E01010130,1851,860,991,0.46461372231226367,0.5353862776877364
E01010131,1487,696,791,0.46805648957632817,0.5319435104236718
E01010109,1661,824,837,0.49608669476219147,0.5039133052378085
E01010110,1596,794,802,0.4974937343358396,0.5025062656641605
E01010112,1565,715,850,0.45686900958466453,0.5431309904153354
E01010113,1353,677,676,0.500369549150037,0.49963045084996305
E01010114,1892,953,939,0.5036997885835095,0.4963002114164905
E01010157,1437,722,715,0.5024356297842728,0.4975643702157272
E01010159,1452,739,713,0.5089531680440771,0.49104683195592286
E01010162,1553,791,762,0.5093367675466839,0.49066323245331617
E01010163,1520,749,771,0.49276315789473685,0.5072368421052632
E01010132,1542,734,808,0.47600518806744485,0.5239948119325551
E01010133,1703,829,874,0.4867880211391662,0.5132119788608338
E01010134,1480,715,765,0.4831081081081081,0.5168918918918919
E01010135,1524,761,763,0.49934383202099736,0.5006561679790026
E01010138,1405,694,711,0.49395017793594304,0.5060498220640569
E01010136,1274,640,634,0.5023547880690737,0.4976452119309262
E01010137,1376,691,685,0.5021802325581395,0.49781976744186046
E01010158,1556,716,840,0.4601542416452442,0.5398457583547558
E01010160,1487,744,743,0.5003362474781439,0.4996637525218561
E01010161,1575,771,804,0.4895238095238095,0.5104761904761905
E01010174,1685,837,848,0.4967359050445104,0.5032640949554896
E01010175,1723,838,885,0.4863609982588508,0.5136390017411492
E01010177,1342,658,684,0.4903129657228018,0.5096870342771982
E01010178,1944,1019,925,0.5241769547325102,0.4758230452674897
E01010172,1576,762,814,0.48350253807106597,0.516497461928934
E01010173,1426,721,705,0.5056100981767181,0.4943899018232819
E01010176,1404,701,703,0.49928774928774927,0.5007122507122507
E01010179,1572,757,815,0.4815521628498728,0.5184478371501272
E01010115,1554,776,778,0.49935649935649934,0.5006435006435006
E01010116,1373,661,712,0.48142753095411506,0.5185724690458849
E01010227,1886,894,992,0.4740190880169671,0.5259809119830329
E01010228,1613,782,831,0.4848109113453193,0.5151890886546807
E01010232,2199,1040,1159,0.47294224647567074,0.5270577535243293
E01010195,1596,788,808,0.49373433583959897,0.506265664160401
E01010226,1740,807,933,0.46379310344827585,0.5362068965517242
E01010229,1599,795,804,0.4971857410881801,0.5028142589118199
E01010230,1824,859,965,0.47094298245614036,0.5290570175438597
E01010231,1671,848,823,0.5074805505685218,0.49251944943147813
E01010233,1943,937,1006,0.4822439526505404,0.5177560473494596
E01010108,2169,1075,1094,0.4956201014292301,0.5043798985707699
E01010164,1715,859,856,0.5008746355685131,0.49912536443148686
E01010165,1806,880,926,0.48726467331118495,0.512735326688815
E01010167,1654,791,863,0.4782345828295042,0.5217654171704957
E01010199,1927,976,951,0.5064867669953296,0.4935132330046705
E01010200,1448,692,756,0.47790055248618785,0.5220994475138122
E01010201,1740,833,907,0.478735632183908,0.521264367816092
E01010204,1366,655,711,0.479502196193265,0.5204978038067349
E01010205,1485,725,760,0.4882154882154882,0.5117845117845118
E01010206,1770,866,904,0.48926553672316386,0.5107344632768361
E01010192,1799,902,897,0.5013896609227348,0.49861033907726515
E01010196,1755,886,869,0.5048433048433049,0.49515669515669514
E01010197,1687,830,857,0.4919976289270895,0.5080023710729105
E01010198,1660,779,881,0.46927710843373494,0.5307228915662651
E01010218,1341,639,702,0.47651006711409394,0.5234899328859061
E01010219,1569,745,824,0.4748247291268324,0.5251752708731676
E01010221,2011,950,1061,0.4724017901541522,0.5275982098458478
E01010222,1386,694,692,0.5007215007215007,0.49927849927849927
E01010191,1935,943,992,0.4873385012919897,0.5126614987080104
E01010202,1591,784,807,0.4927718416090509,0.507228158390949
E01010203,1746,872,874,0.49942726231386025,0.5005727376861397
E01010209,1730,849,881,0.4907514450867052,0.5092485549132948
E01010213,1774,845,929,0.4763246899661781,0.5236753100338218
E01010208,1573,739,834,0.4698029243483789,0.5301970756516211
E01010210,1528,739,789,0.4836387434554974,0.5163612565445026
E01010211,1441,673,768,0.46703678001387927,0.5329632199861207
E01010217,1541,760,781,0.49318624269954575,0.5068137573004543
E01010190,1608,767,841,0.47699004975124376,0.5230099502487562
E01010193,1244,612,632,0.4919614147909968,0.5080385852090032
E01010194,1557,750,807,0.4816955684007707,0.5183044315992292
E01010207,1439,686,753,0.47671994440583737,0.5232800555941626
E01010166,1880,908,972,0.4829787234042553,0.5170212765957447
E01010168,1807,881,926,0.48754842280022137,0.5124515771997786
E01010169,1676,848,828,0.5059665871121718,0.49403341288782815
E01010170,1482,726,756,0.4898785425101215,0.5101214574898786
E01010171,1420,658,762,0.46338028169014084,0.5366197183098591
E01010151,1636,762,874,0.46577017114914426,0.5342298288508558
E01010152,1296,630,666,0.4861111111111111,0.5138888888888888
E01010153,1784,860,924,0.4820627802690583,0.5179372197309418
E01010154,1658,805,853,0.485524728588661,0.514475271411339
E01010155,1825,872,953,0.4778082191780822,0.5221917808219179
E01010156,1531,760,771,0.496407576747224,0.503592423252776
E01010212,1259,632,627,0.5019857029388404,0.4980142970611596
E01010214,1158,551,607,0.4758203799654577,0.5241796200345423
E01010215,1509,724,785,0.47978793903247186,0.5202120609675281
E01010216,1488,713,775,0.4791666666666667,0.5208333333333334
E01010150,1593,740,853,0.4645323289391086,0.5354676710608914
E01010184,1643,778,865,0.47352404138770543,0.5264759586122946
E01010185,1553,764,789,0.49195106245975534,0.5080489375402447
E01010186,1859,876,983,0.471221086605702,0.5287789133942981
E01010187,1484,749,735,0.5047169811320755,0.49528301886792453
E01010188,1714,864,850,0.5040840140023337,0.4959159859976663
E01010180,1503,721,782,0.479707252162342,0.520292747837658
E01010181,2785,1357,1428,0.4872531418312388,0.5127468581687612
E01010183,1893,941,952,0.497094558901215,0.502905441098785
E01010189,1629,800,829,0.4910988336402701,0.5089011663597299
E01032885,1561,812,749,0.5201793721973094,0.4798206278026906
E01032886,2761,1377,1384,0.4987323433538573,0.5012676566461427
E01010220,1666,813,853,0.4879951980792317,0.5120048019207684
E01010223,1248,610,638,0.48878205128205127,0.5112179487179487
E01010225,1519,747,772,0.49177090190915074,0.5082290980908493
E01032590,2297,1127,1170,0.49063996517196345,0.5093600348280366
E01010301,1448,719,729,0.4965469613259669,0.5034530386740331
E01010303,1587,777,810,0.4896030245746692,0.5103969754253308
E01010306,2258,1105,1153,0.4893711248892825,0.5106288751107174
E01010307,1732,860,872,0.49653579676674364,0.5034642032332564
E01010302,1536,735,801,0.478515625,0.521484375
E01010304,1686,822,864,0.4875444839857651,0.5124555160142349
E01010305,1385,662,723,0.4779783393501805,0.5220216606498195
E01010308,1810,862,948,0.47624309392265196,0.523756906077348
E01010345,1123,547,576,0.4870881567230632,0.5129118432769367
E01010346,1262,610,652,0.48335974643423135,0.5166402535657686
E01010347,1474,747,727,0.5067842605156038,0.4932157394843962
E01010350,1413,705,708,0.4989384288747346,0.5010615711252654
E01010249,1759,842,917,0.47868106878908473,0.5213189312109153
E01010250,1399,671,728,0.47962830593280914,0.5203716940671909
E01010252,1776,857,919,0.48254504504504503,0.517454954954955
E01010254,1468,720,748,0.4904632152588556,0.5095367847411444
E01010348,1505,709,796,0.47109634551495017,0.5289036544850498
E01010349,1244,617,627,0.4959807073954984,0.5040192926045016
E01010351,1728,859,869,0.49710648148148145,0.5028935185185185
E01010352,1605,786,819,0.4897196261682243,0.5102803738317757
E01010284,1681,810,871,0.4818560380725758,0.5181439619274242
E01010285,1855,923,932,0.49757412398921835,0.5024258760107817
E01010286,1635,788,847,0.4819571865443425,0.5180428134556575
E01010290,1653,799,854,0.48336358136721114,0.5166364186327889
E01010251,1543,776,767,0.5029163966299417,0.4970836033700583
E01010253,1217,596,621,0.4897288414133114,0.5102711585866886
E01010255,1343,640,703,0.4765450483991065,0.5234549516008935
E01010256,1504,744,760,0.4946808510638298,0.5053191489361702
E01010257,1148,563,585,0.490418118466899,0.509581881533101
E01010292,1949,1023,926,0.5248845561826577,0.4751154438173422
E01010294,1513,764,749,0.5049570389953735,0.4950429610046266
E01010296,1455,709,746,0.4872852233676976,0.5127147766323024
E01010297,1336,656,680,0.49101796407185627,0.5089820359281437
E01010291,1478,695,783,0.4702300405953992,0.5297699594046008
E01010293,1682,807,875,0.4797859690844233,0.5202140309155767
E01010298,1221,608,613,0.49795249795249796,0.502047502047502
E01010299,1582,782,800,0.4943109987357775,0.5056890012642224
E01010300,1459,702,757,0.48115147361206306,0.518848526387937
E01010319,1314,664,650,0.5053272450532724,0.4946727549467275
E01010321,1601,790,811,0.4934415990006246,0.5065584009993754
E01010353,1528,745,783,0.487565445026178,0.512434554973822
E01010354,1540,759,781,0.4928571428571429,0.5071428571428571
E01010395,1350,667,683,0.49407407407407405,0.5059259259259259
E01010397,1701,811,890,0.47677836566725457,0.5232216343327455
E01010398,1534,764,770,0.4980443285528031,0.5019556714471969
E01010399,1527,767,760,0.5022920759659463,0.4977079240340537
E01010282,1349,664,685,0.4922164566345441,0.507783543365456
E01010287,1710,823,887,0.4812865497076023,0.5187134502923977
E01010288,1645,796,849,0.4838905775075988,0.5161094224924012
E01010289,1956,911,1045,0.4657464212678937,0.5342535787321063
E01010277,1766,884,882,0.5005662514156285,0.49943374858437145
E01010283,1923,963,960,0.500780031201248,0.49921996879875197
E01033894,1809,878,931,0.4853510226644555,0.5146489773355445
E01033895,1657,803,854,0.48461074230537116,0.5153892576946288
E01010393,1468,722,746,0.49182561307901906,0.5081743869209809
E01010394,1346,668,678,0.4962852897473997,0.5037147102526003
E01010396,1680,829,851,0.493452380952381,0.506547619047619
E01010400,2108,937,1171,0.4444971537001898,0.5555028462998103
E01010241,2338,1083,1255,0.4632164242942686,0.5367835757057314
E01010242,1638,781,857,0.47680097680097683,0.5231990231990232
E01010243,1487,685,802,0.4606590450571621,0.539340954942838
E01010244,1457,681,776,0.4673987645847632,0.5326012354152367
E01010320,1338,634,704,0.47384155455904337,0.5261584454409567
E01010322,1681,798,883,0.47471743010113027,0.5252825698988697
E01010323,1483,754,729,0.5084288604180714,0.4915711395819285
E01010324,1947,991,956,0.5089881869542886,0.49101181304571134
E01010271,2113,993,1120,0.4699479413156649,0.530052058684335
E01010272,1542,770,772,0.4993514915693904,0.5006485084306096
E01010273,1505,725,780,0.48172757475083056,0.5182724252491694
E01010295,1516,712,804,0.46965699208443273,0.5303430079155673
E01010279,2018,968,1050,0.4796828543111992,0.5203171456888008
E01010374,2707,1300,1407,0.4802364240857037,0.5197635759142962
E01010375,2307,1120,1187,0.48547897702644127,0.5145210229735587
E01032888,2760,1348,1412,0.48840579710144927,0.5115942028985507
E01010378,1177,574,603,0.4876805437553101,0.5123194562446899
E01010379,1273,626,647,0.4917517674783975,0.5082482325216026
E01010382,1500,740,760,0.49333333333333335,0.5066666666666667
E01010383,1679,792,887,0.47170935080405,0.5282906491959499
E01010376,1225,631,594,0.5151020408163265,0.48489795918367345
E01010377,1811,896,915,0.4947542794036444,0.5052457205963556
E01010380,1426,697,729,0.4887798036465638,0.5112201963534362
E01010381,1569,787,782,0.5015933715742511,0.4984066284257489
E01010267,1595,784,811,0.4915360501567398,0.5084639498432602
E01010268,1797,874,923,0.48636616583194214,0.5136338341680579
E01010274,1580,769,811,0.48670886075949366,0.5132911392405063
E01010275,1891,890,1001,0.4706504494976203,0.5293495505023796
E01010245,1592,756,836,0.4748743718592965,0.5251256281407035
E01010246,1572,776,796,0.49363867684478374,0.5063613231552163
E01010247,1579,787,792,0.49841671944268523,0.5015832805573147
E01010248,1605,771,834,0.4803738317757009,0.5196261682242991
E01010388,1431,721,710,0.5038434661076171,0.49615653389238296
E01010258,1660,765,895,0.4608433734939759,0.5391566265060241
E01010259,1592,761,831,0.4780150753768844,0.5219849246231156
E01010260,1872,894,978,0.4775641025641026,0.5224358974358975
E01010266,1317,633,684,0.4806378132118451,0.5193621867881549
E01010317,1608,769,839,0.47823383084577115,0.5217661691542289
E01010318,1626,763,863,0.46924969249692494,0.5307503075030751
E01010325,1923,964,959,0.50130005200208,0.4986999479979199
E01010369,1744,888,856,0.5091743119266054,0.4908256880733945
E01010401,1619,781,838,0.4823965410747375,0.5176034589252625
E01010403,1953,981,972,0.5023041474654378,0.4976958525345622
E01010404,2029,1030,999,0.507639231148349,0.4923607688516511
E01010407,1877,902,975,0.4805540756526372,0.5194459243473628
E01010408,1760,843,917,0.47897727272727275,0.5210227272727272
E01010269,1635,803,832,0.491131498470948,0.5088685015290519
E01010270,1757,847,910,0.4820717131474104,0.5179282868525896
E01010362,1876,914,962,0.48720682302771856,0.5127931769722814
E01010363,2713,1399,1314,0.5156653151492813,0.4843346848507188
E01010402,1750,853,897,0.48742857142857143,0.5125714285714286
E01010405,1837,934,903,0.5084376701143168,0.49156232988568316
E01010406,2868,1443,1425,0.5031380753138075,0.49686192468619245
E01010409,1549,741,808,0.47837314396384767,0.5216268560361523
E01010385,1519,760,759,0.500329163923634,0.49967083607636603
E01010386,1601,765,836,0.4778263585259213,0.5221736414740787
E01010387,1471,714,757,0.48538409245411285,0.5146159075458872
E01010392,1524,753,771,0.4940944881889764,0.5059055118110236
E01010326,1659,820,839,0.49427365883062085,0.5057263411693791
E01010327,1695,814,881,0.48023598820059,0.51976401179941
E01010328,1525,754,771,0.4944262295081967,0.5055737704918033
E01010330,1479,746,733,0.504394861392833,0.495605138607167
E01010368,2198,1120,1078,0.5095541401273885,0.49044585987261147
E01010370,2090,1060,1030,0.507177033492823,0.49282296650717705
E01010372,1634,828,806,0.5067319461444308,0.49326805385556916
E01010373,1890,858,1032,0.45396825396825397,0.546031746031746
E01033896,1619,834,785,0.5151327980234712,0.4848672019765287
E01033897,1432,702,730,0.49022346368715086,0.5097765363128491
E01010361,1500,725,775,0.48333333333333334,0.5166666666666667
E01010364,1607,798,809,0.49657747355320475,0.5034225264467953
E01010365,1715,843,872,0.4915451895043732,0.5084548104956268
E01010366,1821,872,949,0.47885777045579353,0.5211422295442065
E01010367,1912,953,959,0.49843096234309625,0.5015690376569037
E01010384,1425,678,747,0.47578947368421054,0.5242105263157895
E01010389,1476,742,734,0.502710027100271,0.497289972899729
E01010390,1695,819,876,0.4831858407079646,0.5168141592920354
E01010391,1863,884,979,0.4745034889962426,0.5254965110037574
E01010261,1873,859,1014,0.4586225306994127,0.5413774693005873
E01010263,1616,790,826,0.48886138613861385,0.5111386138613861
E01010264,2028,967,1061,0.47682445759368836,0.5231755424063116
E01010265,2033,1068,965,0.5253320216428923,0.4746679783571077
E01010336,1527,761,766,0.49836280288146695,0.501637197118533
E01010340,1753,852,901,0.4860239589275528,0.5139760410724472
E01010341,1687,812,875,0.48132780082987553,0.5186721991701245
E01010342,1846,898,948,0.48645720476706394,0.5135427952329361
E01010343,1601,789,812,0.4928169893816365,0.5071830106183636
E01010344,1851,912,939,0.49270664505672607,0.5072933549432739
E01010331,1655,799,856,0.4827794561933535,0.5172205438066465
E01010332,2003,997,1006,0.4977533699450824,0.5022466300549177
E01010333,1611,798,813,0.49534450651769085,0.5046554934823091
E01010334,1577,761,816,0.4825618262523779,0.517438173747622
E01010262,1796,877,919,0.48830734966592426,0.5116926503340757
E01010309,2218,1071,1147,0.4828674481514878,0.5171325518485121
E01010311,2771,1327,1444,0.47888848791050165,0.5211115120894984
E01010316,1705,836,869,0.49032258064516127,0.5096774193548387
E01010335,1635,771,864,0.47155963302752296,0.5284403669724771
E01010337,1378,659,719,0.4782293178519594,0.5217706821480407
E01010338,1886,939,947,0.49787910922587486,0.5021208907741251
E01010339,1526,746,780,0.4888597640891219,0.5111402359108781
E01010310,2168,1067,1101,0.4921586715867159,0.5078413284132841
E01010312,1794,855,939,0.4765886287625418,0.5234113712374582
E01010313,1527,768,759,0.5029469548133595,0.49705304518664045
E01010314,1667,880,787,0.5278944211157769,0.47210557888422316
E01010315,1953,940,1013,0.48131080389144903,0.5186891961085509
E01010329,1672,798,874,0.4772727272727273,0.5227272727272727
E01010355,1434,694,740,0.4839609483960948,0.5160390516039052
E01010356,1480,727,753,0.4912162162162162,0.5087837837837837
E01010357,2323,1096,1227,0.47180370210934136,0.5281962978906586
E01010358,1537,715,822,0.4651919323357189,0.534808067664281
E01010359,1523,723,800,0.4747209455022981,0.525279054497702
E01010360,1462,704,758,0.48153214774281805,0.518467852257182
E01010434,1763,861,902,0.4883720930232558,0.5116279069767442
E01010436,1432,705,727,0.49231843575418993,0.50768156424581
E01010437,1157,562,595,0.4857389801210026,0.5142610198789974
E01010438,1409,693,716,0.4918381831085876,0.5081618168914124
E01010439,1379,660,719,0.47860768672951415,0.5213923132704859
E01010440,1592,741,851,0.46545226130653267,0.5345477386934674
E01010441,1356,654,702,0.4823008849557522,0.5176991150442478
E01010495,1749,851,898,0.4865637507146941,0.5134362492853058
E01010497,1114,578,536,0.518850987432675,0.48114901256732495
E01010499,1471,704,767,0.4785859959211421,0.521414004078858
E01010500,1458,664,794,0.4554183813443073,0.5445816186556928
E01010496,1409,646,763,0.45848119233498935,0.5415188076650106
E01010498,1336,652,684,0.4880239520958084,0.5119760479041916
E01010541,1394,693,701,0.4971305595408895,0.5028694404591105
E01010543,1417,667,750,0.47071277346506707,0.529287226534933
E01010456,1486,687,799,0.46231493943472407,0.5376850605652759
E01010457,1592,797,795,0.5006281407035176,0.4993718592964824
E01010462,1692,802,890,0.4739952718676123,0.5260047281323877
E01010481,1508,705,803,0.46750663129973474,0.5324933687002652
E01010555,1501,717,784,0.4776815456362425,0.5223184543637575
E01010556,1427,709,718,0.4968465311843027,0.5031534688156972
E01010557,1423,697,726,0.4898102600140548,0.5101897399859452
E01010559,1422,672,750,0.47257383966244726,0.5274261603375527
E01010560,1710,835,875,0.48830409356725146,0.5116959064327485
E01010501,1444,711,733,0.49238227146814406,0.5076177285318559
E01010502,1383,674,709,0.48734634851771513,0.5126536514822849
E01010503,1254,616,638,0.49122807017543857,0.5087719298245614
E01034310,1042,485,557,0.4654510556621881,0.5345489443378119
E01034311,2289,1156,1133,0.5050240279598078,0.4949759720401922
E01010482,1486,680,806,0.4576043068640646,0.5423956931359354
E01010483,1484,679,805,0.45754716981132076,0.5424528301886793
E01010484,1349,622,727,0.46108228317272054,0.5389177168272795
E01010485,2196,1030,1166,0.4690346083788707,0.5309653916211293
E01010458,1752,847,905,0.4834474885844749,0.5165525114155252
E01010459,1551,773,778,0.498388136686009,0.501611863313991
E01010460,1586,788,798,0.4968474148802018,0.5031525851197982
E01010461,1572,773,799,0.4917302798982188,0.5082697201017812
E01010566,1843,861,982,0.4671730873575692,0.5328269126424309
E01010539,1571,739,832,0.4704010184595799,0.5295989815404201
E01010540,1460,705,755,0.4828767123287671,0.5171232876712328
E01010542,1600,762,838,0.47625,0.52375
E01010544,1513,741,772,0.4897554527428949,0.5102445472571051
E01010545,1681,830,851,0.49375371802498513,0.5062462819750149
E01010554,1407,691,716,0.49111584932480457,0.5088841506751954
E01010558,1634,807,827,0.4938800489596083,0.5061199510403916
E01010562,1544,756,788,0.4896373056994819,0.5103626943005182
E01010563,1406,684,722,0.4864864864864865,0.5135135135135135
E01010567,1531,758,773,0.4951012410189419,0.5048987589810582
E01010478,1456,765,691,0.5254120879120879,0.47458791208791207
E01010479,1629,795,834,0.4880294659300184,0.5119705340699816
E01010480,1398,735,663,0.5257510729613734,0.4742489270386266
E01010486,1695,804,891,0.4743362831858407,0.5256637168141592
E01010474,1659,794,865,0.47860156720916214,0.5213984327908379
E01010561,1575,766,809,0.48634920634920636,0.5136507936507937
E01010564,2539,1286,1253,0.5064986215045293,0.49350137849547066
E01010565,1806,883,923,0.48892580287929127,0.5110741971207088
E01010522,1754,912,842,0.5199543899657925,0.48004561003420754
E01010523,1726,907,819,0.5254924681344149,0.47450753186558514
E01010524,1795,930,865,0.5181058495821727,0.4818941504178273
E01010525,1849,949,900,0.513250405624662,0.48674959437533805
E01010546,1752,846,906,0.4828767123287671,0.5171232876712328
E01010547,1473,695,778,0.47182620502376105,0.528173794976239
E01010548,1436,637,799,0.4435933147632312,0.5564066852367688
E01010549,1518,724,794,0.4769433465085639,0.5230566534914362
E01010553,1594,781,813,0.48996235884567124,0.5100376411543287
E01010471,1801,884,917,0.49083842309827874,0.5091615769017213
E01010472,2651,1263,1388,0.47642399094681254,0.5235760090531875
E01010473,2135,1136,999,0.5320843091334895,0.4679156908665105
E01010475,1660,846,814,0.5096385542168674,0.4903614457831325
E01010476,1956,945,1011,0.4831288343558282,0.5168711656441718
E01010477,1672,803,869,0.48026315789473684,0.5197368421052632
E01010526,1488,772,716,0.5188172043010753,0.48118279569892475
E01010527,1898,999,899,0.5263435194942044,0.47365648050579556
E01010528,1608,794,814,0.4937810945273632,0.5062189054726368
E01010529,1746,969,777,0.5549828178694158,0.44501718213058417
E01010506,1554,833,721,0.536036036036036,0.46396396396396394
E01010508,1599,947,652,0.592245153220763,0.407754846779237
E01010510,1545,754,791,0.4880258899676375,0.5119741100323625
E01010511,1791,890,901,0.496929089893914,0.503070910106086
E01010512,1402,699,703,0.4985734664764622,0.5014265335235378
E01010442,1386,686,700,0.494949494949495,0.5050505050505051
E01010443,1691,783,908,0.4630396215257244,0.5369603784742756
E01010444,1274,617,657,0.48430141287284145,0.5156985871271585
E01010445,1475,724,751,0.4908474576271186,0.5091525423728813
E01010447,1886,943,943,0.5,0.5
E01010448,1696,795,901,0.46875,0.53125
E01010509,1530,727,803,0.47516339869281043,0.5248366013071896
E01010550,1655,811,844,0.4900302114803625,0.5099697885196375
E01010551,1589,809,780,0.5091252359974827,0.4908747640025173
E01010552,1866,883,983,0.4732047159699893,0.5267952840300107
E01010463,1838,902,936,0.49075081610446136,0.5092491838955386
E01010464,1627,842,785,0.5175169022741242,0.48248309772587583
E01010465,1688,884,804,0.523696682464455,0.476303317535545
E01010466,1610,791,819,0.49130434782608695,0.508695652173913
E01010470,1592,821,771,0.5157035175879398,0.4842964824120603
E01034312,1895,917,978,0.48390501319261214,0.5160949868073879
E01034313,1281,706,575,0.5511319281811085,0.4488680718188915
E01010487,1526,733,793,0.4803407601572739,0.5196592398427261
E01010488,1459,705,754,0.4832076764907471,0.5167923235092529
E01010493,1543,765,778,0.4957874270900843,0.5042125729099157
E01010504,1582,762,820,0.48166877370417194,0.5183312262958281
E01010505,1239,604,635,0.48748991121872476,0.5125100887812752
E01010507,1459,680,779,0.4660726525017135,0.5339273474982865
E01010418,1490,742,748,0.49798657718120803,0.5020134228187919
E01010421,1660,791,869,0.47650602409638554,0.5234939759036145
E01010423,1607,770,837,0.4791537025513379,0.5208462974486621
E01010424,1556,771,785,0.4955012853470437,0.5044987146529563
E01010417,1634,798,836,0.4883720930232558,0.5116279069767442
E01010419,1757,866,891,0.4928856004553216,0.5071143995446784
E01010420,1357,661,696,0.4871039056742815,0.5128960943257185
E01010425,1322,637,685,0.48184568835098335,0.5181543116490166
E01010446,1656,820,836,0.49516908212560384,0.5048309178743962
E01010467,1615,823,792,0.5095975232198142,0.4904024767801858
E01010468,1526,726,800,0.47575360419397117,0.5242463958060288
E01010469,1446,708,738,0.4896265560165975,0.5103734439834025
E01010516,1427,712,715,0.4989488437281009,0.5010511562718991
E01010518,1628,819,809,0.5030712530712531,0.49692874692874694
E01010414,2213,1109,1104,0.5011296882060551,0.49887031179394487
E01010415,1818,836,982,0.4598459845984598,0.5401540154015402
E01010416,1894,940,954,0.4963041182682154,0.5036958817317846
E01010422,1869,928,941,0.49652220438737293,0.5034777956126271
E01010489,1499,681,818,0.4543028685790527,0.5456971314209473
E01010490,1916,1005,911,0.5245302713987474,0.4754697286012526
E01010491,1567,778,789,0.4964901084875558,0.5035098915124442
E01010492,1279,631,648,0.49335418295543393,0.506645817044566
E01010494,1579,776,803,0.4914502849905003,0.5085497150094996
E01010449,2492,1216,1276,0.48796147672552165,0.5120385232744783
E01010450,2676,1300,1376,0.4857997010463378,0.5142002989536621
E01010451,2033,1019,1014,0.5012297097884899,0.4987702902115101
E01010452,1659,783,876,0.4719710669077758,0.5280289330922242
E01010455,2645,1354,1291,0.5119092627599244,0.4880907372400756
E01010427,1827,908,919,0.4969896004378763,0.5030103995621237
E01010431,1555,767,788,0.4932475884244373,0.5067524115755627
E01010432,1529,765,764,0.5003270111183781,0.499672988881622
E01010519,1551,748,803,0.48226950354609927,0.5177304964539007
E01010520,1679,852,827,0.5074449076831448,0.4925550923168553
E01010513,1548,739,809,0.47739018087855295,0.522609819121447
E01010514,1650,818,832,0.49575757575757573,0.5042424242424243
E01010515,1662,827,835,0.49759326113116725,0.5024067388688327
E01010517,1706,821,885,0.48124267291910905,0.518757327080891
E01010533,1790,865,925,0.48324022346368717,0.5167597765363129
E01010535,1579,750,829,0.4749841671944269,0.5250158328055732
E01010536,1657,809,848,0.48823174411587206,0.5117682558841279
E01010537,1460,726,734,0.49726027397260275,0.5027397260273972
E01010410,2432,1161,1271,0.47738486842105265,0.5226151315789473
E01010411,2160,1061,1099,0.4912037037037037,0.5087962962962963
E01010412,2142,1070,1072,0.4995331465919701,0.5004668534080299
E01010413,1702,817,885,0.4800235017626322,0.5199764982373678
E01010531,1785,829,956,0.46442577030812326,0.5355742296918767
E01010532,1739,869,870,0.4997124784358827,0.5002875215641173
E01010534,1500,755,745,0.5033333333333333,0.49666666666666665
E01010538,1561,764,797,0.4894298526585522,0.5105701473414478
E01010426,1517,731,786,0.4818721160184575,0.5181278839815425
E01010428,1609,821,788,0.5102548166563082,0.4897451833436917
E01010429,1359,686,673,0.5047829286239882,0.4952170713760118
E01010430,1842,958,884,0.5200868621064061,0.4799131378935939
E01010433,1376,699,677,0.5079941860465116,0.49200581395348836
E01010454,1708,851,857,0.49824355971896955,0.5017564402810304
E01010530,1939,931,1008,0.48014440433212996,0.51985559566787
E01034314,1724,771,953,0.447215777262181,0.552784222737819
E01034315,1289,630,659,0.4887509697439876,0.5112490302560124
E01015629,1745,836,909,0.47908309455587395,0.520916905444126
E01015635,1591,782,809,0.491514770584538,0.5084852294154619
E01015636,1111,542,569,0.4878487848784879,0.5121512151215122
E01015679,1709,826,883,0.48332358104154477,0.5166764189584553
E01015678,1324,655,669,0.4947129909365559,0.5052870090634441
E01015680,1514,711,803,0.46961690885072654,0.5303830911492734
E01015681,1478,723,755,0.4891745602165088,0.5108254397834912
E01015682,1421,682,739,0.47994370161857847,0.5200562983814215
E01015630,2013,973,1040,0.48335817188276203,0.5166418281172379
E01015631,1467,735,732,0.5010224948875256,0.49897750511247446
E01015659,1915,932,983,0.4866840731070496,0.5133159268929504
E01015684,1413,686,727,0.4854918612880396,0.5145081387119603
E01015685,1520,751,769,0.49407894736842106,0.5059210526315789
E01015589,1999,980,1019,0.49024512256128067,0.5097548774387194
E01015590,1511,746,765,0.4937127729980146,0.5062872270019855
E01015626,1351,684,667,0.5062916358253146,0.49370836417468544
E01015628,2010,1088,922,0.5412935323383085,0.45870646766169154
E01015617,1446,705,741,0.487551867219917,0.5124481327800829
E01015618,1328,632,696,0.4759036144578313,0.5240963855421686
E01015619,2230,1036,1194,0.46457399103139013,0.5354260089686098
E01015620,2176,1068,1108,0.49080882352941174,0.5091911764705882
E01015674,1555,719,836,0.46237942122186493,0.5376205787781351
E01015675,1621,802,819,0.4947563232572486,0.5052436767427514
E01015676,2000,957,1043,0.4785,0.5215
E01015683,1786,844,942,0.47256438969764836,0.5274356103023516
E01015686,1485,726,759,0.4888888888888889,0.5111111111111111
E01015607,1816,869,947,0.4785242290748899,0.5214757709251101
E01015609,1899,934,965,0.4918378093733544,0.5081621906266456
E01015656,1611,785,826,0.4872749844816884,0.5127250155183116
E01015658,1693,819,874,0.48375664500886,0.5162433549911399
E01015660,1628,820,808,0.5036855036855037,0.4963144963144963
E01035538,1726,847,879,0.4907300115874855,0.5092699884125145
E01035539,1796,879,917,0.48942093541202675,0.5105790645879733
E01015605,1777,878,899,0.494091164884637,0.505908835115363
E01015608,1754,864,890,0.4925883694412771,0.507411630558723
E01015610,1975,956,1019,0.4840506329113924,0.5159493670886076
E01015633,2444,1204,1240,0.49263502454991814,0.5073649754500819
E01015634,2084,1020,1064,0.4894433781190019,0.510556621880998
E01015593,1646,847,799,0.5145808019441069,0.48541919805589306
E01015596,1743,875,868,0.5020080321285141,0.4979919678714859
E01015662,1510,749,761,0.4960264900662252,0.5039735099337749
E01015663,1619,768,851,0.474366893143916,0.525633106856084
E01015664,1725,836,889,0.4846376811594203,0.5153623188405797
E01015603,2532,1269,1263,0.5011848341232228,0.49881516587677727
E01015604,1985,1055,930,0.5314861460957179,0.46851385390428213
E01015632,2014,1025,989,0.5089374379344588,0.4910625620655412
E01015661,2315,1298,1017,0.5606911447084233,0.43930885529157665
E01015677,1185,585,600,0.4936708860759494,0.5063291139240507
E01015591,1505,741,764,0.49235880398671095,0.507641196013289
E01015592,1573,762,811,0.4844246662428481,0.5155753337571519
E01015594,2385,1223,1162,0.5127882599580713,0.48721174004192874
E01015595,1624,794,830,0.48891625615763545,0.5110837438423645
E01015597,1762,858,904,0.4869466515323496,0.5130533484676504
E01015601,2281,1125,1156,0.49320473476545373,0.5067952652345462
E01015651,2268,1138,1130,0.5017636684303352,0.4982363315696649
E01015652,2288,1170,1118,0.5113636363636364,0.48863636363636365
E01015653,1944,953,991,0.49022633744855965,0.5097736625514403
E01015654,2793,1389,1404,0.49731471535982813,0.5026852846401718
E01015606,1864,906,958,0.48605150214592274,0.5139484978540773
E01015613,1603,776,827,0.4840923268870867,0.5159076731129133
E01015614,2156,1048,1108,0.48608534322820035,0.5139146567717996
E01015615,1945,953,992,0.489974293059126,0.510025706940874
E01015616,2222,1088,1134,0.4896489648964896,0.5103510351035103
E01035540,1508,752,756,0.4986737400530504,0.5013262599469496
E01035541,1521,791,730,0.5200525969756739,0.4799474030243261
E01015599,2678,1390,1288,0.5190440627333831,0.4809559372666169
E01015600,1912,951,961,0.4973849372384937,0.5026150627615062
E01015612,2519,1315,1204,0.5220325526002382,0.4779674473997618
E01015655,2212,1133,1079,0.5122061482820977,0.48779385171790235
E01035542,1560,809,751,0.5185897435897436,0.4814102564102564
E01035543,1170,590,580,0.5042735042735043,0.49572649572649574
E01015598,1496,734,762,0.49064171122994654,0.5093582887700535
E01015687,1649,816,833,0.4948453608247423,0.5051546391752577
E01015689,1487,737,750,0.49562878278412914,0.5043712172158709
E01015690,1277,638,639,0.49960845732184805,0.5003915426781519
E01015691,2014,958,1056,0.4756703078450844,0.5243296921549155
E01015622,2624,1347,1277,0.5133384146341463,0.48666158536585363
E01015665,1842,917,925,0.497828447339848,0.502171552660152
E01015688,2522,1229,1293,0.4873116574147502,0.5126883425852498
E01015692,1685,811,874,0.48130563798219583,0.5186943620178042
E01033173,2267,1145,1122,0.5050727834142038,0.4949272165857962
E01033182,1586,779,807,0.4911727616645649,0.5088272383354351
E01015623,1795,885,910,0.49303621169916434,0.5069637883008357
E01015624,1719,874,845,0.508435136707388,0.491564863292612
E01015666,1439,686,753,0.47671994440583737,0.5232800555941626
E01015668,2092,1040,1052,0.497131931166348,0.502868068833652
E01035544,1585,821,764,0.5179810725552051,0.48201892744479496
E01035545,1636,800,836,0.4889975550122249,0.511002444987775
E01015627,1796,908,888,0.5055679287305123,0.49443207126948774
E01015644,2575,1299,1276,0.5044660194174757,0.4955339805825243
E01015645,1684,798,886,0.47387173396674587,0.5261282660332541
E01015646,1840,887,953,0.48206521739130437,0.5179347826086956
E01015648,1344,649,695,0.48288690476190477,0.5171130952380952
E01015667,1451,707,744,0.487250172294969,0.512749827705031
E01015669,1494,734,760,0.49129852744310576,0.5087014725568942
E01015670,1432,709,723,0.49511173184357543,0.5048882681564246
E01015672,1514,756,758,0.49933949801849403,0.5006605019815059
E01015673,1526,706,820,0.46264744429882043,0.5373525557011796
E01035546,1389,688,701,0.4953203743700504,0.5046796256299496
E01035547,1613,797,816,0.4941103533787973,0.5058896466212027
E01035548,1541,744,797,0.4828033744321869,0.5171966255678131
E01035549,1765,842,923,0.47705382436260624,0.5229461756373938
E01015637,1626,778,848,0.4784747847478475,0.5215252152521526
E01015639,1735,888,847,0.5118155619596542,0.48818443804034584
E01015640,1521,768,753,0.504930966469428,0.49506903353057197
E01015641,1387,687,700,0.4953136265320836,0.5046863734679163
E01015642,1685,824,861,0.4890207715133531,0.5109792284866469
E01015647,1665,783,882,0.4702702702702703,0.5297297297297298
E01015638,1620,796,824,0.49135802469135803,0.508641975308642
E01015650,2008,1007,1001,0.5014940239043825,0.49850597609561753
E01033174,2613,1259,1354,0.48182166092613854,0.5181783390738615
E01033179,2992,1482,1510,0.49532085561497324,0.5046791443850267
E01033181,1668,800,868,0.47961630695443647,0.5203836930455635
E01015643,1447,732,715,0.5058742225293711,0.4941257774706289
E01033175,1523,746,777,0.489822718319107,0.5101772816808929
E01033177,1783,872,911,0.4890633763320247,0.5109366236679753
E01033180,1824,914,910,0.5010964912280702,0.49890350877192985
E01035551,1678,820,858,0.48867699642431467,0.5113230035756854
E01035552,1706,863,843,0.5058616647127784,0.49413833528722156
E01035553,1432,715,717,0.4993016759776536,0.5006983240223464
E01035554,1588,776,812,0.48866498740554154,0.5113350125944585
E01015706,1408,683,725,0.4850852272727273,0.5149147727272727
E01015707,1486,729,757,0.49057873485868103,0.509421265141319
E01015708,1373,702,671,0.5112891478514202,0.48871085214857973
E01015709,1500,740,760,0.49333333333333335,0.5066666666666667
E01015710,1500,718,782,0.4786666666666667,0.5213333333333333
E01015770,1342,666,676,0.496274217585693,0.503725782414307
E01015801,1946,858,1088,0.4409044193216855,0.5590955806783144
E01015803,1609,808,801,0.5021752641392169,0.4978247358607831
E01015804,1969,970,999,0.4926358557643474,0.5073641442356526
E01015805,1276,636,640,0.49843260188087773,0.5015673981191222
E01015769,1271,618,653,0.48623131392604246,0.5137686860739575
E01015771,1617,755,862,0.46691403834260975,0.5330859616573902
E01015772,1632,713,919,0.4368872549019608,0.5631127450980392
E01015773,1290,607,683,0.47054263565891474,0.5294573643410853
E01015774,1487,709,778,0.47679892400806995,0.5232010759919301
E01015802,1652,793,859,0.48002421307506055,0.5199757869249395
E01015744,1572,783,789,0.49809160305343514,0.5019083969465649
E01015746,1615,766,849,0.4743034055727554,0.5256965944272446
E01015747,1448,702,746,0.48480662983425415,0.5151933701657458
E01015748,1807,856,951,0.47371333702268953,0.5262866629773104
E01015749,2257,1064,1193,0.4714222419140452,0.5285777580859548
E01015751,2102,1074,1028,0.510941960038059,0.489058039961941
E01015752,1437,706,731,0.4913013221990257,0.5086986778009742
E01015753,1594,810,784,0.5081555834378921,0.4918444165621079
E01015754,1914,916,998,0.4785788923719958,0.5214211076280042
E01015755,1885,922,963,0.4891246684350133,0.5108753315649868
E01015764,1671,810,861,0.48473967684021546,0.5152603231597845
E01015765,1862,940,922,0.5048335123523093,0.49516648764769067
E01015766,1737,838,899,0.48244099021301096,0.5175590097869891
E01015767,1654,856,798,0.5175332527206772,0.48246674727932287
E01015768,1614,778,836,0.48203221809169766,0.5179677819083024
E01015783,1799,887,912,0.49305169538632576,0.5069483046136742
E01015785,2635,1305,1330,0.4952561669829222,0.5047438330170778
E01015693,1753,891,862,0.5082715345122647,0.4917284654877353
E01015694,1590,792,798,0.4981132075471698,0.5018867924528302
E01015695,1757,900,857,0.5122367672168469,0.4877632327831531
E01015696,1372,642,730,0.4679300291545189,0.532069970845481
E01015697,1724,827,897,0.4796983758700696,0.5203016241299304
E01015745,1655,828,827,0.5003021148036254,0.49969788519637465
E01015797,1294,615,679,0.4752704791344668,0.5247295208655333
E01015798,1375,658,717,0.47854545454545455,0.5214545454545455
E01015799,1400,699,701,0.4992857142857143,0.5007142857142857
E01015800,1475,744,731,0.504406779661017,0.49559322033898306
E01015812,1338,646,692,0.4828101644245142,0.5171898355754858
E01015813,1350,701,649,0.5192592592592593,0.48074074074074075
E01015756,1822,852,970,0.4676180021953897,0.5323819978046103
E01015757,1683,825,858,0.49019607843137253,0.5098039215686274
E01015758,1585,783,802,0.494006309148265,0.5059936908517351
E01015759,1726,861,865,0.49884125144843566,0.5011587485515643
E01015760,1468,706,762,0.48092643051771117,0.5190735694822888
E01015761,1829,903,926,0.49371241115363584,0.5062875888463642
E01015700,2849,1454,1395,0.5103545103545104,0.48964548964548965
E01015701,2249,1107,1142,0.49221876389506447,0.5077812361049355
E01015704,2117,1026,1091,0.48464808691544636,0.5153519130845536
E01015782,2451,1239,1212,0.5055079559363526,0.4944920440636475
E01015784,2573,1301,1272,0.5056354450058298,0.4943645549941702
E01015786,2398,1218,1180,0.5079232693911593,0.4920767306088407
E01015711,1991,1011,980,0.5077850326469111,0.4922149673530889
E01015712,2074,1032,1042,0.49758919961427195,0.502410800385728
E01015715,2204,1134,1070,0.514519056261343,0.48548094373865697
E01015716,2277,1072,1205,0.4707949055775143,0.5292050944224858
E01015717,1700,854,846,0.5023529411764706,0.4976470588235294
E01015750,2703,1373,1330,0.5079541250462449,0.49204587495375507
E01015740,1647,837,810,0.5081967213114754,0.4918032786885246
E01015775,1917,995,922,0.5190401669274909,0.4809598330725091
E01015776,1993,970,1023,0.48670346211741095,0.5132965378825891
E01015777,1904,948,956,0.49789915966386555,0.5021008403361344
E01015778,1851,918,933,0.4959481361426256,0.5040518638573744
E01015796,1462,707,755,0.4835841313269494,0.5164158686730507
E01015713,1639,810,829,0.4942037827943868,0.5057962172056132
E01015714,1992,1019,973,0.5115461847389559,0.4884538152610442
E01015718,1583,754,829,0.476310802274163,0.523689197725837
E01015762,1953,983,970,0.5033282130056324,0.49667178699436765
E01015763,1640,814,826,0.49634146341463414,0.5036585365853659
E01015721,1691,864,827,0.5109402720283855,0.48905972797161446
E01015722,1455,748,707,0.5140893470790378,0.4859106529209622
E01015806,1386,685,701,0.49422799422799424,0.5057720057720058
E01015808,1439,728,711,0.5059068797776234,0.49409312022237667
E01015809,1424,725,699,0.5091292134831461,0.49087078651685395
E01015810,1375,673,702,0.4894545454545455,0.5105454545454545
E01015811,1445,748,697,0.5176470588235295,0.4823529411764706
E01015703,2121,1099,1022,0.5181518151815182,0.48184818481848185
E01015726,2418,1229,1189,0.5082712985938792,0.49172870140612074
E01015731,2173,1079,1094,0.4965485503911643,0.5034514496088357
E01015787,2494,1242,1252,0.49799518845228546,0.5020048115477145
E01015788,2148,1088,1060,0.5065176908752328,0.4934823091247672
E01015719,2121,1096,1025,0.5167373880245167,0.48326261197548326
E01015720,1744,862,882,0.49426605504587157,0.5057339449541285
E01015723,1425,725,700,0.5087719298245614,0.49122807017543857
E01015779,1552,722,830,0.4652061855670103,0.5347938144329897
E01015780,1806,877,929,0.4856035437430786,0.5143964562569213
E01015781,1675,829,846,0.4949253731343284,0.5050746268656716
E01015807,1709,830,879,0.48566413107080164,0.5143358689291984
E01015698,1772,944,828,0.5327313769751693,0.4672686230248307
E01015699,1946,1019,927,0.5236382322713258,0.4763617677286742
E01015702,1927,971,956,0.5038920601971977,0.49610793980280227
E01015705,1643,821,822,0.4996956786366403,0.5003043213633597
E01015725,1823,863,960,0.47339550191991225,0.5266044980800878
E01015727,2428,1210,1218,0.49835255354200986,0.5016474464579901
E01015724,2567,1357,1210,0.5286326451110246,0.47136735488897546
E01015728,1808,896,912,0.49557522123893805,0.504424778761062
E01015729,2296,1356,940,0.5905923344947736,0.4094076655052265
E01015730,2478,1243,1235,0.5016142050040355,0.49838579499596447
E01015732,1886,936,950,0.49628844114528103,0.503711558854719
E01015733,2125,1020,1105,0.48,0.52
E01015734,2013,1010,1003,0.50173869846001,0.49826130153999004
E01015735,1929,1028,901,0.5329186106791084,0.46708138932089166
E01015736,2046,1006,1040,0.4916911045943304,0.5083088954056696
E01015737,1617,811,806,0.5015460729746444,0.49845392702535557
E01015738,1997,1096,901,0.5488232348522785,0.4511767651477216
E01015790,1623,845,778,0.5206407886629698,0.4793592113370302
E01015792,1915,988,927,0.5159268929503916,0.4840731070496084
E01015793,1782,910,872,0.510662177328844,0.489337822671156
E01015795,2677,1423,1254,0.5315651849084796,0.46843481509152035
E01033806,1531,723,808,0.4722403657740039,0.527759634225996
E01033807,1750,898,852,0.5131428571428571,0.4868571428571429
E01015739,2175,1130,1045,0.5195402298850574,0.4804597701149425
E01015742,1981,1059,922,0.5345784957092378,0.46542150429076223
E01015743,1783,961,822,0.5389792484576557,0.46102075154234434
E01033801,1809,985,824,0.5444997236042012,0.45550027639579876
E01033802,1624,849,775,0.5227832512315271,0.4772167487684729
E01015789,2351,1205,1146,0.5125478519778818,0.4874521480221182
E01033803,1576,864,712,0.5482233502538071,0.4517766497461929
E01033804,1176,659,517,0.560374149659864,0.43962585034013607
E01033805,1280,716,564,0.559375,0.440625
E01015833,1562,778,784,0.4980793854033291,0.5019206145966709
E01015834,1434,708,726,0.49372384937238495,0.5062761506276151
E01015835,1748,839,909,0.4799771167048055,0.5200228832951945
E01015836,1509,734,775,0.48641484426772696,0.513585155732273
E01015837,1738,841,897,0.48388952819332565,0.5161104718066744
E01015838,1460,706,754,0.48356164383561645,0.5164383561643836
E01015863,2367,1156,1211,0.4883819180397127,0.5116180819602872
E01015864,1444,710,734,0.4916897506925208,0.5083102493074793
E01015865,1458,728,730,0.4993141289437586,0.5006858710562414
E01015866,2144,1047,1097,0.488339552238806,0.511660447761194
E01015867,1472,672,800,0.45652173913043476,0.5434782608695652
E01015868,1696,849,847,0.5005896226415094,0.4994103773584906
E01015814,1379,661,718,0.47933284989122554,0.5206671501087745
E01015815,1633,781,852,0.4782608695652174,0.5217391304347826
E01015816,1575,755,820,0.4793650793650794,0.5206349206349207
E01015817,1664,809,855,0.48617788461538464,0.5138221153846154
E01015818,1711,827,884,0.4833430742255991,0.5166569257744009
E01015819,1481,717,764,0.4841323430114787,0.5158676569885212
E01015857,1627,803,824,0.49354640442532266,0.5064535955746773
E01015858,1836,927,909,0.5049019607843137,0.4950980392156863
E01015859,1929,917,1012,0.4753758424053914,0.5246241575946086
E01015860,1579,769,810,0.487017099430019,0.512982900569981
E01015861,1979,974,1005,0.4921677614957049,0.5078322385042952
E01015862,1742,824,918,0.4730195177956372,0.5269804822043628
E01015820,1690,827,863,0.4893491124260355,0.5106508875739645
E01015821,1658,790,868,0.4764776839565742,0.5235223160434258
E01015822,1269,633,636,0.4988179669030733,0.5011820330969267
E01015823,1732,835,897,0.4821016166281755,0.5178983833718245
E01015824,1582,752,830,0.47534766118836913,0.5246523388116309
E01015825,1633,799,834,0.48928352725045926,0.5107164727495407
E01015826,1428,689,739,0.48249299719887956,0.5175070028011205
E01015869,1647,814,833,0.4942319368548877,0.5057680631451124
E01015870,1631,778,853,0.47700797057020233,0.5229920294297977
E01015871,1633,787,846,0.48193508879363134,0.5180649112063687
E01015872,1657,802,855,0.484007242003621,0.515992757996379
E01015873,1249,588,661,0.4707766212970376,0.5292233787029623
E01015874,1747,864,883,0.49456210646823123,0.5054378935317687
E01015875,1644,786,858,0.4781021897810219,0.5218978102189781
E01015901,1621,792,829,0.48858729179518817,0.5114127082048119
E01015902,1662,830,832,0.4993983152827918,0.5006016847172082
E01015903,1623,773,850,0.4762784966112138,0.5237215033887862
E01015904,1756,827,929,0.47095671981776766,0.5290432801822323
E01015905,1490,732,758,0.4912751677852349,0.508724832214765
E01015906,1530,765,765,0.5,0.5
E01015907,1599,805,794,0.5034396497811132,0.4965603502188868
E01015908,1637,786,851,0.48014660965180206,0.5198533903481979
E01015909,1545,759,786,0.4912621359223301,0.5087378640776699
E01015910,1569,773,796,0.4926704907584449,0.5073295092415552
E01015911,1292,633,659,0.48993808049535603,0.510061919504644
E01015912,1584,775,809,0.48926767676767674,0.5107323232323232
E01015913,1741,864,877,0.49626651349798967,0.5037334865020103
E01015883,1451,717,734,0.4941419710544452,0.5058580289455548
E01015884,2347,1106,1241,0.4712398806987644,0.5287601193012356
E01015885,1714,810,904,0.4725787631271879,0.5274212368728122
E01015886,1538,757,781,0.49219765929778936,0.5078023407022106
E01015887,1602,728,874,0.4544319600499376,0.5455680399500624
E01015888,1499,692,807,0.4616410940627085,0.5383589059372915
E01015896,1940,977,963,0.5036082474226804,0.4963917525773196
E01015897,2043,986,1057,0.48262359275575134,0.5173764072442486
E01015898,1911,955,956,0.49973835688121404,0.500261643118786
E01015899,2080,1003,1077,0.48221153846153847,0.5177884615384616
E01015900,1733,872,861,0.5031736872475476,0.49682631275245237
E01034095,1565,779,786,0.49776357827476037,0.5022364217252396
E01034096,1736,837,899,0.48214285714285715,0.5178571428571429
E01015845,1615,771,844,0.4773993808049536,0.5226006191950464
E01015846,1733,838,895,0.4835545297172533,0.5164454702827467
E01015847,1603,771,832,0.4809731752963194,0.5190268247036806
E01015848,1659,792,867,0.47739602169981915,0.5226039783001808
E01015849,1702,843,859,0.49529964747356053,0.5047003525264395
E01015850,1579,758,821,0.48005066497783405,0.5199493350221659
E01015827,1705,842,863,0.493841642228739,0.506158357771261
E01015828,1759,912,847,0.51847640704946,0.4815235929505401
E01015829,1560,750,810,0.4807692307692308,0.5192307692307693
E01015830,1557,755,802,0.4849068721901092,0.5150931278098908
E01015831,1727,852,875,0.493341053850608,0.506658946149392
E01015832,1615,752,863,0.46563467492260063,0.5343653250773994
E01015876,2481,1228,1253,0.49496170898831116,0.5050382910116888
E01015877,1895,916,979,0.48337730870712403,0.516622691292876
E01015878,1256,590,666,0.4697452229299363,0.5302547770700637
E01015879,1381,659,722,0.47719044170890657,0.5228095582910934
E01015880,1522,732,790,0.480946123521682,0.519053876478318
E01015881,1373,659,714,0.47997086671522216,0.5200291332847778
E01015882,1768,842,926,0.4762443438914027,0.5237556561085973
E01015839,1873,893,980,0.4767752269087026,0.5232247730912973
E01015840,1822,897,925,0.49231613611416025,0.5076838638858397
E01015841,2570,1311,1259,0.5101167315175097,0.48988326848249025
E01015842,2008,934,1074,0.4651394422310757,0.5348605577689243
E01015843,1693,842,851,0.49734199645599525,0.5026580035440047
E01015844,2126,1092,1034,0.5136406396989652,0.4863593603010348
E01015851,1635,792,843,0.48440366972477067,0.5155963302752293
E01015852,2113,1093,1020,0.5172740179839092,0.48272598201609085
E01015853,1828,879,949,0.48085339168490154,0.5191466083150985
E01015854,2186,1090,1096,0.4986276303751144,0.5013723696248856
E01015855,2087,1039,1048,0.49784379492093916,0.5021562050790609
E01015856,1845,953,892,0.5165311653116531,0.4834688346883469
E01015889,1395,659,736,0.47240143369175625,0.5275985663082438
E01015890,1534,748,786,0.4876140808344198,0.5123859191655802
E01015891,1468,694,774,0.47275204359673023,0.5272479564032697
E01015892,1689,826,863,0.48904677323860274,0.5109532267613973
E01015893,1501,708,793,0.47168554297135246,0.5283144570286475
E01015894,1529,748,781,0.4892086330935252,0.5107913669064749
E01015914,1304,639,665,0.49003067484662577,0.5099693251533742
E01015915,1440,663,777,0.46041666666666664,0.5395833333333333
E01015916,1409,665,744,0.47196593328601844,0.5280340667139816
E01015917,1658,822,836,0.4957780458383595,0.5042219541616405
E01015918,1406,680,726,0.48364153627311524,0.5163584637268848
E01015919,1360,662,698,0.48676470588235293,0.513235294117647
E01015920,1541,715,826,0.46398442569759896,0.536015574302401
E01015943,1529,770,759,0.5035971223021583,0.49640287769784175
E01015944,1283,623,660,0.48558067030397506,0.514419329696025
E01015946,1577,779,798,0.4939759036144578,0.5060240963855421
E01015997,1373,684,689,0.4981791697013838,0.5018208302986161
E01015999,1323,638,685,0.48223733938019653,0.5177626606198035
E01015945,1297,635,662,0.48959136468774095,0.5104086353122591
E01015983,1472,721,751,0.4898097826086957,0.5101902173913043
E01015987,1570,736,834,0.46878980891719746,0.5312101910828025
E01015988,1444,671,773,0.4646814404432133,0.5353185595567868
E01015998,1526,740,786,0.4849279161205767,0.5150720838794234
E01015984,1268,611,657,0.48186119873817035,0.5181388012618297
E01015985,1353,642,711,0.4745011086474501,0.5254988913525499
E01015986,1543,729,814,0.47245625405055086,0.5275437459494491
E01015990,1527,769,758,0.5036018336607727,0.49639816633922723
E01016001,1406,688,718,0.48933143669985774,0.5106685633001422
E01015977,1928,912,1016,0.4730290456431535,0.5269709543568465
E01015978,1506,756,750,0.50199203187251,0.49800796812749004
E01015979,1473,731,742,0.49626612355736593,0.5037338764426341
E01015980,1510,745,765,0.49337748344370863,0.5066225165562914
E01015989,1507,753,754,0.4996682149966821,0.5003317850033179
E01015991,1763,862,901,0.48893930799773117,0.5110606920022689
E01015992,2852,1414,1438,0.4957924263674614,0.5042075736325385
E01016000,1480,722,758,0.48783783783783785,0.5121621621621621
E01016002,1344,657,687,0.4888392857142857,0.5111607142857143
E01015932,1864,923,941,0.4951716738197425,0.5048283261802575
E01015971,1607,772,835,0.48039825762289984,0.5196017423771002
E01015972,1925,955,970,0.4961038961038961,0.5038961038961038
E01015974,1439,697,742,0.48436414176511466,0.5156358582348853
E01015975,1599,792,807,0.49530956848030017,0.5046904315196998
E01034368,1760,865,895,0.4914772727272727,0.5085227272727273
E01034369,1835,890,945,0.48501362397820164,0.5149863760217984
E01015927,1915,941,974,0.49138381201044384,0.5086161879895561
E01015928,1769,859,910,0.48558507631430187,0.5144149236856982
E01015929,1538,745,793,0.48439531859557866,0.5156046814044213
E01015930,1839,926,913,0.5035345296356716,0.4964654703643284
E01015931,1543,768,775,0.49773169151004537,0.5022683084899546
E01015976,1802,869,933,0.48224195338512765,0.5177580466148723
E01015922,1596,752,844,0.47117794486215536,0.5288220551378446
E01015923,2360,1159,1201,0.49110169491525424,0.5088983050847458
E01015924,1634,806,828,0.49326805385556916,0.5067319461444308
E01015925,1788,899,889,0.5027964205816555,0.49720357941834453
E01015926,2142,1051,1091,0.4906629318394024,0.5093370681605975
E01015957,1536,754,782,0.4908854166666667,0.5091145833333334
E01015958,1358,675,683,0.49705449189985274,0.5029455081001473
E01015993,1643,790,853,0.4808277541083384,0.5191722458916616
E01015994,1703,782,921,0.45918966529653554,0.5408103347034645
E01015995,1667,827,840,0.49610077984403117,0.5038992201559688
E01015996,1743,857,886,0.4916810097532989,0.5083189902467011
E01015963,1211,580,631,0.47894302229562347,0.5210569777043765
E01015964,1614,788,826,0.4882280049566295,0.5117719950433705
E01015965,2626,1262,1364,0.4805788271134806,0.5194211728865195
E01015966,1630,825,805,0.5061349693251533,0.4938650306748466
E01015933,1795,882,913,0.4913649025069638,0.5086350974930363
E01015934,1521,750,771,0.4930966469428008,0.5069033530571992
E01015935,1853,906,947,0.48893685914732865,0.5110631408526713
E01015936,1930,923,1007,0.4782383419689119,0.5217616580310881
E01015937,1589,801,788,0.5040906230333543,0.49590937696664567
E01015938,1932,880,1052,0.4554865424430642,0.5445134575569358
E01015947,1492,714,778,0.4785522788203753,0.5214477211796247
E01015948,2653,1305,1348,0.49189596683000375,0.5081040331699962
E01015949,1781,861,920,0.48343627175743964,0.5165637282425604
E01015950,1787,860,927,0.4812534974818131,0.5187465025181869
E01015960,1506,728,778,0.48339973439575035,0.5166002656042497
E01015967,1570,788,782,0.5019108280254777,0.4980891719745223
E01015968,1445,700,745,0.4844290657439446,0.5155709342560554
E01015969,1834,910,924,0.4961832061068702,0.5038167938931297
E01015970,1413,699,714,0.49469214437367304,0.505307855626327
E01015955,1711,861,850,0.5032144944476914,0.4967855055523086
E01015956,2156,1091,1065,0.5060296846011132,0.4939703153988868
E01015959,1952,978,974,0.5010245901639344,0.4989754098360656
E01015961,1655,826,829,0.4990936555891239,0.5009063444108761
E01015962,1831,916,915,0.5002730748225014,0.4997269251774986
E01015951,1763,847,916,0.48043108338060125,0.5195689166193987
E01015952,2371,1151,1220,0.48544917756221,0.5145508224377899
E01015953,2709,1366,1343,0.5042451088962717,0.49575489110372833
E01015954,2581,1252,1329,0.48508330104610614,0.5149166989538938
E01016003,2431,1166,1265,0.4796380090497738,0.5203619909502263
E01016004,1946,890,1056,0.4573484069886948,0.5426515930113053
E01016005,1676,791,885,0.47195704057279236,0.5280429594272077
E01016006,1923,926,997,0.48153926157046284,0.5184607384295372
E01016007,2026,1000,1026,0.49358341559723595,0.506416584402764
E01016008,1555,762,793,0.490032154340836,0.509967845659164
E01016009,1738,822,916,0.47295742232451093,0.5270425776754891
E01016010,1525,745,780,0.4885245901639344,0.5114754098360655
E01015982,2647,1303,1344,0.4922553834529656,0.5077446165470344
E01033610,1700,843,857,0.4958823529411765,0.5041176470588236
E01033611,1755,864,891,0.49230769230769234,0.5076923076923077
E01033613,1589,779,810,0.49024543738200127,0.5097545626179988
E01015939,1532,765,767,0.4993472584856397,0.5006527415143603
E01015941,1463,717,746,0.49008885850991113,0.5099111414900889
E01015942,1547,756,791,0.48868778280542985,0.5113122171945701
E01033612,1616,829,787,0.5129950495049505,0.4870049504950495
E01033614,1850,895,955,0.4837837837837838,0.5162162162162162
E01015921,1307,662,645,0.5065034429992349,0.4934965570007651
E01016013,2546,1279,1267,0.502356637863315,0.497643362136685
E01016014,2837,1402,1435,0.49418399718011985,0.5058160028198802
E01016011,1793,922,871,0.5142219743446738,0.4857780256553263
E01016015,2677,1347,1330,0.5031751961150541,0.4968248038849458
E01034370,1832,918,914,0.5010917030567685,0.49890829694323147
E01034371,2114,1030,1084,0.48722800378429515,0.5127719962157048
E01017540,1456,724,732,0.49725274725274726,0.5027472527472527
E01017541,1319,633,686,0.4799090219863533,0.5200909780136467
E01017544,1445,701,744,0.485121107266436,0.514878892733564
E01017545,1453,707,746,0.4865794907088782,0.5134205092911218
E01017464,1403,669,734,0.4768353528153956,0.5231646471846044
E01017465,1508,738,770,0.48938992042440316,0.5106100795755968
E01017503,1384,674,710,0.4869942196531792,0.5130057803468208
E01017504,1949,968,981,0.4966649563878912,0.5033350436121088
E01017546,1192,587,605,0.4924496644295302,0.5075503355704698
E01017547,1599,803,796,0.5021888680425266,0.4978111319574734
E01017478,1745,826,919,0.47335243553008594,0.526647564469914
E01017479,1331,647,684,0.4861006761833208,0.5138993238166792
E01017480,1963,950,1013,0.48395313295975545,0.5160468670402445
E01017481,1209,591,618,0.48883374689826303,0.511166253101737
E01017528,2510,1187,1323,0.47290836653386453,0.5270916334661354
E01017495,2252,1072,1180,0.47602131438721135,0.5239786856127886
E01017496,1584,769,815,0.48547979797979796,0.514520202020202
E01017542,1435,743,692,0.5177700348432056,0.48222996515679445
E01017543,1591,788,803,0.4952859836580767,0.5047140163419234
E01033431,1745,824,921,0.4722063037249284,0.5277936962750717
E01034412,2092,1030,1062,0.49235181644359466,0.5076481835564054
E01034413,1156,561,595,0.4852941176470588,0.5147058823529411
E01017453,1361,684,677,0.5025716385011021,0.49742836149889785
E01017454,1456,722,734,0.4958791208791209,0.5041208791208791
E01017455,1416,692,724,0.4887005649717514,0.5112994350282486
E01017456,1485,726,759,0.4888888888888889,0.5111111111111111
E01017457,1211,591,620,0.4880264244426094,0.5119735755573905
E01017458,1233,596,637,0.48337388483373883,0.5166261151662611
E01017529,1283,629,654,0.49025720966484804,0.509742790335152
E01017530,1441,716,725,0.49687716863289383,0.5031228313671062
E01017531,1342,623,719,0.4642324888226528,0.5357675111773472
E01017532,1299,630,669,0.48498845265588914,0.5150115473441108
E01017533,1165,555,610,0.47639484978540775,0.5236051502145923
E01017534,1530,745,785,0.4869281045751634,0.5130718954248366
E01017488,1560,737,823,0.4724358974358974,0.5275641025641026
E01017489,1609,742,867,0.46115599751398384,0.5388440024860162
E01017490,1366,646,720,0.47291361639824303,0.527086383601757
E01017491,1555,765,790,0.4919614147909968,0.5080385852090032
E01017492,1472,721,751,0.4898097826086957,0.5101902173913043
E01017493,1648,784,864,0.47572815533980584,0.5242718446601942
E01017459,1643,806,837,0.49056603773584906,0.5094339622641509
E01017460,2360,1174,1186,0.49745762711864405,0.502542372881356
E01017462,1585,783,802,0.494006309148265,0.5059936908517351
E01017463,1358,651,707,0.4793814432989691,0.520618556701031
E01034414,1520,770,750,0.506578947368421,0.4934210526315789
E01034415,1507,729,778,0.48374253483742535,0.5162574651625746
E01034416,1520,767,753,0.5046052631578948,0.4953947368421053
E01034417,1335,630,705,0.47191011235955055,0.5280898876404494
E01017482,1411,708,703,0.5017717930545712,0.4982282069454288
E01017483,1743,810,933,0.46471600688468157,0.5352839931153184
E01017484,1405,749,656,0.5330960854092527,0.4669039145907473
E01017485,1376,718,658,0.5218023255813954,0.47819767441860467
E01017497,1369,706,663,0.5157048940832725,0.48429510591672753
E01017498,1187,590,597,0.4970513900589722,0.5029486099410277
E01017499,1380,667,713,0.48333333333333334,0.5166666666666667
E01017500,1192,623,569,0.5226510067114094,0.4773489932885906
E01017501,1880,965,915,0.5132978723404256,0.4867021276595745
E01017502,1863,1086,777,0.5829307568438004,0.4170692431561997
E01017524,1689,844,845,0.4997039668442866,0.5002960331557135
E01017525,1231,607,624,0.4930950446791227,0.5069049553208773
E01017526,1501,721,780,0.480346435709527,0.519653564290473
E01017527,1187,589,598,0.4962089300758214,0.5037910699241785
E01017466,2306,1227,1079,0.5320901994796184,0.4679098005203816
E01017467,1363,673,690,0.4937637564196625,0.5062362435803375
E01017468,1381,666,715,0.4822592324402607,0.5177407675597393
E01017470,1309,663,646,0.5064935064935064,0.4935064935064935
E01017471,1883,996,887,0.5289431757833245,0.4710568242166755
E01034418,1125,581,544,0.5164444444444445,0.48355555555555557
E01034419,1280,660,620,0.515625,0.484375
E01017535,2211,1100,1111,0.4975124378109453,0.5024875621890548
E01017536,2541,1301,1240,0.5120031483667847,0.48799685163321527
E01017537,1497,728,769,0.4863059452237809,0.5136940547762191
E01017538,1885,961,924,0.5098143236074271,0.49018567639257293
E01017539,1644,858,786,0.5218978102189781,0.4781021897810219
E01017518,1736,832,904,0.4792626728110599,0.5207373271889401
E01017519,1635,776,859,0.4746177370030581,0.5253822629969419
E01017520,1827,883,944,0.48330596606458676,0.5166940339354132
E01017521,1642,822,820,0.5006090133982948,0.4993909866017052
E01017522,2088,1043,1045,0.49952107279693486,0.5004789272030651
E01017523,1756,829,927,0.47209567198177677,0.5279043280182233
E01017472,1540,733,807,0.475974025974026,0.5240259740259741
E01017474,1883,937,946,0.49761019649495486,0.5023898035050451
E01017475,1631,800,831,0.49049662783568365,0.5095033721643164
E01017476,1528,765,763,0.5006544502617801,0.4993455497382199
E01017477,1341,625,716,0.46607009694258017,0.5339299030574198
E01034420,1889,943,946,0.49920592906299627,0.5007940709370037
E01034421,1559,784,775,0.5028864656831302,0.4971135343168698
E01017509,1230,583,647,0.4739837398373984,0.5260162601626016
E01017510,1589,762,827,0.47954688483322844,0.5204531151667715
E01017511,1183,617,566,0.5215553677092138,0.47844463229078615
E01017512,1505,731,774,0.4857142857142857,0.5142857142857142
E01017505,1549,749,800,0.4835377663008393,0.5164622336991608
E01017506,1569,759,810,0.4837476099426386,0.5162523900573613
E01017507,1391,694,697,0.49892163910855497,0.501078360891445
E01017508,1697,840,857,0.4949911608721273,0.5050088391278728
E01017513,1477,719,758,0.4867975626269465,0.5132024373730535
E01017514,1725,847,878,0.4910144927536232,0.5089855072463768
E01017515,1651,810,841,0.49061175045427013,0.5093882495457298
E01017517,1568,789,779,0.5031887755102041,0.4968112244897959
E01034422,1540,757,783,0.4915584415584416,0.5084415584415585
E01034423,1061,537,524,0.5061262959472196,0.4938737040527804
E01034424,1540,738,802,0.4792207792207792,0.5207792207792208
E01017552,2781,1330,1451,0.47824523552678894,0.5217547644732111
E01017553,1366,666,700,0.48755490483162517,0.5124450951683748
E01017554,1980,946,1034,0.4777777777777778,0.5222222222222223
E01034425,1884,918,966,0.4872611464968153,0.5127388535031847
E01034426,2335,1137,1198,0.48693790149892935,0.5130620985010707
E01017487,1945,938,1007,0.48226221079691517,0.5177377892030849
E01017549,1514,700,814,0.4623513870541612,0.5376486129458389
E01034427,1493,763,730,0.5110515740120563,0.48894842598794375
E01034428,1402,704,698,0.5021398002853067,0.4978601997146933
E01034429,1156,561,595,0.4852941176470588,0.5147058823529411
E01034430,1023,486,537,0.4750733137829912,0.5249266862170088
E01034431,1914,922,992,0.48171368861024033,0.5182863113897597
E01034432,1240,596,644,0.4806451612903226,0.5193548387096775
E01034433,2406,1187,1219,0.4933499584372402,0.5066500415627597
E01034434,2037,963,1074,0.4727540500736377,0.5272459499263623
E01017433,1609,783,826,0.48663766314481044,0.5133623368551895
E01017434,1669,819,850,0.4907130017974835,0.5092869982025164
E01017436,2471,1255,1216,0.5078915418858762,0.49210845811412385
E01017430,1490,737,753,0.49463087248322146,0.5053691275167785
E01017431,1629,804,825,0.49355432780847147,0.5064456721915286
E01017432,1488,719,769,0.4831989247311828,0.5168010752688172
E01017435,1821,904,917,0.4964305326743548,0.5035694673256452
E01017425,1167,601,566,0.5149957155098543,0.48500428449014565
E01017426,1403,684,719,0.48752672843905914,0.5124732715609408
E01017427,2004,977,1027,0.4875249500998004,0.5124750499001997
E01017428,1649,801,848,0.48574893875075803,0.5142510612492419
E01017429,1934,959,975,0.49586349534643226,0.5041365046535677
E01017412,1508,744,764,0.493368700265252,0.506631299734748
E01017422,1652,813,839,0.49213075060532685,0.5078692493946732
E01017423,1994,955,1039,0.4789368104312939,0.5210631895687061
E01017424,1412,679,733,0.48087818696883855,0.5191218130311614
E01017383,1937,983,954,0.5074858027878162,0.4925141972121838
E01017384,1627,798,829,0.49047326367547633,0.5095267363245236
E01017385,1887,949,938,0.5029146793852676,0.4970853206147324
E01017386,1765,894,871,0.5065155807365439,0.4934844192634561
E01017387,1263,605,658,0.47901821060965954,0.5209817893903405
E01017388,2834,1421,1413,0.5014114326040932,0.49858856739590685
E01017381,1427,722,705,0.5059565522074282,0.4940434477925718
E01017382,1509,709,800,0.46984758117958914,0.5301524188204109
E01033808,1334,661,673,0.4955022488755622,0.5044977511244377
E01033809,1444,715,729,0.4951523545706371,0.5048476454293629
E01033810,1422,694,728,0.4880450070323488,0.5119549929676512
E01033811,1551,779,772,0.5022566086395873,0.4977433913604126
E01033812,1408,692,716,0.4914772727272727,0.5085227272727273
E01033813,1133,550,583,0.4854368932038835,0.5145631067961165
E01017379,1193,567,626,0.4752724224643755,0.5247275775356245
E01017380,1264,632,632,0.5,0.5
E01017394,1474,746,728,0.5061058344640434,0.49389416553595655
E01017397,1776,901,875,0.5073198198198198,0.49268018018018017
E01033814,1885,1047,838,0.5554376657824933,0.4445623342175066
E01033815,1362,662,700,0.48604992657856094,0.5139500734214391
E01033816,1336,647,689,0.4842814371257485,0.5157185628742516
E01017410,1173,577,596,0.4919011082693947,0.5080988917306053
E01017419,1640,815,825,0.4969512195121951,0.5030487804878049
E01017420,1676,802,874,0.4785202863961814,0.5214797136038186
E01017421,1823,889,934,0.48765770707624795,0.5123422929237521
E01033817,1505,753,752,0.5003322259136213,0.49966777408637875
E01033818,1507,744,763,0.4936960849369608,0.5063039150630392
E01017418,1481,700,781,0.4726536124240378,0.5273463875759622
E01017451,1417,704,713,0.49682427664079043,0.5031757233592096
E01017452,1241,574,667,0.46253021756647866,0.5374697824335214
E01033819,1686,817,869,0.4845788849347568,0.5154211150652431
E01033820,1663,842,821,0.5063138905592303,0.4936861094407697
E01033821,1304,623,681,0.47776073619631904,0.522239263803681
E01033822,1367,655,712,0.479151426481346,0.520848573518654
E01033823,1044,512,532,0.4904214559386973,0.5095785440613027
E01017376,2079,1036,1043,0.4983164983164983,0.5016835016835017
E01017377,1932,962,970,0.4979296066252588,0.5020703933747412
E01017378,2016,974,1042,0.48313492063492064,0.5168650793650794
E01017413,2255,1092,1163,0.4842572062084257,0.5157427937915743
E01017414,1878,929,949,0.4946751863684771,0.5053248136315229
E01017415,2025,966,1059,0.47703703703703704,0.522962962962963
E01017437,1903,945,958,0.49658434051497635,0.5034156594850236
E01017438,1687,827,860,0.4902193242442205,0.5097806757557795
E01017439,2112,1023,1089,0.484375,0.515625
E01017440,1945,959,986,0.4930591259640103,0.5069408740359898
E01017441,2120,1143,977,0.5391509433962264,0.46084905660377357
E01017444,2077,1003,1074,0.48290804044294655,0.5170919595570534
E01017371,1788,871,917,0.48713646532438476,0.5128635346756152
E01017372,1842,887,955,0.4815418023887079,0.5184581976112921
E01017373,2327,1123,1204,0.48259561667382894,0.517404383326171
E01017374,1541,766,775,0.4970798182998053,0.5029201817001947
E01017375,1469,735,734,0.5003403675970047,0.4996596324029952
E01017391,1525,751,774,0.49245901639344264,0.5075409836065574
E01017392,1873,916,957,0.4890549919914576,0.5109450080085425
E01017393,2044,969,1075,0.4740704500978474,0.5259295499021527
E01017442,2790,1402,1388,0.5025089605734767,0.4974910394265233
E01017443,1656,803,853,0.48490338164251207,0.5150966183574879
E01017446,1788,885,903,0.4949664429530201,0.5050335570469798
E01017447,2554,1232,1322,0.48238057948316365,0.5176194205168363
E01017449,2154,1034,1120,0.48003714020427113,0.5199628597957289
E01033188,1497,721,776,0.4816299265197061,0.518370073480294
E01033189,2894,1396,1498,0.4823773324118867,0.5176226675881134
E01033190,1536,750,786,0.48828125,0.51171875
E01017399,1440,706,734,0.49027777777777776,0.5097222222222222
E01017400,1539,756,783,0.49122807017543857,0.5087719298245614
E01017401,1211,610,601,0.5037159372419489,0.4962840627580512
E01017402,1524,758,766,0.4973753280839895,0.5026246719160105
E01017403,1437,735,702,0.511482254697286,0.48851774530271397
E01017404,1252,616,636,0.49201277955271566,0.5079872204472844
E01017405,1363,697,666,0.5113719735876743,0.4886280264123258
E01017406,2578,1269,1309,0.4922420480993018,0.5077579519006982
E01017407,1511,738,773,0.4884182660489742,0.5115817339510258
E01017398,2536,1248,1288,0.4921135646687697,0.5078864353312302
E01017408,1065,543,522,0.5098591549295775,0.49014084507042255
E01017409,1221,606,615,0.4963144963144963,0.5036855036855037
E01017450,2258,1128,1130,0.4995571302037201,0.5004428697962799
E01033824,1755,880,875,0.5014245014245015,0.4985754985754986
E01033825,1667,788,879,0.47270545890821836,0.5272945410917816
E01017558,1770,854,916,0.4824858757062147,0.5175141242937853
E01017559,1660,800,860,0.4819277108433735,0.5180722891566265
E01017560,1507,741,766,0.49170537491705374,0.5082946250829462
E01017616,2345,1147,1198,0.4891257995735608,0.5108742004264393
E01017577,2519,1242,1277,0.49305279872965463,0.5069472012703454
E01017620,1863,908,955,0.487385936661299,0.512614063338701
E01017621,1496,756,740,0.5053475935828877,0.4946524064171123
E01017622,1705,833,872,0.48856304985337246,0.5114369501466276
E01033826,1146,564,582,0.49214659685863876,0.5078534031413613
E01033827,1972,991,981,0.5025354969574036,0.4974645030425964
E01017603,1475,744,731,0.504406779661017,0.49559322033898306
E01017604,1572,790,782,0.5025445292620865,0.49745547073791346
E01017605,1424,710,714,0.49859550561797755,0.5014044943820225
E01017606,1766,868,898,0.49150622876557193,0.5084937712344281
E01017607,1452,733,719,0.5048209366391184,0.4951790633608815
E01017555,2086,1052,1034,0.5043144774688398,0.4956855225311601
E01017556,1655,831,824,0.5021148036253776,0.49788519637462236
E01017557,1907,870,1037,0.4562139486103828,0.5437860513896172
E01017608,1792,883,909,0.4927455357142857,0.5072544642857143
E01017609,2144,1027,1117,0.47901119402985076,0.5209888059701493
E01017589,1659,851,808,0.512959614225437,0.487040385774563
E01017590,1543,743,800,0.48152948801036943,0.5184705119896306
E01017591,1744,898,846,0.5149082568807339,0.48509174311926606
E01017610,1099,546,553,0.4968152866242038,0.5031847133757962
E01017611,1222,609,613,0.4983633387888707,0.5016366612111293
E01017612,1280,628,652,0.490625,0.509375
E01017613,1399,674,725,0.48177269478198714,0.5182273052180129
E01017614,1457,738,719,0.5065202470830473,0.4934797529169526
E01017600,2055,1074,981,0.5226277372262774,0.47737226277372263
E01017601,1512,771,741,0.5099206349206349,0.49007936507936506
E01017602,1541,754,787,0.4892926670992862,0.5107073329007138
E01017618,2266,1083,1183,0.47793468667255073,0.5220653133274492
E01017619,2232,1096,1136,0.4910394265232975,0.5089605734767025
E01017573,1389,677,712,0.48740100791936647,0.5125989920806335
E01017576,1352,671,681,0.496301775147929,0.503698224852071
E01033191,1806,868,938,0.4806201550387597,0.5193798449612403
E01033192,1713,849,864,0.4956217162872154,0.5043782837127846
E01033828,1375,698,677,0.5076363636363637,0.49236363636363634
E01033829,1216,613,603,0.5041118421052632,0.49588815789473684
E01033830,1066,531,535,0.4981238273921201,0.50187617260788
E01033831,1022,502,520,0.4911937377690802,0.5088062622309197
E01033832,1262,604,658,0.4786053882725832,0.5213946117274167
E01033833,1525,761,764,0.49901639344262294,0.5009836065573771
E01017578,2386,1169,1217,0.4899413243922883,0.5100586756077117
E01017579,2020,997,1023,0.49356435643564356,0.5064356435643564
E01017580,2488,1196,1292,0.4807073954983923,0.5192926045016077
E01017581,1848,911,937,0.49296536796536794,0.5070346320346321
E01017617,1316,636,680,0.48328267477203646,0.5167173252279635
E01017582,1510,766,744,0.5072847682119205,0.49271523178807947
E01017583,1978,967,1011,0.48887765419615775,0.5111223458038423
E01017584,2102,1078,1024,0.5128449096098954,0.4871550903901047
E01017585,1393,709,684,0.5089734386216799,0.4910265613783202
E01017566,1453,692,761,0.47625602202339984,0.5237439779766001
E01017595,1196,609,587,0.5091973244147158,0.4908026755852843
E01017596,1665,824,841,0.4948948948948949,0.5051051051051051
E01017597,1589,799,790,0.5028319697923223,0.4971680302076778
E01017598,1681,815,866,0.48483045806067815,0.5151695419393219
E01033834,1605,824,781,0.5133956386292835,0.4866043613707165
E01033835,1481,731,750,0.49358541525995947,0.5064145847400405
E01017565,1502,708,794,0.47137150466045274,0.5286284953395473
E01017567,1668,834,834,0.5,0.5
E01017568,2247,1111,1136,0.49443702714730753,0.5055629728526925
E01017569,1835,922,913,0.5024523160762943,0.49754768392370574
E01033836,1711,837,874,0.489187609585038,0.510812390414962
E01033837,1542,769,773,0.4987029831387808,0.5012970168612192
E01017592,1689,847,842,0.5014801657785672,0.4985198342214328
E01017593,1516,739,777,0.487467018469657,0.512532981530343
E01017594,2316,1136,1180,0.4905008635578584,0.5094991364421416
E01017623,1693,864,829,0.5103366804489072,0.4896633195510927
E01017624,1788,861,927,0.4815436241610738,0.5184563758389261
E01017625,1553,770,783,0.49581455247907275,0.5041854475209272
E01017626,1571,784,787,0.4990451941438574,0.5009548058561426
E01017571,1256,617,639,0.4912420382165605,0.5087579617834395
E01017572,1388,673,715,0.48487031700288186,0.5151296829971181
E01017586,1517,735,782,0.48450889914304546,0.5154911008569545
E01017587,1639,827,812,0.5045759609517999,0.49542403904820015
E01017588,1197,607,590,0.5071010860484545,0.4928989139515455
E01017561,1479,716,763,0.4841108857336038,0.5158891142663962
E01017562,2470,1202,1268,0.48663967611336034,0.5133603238866397
E01017563,1600,765,835,0.478125,0.521875
E01017564,1446,697,749,0.48201936376210236,0.5179806362378977
E01017975,2319,1236,1083,0.5329883570504528,0.4670116429495472
E01017976,1726,900,826,0.5214368482039398,0.47856315179606024
E01017977,1772,869,903,0.4904063205417607,0.5095936794582393
E01017978,1501,757,744,0.5043304463690873,0.49566955363091275
E01017979,1557,787,770,0.5054592164418754,0.4945407835581246
E01017980,1438,720,718,0.5006954102920723,0.4993045897079277
E01017949,1607,810,797,0.5040448039825762,0.49595519601742377
E01017950,1297,643,654,0.49575944487278334,0.5042405551272167
E01017951,1502,788,714,0.5246338215712384,0.47536617842876167
E01017952,1652,806,846,0.48789346246973364,0.5121065375302664
E01017953,2104,1044,1060,0.49619771863117873,0.5038022813688213
E01017954,1558,751,807,0.4820282413350449,0.517971758664955
E01017971,1654,844,810,0.5102781136638452,0.48972188633615477
E01017972,1721,872,849,0.5066821615339918,0.49331783846600813
E01017973,2008,964,1044,0.4800796812749004,0.5199203187250996
E01017974,1757,899,858,0.5116676152532726,0.48833238474672735
E01032792,1233,644,589,0.5223033252230332,0.47769667477696676
E01032802,1341,667,674,0.49739000745712153,0.5026099925428784
E01018006,1554,757,797,0.4871299871299871,0.5128700128700129
E01018007,1533,755,778,0.49249836921069795,0.507501630789302
E01018008,1588,804,784,0.5062972292191436,0.49370277078085645
E01018009,2182,1068,1114,0.4894592117323556,0.5105407882676444
E01018010,1632,793,839,0.48590686274509803,0.5140931372549019
E01017955,1466,689,777,0.46998635743519784,0.5300136425648022
E01035511,1225,605,620,0.49387755102040815,0.5061224489795918
E01035512,1032,562,470,0.5445736434108527,0.45542635658914726
E01035513,1030,544,486,0.5281553398058253,0.47184466019417476
E01035514,8227,4405,3822,0.5354321137717273,0.4645678862282728
E01017943,2182,1051,1131,0.48166819431714025,0.5183318056828597
E01017944,1432,698,734,0.48743016759776536,0.5125698324022346
E01017945,1741,926,815,0.5318782309017805,0.4681217690982194
E01017946,1572,796,776,0.5063613231552163,0.49363867684478374
E01017947,1730,922,808,0.5329479768786127,0.46705202312138727
E01017948,1682,827,855,0.49167657550535077,0.5083234244946492
E01017983,2748,1387,1361,0.504730713245997,0.4952692867540029
E01017985,1887,947,940,0.501854795972443,0.49814520402755696
E01035515,2612,1410,1202,0.5398162327718223,0.46018376722817766
E01035516,5734,2821,2913,0.4919776770143007,0.5080223229856994
E01035517,3264,1724,1540,0.5281862745098039,0.47181372549019607
E01017987,1974,989,985,0.5010131712259371,0.4989868287740628
E01017988,1755,900,855,0.5128205128205128,0.48717948717948717
E01017989,1923,922,1001,0.4794591783671347,0.5205408216328653
E01017990,1195,594,601,0.497071129707113,0.502928870292887
E01017991,1381,668,713,0.4837074583635047,0.5162925416364953
E01017997,2645,1311,1334,0.4956521739130435,0.5043478260869565
E01017998,1893,994,899,0.5250924458531432,0.4749075541468568
E01017999,2205,1121,1084,0.508390022675737,0.49160997732426304
E01018000,1824,921,903,0.5049342105263158,0.49506578947368424
E01018001,1622,832,790,0.5129469790382244,0.4870530209617756
E01017965,1737,817,920,0.4703511801957398,0.5296488198042603
E01017967,1731,847,884,0.48931253610629694,0.510687463893703
E01017968,1571,768,803,0.48886059834500317,0.5111394016549968
E01017969,1763,805,958,0.4566080544526375,0.5433919455473625
E01035518,1680,863,817,0.5136904761904761,0.4863095238095238
E01035519,2341,1312,1029,0.5604442545920547,0.43955574540794534
E01017959,1787,874,913,0.4890878567431449,0.5109121432568551
E01017960,1451,710,741,0.48931771192281187,0.5106822880771882
E01017961,1213,608,605,0.5012366034624897,0.4987633965375103
E01017962,1897,946,951,0.49868212967843967,0.5013178703215604
E01017963,1623,818,805,0.5040049291435613,0.4959950708564387
E01017964,1372,682,690,0.4970845481049563,0.5029154518950437
E01017992,2086,938,1148,0.44966442953020136,0.5503355704697986
E01017994,1900,920,980,0.4842105263157895,0.5157894736842106
E01017995,2128,1020,1108,0.4793233082706767,0.5206766917293233
E01017996,2073,1036,1037,0.49975880366618425,0.5002411963338157
E01035520,1962,1185,777,0.6039755351681957,0.39602446483180426
E01035521,1778,743,1035,0.4178852643419573,0.5821147356580427
E01035524,1523,761,762,0.49967170059093896,0.5003282994090611
E01035525,1572,754,818,0.4796437659033079,0.5203562340966921
E01035526,1995,939,1056,0.4706766917293233,0.5293233082706766
E01035527,1493,729,764,0.4882786336235767,0.5117213663764233
E01035528,1523,732,791,0.48063033486539725,0.5193696651346028
E01035529,1618,795,823,0.49134734239802225,0.5086526576019778
E01035530,1411,664,747,0.47058823529411764,0.5294117647058824
E01018005,1818,892,926,0.49064906490649063,0.5093509350935094
E01032794,1260,613,647,0.4865079365079365,0.5134920634920634
E01035522,1979,880,1099,0.44466902475997977,0.5553309752400202
E01035523,1170,588,582,0.5025641025641026,0.49743589743589745
E01018042,1402,662,740,0.47218259629101283,0.5278174037089871
E01018043,2287,1135,1152,0.49628334062090074,0.5037166593790993
E01018044,1770,893,877,0.5045197740112994,0.49548022598870056
E01018045,1365,691,674,0.5062271062271062,0.4937728937728938
E01035531,1293,646,647,0.49961330239752516,0.5003866976024749
E01035532,1793,901,892,0.5025097601784718,0.4974902398215282
E01018020,1561,800,761,0.5124919923126201,0.4875080076873799
E01018021,1466,701,765,0.4781718963165075,0.5218281036834925
E01018022,1417,702,715,0.4954128440366973,0.5045871559633027
E01018055,2012,998,1014,0.4960238568588469,0.5039761431411531
E01018056,2015,985,1030,0.48883374689826303,0.511166253101737
E01018027,1773,840,933,0.47377326565143824,0.5262267343485617
E01018032,2483,1186,1297,0.47764800644381794,0.522351993556182
E01018033,1903,921,982,0.4839726747241198,0.5160273252758802
E01033426,1613,796,817,0.4934903905765654,0.5065096094234346
E01033430,1413,687,726,0.4861995753715499,0.5138004246284501
E01035533,1535,756,779,0.49250814332247556,0.5074918566775244
E01035534,1242,595,647,0.47906602254428343,0.5209339774557166
E01018024,1225,584,641,0.476734693877551,0.5232653061224489
E01018025,1503,717,786,0.47704590818363274,0.5229540918163673
E01018026,1470,719,751,0.4891156462585034,0.5108843537414965
E01033425,2010,1004,1006,0.49950248756218907,0.5004975124378109
E01035535,2405,1176,1229,0.488981288981289,0.511018711018711
E01018036,1674,823,851,0.491636798088411,0.508363201911589
E01018037,1463,727,736,0.4969241285030759,0.5030758714969241
E01018038,1581,782,799,0.4946236559139785,0.5053763440860215
E01018039,1303,636,667,0.48810437452033767,0.5118956254796623
E01018053,1808,880,928,0.48672566371681414,0.5132743362831859
E01018054,2450,1215,1235,0.4959183673469388,0.5040816326530613
E01018047,2058,1012,1046,0.49173955296404276,0.5082604470359572
E01018049,2012,964,1048,0.47912524850894633,0.5208747514910537
E01018050,1492,720,772,0.48257372654155495,0.517426273458445
E01018051,2462,1205,1257,0.4894394800974817,0.5105605199025183
E01018052,1907,1005,902,0.5270057682223388,0.47299423177766126
E01033427,1303,647,656,0.4965464313123561,0.5034535686876439
E01033429,2008,970,1038,0.48306772908366535,0.5169322709163346
E01018034,1739,874,865,0.5025876940770557,0.4974123059229442
E01018035,2177,1076,1101,0.4942581534221406,0.5057418465778595
E01018040,1315,659,656,0.5011406844106464,0.4988593155893536
E01018041,1166,570,596,0.4888507718696398,0.5111492281303602
E01018013,1860,892,968,0.47956989247311826,0.5204301075268817
E01018014,1756,867,889,0.49373576309794986,0.5062642369020501
E01018015,1359,680,679,0.5003679175864606,0.49963208241353935
E01018016,1429,708,721,0.49545136459062283,0.5045486354093772
E01018011,2606,1240,1366,0.4758250191864927,0.5241749808135073
E01018012,1623,788,835,0.48552064078866297,0.514479359211337
E01018057,2051,996,1055,0.4856167723061921,0.514383227693808
E01018017,1324,633,691,0.4780966767371601,0.5219033232628398
E01018019,1082,505,577,0.466728280961183,0.533271719038817
E01018023,2137,1069,1068,0.5002339728591484,0.49976602714085167
E01032611,1657,808,849,0.4876282438141219,0.512371756185878
E01018094,1860,890,970,0.478494623655914,0.521505376344086
E01018095,1723,838,885,0.4863609982588508,0.5136390017411492
E01018096,1673,848,825,0.5068738792588166,0.4931261207411835
E01018097,1552,758,794,0.4884020618556701,0.5115979381443299
E01018063,2772,1360,1412,0.4906204906204906,0.5093795093795094
E01018073,2609,1303,1306,0.4994250670755079,0.5005749329244922
E01018107,1752,839,913,0.4788812785388128,0.5211187214611872
E01018108,2026,972,1054,0.4797630799605133,0.5202369200394866
E01018109,1920,922,998,0.48020833333333335,0.5197916666666667
E01018069,1739,841,898,0.4836112708453134,0.5163887291546866
E01018070,2004,960,1044,0.47904191616766467,0.5209580838323353
E01018071,1963,916,1047,0.46663270504330107,0.5333672949566989
E01018093,2471,1232,1239,0.4985835694050991,0.5014164305949008
E01018103,1233,591,642,0.4793187347931874,0.5206812652068127
E01018104,1170,577,593,0.4931623931623932,0.5068376068376068
E01033111,1690,846,844,0.5005917159763313,0.49940828402366866
E01033112,1450,755,695,0.5206896551724138,0.4793103448275862
E01018066,1492,723,769,0.48458445040214476,0.5154155495978552
E01018067,1859,918,941,0.49381387842926305,0.506186121570737
E01018068,1571,784,787,0.4990451941438574,0.5009548058561426
E01018090,2030,952,1078,0.4689655172413793,0.5310344827586206
E01018091,1519,753,766,0.4957208689927584,0.5042791310072416
E01018092,1890,930,960,0.49206349206349204,0.5079365079365079
E01018081,1984,1202,782,0.6058467741935484,0.3941532258064516
E01018082,1947,953,994,0.48947098099640474,0.5105290190035953
E01018083,1866,901,965,0.4828510182207931,0.5171489817792069
E01018084,2018,988,1030,0.489593657086224,0.5104063429137761
E01018064,2493,1207,1286,0.4841556357801845,0.5158443642198155
E01018072,2398,1159,1239,0.48331943286071727,0.5166805671392828
E01018074,1219,589,630,0.4831829368334701,0.51681706316653
E01018075,1196,552,644,0.46153846153846156,0.5384615384615384
E01018098,1270,610,660,0.48031496062992124,0.5196850393700787
E01018099,1218,604,614,0.49589490968801314,0.5041050903119869
E01018100,1426,705,721,0.4943899018232819,0.5056100981767181
E01018101,1460,708,752,0.4849315068493151,0.5150684931506849
E01018077,1880,907,973,0.4824468085106383,0.5175531914893617
E01018078,1750,798,952,0.456,0.544
E01018079,1679,788,891,0.46932698034544373,0.5306730196545563
E01018080,2350,1157,1193,0.49234042553191487,0.5076595744680851
E01018058,1441,690,751,0.47883414295628035,0.5211658570437196
E01018059,1492,748,744,0.5013404825737265,0.49865951742627346
E01018060,1904,936,968,0.49159663865546216,0.5084033613445378
E01018061,1286,637,649,0.4953343701399689,0.504665629860031
E01018085,1618,788,830,0.48702101359703337,0.5129789864029666
E01018086,2102,1007,1095,0.47906755470980017,0.5209324452901998
E01018087,2239,1116,1123,0.4984368021438142,0.5015631978561857
E01018088,1529,720,809,0.4708960104643558,0.5291039895356442
E01018065,2532,1235,1297,0.48775671406003157,0.5122432859399684
E01018076,2639,1293,1346,0.48995831754452446,0.5100416824554755
E01018111,2372,1162,1210,0.48988195615514335,0.5101180438448567
E01018062,2645,1280,1365,0.4839319470699433,0.5160680529300568
E01018105,1194,605,589,0.5067001675041876,0.4932998324958124
E01018106,1589,774,815,0.48709880427942104,0.512901195720579
E01018110,2702,1324,1378,0.4900074019245004,0.5099925980754997
E01035536,1743,873,870,0.5008605851979346,0.4991394148020654
E01035537,1312,674,638,0.5137195121951219,0.48628048780487804
E01018212,1596,784,812,0.49122807017543857,0.5087719298245614
E01018213,1968,940,1028,0.47764227642276424,0.5223577235772358
E01018214,2000,979,1021,0.4895,0.5105
E01018215,1502,745,757,0.4960053262316911,0.503994673768309
E01018216,2530,1232,1298,0.48695652173913045,0.5130434782608696
E01018217,1603,782,821,0.4878353087960075,0.5121646912039926
E01018127,1467,729,738,0.49693251533742333,0.5030674846625767
E01018128,1157,558,599,0.4822817631806396,0.5177182368193605
E01018200,1651,820,831,0.4966686856450636,0.5033313143549364
E01018201,1387,668,719,0.4816149963950973,0.5183850036049027
E01018156,1605,783,822,0.48785046728971965,0.5121495327102804
E01018157,2119,1052,1067,0.49646059462010383,0.5035394053798962
E01018158,1634,814,820,0.4981640146878825,0.5018359853121175
E01018159,1612,807,805,0.500620347394541,0.4993796526054591
E01018160,1627,784,843,0.48186846957590657,0.5181315304240934
E01018191,1349,688,661,0.5100074128984433,0.4899925871015567
E01018192,1840,897,943,0.4875,0.5125
E01018193,1261,596,665,0.4726407613005551,0.5273592386994449
E01018194,1344,664,680,0.49404761904761907,0.5059523809523809
E01018195,1293,620,673,0.4795050270688322,0.5204949729311679
E01018208,2136,1026,1110,0.4803370786516854,0.5196629213483146
E01018209,1553,770,783,0.49581455247907275,0.5041854475209272
E01018210,1318,633,685,0.4802731411229135,0.5197268588770865
E01018211,1943,942,1001,0.48481729284611425,0.5151827071538857
E01018196,1294,642,652,0.49613601236476046,0.5038639876352395
E01018197,1386,683,703,0.49278499278499277,0.5072150072150072
E01018198,1622,806,816,0.4969173859432799,0.5030826140567201
E01018199,1567,768,799,0.4901084875558392,0.5098915124441609
E01018206,2255,1180,1075,0.5232815964523282,0.47671840354767187
E01018207,1558,760,798,0.4878048780487805,0.5121951219512195
E01018121,1282,644,638,0.5023400936037441,0.49765990639625585
E01018122,1069,519,550,0.4855004677268475,0.5144995322731525
E01018123,1655,834,821,0.5039274924471299,0.4960725075528701
E01018124,1888,930,958,0.4925847457627119,0.5074152542372882
E01018143,2155,1044,1111,0.48445475638051044,0.5155452436194896
E01018144,1788,871,917,0.48713646532438476,0.5128635346756152
E01018145,1346,677,669,0.5029717682020802,0.4970282317979198
E01018146,2094,1074,1020,0.5128939828080229,0.4871060171919771
E01018147,1674,813,861,0.48566308243727596,0.514336917562724
E01018139,1626,790,836,0.4858548585485855,0.5141451414514145
E01018140,1252,646,606,0.5159744408945687,0.4840255591054313
E01018141,1609,799,810,0.49658172778123055,0.5034182722187694
E01018142,1487,703,784,0.47276395427034296,0.527236045729657
E01018113,1482,707,775,0.47705802968960864,0.5229419703103914
E01018116,2805,1347,1458,0.4802139037433155,0.5197860962566845
E01018117,1736,817,919,0.4706221198156682,0.5293778801843319
E01018118,2045,1007,1038,0.4924205378973105,0.5075794621026894
E01034435,1663,850,813,0.5111244738424534,0.4888755261575466
E01034436,1817,936,881,0.5151348376444689,0.4848651623555311
E01018161,1361,679,682,0.49889786921381335,0.5011021307861866
E01018162,1448,729,719,0.5034530386740331,0.4965469613259669
E01018163,1335,672,663,0.503370786516854,0.4966292134831461
E01018164,1253,605,648,0.4828411811652035,0.5171588188347965
E01018165,1238,631,607,0.5096930533117933,0.4903069466882068
E01018170,1343,652,691,0.4854802680565897,0.5145197319434103
E01018171,1622,815,807,0.5024660912453761,0.49753390875462394
E01018138,2103,1078,1025,0.5126010461245839,0.4873989538754161
E01018148,2771,1340,1431,0.48357993504150126,0.5164200649584988
E01018149,1454,730,724,0.5020632737276479,0.49793672627235214
E01018150,1623,811,812,0.49969192852741834,0.5003080714725816
E01034437,1126,543,583,0.4822380106571936,0.5177619893428064
E01034438,1322,673,649,0.5090771558245083,0.4909228441754917
E01018166,1503,743,760,0.49434464404524286,0.5056553559547572
E01018167,1439,718,721,0.49895760945100764,0.5010423905489924
E01018168,2029,1023,1006,0.50418925579103,0.4958107442089699
E01018169,2248,1071,1177,0.476423487544484,0.5235765124555161
E01018131,1514,752,762,0.4966974900924703,0.5033025099075297
E01018133,1654,812,842,0.4909310761789601,0.5090689238210399
E01018134,1860,924,936,0.4967741935483871,0.5032258064516129
E01034439,1283,635,648,0.49493374902572096,0.505066250974279
E01034440,1578,790,788,0.5006337135614702,0.49936628643852976
E01018125,1529,767,762,0.5016350555918901,0.49836494440810986
E01018126,1693,856,837,0.505611340815121,0.4943886591848789
E01018152,1430,692,738,0.48391608391608393,0.5160839160839161
E01018153,1722,851,871,0.49419279907084784,0.5058072009291521
E01018129,1635,803,832,0.491131498470948,0.5088685015290519
E01018130,1943,912,1031,0.46937725167267114,0.5306227483273289
E01018202,1452,695,757,0.4786501377410468,0.5213498622589532
E01018203,1854,909,945,0.49029126213592233,0.5097087378640777
E01018204,1402,695,707,0.4957203994293866,0.5042796005706134
E01018205,1753,879,874,0.5014261266400456,0.49857387335995434
E01018115,2344,1728,616,0.7372013651877133,0.2627986348122867
E01018119,1564,781,783,0.4993606138107417,0.5006393861892583
E01018120,1825,859,966,0.4706849315068493,0.5293150684931507
E01018137,1729,853,876,0.4933487565066512,0.5066512434933488
E01018136,1685,832,853,0.4937685459940653,0.5062314540059347
E01018154,2471,1220,1251,0.4937272359368677,0.5062727640631324
E01018155,1559,759,800,0.4868505452212957,0.5131494547787043
E01034441,1732,842,890,0.48614318706697457,0.5138568129330254
E01034442,1781,898,883,0.5042111173498035,0.4957888826501965
E01034443,1706,836,870,0.4900351699882767,0.5099648300117233
E01018187,2036,1005,1031,0.49361493123772104,0.506385068762279
E01018188,1424,697,727,0.48946629213483145,0.5105337078651685
E01018189,1259,624,635,0.49563145353455124,0.5043685464654488
E01018190,1565,767,798,0.49009584664536743,0.5099041533546326
E01018172,1418,671,747,0.47320169252468264,0.5267983074753173
E01018173,1152,562,590,0.4878472222222222,0.5121527777777778
E01018174,1512,748,764,0.4947089947089947,0.5052910052910053
E01018175,1356,670,686,0.4941002949852507,0.5058997050147492
E01018176,1277,652,625,0.5105716523101018,0.4894283476898982
E01018182,1424,712,712,0.5,0.5
E01018183,1397,687,710,0.4917680744452398,0.5082319255547602
E01018184,1203,571,632,0.4746467165419784,0.5253532834580216
E01018185,1546,765,781,0.4948253557567917,0.5051746442432082
E01018186,1684,835,849,0.49584323040380046,0.5041567695961995
E01034444,1622,816,806,0.5030826140567201,0.4969173859432799
E01034445,1664,833,831,0.5006009615384616,0.49939903846153844
E01018177,1398,692,706,0.4949928469241774,0.5050071530758226
E01018178,1679,830,849,0.49434187016081,0.50565812983919
E01018179,1416,694,722,0.4901129943502825,0.5098870056497176
E01018180,1235,599,636,0.48502024291497975,0.5149797570850202
E01018304,2093,1024,1069,0.48924988055422836,0.5107501194457716
E01018305,1293,648,645,0.5011600928074246,0.4988399071925754
E01018306,1601,780,821,0.4871955028107433,0.5128044971892567
E01018307,2250,1099,1151,0.48844444444444446,0.5115555555555555
E01018233,1525,759,766,0.4977049180327869,0.5022950819672131
E01018234,1558,785,773,0.5038510911424904,0.4961489088575096
E01018235,1639,799,840,0.48749237339841367,0.5125076266015863
E01018236,2057,1025,1032,0.49829849295089934,0.5017015070491007
E01018237,1495,725,770,0.48494983277591974,0.5150501672240803
E01018284,1360,640,720,0.47058823529411764,0.5294117647058824
E01018285,1380,655,725,0.4746376811594203,0.5253623188405797
E01035555,1683,860,823,0.5109922756981581,0.489007724301842
E01035556,1453,747,706,0.5141087405368203,0.4858912594631796
E01035557,1309,641,668,0.48968678380443087,0.5103132161955691
E01035558,1259,647,612,0.5138999205718825,0.48610007942811756
E01018298,1613,778,835,0.4823310601363918,0.5176689398636082
E01018299,2305,1132,1173,0.4911062906724512,0.5088937093275488
E01018300,1247,655,592,0.5252606255012029,0.4747393744987971
E01018301,1361,649,712,0.47685525349008084,0.5231447465099192
E01018257,1465,702,763,0.47918088737201364,0.5208191126279863
E01018258,1648,814,834,0.49393203883495146,0.5060679611650486
E01018259,1431,716,715,0.5003494060097834,0.4996505939902166
E01018260,1919,925,994,0.4820218863991662,0.5179781136008338
E01018262,1383,668,715,0.48300795372378885,0.5169920462762111
E01033120,1444,705,739,0.48822714681440443,0.5117728531855956
E01033121,2137,1113,1024,0.5208235844642022,0.4791764155357979
E01018272,1516,751,765,0.4953825857519789,0.5046174142480211
E01018273,1354,662,692,0.48892171344165436,0.5110782865583456
E01018274,1530,787,743,0.5143790849673202,0.48562091503267973
E01018297,1689,818,871,0.4843102427471877,0.5156897572528123
E01018231,2866,1400,1466,0.4884856943475227,0.5115143056524774
E01018232,2254,1056,1198,0.46850044365572313,0.5314995563442768
E01018251,1136,565,571,0.49735915492957744,0.5026408450704225
E01018252,1522,750,772,0.492772667542707,0.507227332457293
E01018255,1113,536,577,0.481581311769991,0.518418688230009
E01018242,1691,827,864,0.48905972797161446,0.5109402720283855
E01018243,1627,828,799,0.5089121081745543,0.4910878918254456
E01018244,1731,779,952,0.45002888503755056,0.5499711149624494
E01018286,1579,772,807,0.4889170360987967,0.5110829639012033
E01018287,1285,650,635,0.5058365758754864,0.49416342412451364
E01018296,1037,513,524,0.49469623915139826,0.5053037608486017
E01018292,1542,727,815,0.4714656290531777,0.5285343709468223
E01018293,1576,755,821,0.47906091370558374,0.5209390862944162
E01018294,1741,872,869,0.5008615738081562,0.4991384261918438
E01018295,1676,824,852,0.4916467780429594,0.5083532219570406
E01018245,1692,845,847,0.49940898345153667,0.5005910165484634
E01018246,1556,736,820,0.4730077120822622,0.5269922879177378
E01018247,1789,877,912,0.490217998882057,0.509782001117943
E01018275,2621,1262,1359,0.481495612361694,0.518504387638306
E01018240,1275,618,657,0.48470588235294115,0.5152941176470588
E01018253,1158,588,570,0.5077720207253886,0.49222797927461137
E01018254,1989,1017,972,0.5113122171945701,0.48868778280542985
E01018256,2560,1239,1321,0.483984375,0.516015625
E01018291,1140,552,588,0.4842105263157895,0.5157894736842106
E01018279,1631,773,858,0.4739423666462293,0.5260576333537706
E01018280,1480,750,730,0.5067567567567568,0.49324324324324326
E01018281,1582,767,815,0.48482932996207334,0.5151706700379267
E01018282,1318,617,701,0.468133535660091,0.5318664643399089
E01018283,1256,623,633,0.49601910828025475,0.5039808917197452
E01018218,1700,833,867,0.49,0.51
E01018219,1433,685,748,0.47801814375436147,0.5219818562456385
E01018220,1405,698,707,0.496797153024911,0.503202846975089
E01018263,1478,739,739,0.5,0.5
E01018264,1602,735,867,0.45880149812734083,0.5411985018726592
E01018265,1686,823,863,0.48813760379596677,0.5118623962040332
E01018238,1460,714,746,0.48904109589041095,0.510958904109589
E01018239,1504,746,758,0.49601063829787234,0.5039893617021277
E01018288,1286,649,637,0.504665629860031,0.4953343701399689
E01018289,1279,626,653,0.48944487881157156,0.5105551211884285
E01018302,1501,779,722,0.5189873417721519,0.4810126582278481
E01018303,1237,592,645,0.4785772029102668,0.5214227970897333
E01018241,1295,660,635,0.5096525096525096,0.49034749034749037
E01018267,2278,1105,1173,0.48507462686567165,0.5149253731343284
E01018268,1970,968,1002,0.49137055837563454,0.5086294416243655
E01018269,1516,724,792,0.47757255936675463,0.5224274406332454
E01018270,1109,547,562,0.4932371505861136,0.5067628494138864
E01018271,1707,829,878,0.4856473345049795,0.5143526654950205
E01018226,1220,642,578,0.5262295081967213,0.4737704918032787
E01018227,1920,914,1006,0.47604166666666664,0.5239583333333333
E01018228,1642,820,822,0.4993909866017052,0.5006090133982948
E01018290,2457,1195,1262,0.4863654863654864,0.5136345136345136
E01033113,1263,592,671,0.46872525732383213,0.5312747426761678
E01033114,1409,693,716,0.4918381831085876,0.5081618168914124
E01033115,1420,692,728,0.48732394366197185,0.5126760563380282
E01033117,1320,639,681,0.48409090909090907,0.5159090909090909
E01035559,2021,1012,1009,0.5007422068283028,0.49925779317169716
E01035560,2458,1203,1255,0.48942229454841335,0.5105777054515866
E01018276,1514,744,770,0.4914134742404227,0.5085865257595773
E01018277,1799,887,912,0.49305169538632576,0.5069483046136742
E01018278,2586,1277,1309,0.4938128383604022,0.5061871616395979
E01033116,2831,1375,1456,0.485694101024373,0.514305898975627
E01033118,1503,747,756,0.49700598802395207,0.5029940119760479
E01018221,1621,810,811,0.499691548426897,0.500308451573103
E01018222,1407,695,712,0.4939587775408671,0.5060412224591329
E01018223,1948,978,970,0.502053388090349,0.49794661190965095
E01018224,1475,739,736,0.5010169491525424,0.49898305084745764
E01018225,1041,476,565,0.457252641690682,0.542747358309318
E01018248,2224,1090,1134,0.49010791366906475,0.5098920863309353
E01035561,2167,1058,1109,0.488232579603138,0.5117674203968621
E01021237,1367,680,687,0.49743964886613024,0.5025603511338698
E01021238,1367,664,703,0.4857351865398683,0.5142648134601316
E01021242,1252,608,644,0.48562300319488816,0.5143769968051118
E01021250,1553,752,801,0.4842240824211204,0.5157759175788796
E01021251,1576,767,809,0.4866751269035533,0.5133248730964467
E01021245,1455,680,775,0.46735395189003437,0.5326460481099656
E01021246,1454,690,764,0.47455295735900965,0.5254470426409904
E01021248,1508,722,786,0.47877984084880637,0.5212201591511937
E01021249,1547,754,793,0.48739495798319327,0.5126050420168067
E01021252,1381,656,725,0.47501810282404056,0.5249818971759594
E01021239,1450,721,729,0.49724137931034484,0.5027586206896552
E01021240,1769,892,877,0.50423968343697,0.49576031656302993
E01021241,1714,803,911,0.4684947491248541,0.5315052508751459
E01021243,1669,839,830,0.5026962252846016,0.49730377471539844
E01021247,1499,746,753,0.49766511007338227,0.5023348899266178
E01021244,1545,772,773,0.49967637540453075,0.5003236245954693
E01021253,1769,881,888,0.4980214810627473,0.5019785189372526
E01021255,1536,704,832,0.4583333333333333,0.5416666666666666
E01021256,1501,733,768,0.4883411059293804,0.5116588940706196
E01021258,1712,795,917,0.46436915887850466,0.5356308411214953
E01021334,1712,820,892,0.47897196261682246,0.5210280373831776
E01021336,1695,806,889,0.4755162241887906,0.5244837758112094
E01021338,2132,1035,1097,0.48545966228893056,0.5145403377110694
E01021339,1425,679,746,0.47649122807017547,0.5235087719298246
E01021264,1467,744,723,0.5071574642126789,0.49284253578732107
E01021329,1506,728,778,0.48339973439575035,0.5166002656042497
E01021330,1618,813,805,0.5024721878862793,0.49752781211372066
E01021332,1427,687,740,0.48142957252978275,0.5185704274702172
E01021333,1555,741,814,0.47652733118971063,0.5234726688102894
E01021335,1387,698,689,0.5032444124008651,0.4967555875991348
E01021337,1496,724,772,0.4839572192513369,0.516042780748663
E01021340,1810,911,899,0.5033149171270718,0.4966850828729282
E01021341,1672,825,847,0.4934210526315789,0.506578947368421
E01021345,2070,1023,1047,0.49420289855072463,0.5057971014492754
E01021331,1883,926,957,0.4917684545937334,0.5082315454062666
E01021342,1679,807,872,0.4806432400238237,0.5193567599761763
E01021343,1759,855,904,0.4860716316088687,0.5139283683911313
E01021344,2249,1092,1157,0.48554913294797686,0.5144508670520231
E01021346,2149,1056,1093,0.49139134481154023,0.5086086551884598
E01021254,1502,747,755,0.4973368841544607,0.5026631158455392
E01021257,1570,784,786,0.49936305732484076,0.5006369426751592
E01021259,1550,762,788,0.4916129032258065,0.5083870967741936
E01021260,1820,903,917,0.49615384615384617,0.5038461538461538
E01021261,1704,854,850,0.5011737089201878,0.4988262910798122
E01021262,1562,732,830,0.4686299615877081,0.5313700384122919
E01021263,1884,904,980,0.47983014861995754,0.5201698513800425
E01021274,1922,913,1009,0.4750260145681582,0.5249739854318418
E01021279,1664,800,864,0.4807692307692308,0.5192307692307693
E01021301,1546,758,788,0.49029754204398446,0.5097024579560155
E01021303,1390,655,735,0.4712230215827338,0.5287769784172662
E01021307,1388,681,707,0.49063400576368876,0.5093659942363112
E01021308,1239,592,647,0.4778046811945117,0.5221953188054883
E01021309,1358,664,694,0.4889543446244477,0.5110456553755522
E01021312,1625,811,814,0.4990769230769231,0.5009230769230769
E01021265,1788,891,897,0.4983221476510067,0.5016778523489933
E01021267,1995,962,1033,0.48220551378446114,0.5177944862155388
E01021269,2132,1033,1099,0.4845215759849906,0.5154784240150094
E01021270,2225,1081,1144,0.4858426966292135,0.5141573033707865
E01021272,1649,775,874,0.469981807155852,0.530018192844148
E01021271,1870,847,1023,0.45294117647058824,0.5470588235294118
E01021302,1679,822,857,0.48957712924359736,0.5104228707564026
E01021304,1449,688,761,0.4748102139406487,0.5251897860593513
E01021305,1449,699,750,0.4824016563146998,0.5175983436853002
E01021306,1461,707,754,0.4839151266255989,0.5160848733744011
E01021273,1914,915,999,0.4780564263322884,0.5219435736677116
E01021275,1659,793,866,0.47799879445449067,0.5220012055455093
E01021276,1515,734,781,0.4844884488448845,0.5155115511551155
E01021277,1413,689,724,0.4876150035385704,0.5123849964614295
E01034354,1893,922,971,0.48705758055995774,0.5129424194400423
E01034355,1676,771,905,0.46002386634844866,0.5399761336515513
E01021266,1784,853,931,0.4781390134529148,0.5218609865470852
E01021268,1686,763,923,0.4525504151838671,0.5474495848161328
E01021318,2703,1244,1459,0.46022937476877546,0.5397706252312245
E01021320,1728,851,877,0.49247685185185186,0.5075231481481481
E01021321,1709,811,898,0.4745465184318315,0.5254534815681685
E01021286,2103,1065,1038,0.5064194008559201,0.49358059914407987
E01021288,1763,821,942,0.46568349404424275,0.5343165059557572
E01021289,1948,937,1011,0.48100616016427106,0.518993839835729
E01021290,1880,888,992,0.4723404255319149,0.5276595744680851
E01021291,2189,1082,1107,0.49428962996802195,0.505710370031978
E01021287,1595,777,818,0.4871473354231975,0.5128526645768025
E01021292,1737,833,904,0.47956246401842256,0.5204375359815774
E01021293,1849,923,926,0.4991887506760411,0.5008112493239589
E01021298,1580,750,830,0.47468354430379744,0.5253164556962026
E01021319,2404,1196,1208,0.49750415973377704,0.502495840266223
E01021313,1466,722,744,0.4924965893587995,0.5075034106412005
E01021314,1434,674,760,0.4700139470013947,0.5299860529986054
E01021315,1560,768,792,0.49230769230769234,0.5076923076923077
E01021316,1720,829,891,0.4819767441860465,0.5180232558139535
E01021317,1649,813,836,0.49302607640994545,0.5069739235900546
E01021322,1628,815,813,0.5006142506142506,0.49938574938574937
E01021323,1819,866,953,0.4760857614073667,0.5239142385926333
E01021324,1787,870,917,0.4868494683827644,0.5131505316172356
E01021325,1640,790,850,0.4817073170731707,0.5182926829268293
E01021327,1742,836,906,0.4799081515499426,0.5200918484500574
E01021294,1747,868,879,0.4968517458500286,0.5031482541499713
E01021295,1666,793,873,0.4759903961584634,0.5240096038415366
E01021297,2227,1064,1163,0.4777727885047149,0.5222272114952852
E01021299,1547,763,784,0.49321266968325794,0.5067873303167421
E01034356,1487,746,741,0.5016812373907196,0.49831876260928043
E01034357,1640,804,836,0.4902439024390244,0.5097560975609756
E01021280,1476,718,758,0.48644986449864497,0.513550135501355
E01021281,1465,708,757,0.4832764505119454,0.5167235494880547
E01021282,1554,789,765,0.5077220077220077,0.4922779922779923
E01021283,1588,770,818,0.48488664987405544,0.5151133501259446
E01021284,1541,771,770,0.500324464633355,0.49967553536664505
E01021285,1419,688,731,0.48484848484848486,0.5151515151515151
E01021300,2138,1031,1107,0.4822263797942002,0.5177736202057999
E01021310,1339,690,649,0.515309932785661,0.48469006721433905
E01021311,1409,701,708,0.49751596877217885,0.5024840312278211
E01021326,1870,914,956,0.48877005347593583,0.5112299465240642
E01021328,1546,760,786,0.49159120310478654,0.5084087968952135
E01021375,1086,550,536,0.5064456721915286,0.49355432780847147
E01021376,1415,680,735,0.48056537102473496,0.519434628975265
E01021414,2217,1104,1113,0.4979702300405954,0.5020297699594046
E01021430,2303,1167,1136,0.5067303517151541,0.4932696482848459
E01021398,1472,731,741,0.49660326086956524,0.5033967391304348
E01021406,2287,1154,1133,0.5045911674682991,0.4954088325317009
E01021407,2212,1087,1125,0.4914104882459313,0.5085895117540687
E01021382,1943,940,1003,0.4837879567678847,0.5162120432321153
E01021397,2455,1227,1228,0.49979633401221996,0.50020366598778
E01021399,1692,820,872,0.4846335697399527,0.5153664302600472
E01021400,1725,848,877,0.4915942028985507,0.5084057971014493
E01021387,2120,1033,1087,0.4872641509433962,0.5127358490566037
E01021388,1780,849,931,0.47696629213483144,0.5230337078651686
E01021391,1676,799,877,0.4767303102625298,0.5232696897374701
E01021392,1733,859,874,0.4956722446624351,0.5043277553375649
E01021393,1574,776,798,0.49301143583227447,0.5069885641677255
E01021404,2167,1097,1070,0.5062298107983387,0.49377018920166127
E01021411,1374,663,711,0.48253275109170307,0.517467248908297
E01021412,1443,730,713,0.5058905058905059,0.4941094941094941
E01021413,1295,643,652,0.4965250965250965,0.5034749034749034
E01021389,2165,1063,1102,0.4909930715935335,0.5090069284064666
E01021390,1859,913,946,0.4911242603550296,0.5088757396449705
E01021408,1790,877,913,0.4899441340782123,0.5100558659217878
E01021409,1818,917,901,0.5044004400440044,0.4955995599559956
E01021410,1862,875,987,0.4699248120300752,0.5300751879699248
E01021349,1411,719,692,0.5095676824946846,0.49043231750531535
E01021351,1615,789,826,0.4885448916408669,0.5114551083591331
E01021352,1558,739,819,0.4743260590500642,0.5256739409499358
E01021355,2039,976,1063,0.4786660127513487,0.5213339872486513
E01021356,1492,754,738,0.5053619302949062,0.49463806970509383
E01021381,1225,605,620,0.49387755102040815,0.5061224489795918
E01021354,1265,619,646,0.4893280632411067,0.5106719367588933
E01021357,1539,740,799,0.4808317089018843,0.5191682910981157
E01021358,2543,1216,1327,0.47817538340542665,0.5218246165945734
E01021359,2105,1048,1057,0.4978622327790974,0.5021377672209026
E01021350,1815,893,922,0.4920110192837466,0.5079889807162534
E01021353,1765,860,905,0.48725212464589235,0.5127478753541076
E01021365,2472,1250,1222,0.5056634304207119,0.494336569579288
E01033458,1634,832,802,0.5091799265605875,0.4908200734394125
E01033459,1755,875,880,0.4985754985754986,0.5014245014245015
E01021364,1687,847,840,0.5020746887966805,0.4979253112033195
E01021366,1639,800,839,0.4881025015253203,0.5118974984746797
E01021383,2262,1108,1154,0.48983200707338637,0.5101679929266136
E01021405,2360,1153,1207,0.4885593220338983,0.5114406779661017
E01021368,1570,795,775,0.5063694267515924,0.49363057324840764
E01021370,1728,850,878,0.49189814814814814,0.5081018518518519
E01021372,2121,1047,1074,0.49363507779349364,0.5063649222065064
E01021374,1525,738,787,0.4839344262295082,0.5160655737704918
E01035155,1405,701,704,0.498932384341637,0.501067615658363
E01035156,1483,739,744,0.4983142279163857,0.5016857720836143
E01021360,1892,896,996,0.47357293868921774,0.5264270613107822
E01021361,1773,884,889,0.49858996051889454,0.5014100394811055
E01021367,1479,695,784,0.46991210277214335,0.5300878972278567
E01021369,2818,1394,1424,0.49467707594038324,0.5053229240596168
E01021380,2650,1316,1334,0.49660377358490565,0.5033962264150943
E01021347,2698,1314,1384,0.4870274277242402,0.5129725722757599
E01021371,1697,789,908,0.464938126104891,0.5350618738951091
E01021384,2279,1116,1163,0.4896884598508118,0.5103115401491882
E01021385,1273,598,675,0.46975648075412413,0.5302435192458759
E01021386,1591,771,820,0.4846008799497172,0.5153991200502829
E01021377,1784,870,914,0.4876681614349776,0.5123318385650224
E01021378,1580,730,850,0.4620253164556962,0.5379746835443038
E01021379,1802,909,893,0.5044395116537181,0.4955604883462819
E01021401,1621,778,843,0.47995064774830354,0.5200493522516965
E01021402,2027,1032,995,0.5091267883571781,0.4908732116428219
E01021403,1594,781,813,0.48996235884567124,0.5100376411543287
E01021362,2310,1141,1169,0.49393939393939396,0.5060606060606061
E01021417,1535,751,784,0.48925081433224754,0.5107491856677524
E01021418,1546,756,790,0.4890038809831824,0.5109961190168176
E01021419,1730,840,890,0.48554913294797686,0.5144508670520231
E01021426,1248,598,650,0.4791666666666667,0.5208333333333334
E01021428,1397,687,710,0.4917680744452398,0.5082319255547602
E01021423,1590,756,834,0.47547169811320755,0.5245283018867924
E01021425,1488,717,771,0.48185483870967744,0.5181451612903226
E01021427,1342,660,682,0.4918032786885246,0.5081967213114754
E01021429,1324,620,704,0.46827794561933533,0.5317220543806647
E01021415,1564,744,820,0.47570332480818417,0.5242966751918159
E01021416,1933,962,971,0.4976720124159338,0.5023279875840663
E01021420,1717,837,880,0.48747815958066393,0.512521840419336
E01021422,1749,856,893,0.4894225271583762,0.5105774728416238
E01033460,2079,1002,1077,0.481962481962482,0.5180375180375181
E01033461,1506,732,774,0.4860557768924303,0.5139442231075697
E01033462,1034,506,528,0.48936170212765956,0.5106382978723404
E01021348,1584,798,786,0.5037878787878788,0.4962121212121212
E01021394,1441,716,725,0.49687716863289383,0.5031228313671062
E01021395,1489,719,770,0.4828744123572868,0.5171255876427132
E01021396,1370,669,701,0.48832116788321167,0.5116788321167883
E01021424,2252,1086,1166,0.4822380106571936,0.5177619893428064
E01021441,1481,717,764,0.4841323430114787,0.5158676569885212
E01021442,1274,632,642,0.49607535321821034,0.5039246467817896
E01021443,1577,731,846,0.4635383639822448,0.5364616360177552
E01021444,1708,826,882,0.48360655737704916,0.5163934426229508
E01021469,1167,560,607,0.47986289631533846,0.5201371036846615
E01021470,1053,513,540,0.48717948717948717,0.5128205128205128
E01021471,1606,789,817,0.4912826899128269,0.5087173100871731
E01021457,1523,752,771,0.4937623112278398,0.5062376887721602
E01021458,1717,817,900,0.47582993593476997,0.52417006406523
E01021459,1285,623,662,0.4848249027237354,0.5151750972762645
E01021460,1839,870,969,0.4730831973898858,0.5269168026101142
E01021448,1548,751,797,0.4851421188630491,0.5148578811369509
E01021449,1671,810,861,0.48473967684021546,0.5152603231597845
E01021450,1983,965,1018,0.48663640948058495,0.513363590519415
E01021451,1546,728,818,0.47089262613195343,0.5291073738680466
E01021452,1483,712,771,0.4801078894133513,0.5198921105866486
E01021431,1650,797,853,0.48303030303030303,0.516969696969697
E01021432,1864,888,976,0.47639484978540775,0.5236051502145923
E01021434,1649,808,841,0.4899939357186173,0.5100060642813826
E01021461,1491,716,775,0.4802146210596915,0.5197853789403085
E01021464,1583,769,814,0.4857864813644978,0.5142135186355022
E01021447,2512,1207,1305,0.4804936305732484,0.5195063694267515
E01021453,1263,638,625,0.5051464766429137,0.4948535233570863
E01021455,1383,705,678,0.5097613882863341,0.49023861171366595
E01021465,1933,934,999,0.4831867563372995,0.5168132436627004
E01021466,1745,849,896,0.4865329512893983,0.5134670487106017
E01021467,1779,900,879,0.5059021922428331,0.49409780775716694
E01021438,2234,1097,1137,0.491047448522829,0.508952551477171
E01021462,1411,668,743,0.47342310418143163,0.5265768958185684
E01021463,1607,777,830,0.4835096453018046,0.5164903546981954
E01021468,2010,985,1025,0.4900497512437811,0.5099502487562189
E01021433,2183,1029,1154,0.47136967475950525,0.5286303252404947
E01021475,1556,794,762,0.5102827763496144,0.4897172236503856
E01033063,1448,692,756,0.47790055248618785,0.5220994475138122
E01033064,1379,674,705,0.4887599709934735,0.5112400290065264
E01034358,1182,626,556,0.5296108291032149,0.4703891708967851
E01034359,1415,690,725,0.4876325088339223,0.5123674911660777
E01034360,1438,682,756,0.47426981919332406,0.5257301808066759
E01034361,1164,569,595,0.4888316151202749,0.511168384879725
E01021435,1878,902,976,0.4802981895633653,0.5197018104366348
E01021437,1781,850,931,0.4772599663110612,0.5227400336889388
E01021472,1799,863,936,0.47971095052807117,0.5202890494719289
E01021473,1530,755,775,0.4934640522875817,0.5065359477124183
E01021474,1528,736,792,0.4816753926701571,0.518324607329843
E01021445,2160,1084,1076,0.5018518518518519,0.4981481481481482
E01021446,1649,840,809,0.509399636143117,0.49060036385688294
E01021454,1161,533,628,0.4590869939707149,0.540913006029285
E01021456,1213,598,615,0.49299258037922505,0.5070074196207749
E01021513,1608,782,826,0.486318407960199,0.513681592039801
E01021514,1537,708,829,0.46063760572543916,0.5393623942745608
E01021515,1334,650,684,0.487256371814093,0.512743628185907
E01021525,1665,826,839,0.4960960960960961,0.5039039039039039
E01021527,1679,806,873,0.4800476474091721,0.5199523525908278
E01021509,1409,691,718,0.49041873669268987,0.5095812633073101
E01021510,1471,668,803,0.4541128484024473,0.5458871515975526
E01021511,1995,957,1038,0.47969924812030074,0.5203007518796993
E01021528,1577,756,821,0.47939124920735576,0.5206087507926442
E01021531,1501,731,770,0.4870086608927382,0.5129913391072618
E01021476,1993,986,1007,0.49473156046161565,0.5052684395383843
E01021477,1511,739,772,0.48908007941760423,0.5109199205823958
E01021478,1790,883,907,0.49329608938547487,0.5067039106145251
E01021516,1332,653,679,0.49024024024024027,0.5097597597597597
E01021479,1538,753,785,0.4895968790637191,0.5104031209362809
E01021481,1642,823,819,0.5012180267965896,0.4987819732034105
E01021483,1799,884,915,0.4913841022790439,0.5086158977209561
E01021512,1522,721,801,0.47371879106438897,0.526281208935611
E01021526,1578,756,822,0.4790874524714829,0.5209125475285171
E01021517,1664,771,893,0.46334134615384615,0.5366586538461539
E01021519,1534,749,785,0.48826597131681876,0.5117340286831812
E01021530,1463,697,766,0.4764183185235817,0.5235816814764184
E01021532,1385,674,711,0.4866425992779783,0.5133574007220216
E01021482,1527,746,781,0.4885396201702685,0.5114603798297315
E01021518,2131,999,1132,0.4687939934303144,0.5312060065696856
E01021520,1533,741,792,0.48336594911937375,0.5166340508806262
E01021529,1497,736,761,0.4916499665998664,0.5083500334001336
E01021480,1749,880,869,0.5031446540880503,0.4968553459119497
E01021521,1395,695,700,0.4982078853046595,0.5017921146953405
E01021522,1872,903,969,0.4823717948717949,0.5176282051282052
E01021523,1404,682,722,0.48575498575498577,0.5142450142450142
E01021524,1627,769,858,0.47264904732636753,0.5273509526736324
E01021487,1325,665,660,0.5018867924528302,0.4981132075471698
E01021494,1427,698,729,0.48913805185704273,0.5108619481429573
E01021504,1501,728,773,0.48500999333777484,0.5149900066622252
E01021505,1430,705,725,0.493006993006993,0.506993006993007
E01021506,1292,636,656,0.49226006191950467,0.5077399380804953
E01021492,1647,804,843,0.48816029143898,0.51183970856102
E01021493,1514,743,771,0.4907529722589168,0.5092470277410832
E01021495,2030,904,1126,0.44532019704433495,0.554679802955665
E01021496,1456,724,732,0.49725274725274726,0.5027472527472527
E01021485,1228,605,623,0.49267100977198697,0.507328990228013
E01021486,1328,611,717,0.46009036144578314,0.5399096385542169
E01021488,1501,691,810,0.4603597601598934,0.5396402398401066
E01021503,1462,708,754,0.4842681258549932,0.5157318741450069
E01021507,1496,712,784,0.47593582887700536,0.5240641711229946
E01021508,1327,666,661,0.5018839487565938,0.4981160512434062
E01021484,1351,616,735,0.45595854922279794,0.5440414507772021
E01021498,1647,824,823,0.5003035822707954,0.4996964177292046
E01021499,1583,773,810,0.4883133291219204,0.5116866708780796
E01021501,1385,667,718,0.4815884476534296,0.5184115523465704
E01021502,2034,974,1060,0.47885939036381514,0.5211406096361848
E01021489,1391,683,708,0.4910136592379583,0.5089863407620417
E01021490,1414,683,731,0.48302687411598305,0.516973125884017
E01021491,1662,817,845,0.4915764139590854,0.5084235860409145
E01021497,1513,729,784,0.48182419035029744,0.5181758096497026
E01021500,2385,1184,1201,0.4964360587002096,0.5035639412997903
E01021538,2968,1441,1527,0.4855121293800539,0.514487870619946
E01021539,1373,684,689,0.4981791697013838,0.5018208302986161
E01021540,2193,1081,1112,0.49293205654354766,0.5070679434564523
E01034081,1642,765,877,0.4658952496954933,0.5341047503045067
E01034082,1685,808,877,0.4795252225519288,0.5204747774480712
E01021542,2404,1155,1249,0.48044925124792015,0.5195507487520798
E01021543,1741,837,904,0.4807581849511775,0.5192418150488225
E01021587,1465,712,753,0.48600682593856653,0.5139931740614334
E01021590,1404,683,721,0.48646723646723644,0.5135327635327636
E01021591,1617,795,822,0.49165120593692024,0.5083487940630798
E01021550,1785,894,891,0.5008403361344538,0.4991596638655462
E01021597,1562,740,822,0.4737516005121639,0.5262483994878361
E01021598,1613,757,856,0.46931184128952264,0.5306881587104774
E01021600,1142,563,579,0.4929947460595447,0.5070052539404554
E01021601,1524,734,790,0.4816272965879265,0.5183727034120735
E01021617,1316,624,692,0.47416413373860183,0.5258358662613982
E01021619,1428,714,714,0.5,0.5
E01021620,1465,733,732,0.5003412969283276,0.49965870307167237
E01021623,1240,606,634,0.48870967741935484,0.5112903225806451
E01021624,1226,592,634,0.4828711256117455,0.5171288743882545
E01034083,1519,710,809,0.467412771560237,0.532587228439763
E01034084,1804,887,917,0.4916851441241685,0.5083148558758315
E01021536,1591,782,809,0.491514770584538,0.5084852294154619
E01021537,2381,1173,1208,0.49265014699706006,0.5073498530029399
E01021568,1600,787,813,0.491875,0.508125
E01033142,2146,1049,1097,0.48881640260950604,0.5111835973904939
E01033144,1779,872,907,0.4901630129286116,0.5098369870713885
E01021576,1710,806,904,0.47134502923976607,0.5286549707602339
E01021588,1376,664,712,0.48255813953488375,0.5174418604651163
E01021589,1577,775,802,0.4914394419784401,0.50856055802156
E01021592,1633,760,873,0.46540110226576853,0.5345988977342315
E01021596,1611,778,833,0.4829298572315332,0.5170701427684667
E01021618,1428,707,721,0.4950980392156863,0.5049019607843137
E01021621,1579,813,766,0.5148828372387587,0.4851171627612413
E01021622,1523,758,765,0.49770190413657256,0.5022980958634274
E01021625,1448,705,743,0.48687845303867405,0.513121546961326
E01021626,1496,741,755,0.49532085561497324,0.5046791443850267
E01021544,1263,634,629,0.5019794140934284,0.49802058590657167
E01021545,1565,764,801,0.4881789137380192,0.5118210862619809
E01021546,1405,692,713,0.4925266903914591,0.507473309608541
E01021547,1462,730,732,0.4993160054719562,0.5006839945280438
E01021628,1838,901,937,0.49020674646354734,0.5097932535364527
E01021629,1816,895,921,0.49284140969163,0.5071585903083701
E01021573,1778,909,869,0.5112485939257593,0.4887514060742407
E01021575,1701,844,857,0.49617871840094063,0.5038212815990594
E01021599,1837,924,913,0.5029940119760479,0.49700598802395207
E01021631,1920,880,1040,0.4583333333333333,0.5416666666666666
E01033138,1474,737,737,0.5,0.5
E01033139,1640,829,811,0.5054878048780488,0.4945121951219512
E01021551,1415,692,723,0.4890459363957597,0.5109540636042402
E01021632,1566,775,791,0.4948914431673052,0.5051085568326947
E01021633,1338,579,759,0.4327354260089686,0.5672645739910314
E01021634,1465,702,763,0.47918088737201364,0.5208191126279863
E01021635,1387,637,750,0.45926459985580387,0.5407354001441961
E01021636,1138,538,600,0.4727592267135325,0.5272407732864675
E01021556,2150,1079,1071,0.501860465116279,0.4981395348837209
E01021577,1547,759,788,0.4906270200387847,0.5093729799612152
E01021579,1801,872,929,0.4841754580788451,0.5158245419211549
E01021580,1469,749,720,0.5098706603131382,0.4901293396868618
E01021584,1257,641,616,0.5099443118536198,0.4900556881463803
E01021548,1228,623,605,0.507328990228013,0.49267100977198697
E01021560,1696,811,885,0.47818396226415094,0.5218160377358491
E01021561,1839,866,973,0.47090810222947255,0.5290918977705275
E01021564,1527,764,763,0.5003274394237066,0.4996725605762934
E01021571,1535,755,780,0.49185667752442996,0.50814332247557
E01021562,1719,847,872,0.4927283304246655,0.5072716695753345
E01021563,1731,866,865,0.5002888503755055,0.49971114962449453
E01021565,1650,775,875,0.4696969696969697,0.5303030303030303
E01021566,1652,806,846,0.48789346246973364,0.5121065375302664
E01033137,1601,795,806,0.49656464709556525,0.5034353529044348
E01033145,1538,737,801,0.47919375812743825,0.5208062418725617
E01021557,1263,643,620,0.5091053048297703,0.4908946951702296
E01021558,1177,584,593,0.49617672047578587,0.5038232795242141
E01021583,1593,792,801,0.4971751412429379,0.5028248587570622
E01021585,1263,610,653,0.4829770387965162,0.5170229612034838
E01021586,1541,763,778,0.49513303049967555,0.5048669695003245
E01021533,2278,1124,1154,0.4934152765583846,0.5065847234416154
E01021535,1770,842,928,0.47570621468926555,0.5242937853107345
E01021569,1741,859,882,0.49339460080413555,0.5066053991958644
E01021570,1939,930,1009,0.47962867457452296,0.520371325425477
E01021572,1517,720,797,0.47462096242584045,0.5253790375741595
E01021552,1540,725,815,0.4707792207792208,0.5292207792207793
E01021553,1346,654,692,0.48588410104011887,0.5141158989598811
E01021554,1407,675,732,0.47974413646055436,0.5202558635394456
E01021555,1368,670,698,0.489766081871345,0.5102339181286549
E01021559,1389,696,693,0.5010799136069114,0.49892008639308855
E01021602,1724,856,868,0.4965197215777262,0.5034802784222738
E01021604,2333,1159,1174,0.4967852550364338,0.5032147449635662
E01034085,1495,772,723,0.5163879598662208,0.4836120401337793
E01034086,1679,858,821,0.5110184633710542,0.4889815366289458
E01021611,1406,709,697,0.5042674253200569,0.4957325746799431
E01021612,1457,699,758,0.47975291695264244,0.5202470830473576
E01021613,1866,932,934,0.4994640943193998,0.5005359056806002
E01021614,1767,873,894,0.4940577249575552,0.5059422750424448
E01021615,1521,739,782,0.48586456278763973,0.5141354372123603
E01021605,1177,595,582,0.5055225148683092,0.49447748513169076
E01021606,1620,789,831,0.48703703703703705,0.512962962962963
E01021607,1469,695,774,0.47311095983662355,0.5268890401633765
E01021608,1129,540,589,0.4782993799822852,0.5217006200177148
E01021609,1352,681,671,0.503698224852071,0.496301775147929
E01021610,1262,605,657,0.47939778129952454,0.5206022187004754
E01021593,1627,805,822,0.4947756607252612,0.5052243392747388
E01021595,1837,916,921,0.4986390854654328,0.5013609145345672
E01034087,1393,654,739,0.4694903086862886,0.5305096913137114
E01034088,1651,832,819,0.5039370078740157,0.49606299212598426
E01021627,1590,996,594,0.6264150943396226,0.37358490566037733
E01033140,2052,1008,1044,0.49122807017543857,0.5087719298245614
E01034089,2304,1099,1205,0.4769965277777778,0.5230034722222222
E01034090,1310,661,649,0.5045801526717557,0.4954198473282443
E01021578,1824,902,922,0.49451754385964913,0.5054824561403509
E01021582,2091,1041,1050,0.49784791965566716,0.5021520803443329
E01034091,1269,633,636,0.4988179669030733,0.5011820330969267
E01034092,1243,604,639,0.48592115848753015,0.5140788415124699
E01021655,1367,670,697,0.49012435991221653,0.5098756400877835
E01021656,1657,779,878,0.47012673506336755,0.5298732649366324
E01021659,2104,1048,1056,0.49809885931558934,0.5019011406844106
E01021661,2020,998,1022,0.49405940594059405,0.505940594059406
E01021668,1546,814,732,0.5265200517464425,0.47347994825355755
E01021669,1431,702,729,0.49056603773584906,0.5094339622641509
E01021670,1445,680,765,0.47058823529411764,0.5294117647058824
E01021671,1448,678,770,0.468232044198895,0.5317679558011049
E01033720,2074,997,1077,0.48071359691417553,0.5192864030858245
E01033721,1747,858,889,0.4911276473955352,0.5088723526044648
E01021660,1488,715,773,0.48051075268817206,0.519489247311828
E01021728,1664,822,842,0.49399038461538464,0.5060096153846154
E01021729,1646,814,832,0.4945321992709599,0.5054678007290401
E01021730,1768,876,892,0.49547511312217196,0.504524886877828
E01021646,2122,1014,1108,0.47785108388312914,0.5221489161168709
E01021647,2318,1114,1204,0.48058671268334774,0.5194132873166523
E01021648,2373,1171,1202,0.49346818373367046,0.5065318162663296
E01021650,2190,1057,1133,0.482648401826484,0.517351598173516
E01035157,1194,615,579,0.5150753768844221,0.4849246231155779
E01035158,1117,589,528,0.5273052820053715,0.4726947179946285
E01021696,1552,737,815,0.47487113402061853,0.5251288659793815
E01021697,1724,830,894,0.4814385150812065,0.5185614849187935
E01021698,1550,756,794,0.48774193548387096,0.512258064516129
E01021699,1463,722,741,0.4935064935064935,0.5064935064935064
E01021700,1389,652,737,0.46940244780417567,0.5305975521958244
E01033719,2042,1021,1021,0.5,0.5
E01033722,1629,841,788,0.516267648864334,0.48373235113566604
E01021673,1442,679,763,0.470873786407767,0.529126213592233
E01021674,1409,661,748,0.4691270404542229,0.5308729595457772
E01021675,1345,657,688,0.4884758364312268,0.5115241635687733
E01021676,1629,754,875,0.46286065070595456,0.5371393492940454
E01021662,1545,774,771,0.5009708737864078,0.49902912621359224
E01021663,1135,558,577,0.49162995594713654,0.5083700440528635
E01021677,1215,613,602,0.5045267489711934,0.49547325102880657
E01021678,1402,717,685,0.5114122681883024,0.48858773181169757
E01035159,2686,1288,1398,0.47952345495160087,0.5204765450483991
E01035160,1726,860,866,0.4982618771726535,0.5017381228273464
E01021683,2164,1086,1078,0.5018484288354899,0.49815157116451014
E01021684,1517,738,779,0.4864864864864865,0.5135135135135135
E01021687,1842,913,929,0.495656894679696,0.504343105320304
E01021688,1779,867,912,0.4873524451939292,0.5126475548060708
E01035161,1576,753,823,0.47779187817258884,0.5222081218274112
E01035162,1309,660,649,0.5042016806722689,0.4957983193277311
E01035163,1487,745,742,0.5010087424344317,0.4989912575655683
E01035164,1708,781,927,0.4572599531615925,0.5427400468384075
E01021718,1868,924,944,0.49464668094218417,0.5053533190578159
E01021719,1597,777,820,0.4865372573575454,0.5134627426424546
E01021720,1612,743,869,0.4609181141439206,0.5390818858560794
E01021721,1978,944,1034,0.47724974721941354,0.5227502527805864
E01021722,2557,1244,1313,0.4865076261243645,0.5134923738756355
E01021651,2443,1244,1199,0.5092099877200164,0.49079001227998365
E01021652,1570,788,782,0.5019108280254777,0.4980891719745223
E01021653,1330,650,680,0.48872180451127817,0.5112781954887218
E01021717,2738,1368,1370,0.4996347699050402,0.5003652300949598
E01021689,1505,710,795,0.4717607973421927,0.5282392026578073
E01021690,1304,648,656,0.49693251533742333,0.5030674846625767
E01021691,1560,745,815,0.4775641025641026,0.5224358974358975
E01021692,1423,663,760,0.46591707659873505,0.534082923401265
E01021693,1706,811,895,0.4753810082063306,0.5246189917936694
E01021711,1414,681,733,0.4816124469589816,0.5183875530410184
E01021713,1291,638,653,0.4941905499612703,0.5058094500387297
E01021714,1884,914,970,0.4851380042462845,0.5148619957537155
E01021715,1506,707,799,0.46945551128818064,0.5305444887118194
E01035165,2396,1308,1088,0.5459098497495827,0.4540901502504174
E01035166,1207,558,649,0.4623032311516156,0.5376967688483845
E01021657,2138,1023,1115,0.4784845650140318,0.5215154349859682
E01021658,1088,526,562,0.4834558823529412,0.5165441176470589
E01021664,1967,958,1009,0.4870360955770208,0.5129639044229791
E01021665,1417,664,753,0.46859562455892734,0.5314043754410727
E01021666,1295,647,648,0.4996138996138996,0.5003861003861004
E01021667,1540,729,811,0.4733766233766234,0.5266233766233767
E01021736,2402,1202,1200,0.5004163197335554,0.4995836802664446
E01021737,1152,561,591,0.4869791666666667,0.5130208333333334
E01021738,2185,1025,1160,0.4691075514874142,0.5308924485125858
E01021739,1527,745,782,0.48788474132285525,0.5121152586771447
E01021740,1719,843,876,0.49040139616055844,0.5095986038394416
E01021637,1202,585,617,0.48668885191347755,0.5133111480865225
E01021638,2025,1001,1024,0.494320987654321,0.505679012345679
E01021639,2339,1167,1172,0.4989311671654553,0.5010688328345447
E01021640,1216,576,640,0.47368421052631576,0.5263157894736842
E01021641,1529,736,793,0.4813603662524526,0.5186396337475474
E01021642,2194,1051,1143,0.4790337283500456,0.5209662716499545
E01021643,2454,1210,1244,0.4930725346373268,0.5069274653626732
E01021644,1737,886,851,0.5100748416810593,0.4899251583189407
E01021645,1468,709,759,0.4829700272479564,0.5170299727520435
E01021694,1471,748,723,0.5084976206662135,0.49150237933378654
E01021695,1170,572,598,0.4888888888888889,0.5111111111111111
E01021723,1884,919,965,0.487791932059448,0.5122080679405521
E01021724,1671,790,881,0.47277079593058047,0.5272292040694195
E01021725,1483,719,764,0.48482805124747136,0.5151719487525287
E01021726,1518,748,770,0.4927536231884058,0.5072463768115942
E01021727,1532,732,800,0.47780678851174935,0.5221932114882507
E01021731,1413,656,757,0.46426043878273177,0.5357395612172682
E01021732,1517,739,778,0.4871456822676335,0.5128543177323666
E01021733,1564,772,792,0.4936061381074169,0.5063938618925832
E01021734,1367,644,723,0.47110460863204096,0.528895391367959
E01021735,1361,643,718,0.4724467303453343,0.5275532696546656
E01021702,1340,671,669,0.5007462686567165,0.4992537313432836
E01021703,1345,646,699,0.48029739776951674,0.5197026022304833
E01021704,1492,774,718,0.5187667560321716,0.4812332439678284
E01021705,1958,1000,958,0.5107252298263534,0.48927477017364657
E01021706,1364,669,695,0.4904692082111437,0.5095307917888563
E01021707,1368,649,719,0.47441520467836257,0.5255847953216374
E01021708,1441,719,722,0.4989590562109646,0.5010409437890354
E01021709,1492,698,794,0.467828418230563,0.532171581769437
E01021710,2315,1135,1180,0.490280777537797,0.509719222462203
E01035167,1114,565,549,0.507181328545781,0.49281867145421904
E01035168,1671,831,840,0.49730700179533216,0.5026929982046678
E01035169,1395,718,677,0.5146953405017921,0.4853046594982079
E01035170,1487,756,731,0.5084061869535978,0.49159381304640215
E01035171,1116,576,540,0.5161290322580645,0.4838709677419355
E01035172,1883,924,959,0.49070631970260226,0.5092936802973977
E01035173,1272,599,673,0.47091194968553457,0.5290880503144654
E01035174,1476,707,769,0.47899728997289975,0.5210027100271003
E01035175,1723,836,887,0.4852002321532211,0.5147997678467788
E01035176,1706,858,848,0.5029308323563892,0.4970691676436108
E01035177,1349,675,674,0.5003706449221645,0.49962935507783546
E01021768,2350,1184,1166,0.5038297872340426,0.49617021276595746
E01021795,2173,1103,1070,0.5075931891394385,0.49240681086056143
E01021797,1353,690,663,0.5099778270509978,0.49002217294900224
E01021798,1545,734,811,0.47508090614886733,0.5249190938511327
E01021799,1857,867,990,0.4668820678513732,0.5331179321486268
E01021741,2293,1142,1151,0.49803750545137376,0.5019624945486263
E01021792,1390,685,705,0.49280575539568344,0.5071942446043165
E01021793,1658,821,837,0.4951749095295537,0.5048250904704463
E01021794,1226,605,621,0.4934747145187602,0.5065252854812398
E01021801,2250,1150,1100,0.5111111111111111,0.4888888888888889
E01021769,2464,1223,1241,0.4963474025974026,0.5036525974025974
E01021796,2390,1153,1237,0.4824267782426778,0.5175732217573221
E01021800,2519,1272,1247,0.5049622866216753,0.49503771337832475
E01021753,1642,783,859,0.476857490864799,0.523142509135201
E01021754,1533,748,785,0.48793215916503585,0.5120678408349641
E01021755,1204,568,636,0.4717607973421927,0.5282392026578073
E01021802,2762,1316,1446,0.47646632874728456,0.5235336712527154
E01021760,1530,746,784,0.4875816993464052,0.5124183006535947
E01021761,2088,986,1102,0.4722222222222222,0.5277777777777778
E01021762,1500,703,797,0.4686666666666667,0.5313333333333333
E01021763,2042,991,1051,0.4853085210577865,0.5146914789422136
E01021756,1582,778,804,0.4917825537294564,0.5082174462705437
E01021757,1716,846,870,0.493006993006993,0.506993006993007
E01021758,1529,711,818,0.4650098103335513,0.5349901896664486
E01021759,1589,757,832,0.4764002517306482,0.5235997482693517
E01021811,1394,656,738,0.47058823529411764,0.5294117647058824
E01021813,1407,688,719,0.48898365316275766,0.5110163468372424
E01021814,1842,897,945,0.48697068403908794,0.5130293159609121
E01021815,1609,784,825,0.4872591671845867,0.5127408328154133
E01021816,1464,717,747,0.48975409836065575,0.5102459016393442
E01021807,1549,781,768,0.5041962556488057,0.49580374435119434
E01021808,1581,775,806,0.49019607843137253,0.5098039215686274
E01021809,1419,678,741,0.47780126849894294,0.5221987315010571
E01021810,1834,889,945,0.4847328244274809,0.5152671755725191
E01021817,2690,1336,1354,0.4966542750929368,0.5033457249070632
E01021806,2774,1362,1412,0.49098774333093004,0.5090122566690699
E01021812,1255,613,642,0.48844621513944225,0.5115537848605578
E01021818,2042,990,1052,0.48481880509304603,0.515181194906954
E01021770,2051,1012,1039,0.49341784495368113,0.5065821550463189
E01021803,1324,659,665,0.49773413897280966,0.5022658610271903
E01021804,1482,715,767,0.4824561403508772,0.5175438596491229
E01021805,1379,678,701,0.4916606236403191,0.508339376359681
E01021774,1529,742,787,0.48528449967298887,0.5147155003270111
E01021775,1637,765,872,0.46731826511912034,0.5326817348808797
E01021776,1758,807,951,0.4590443686006826,0.5409556313993175
E01021777,1463,703,760,0.4805194805194805,0.5194805194805194
E01021778,1539,770,769,0.5003248862897985,0.4996751137102014
E01021779,1603,773,830,0.4822208359326263,0.5177791640673737
E01021786,1281,624,657,0.48711943793911006,0.5128805620608899
E01021787,1598,805,793,0.5037546933667084,0.49624530663329164
E01021788,1616,785,831,0.48576732673267325,0.5142326732673267
E01021789,1601,774,827,0.4834478450968145,0.5165521549031855
E01021790,2082,955,1127,0.4586935638808838,0.5413064361191162
E01021791,1688,822,866,0.48696682464454977,0.5130331753554502
E01021771,1745,836,909,0.47908309455587395,0.520916905444126
E01021772,1505,751,754,0.49900332225913624,0.5009966777408638
E01021773,1558,771,787,0.49486521181001286,0.5051347881899871
E01021783,1581,763,818,0.48260594560404807,0.5173940543959519
E01021784,1534,732,802,0.4771838331160365,0.5228161668839635
E01021780,1388,679,709,0.489193083573487,0.510806916426513
E01021781,1540,745,795,0.4837662337662338,0.5162337662337663
E01021782,1410,666,744,0.4723404255319149,0.5276595744680851
E01021785,1696,826,870,0.48702830188679247,0.5129716981132075
E01021742,1332,639,693,0.4797297297297297,0.5202702702702703
E01021743,1711,794,917,0.4640561075394506,0.5359438924605494
E01021744,1687,834,853,0.4943687018375815,0.5056312981624185
E01021745,1675,788,887,0.47044776119402987,0.5295522388059701
E01021746,1918,916,1002,0.47758081334723673,0.5224191866527633
E01021747,1665,823,842,0.4942942942942943,0.5057057057057057
E01021748,1762,866,896,0.49148694665153236,0.5085130533484676
E01021749,2352,1150,1202,0.48894557823129253,0.5110544217687075
E01021750,1708,862,846,0.5046838407494145,0.4953161592505855
E01021751,1412,703,709,0.4978753541076487,0.5021246458923513
E01021752,1528,728,800,0.47643979057591623,0.5235602094240838
E01021764,1893,866,1027,0.4574749075541469,0.5425250924458531
E01021765,2043,966,1077,0.47283406754772395,0.527165932452276
E01021766,1688,823,865,0.48755924170616116,0.5124407582938388
E01021767,1978,946,1032,0.4782608695652174,0.5217391304347826
E01021854,2215,1081,1134,0.48803611738148983,0.5119638826185101
E01021855,1550,744,806,0.48,0.52
E01021856,1508,707,801,0.46883289124668437,0.5311671087533156
E01034362,1511,745,766,0.4930509596293845,0.5069490403706155
E01034363,1267,633,634,0.4996053670086819,0.500394632991318
E01034364,1696,825,871,0.486438679245283,0.5135613207547169
E01034365,1436,743,693,0.5174094707520891,0.48259052924791085
E01021844,1407,678,729,0.48187633262260127,0.5181236673773987
E01021845,1645,754,891,0.4583586626139818,0.5416413373860183
E01021846,1484,755,729,0.5087601078167115,0.4912398921832884
E01021847,1477,690,787,0.46716316858496953,0.5328368314150305
E01021848,1957,984,973,0.5028104241185488,0.4971895758814512
E01021849,1690,829,861,0.4905325443786982,0.5094674556213018
E01021850,1472,715,757,0.4857336956521739,0.514266304347826
E01021851,1792,905,887,0.5050223214285714,0.49497767857142855
E01021852,1658,789,869,0.4758745476477684,0.5241254523522316
E01021853,1802,892,910,0.49500554938956715,0.5049944506104328
E01021839,2020,973,1047,0.48168316831683167,0.5183168316831683
E01021840,1876,876,1000,0.4669509594882729,0.5330490405117271
E01021841,1555,756,799,0.48617363344051445,0.5138263665594855
E01021842,1709,807,902,0.4722059684025746,0.5277940315974254
E01021843,2901,1406,1495,0.4846604619096863,0.5153395380903136
E01021824,1763,883,880,0.500850822461713,0.499149177538287
E01021825,1623,787,836,0.4849044978434997,0.5150955021565004
E01021826,1525,760,765,0.49836065573770494,0.5016393442622951
E01021827,1690,802,888,0.47455621301775147,0.5254437869822485
E01021828,2342,1146,1196,0.4893253629376601,0.5106746370623398
E01021819,1673,842,831,0.5032875074716079,0.4967124925283921
E01021820,1553,745,808,0.47971667739858337,0.5202833226014166
E01021822,1678,798,880,0.4755661501787843,0.5244338498212158
E01021823,1870,920,950,0.4919786096256685,0.5080213903743316
E01021870,1384,664,720,0.4797687861271676,0.5202312138728323
E01021831,1401,689,712,0.4917915774446824,0.5082084225553176
E01021868,1650,786,864,0.4763636363636364,0.5236363636363637
E01021869,1399,691,708,0.49392423159399573,0.5060757684060043
E01021871,1511,706,805,0.4672402382528127,0.5327597617471873
E01034366,1155,602,553,0.5212121212121212,0.47878787878787876
E01034367,1710,849,861,0.4964912280701754,0.5035087719298246
E01021821,1432,699,733,0.48812849162011174,0.5118715083798883
E01021834,1597,738,859,0.46211646837820913,0.5378835316217908
E01021835,1503,748,755,0.4976713240186294,0.5023286759813705
E01021836,1544,743,801,0.48121761658031087,0.5187823834196891
E01021837,1529,727,802,0.4754741661216481,0.5245258338783518
E01021829,1491,714,777,0.4788732394366197,0.5211267605633803
E01021830,1259,642,617,0.5099285146942018,0.49007148530579825
E01021832,1235,615,620,0.4979757085020243,0.5020242914979757
E01021833,1210,579,631,0.47851239669421486,0.5214876033057851
E01021865,1396,680,716,0.4871060171919771,0.5128939828080229
E01021838,1509,713,796,0.47249834327369117,0.5275016567263088
E01021858,1648,792,856,0.48058252427184467,0.5194174757281553
E01021859,1629,797,832,0.4892572130141191,0.5107427869858809
E01021860,1602,768,834,0.4794007490636704,0.5205992509363296
E01021861,1457,675,782,0.46328071379547014,0.5367192862045299
E01021862,1582,753,829,0.47597977243994943,0.5240202275600506
E01021863,1766,905,861,0.5124575311438279,0.48754246885617214
E01021864,1540,788,752,0.5116883116883116,0.4883116883116883
E01021866,1351,665,686,0.49222797927461137,0.5077720207253886
E01021867,1494,713,781,0.47724230254350736,0.5227576974564926
E01021908,2087,1049,1038,0.5026353617632966,0.4973646382367034
E01021909,1480,702,778,0.4743243243243243,0.5256756756756756
E01021910,1628,812,816,0.4987714987714988,0.5012285012285013
E01021911,1292,641,651,0.49613003095975233,0.5038699690402477
E01021882,2158,1052,1106,0.48748841519925856,0.5125115848007414
E01021883,1704,845,859,0.49589201877934275,0.5041079812206573
E01021912,2085,1008,1077,0.48345323741007196,0.516546762589928
E01021913,1605,800,805,0.4984423676012461,0.5015576323987538
E01021884,1395,697,698,0.4996415770609319,0.5003584229390681
E01021885,1115,545,570,0.48878923766816146,0.5112107623318386
E01021886,1588,795,793,0.5006297229219143,0.4993702770780856
E01021887,2343,1101,1242,0.469910371318822,0.5300896286811779
E01021888,2467,1147,1320,0.46493717065261453,0.5350628293473855
E01021889,2500,1197,1303,0.4788,0.5212
E01021890,1809,875,934,0.48369264787175237,0.5163073521282476
E01021891,1518,701,817,0.46179183135704877,0.5382081686429513
E01021892,1082,512,570,0.4731977818853974,0.5268022181146026
E01021893,1459,721,738,0.49417409184372857,0.5058259081562714
E01021894,1227,596,631,0.48573757131214346,0.5142624286878565
E01021895,1152,568,584,0.4930555555555556,0.5069444444444444
E01021896,1838,882,956,0.47986942328618065,0.5201305767138193
E01021897,1083,531,552,0.4903047091412742,0.5096952908587258
E01021898,1273,619,654,0.48625294579732914,0.5137470542026709
E01021901,1923,966,957,0.5023400936037441,0.49765990639625585
E01021904,2028,1027,1001,0.5064102564102564,0.4935897435897436
E01021905,1258,635,623,0.5047694753577107,0.49523052464228934
E01021906,1543,755,788,0.48930654569021387,0.5106934543097861
E01021907,2332,1146,1186,0.4914236706689537,0.5085763293310464
E01021873,1346,672,674,0.49925705794947994,0.5007429420505201
E01021874,1510,745,765,0.49337748344370863,0.5066225165562914
E01021875,1482,738,744,0.4979757085020243,0.5020242914979757
E01021899,1402,717,685,0.5114122681883024,0.48858773181169757
E01021900,1128,577,551,0.5115248226950354,0.48847517730496454
E01021902,1872,911,961,0.48664529914529914,0.5133547008547008
E01021903,1652,821,831,0.49697336561743344,0.5030266343825666
E01021878,1366,652,714,0.4773060029282577,0.5226939970717424
E01021879,1441,685,756,0.4753643303261624,0.5246356696738376
E01021880,1589,754,835,0.47451227186910006,0.5254877281309
E01021881,1138,543,595,0.4771528998242531,0.5228471001757469
E01034093,1713,841,872,0.4909515469935785,0.5090484530064214
E01034094,1604,811,793,0.5056109725685786,0.49438902743142144
E01021942,1653,804,849,0.4863883847549909,0.5136116152450091
E01021943,1667,804,863,0.4823035392921416,0.5176964607078585
E01021944,1673,844,829,0.5044829647340108,0.4955170352659892
E01021945,1599,746,853,0.466541588492808,0.533458411507192
E01021914,2008,1009,999,0.5024900398406374,0.49750996015936255
E01021927,1229,606,623,0.49308380797396256,0.5069161920260374
E01021928,1494,702,792,0.46987951807228917,0.5301204819277109
E01021929,1599,795,804,0.4971857410881801,0.5028142589118199
E01021931,1585,768,817,0.48454258675078865,0.5154574132492113
E01021915,1357,674,683,0.496683861459101,0.5033161385408991
E01021916,1214,598,616,0.4925864909390445,0.5074135090609555
E01021953,1339,627,712,0.4682598954443615,0.5317401045556386
E01021955,1744,846,898,0.48509174311926606,0.5149082568807339
E01021918,1484,731,753,0.4925876010781671,0.5074123989218329
E01021919,1342,653,689,0.48658718330849476,0.5134128166915052
E01021925,1667,808,859,0.48470305938812236,0.5152969406118776
E01021960,2042,1003,1039,0.4911851126346719,0.5088148873653281
E01021961,1593,748,845,0.46955430006277465,0.5304456999372253
E01021920,2193,1091,1102,0.49749202006383947,0.5025079799361605
E01021926,2087,1030,1057,0.49353138476281744,0.5064686152371826
E01021957,1711,803,908,0.46931618936294567,0.5306838106370544
E01021958,1229,597,632,0.48576078112286414,0.5142392188771359
E01021959,1642,792,850,0.4823386114494519,0.5176613885505481
E01021930,1317,677,640,0.5140470766894457,0.4859529233105543
E01021932,1537,742,795,0.4827586206896552,0.5172413793103449
E01021952,1474,689,785,0.46743554952510175,0.5325644504748982
E01021954,2841,1353,1488,0.47624076029567053,0.5237592397043295
E01021956,1482,720,762,0.48582995951417,0.5141700404858299
E01021950,1445,673,772,0.4657439446366782,0.5342560553633218
E01021951,1273,617,656,0.4846818538884525,0.5153181461115475
E01021962,1238,563,675,0.45476575121163165,0.5452342487883683
E01021963,1374,658,716,0.47889374090247455,0.5211062590975255
E01021964,1611,786,825,0.48789571694599626,0.5121042830540037
E01021966,1752,831,921,0.4743150684931507,0.5256849315068494
E01021946,1483,728,755,0.4908968307484828,0.5091031692515172
E01021947,1232,587,645,0.476461038961039,0.523538961038961
E01021948,1283,606,677,0.47233047544816836,0.5276695245518317
E01021949,1477,714,763,0.4834123222748815,0.5165876777251185
E01021965,2340,1115,1225,0.47649572649572647,0.5235042735042735
E01021917,1735,853,882,0.49164265129683,0.5083573487031701
E01021921,1461,706,755,0.48323066392881586,0.5167693360711841
E01021922,1572,764,808,0.4860050890585242,0.5139949109414759
E01021923,1325,664,661,0.5011320754716981,0.49886792452830186
E01021924,1837,878,959,0.4779531845400109,0.5220468154599891
E01021938,1520,708,812,0.46578947368421053,0.5342105263157895
E01021939,1677,806,871,0.4806201550387597,0.5193798449612403
E01021940,1994,982,1012,0.49247743229689067,0.5075225677031093
E01021941,2316,1126,1190,0.48618307426597585,0.5138169257340242
E01021933,2002,989,1013,0.494005994005994,0.505994005994006
E01021934,1364,671,693,0.49193548387096775,0.5080645161290323
E01021935,1311,645,666,0.4919908466819222,0.5080091533180778
E01021936,1662,798,864,0.48014440433212996,0.51985559566787
E01021937,1580,780,800,0.4936708860759494,0.5063291139240507
E01021997,1324,669,655,0.5052870090634441,0.4947129909365559
E01021998,1456,692,764,0.47527472527472525,0.5247252747252747
E01021999,1702,818,884,0.4806110458284371,0.5193889541715628
E01022001,1936,925,1011,0.4777892561983471,0.5222107438016529
E01022000,1644,795,849,0.4835766423357664,0.5164233576642335
E01022006,1796,833,963,0.46380846325167036,0.5361915367483296
E01022007,1870,929,941,0.49679144385026736,0.5032085561497326
E01033051,2553,1237,1316,0.4845280062671367,0.5154719937328633
E01021978,2427,1202,1225,0.49526163988463123,0.5047383601153688
E01022013,1908,929,979,0.4868972746331237,0.5131027253668763
E01022014,1506,726,780,0.4820717131474104,0.5179282868525896
E01022015,1373,648,725,0.471959213401311,0.528040786598689
E01022019,1701,815,886,0.479129923574368,0.520870076425632
E01022020,1682,793,889,0.4714625445897741,0.5285374554102259
E01022021,1489,714,775,0.4795164539959704,0.5204835460040296
E01021991,1051,511,540,0.4862036156041865,0.5137963843958135
E01021992,1189,603,586,0.5071488645920942,0.4928511354079058
E01022002,1949,967,982,0.4961518727552591,0.5038481272447409
E01022004,1737,801,936,0.46113989637305697,0.538860103626943
E01022005,1801,874,927,0.4852859522487507,0.5147140477512493
E01022028,1412,679,733,0.48087818696883855,0.5191218130311614
E01021971,1638,830,808,0.5067155067155067,0.4932844932844933
E01021972,1375,700,675,0.509090909090909,0.4909090909090909
E01022051,1541,780,761,0.5061648280337443,0.4938351719662557
E01022052,1554,752,802,0.4839124839124839,0.5160875160875161
E01021985,1351,596,755,0.4411547002220577,0.5588452997779423
E01021986,1465,694,771,0.4737201365187713,0.5262798634812287
E01022054,1569,728,841,0.4639898024219248,0.5360101975780752
E01022055,1512,688,824,0.455026455026455,0.544973544973545
E01022056,1730,846,884,0.4890173410404624,0.5109826589595375
E01021973,1272,611,661,0.4803459119496855,0.5196540880503144
E01021974,1342,657,685,0.48956780923994037,0.5104321907600596
E01022016,1816,898,918,0.4944933920704846,0.5055066079295154
E01022017,1706,838,868,0.4912075029308324,0.5087924970691676
E01022018,1777,879,898,0.4946539110861002,0.5053460889138999
E01021987,1301,593,708,0.4558032282859339,0.5441967717140661
E01021994,1157,543,614,0.4693171996542783,0.5306828003457217
E01021995,1348,634,714,0.47032640949554894,0.5296735905044511
E01021996,1309,609,700,0.46524064171123,0.5347593582887701
E01022009,1524,737,787,0.4835958005249344,0.5164041994750657
E01022010,1739,832,907,0.47843588269120185,0.5215641173087981
E01022011,1930,933,997,0.483419689119171,0.516580310880829
E01022012,1977,930,1047,0.47040971168437024,0.5295902883156297
E01021967,2462,1200,1262,0.487408610885459,0.512591389114541
E01021983,1478,749,729,0.506765899864682,0.493234100135318
E01021993,2517,1233,1284,0.4898688915375447,0.5101311084624554
E01022053,2051,1008,1043,0.49146757679180886,0.5085324232081911
E01021984,2177,1060,1117,0.4869085898024805,0.5130914101975195
E01022039,1505,710,795,0.4717607973421927,0.5282392026578073
E01022040,1778,826,952,0.4645669291338583,0.5354330708661418
E01022041,1512,698,814,0.46164021164021163,0.5383597883597884
E01021979,1504,727,777,0.4833776595744681,0.5166223404255319
E01021980,1684,827,857,0.4910926365795725,0.5089073634204275
E01021981,1957,922,1035,0.47112927950945327,0.5288707204905467
E01021982,2057,1035,1022,0.5031599416626155,0.49684005833738454
E01022046,1705,838,867,0.49149560117302055,0.5085043988269795
E01022008,2121,1009,1112,0.4757190004714757,0.5242809995285242
E01022033,1476,698,778,0.47289972899729,0.5271002710027101
E01022034,1540,721,819,0.4681818181818182,0.5318181818181819
E01022035,1448,693,755,0.47859116022099446,0.5214088397790055
E01021975,1540,711,829,0.4616883116883117,0.5383116883116883
E01021976,1546,744,802,0.48124191461837,0.51875808538163
E01021977,2798,1316,1482,0.47033595425303787,0.5296640457469621
E01022022,1517,765,752,0.5042847725774555,0.4957152274225445
E01022044,1637,793,844,0.4844227244960293,0.5155772755039707
E01022042,1549,743,806,0.47966429954809553,0.5203357004519045
E01022043,1890,937,953,0.49576719576719575,0.5042328042328043
E01022048,1495,705,790,0.47157190635451507,0.5284280936454849
E01022049,1501,708,793,0.47168554297135246,0.5283144570286475
E01022050,1811,830,981,0.4583103257868581,0.541689674213142
E01022023,1461,696,765,0.47638603696098564,0.5236139630390144
E01022024,1516,739,777,0.487467018469657,0.512532981530343
E01022030,1573,751,822,0.47743165924984104,0.5225683407501589
E01022031,1354,657,697,0.48522895125553916,0.5147710487444609
E01022032,1829,861,968,0.47074904319300165,0.5292509568069984
E01021970,1832,879,953,0.4798034934497817,0.5201965065502183
E01022025,1985,997,988,0.5022670025188917,0.49773299748110833
E01022026,1708,848,860,0.4964871194379391,0.5035128805620609
E01022027,1684,805,879,0.47802850356294535,0.5219714964370546
E01021968,1923,942,981,0.48985959438377535,0.5101404056162246
E01021969,1482,731,751,0.4932523616734143,0.5067476383265856
E01022036,1201,562,639,0.46794338051623646,0.5320566194837635
E01022037,1387,636,751,0.4585436193222783,0.5414563806777217
E01022038,1420,666,754,0.46901408450704224,0.5309859154929577
E01021988,1991,999,992,0.5017579105976896,0.4982420894023104
E01021989,1456,723,733,0.4965659340659341,0.5034340659340659
E01021990,1637,778,859,0.4752596212583995,0.5247403787416005
E01022045,1704,847,857,0.4970657276995305,0.5029342723004695
E01022047,1450,681,769,0.4696551724137931,0.5303448275862069
E01022057,1749,861,888,0.4922813036020583,0.5077186963979416
E01022075,1832,853,979,0.4656113537117904,0.5343886462882096
E01022077,2057,987,1070,0.4798249878463782,0.5201750121536218
E01022094,1988,960,1028,0.482897384305835,0.5171026156941649
E01022074,1486,702,784,0.47240915208613726,0.5275908479138627
E01022076,1647,792,855,0.4808743169398907,0.5191256830601093
E01022078,1507,732,775,0.48573324485733244,0.5142667551426675
E01022079,2165,1041,1124,0.4808314087759815,0.5191685912240185
E01022080,1463,729,734,0.49829118250170884,0.5017088174982912
E01022081,2590,1231,1359,0.4752895752895753,0.5247104247104247
E01022082,2269,1087,1182,0.47906566769501985,0.5209343323049802
E01022061,1575,780,795,0.49523809523809526,0.5047619047619047
E01022071,1696,858,838,0.5058962264150944,0.49410377358490565
E01022072,2073,1041,1032,0.5021707670043415,0.49782923299565845
E01022073,2059,984,1075,0.47790189412336087,0.5220981058766392
E01022098,1563,772,791,0.49392194497760716,0.5060780550223928
E01022092,1854,956,898,0.5156418554476807,0.4843581445523193
E01022093,2255,1085,1170,0.4811529933481153,0.5188470066518847
E01022097,1939,976,963,0.5033522434244456,0.49664775657555443
E01022099,2264,1147,1117,0.5066254416961131,0.49337455830388693
E01022062,2482,1213,1269,0.4887187751813054,0.5112812248186946
E01022063,2461,1204,1257,0.48923201950426654,0.5107679804957335
E01022083,1796,861,935,0.47939866369710465,0.5206013363028953
E01022084,2002,989,1013,0.494005994005994,0.505994005994006
E01022085,1725,851,874,0.49333333333333335,0.5066666666666667
E01022087,2758,1361,1397,0.49347353154459755,0.5065264684554025
E01022089,1612,801,811,0.4968982630272953,0.5031017369727047
E01022086,1767,921,846,0.5212224108658744,0.47877758913412566
E01022095,1730,853,877,0.4930635838150289,0.5069364161849711
E01035178,1914,946,968,0.4942528735632184,0.5057471264367817
E01035179,1371,678,693,0.49452954048140046,0.5054704595185996
E01035180,1212,604,608,0.49834983498349833,0.5016501650165016
E01035181,1341,648,693,0.48322147651006714,0.5167785234899329
E01035182,1285,617,668,0.4801556420233463,0.5198443579766537
E01022067,1922,909,1013,0.47294484911550466,0.5270551508844953
E01022068,1999,941,1058,0.47073536768384194,0.5292646323161581
E01033054,1232,605,627,0.49107142857142855,0.5089285714285714
E01033055,2288,1108,1180,0.48426573426573427,0.5157342657342657
E01033056,1585,774,811,0.48832807570977915,0.5116719242902208
E01022058,1646,821,825,0.49878493317132444,0.5012150668286756
E01022064,1921,951,970,0.4950546590317543,0.5049453409682457
E01022069,1598,747,851,0.467459324155194,0.532540675844806
E01022088,1726,869,857,0.503476245654693,0.49652375434530704
E01033052,1935,928,1007,0.47958656330749355,0.5204134366925065
E01033053,2210,1061,1149,0.4800904977375566,0.5199095022624435
E01022059,1623,794,829,0.48921749845964263,0.5107825015403573
E01022060,2074,1014,1060,0.4889103182256509,0.5110896817743491
E01022070,2002,973,1029,0.486013986013986,0.513986013986014
E01022096,2094,1033,1061,0.4933142311365807,0.5066857688634193
E01023316,1368,685,683,0.5007309941520468,0.4992690058479532
E01023317,2681,1285,1396,0.4792987691160015,0.5207012308839986
E01023318,1625,800,825,0.49230769230769234,0.5076923076923077
E01023319,1558,759,799,0.4871630295250321,0.5128369704749679
E01023327,1358,644,714,0.4742268041237113,0.5257731958762887
E01023328,1381,680,701,0.49239681390296886,0.5076031860970311
E01023329,1317,639,678,0.48519362186788156,0.5148063781321185
E01023330,1698,811,887,0.47762073027090696,0.5223792697290931
E01023331,1705,832,873,0.4879765395894428,0.5120234604105571
E01023320,2230,1076,1154,0.48251121076233183,0.5174887892376682
E01023321,1992,993,999,0.49849397590361444,0.5015060240963856
E01023322,1949,967,982,0.4961518727552591,0.5038481272447409
E01023323,1725,844,881,0.48927536231884056,0.5107246376811594
E01023289,1559,766,793,0.4913406029506094,0.5086593970493907
E01023290,1657,822,835,0.496077248038624,0.5039227519613759
E01023291,1608,778,830,0.48383084577114427,0.5161691542288557
E01023292,1576,761,815,0.48286802030456855,0.5171319796954315
E01023340,1815,857,958,0.4721763085399449,0.5278236914600551
E01023341,1806,874,932,0.4839424141749723,0.5160575858250277
E01023343,2173,1032,1141,0.47491946617579384,0.5250805338242062
E01023344,1644,803,841,0.4884428223844282,0.5115571776155717
E01035583,1355,623,732,0.45977859778597785,0.5402214022140222
E01035584,1557,719,838,0.4617854849068722,0.5382145150931278
E01023307,1514,735,779,0.4854689564068692,0.5145310435931307
E01023308,1684,839,845,0.4982185273159145,0.5017814726840855
E01023309,1654,820,834,0.4957678355501814,0.5042321644498187
E01023310,2866,1350,1516,0.471039776692254,0.528960223307746
E01023311,1860,905,955,0.48655913978494625,0.5134408602150538
E01023312,1582,798,784,0.504424778761062,0.49557522123893805
E01023313,1630,785,845,0.4815950920245399,0.5184049079754601
E01023315,1780,867,913,0.48707865168539327,0.5129213483146068
E01023302,1462,699,763,0.4781121751025992,0.5218878248974008
E01023303,1560,775,785,0.4967948717948718,0.5032051282051282
E01023304,1547,763,784,0.49321266968325794,0.5067873303167421
E01023305,1394,688,706,0.4935437589670014,0.5064562410329986
E01023306,1486,716,770,0.48183041722745623,0.5181695827725438
E01023314,1601,780,821,0.4871955028107433,0.5128044971892567
E01023324,1329,616,713,0.4635063957863055,0.5364936042136945
E01023325,1406,654,752,0.465149359886202,0.534850640113798
E01023326,1600,756,844,0.4725,0.5275
E01023297,1368,686,682,0.5014619883040936,0.49853801169590645
E01023298,1564,729,835,0.46611253196930946,0.5338874680306905
E01023299,1720,842,878,0.48953488372093024,0.5104651162790698
E01023300,1589,719,870,0.4524858401510384,0.5475141598489616
E01023301,1828,883,945,0.48304157549234134,0.5169584245076586
E01023293,1745,850,895,0.4871060171919771,0.5128939828080229
E01023294,1902,892,1010,0.46898002103049424,0.5310199789695058
E01023295,1391,659,732,0.47375988497483823,0.5262401150251618
E01023296,1953,924,1029,0.4731182795698925,0.5268817204301075
E01023332,2385,1123,1262,0.4708595387840671,0.529140461215933
E01023333,2129,1016,1113,0.4772193518083607,0.5227806481916393
E01023334,1760,852,908,0.48409090909090907,0.5159090909090909
E01023335,1802,881,921,0.48890122086570476,0.5110987791342952
E01023336,2143,1049,1094,0.48950069995333645,0.5104993000466636
E01023337,2006,1023,983,0.5099700897308076,0.4900299102691924
E01023339,1581,730,851,0.46173308032890575,0.5382669196710942
E01035585,1521,758,763,0.4983563445101907,0.5016436554898094
E01035586,1329,663,666,0.49887133182844245,0.5011286681715575
E01023430,1264,635,629,0.502373417721519,0.497626582278481
E01023431,1360,689,671,0.5066176470588235,0.4933823529411765
E01023432,1664,843,821,0.5066105769230769,0.4933894230769231
E01023433,1512,759,753,0.501984126984127,0.498015873015873
E01023423,1472,693,779,0.47078804347826086,0.5292119565217391
E01023424,1551,761,790,0.49065119277885233,0.5093488072211476
E01023425,1380,687,693,0.49782608695652175,0.5021739130434782
E01023426,1638,735,903,0.44871794871794873,0.5512820512820513
E01023418,1453,714,739,0.4913971094287681,0.508602890571232
E01023419,2046,962,1084,0.4701857282502444,0.5298142717497556
E01023420,1527,755,772,0.49443352979698757,0.5055664702030125
E01023352,2406,1173,1233,0.48753117206982544,0.5124688279301746
E01023421,1579,784,795,0.49651678277390754,0.5034832172260925
E01023422,1332,643,689,0.4827327327327327,0.5172672672672672
E01023434,1682,846,836,0.5029726516052319,0.49702734839476814
E01023435,1476,739,737,0.5006775067750677,0.4993224932249323
E01023436,1238,607,631,0.4903069466882068,0.5096930533117933
E01023437,1436,682,754,0.47493036211699163,0.5250696378830083
E01023355,1563,744,819,0.4760076775431862,0.5239923224568138
E01023356,1133,543,590,0.47925860547219773,0.5207413945278023
E01023416,1481,714,767,0.48210668467251855,0.5178933153274814
E01023417,1355,648,707,0.4782287822878229,0.5217712177121772
E01023393,1674,841,833,0.502389486260454,0.497610513739546
E01023394,1438,721,717,0.5013908205841446,0.49860917941585536
E01023395,1682,874,808,0.5196195005945303,0.4803804994054697
E01023396,1592,804,788,0.5050251256281407,0.4949748743718593
E01023397,1396,667,729,0.4777936962750716,0.5222063037249284
E01023401,1781,875,906,0.4912970241437395,0.5087029758562606
E01023402,1724,859,865,0.4982598607888631,0.5017401392111369
E01023403,1508,740,768,0.4907161803713528,0.5092838196286472
E01023404,1351,651,700,0.48186528497409326,0.5181347150259067
E01023405,1570,760,810,0.4840764331210191,0.5159235668789809
E01023361,1660,829,831,0.49939759036144576,0.5006024096385542
E01023362,1837,879,958,0.4784975503538378,0.5215024496461622
E01023363,1545,727,818,0.47055016181229775,0.5294498381877023
E01023364,1329,668,661,0.5026335590669676,0.49736644093303234
E01023390,2123,1022,1101,0.4813942534149788,0.5186057465850212
E01023391,1721,830,891,0.4822777454968042,0.5177222545031959
E01023399,1670,824,846,0.4934131736526946,0.5065868263473053
E01023392,1655,762,893,0.46042296072507555,0.5395770392749245
E01023427,1806,843,963,0.46677740863787376,0.5332225913621262
E01023428,1455,726,729,0.49896907216494846,0.5010309278350515
E01023429,1853,887,966,0.4786832164058284,0.5213167835941717
E01023369,1535,736,799,0.4794788273615635,0.5205211726384364
E01023370,1682,798,884,0.47443519619500596,0.525564803804994
E01023371,1791,883,908,0.49302065884980456,0.5069793411501954
E01023372,1529,741,788,0.48463047743623283,0.5153695225637671
E01023345,1983,952,1031,0.4800806858295512,0.5199193141704488
E01023346,2823,1331,1492,0.471484236627701,0.528515763372299
E01023347,1438,680,758,0.4728789986091794,0.5271210013908206
E01023348,1553,747,806,0.48100450740502254,0.5189954925949775
E01023365,1318,659,659,0.5,0.5
E01023366,1548,732,816,0.4728682170542636,0.5271317829457365
E01023367,1221,592,629,0.48484848484848486,0.5151515151515151
E01023368,1786,845,941,0.4731243001119821,0.526875699888018
E01023349,1900,920,980,0.4842105263157895,0.5157894736842106
E01023350,1823,879,944,0.4821722435545804,0.5178277564454197
E01023351,1707,830,877,0.4862331575864089,0.513766842413591
E01023400,2080,999,1081,0.48028846153846155,0.5197115384615385
E01035562,1522,778,744,0.5111695137976346,0.4888304862023653
E01035563,1387,680,707,0.49026676279740444,0.5097332372025956
E01035564,1195,627,568,0.5246861924686193,0.47531380753138075
E01023383,1481,695,786,0.46927751519243754,0.5307224848075625
E01023384,1965,935,1030,0.4758269720101781,0.5241730279898219
E01023385,1581,784,797,0.4958886780518659,0.5041113219481341
E01023409,1939,963,976,0.49664775657555443,0.5033522434244456
E01023410,1317,633,684,0.4806378132118451,0.5193621867881549
E01023411,1589,753,836,0.47388294524858404,0.526117054751416
E01023412,1256,634,622,0.5047770700636943,0.49522292993630573
E01023413,1324,639,685,0.4826283987915408,0.5173716012084593
E01023354,2454,1237,1217,0.5040749796251018,0.4959250203748981
E01023379,1627,811,816,0.49846342962507684,0.5015365703749232
E01023380,1170,550,620,0.4700854700854701,0.5299145299145299
E01023381,1368,672,696,0.49122807017543857,0.5087719298245614
E01023382,1537,755,782,0.49121665582303187,0.5087833441769681
E01033022,1401,690,711,0.4925053533190578,0.5074946466809421
E01033023,2109,1054,1055,0.4997629208155524,0.5002370791844476
E01023386,1466,728,738,0.4965893587994543,0.5034106412005457
E01023387,1358,634,724,0.46686303387334316,0.5331369661266568
E01023388,1519,760,759,0.500329163923634,0.49967083607636603
E01023389,1657,835,822,0.5039227519613759,0.496077248038624
E01023357,1691,845,846,0.4997043169722058,0.5002956830277943
E01023358,1562,751,811,0.48079385403329067,0.5192061459667093
E01023359,1850,887,963,0.47945945945945945,0.5205405405405406
E01023360,1558,784,774,0.503209242618742,0.496790757381258
E01023414,2371,1164,1207,0.490932096161957,0.509067903838043
E01023415,1409,669,740,0.47480482611781405,0.525195173882186
E01023373,2150,1546,604,0.7190697674418605,0.28093023255813954
E01023374,1394,662,732,0.4748923959827834,0.5251076040172167
E01023375,1571,784,787,0.4990451941438574,0.5009548058561426
E01023376,1242,607,635,0.4887278582930757,0.5112721417069244
E01023377,1369,685,684,0.5003652300949598,0.4996347699050402
E01023378,1771,885,886,0.4997176736307171,0.5002823263692829
E01023406,1960,919,1041,0.4688775510204082,0.5311224489795918
E01023407,1721,846,875,0.4915746658919233,0.5084253341080767
E01023408,1607,781,826,0.48599875544492843,0.5140012445550716
E01023576,1460,697,763,0.4773972602739726,0.5226027397260274
E01023577,1700,795,905,0.4676470588235294,0.5323529411764706
E01023578,1704,825,879,0.4841549295774648,0.5158450704225352
E01023579,1436,674,762,0.46935933147632314,0.5306406685236769
E01023580,1680,798,882,0.475,0.525
E01023567,2083,1001,1082,0.48055688910225636,0.5194431108977436
E01023568,1553,728,825,0.4687701223438506,0.5312298776561494
E01023569,1712,825,887,0.48189252336448596,0.518107476635514
E01023570,1467,710,757,0.4839809134287662,0.5160190865712339
E01023571,1588,719,869,0.4527707808564232,0.5472292191435768
E01023572,1618,782,836,0.48331273176761436,0.5166872682323856
E01023573,1309,576,733,0.4400305576776165,0.5599694423223835
E01023574,1649,795,854,0.48211036992116435,0.5178896300788357
E01023575,1585,758,827,0.4782334384858044,0.5217665615141955
E01023581,1294,613,681,0.47372488408037094,0.526275115919629
E01023582,1644,757,887,0.4604622871046229,0.5395377128953771
E01023583,1387,638,749,0.45998558038932946,0.5400144196106705
E01023584,1066,535,531,0.50187617260788,0.4981238273921201
E01023523,1743,886,857,0.5083189902467011,0.4916810097532989
E01023524,1444,702,742,0.48614958448753465,0.5138504155124654
E01023525,1766,897,869,0.5079275198187996,0.4920724801812005
E01023526,1762,867,895,0.49205448354143017,0.5079455164585698
E01023527,1470,683,787,0.46462585034013604,0.535374149659864
E01023534,1855,911,944,0.4911051212938005,0.5088948787061994
E01023535,1804,836,968,0.4634146341463415,0.5365853658536586
E01023536,1644,763,881,0.46411192214111924,0.5358880778588808
E01023537,2780,1364,1416,0.4906474820143885,0.5093525179856115
E01023538,2131,1049,1082,0.4922571562646645,0.5077428437353355
E01023529,1534,743,791,0.48435462842242505,0.515645371577575
E01023530,1299,624,675,0.48036951501154734,0.5196304849884527
E01023531,2002,956,1046,0.4775224775224775,0.5224775224775224
E01023532,1645,806,839,0.4899696048632219,0.5100303951367782
E01023533,1648,811,837,0.49211165048543687,0.5078883495145631
E01023552,1705,799,906,0.4686217008797654,0.5313782991202346
E01023553,2086,1024,1062,0.49089165867689355,0.5091083413231065
E01023554,1753,828,925,0.47233314318311465,0.5276668568168853
E01023555,1969,937,1032,0.47587607922803454,0.5241239207719655
E01023544,1174,559,615,0.47614991482112434,0.5238500851788757
E01023545,1811,903,908,0.4986195472114854,0.5013804527885146
E01023546,2018,960,1058,0.4757185332011893,0.5242814667988107
E01023547,1867,925,942,0.49544724156400644,0.5045527584359936
E01023528,1446,707,739,0.48893499308437066,0.5110650069156293
E01023564,1737,848,889,0.4881980426021877,0.5118019573978123
E01023565,1831,894,937,0.4882577826324413,0.5117422173675588
E01023566,1527,733,794,0.48002619515389655,0.5199738048461034
E01023540,1853,903,950,0.4873178629249865,0.5126821370750135
E01023541,2484,1238,1246,0.49838969404186795,0.501610305958132
E01023542,1952,955,997,0.48924180327868855,0.5107581967213115
E01023543,1423,676,747,0.47505270555165147,0.5249472944483485
E01035598,1713,851,862,0.4967892586106246,0.5032107413893754
E01035599,1685,825,860,0.4896142433234421,0.5103857566765578
E01023558,1822,844,978,0.4632272228320527,0.5367727771679474
E01023559,1664,814,850,0.4891826923076923,0.5108173076923077
E01023560,1928,914,1014,0.47406639004149376,0.5259336099585062
E01023561,1694,776,918,0.45808736717827625,0.5419126328217237
E01023562,1814,887,927,0.48897464167585447,0.5110253583241455
E01023563,1853,866,987,0.46735024284943333,0.5326497571505666
E01023548,2047,976,1071,0.4767953102100635,0.5232046897899365
E01023549,1744,805,939,0.46158256880733944,0.5384174311926605
E01023550,1777,859,918,0.48339898705683737,0.5166010129431626
E01023551,1553,737,816,0.4745653573728268,0.5254346426271732
E01023556,1900,907,993,0.47736842105263155,0.5226315789473684
E01023557,1535,730,805,0.4755700325732899,0.5244299674267101
E01023660,2372,1206,1166,0.5084317032040472,0.49156829679595276
E01023661,1365,654,711,0.47912087912087914,0.5208791208791209
E01023662,2076,1063,1013,0.5120423892100193,0.48795761078998073
E01023654,1564,765,799,0.4891304347826087,0.5108695652173914
E01023655,2043,985,1058,0.48213411649535,0.51786588350465
E01023656,2334,1101,1233,0.4717223650385604,0.5282776349614395
E01023657,2555,1280,1275,0.5009784735812133,0.49902152641878667
E01023658,1791,891,900,0.49748743718592964,0.5025125628140703
E01023659,1343,687,656,0.5115413253909159,0.48845867460908415
E01023635,1496,732,764,0.4893048128342246,0.5106951871657754
E01023636,1854,908,946,0.48975188781014023,0.5102481121898598
E01023637,1824,844,980,0.46271929824561403,0.5372807017543859
E01023638,1634,775,859,0.47429620563035496,0.5257037943696451
E01023587,1039,504,535,0.4850818094321463,0.5149181905678537
E01023588,1411,690,721,0.4890148830616584,0.5109851169383416
E01023589,1695,862,833,0.5085545722713865,0.49144542772861355
E01023590,1801,882,919,0.48972792892837314,0.5102720710716269
E01023591,1546,738,808,0.47736093143596375,0.5226390685640362
E01023592,1635,782,853,0.4782874617737003,0.5217125382262997
E01023593,1489,704,785,0.4728005372733378,0.5271994627266622
E01023630,1856,923,933,0.4973060344827586,0.5026939655172413
E01023631,1684,787,897,0.4673396674584323,0.5326603325415677
E01023632,1922,913,1009,0.4750260145681582,0.5249739854318418
E01023633,1328,640,688,0.4819277108433735,0.5180722891566265
E01023634,1285,631,654,0.4910505836575875,0.5089494163424124
E01023649,1270,634,636,0.49921259842519683,0.5007874015748032
E01023650,1628,792,836,0.4864864864864865,0.5135135135135135
E01023651,1231,608,623,0.4939073923639318,0.5060926076360682
E01023652,1500,697,803,0.4646666666666667,0.5353333333333333
E01023644,1712,846,866,0.4941588785046729,0.5058411214953271
E01023645,1563,744,819,0.4760076775431862,0.5239923224568138
E01023646,1479,684,795,0.46247464503042596,0.537525354969574
E01023647,1469,698,771,0.47515316541865216,0.5248468345813478
E01023648,1193,564,629,0.4727577535624476,0.5272422464375524
E01023639,1273,629,644,0.49410840534171246,0.5058915946582875
E01023640,1251,585,666,0.4676258992805755,0.5323741007194245
E01023641,1355,649,706,0.4789667896678967,0.5210332103321034
E01023642,1259,623,636,0.4948371723590151,0.5051628276409849
E01023643,1256,606,650,0.482484076433121,0.517515923566879
E01023601,2205,1077,1128,0.4884353741496599,0.5115646258503401
E01023602,1561,778,783,0.4983984625240231,0.5016015374759769
E01023603,1573,799,774,0.5079465988556897,0.49205340114431023
E01023604,1399,688,711,0.49177984274481773,0.5082201572551823
E01023605,1424,703,721,0.4936797752808989,0.5063202247191011
E01023617,1562,743,819,0.47567221510883484,0.5243277848911652
E01023618,1743,846,897,0.4853700516351119,0.5146299483648882
E01023619,1699,833,866,0.49028840494408477,0.5097115950559152
E01023620,1358,656,702,0.48306332842415317,0.5169366715758469
E01023621,1345,650,695,0.483271375464684,0.516728624535316
E01023611,1662,768,894,0.4620938628158845,0.5379061371841155
E01023612,1830,871,959,0.47595628415300545,0.5240437158469945
E01023613,1621,766,855,0.47254780999383095,0.527452190006169
E01023614,2062,1012,1050,0.49078564500484967,0.5092143549951503
E01023615,1841,866,975,0.4703965236284628,0.5296034763715373
E01023616,2470,1227,1243,0.49676113360323887,0.5032388663967612
E01023606,1751,840,911,0.47972587093089664,0.5202741290691034
E01023607,1480,709,771,0.47905405405405405,0.5209459459459459
E01023608,1605,779,826,0.4853582554517134,0.5146417445482866
E01023609,1669,815,854,0.48831635710005994,0.5116836428999401
E01023610,1361,661,700,0.4856722997795738,0.5143277002204262
E01023594,2358,1157,1201,0.4906700593723495,0.5093299406276506
E01023622,1167,558,609,0.4781491002570694,0.5218508997429306
E01023623,1582,779,803,0.49241466498103664,0.5075853350189633
E01023624,1409,703,706,0.49893541518807666,0.5010645848119234
E01023625,1077,514,563,0.47725162488393685,0.5227483751160631
E01023653,2539,1234,1305,0.48601811736904293,0.5139818826309571
E01023595,1534,746,788,0.4863102998696219,0.5136897001303781
E01023596,1143,538,605,0.47069116360454943,0.5293088363954506
E01023626,2261,1108,1153,0.4900486510393631,0.5099513489606369
E01023627,1885,912,973,0.48381962864721484,0.5161803713527852
E01023628,1850,900,950,0.4864864864864865,0.5135135135135135
E01023629,1712,811,901,0.473714953271028,0.5262850467289719
E01023585,1162,573,589,0.49311531841652323,0.5068846815834768
E01023586,1667,787,880,0.47210557888422316,0.5278944211157769
E01023597,1252,593,659,0.4736421725239617,0.5263578274760383
E01023598,1539,769,770,0.4996751137102014,0.5003248862897985
E01023663,2065,1002,1063,0.48523002421307504,0.514769975786925
E01023600,1409,685,724,0.48616039744499645,0.5138396025550035
E01033024,1560,784,776,0.5025641025641026,0.49743589743589745
E01033025,1324,651,673,0.4916918429003021,0.5083081570996979
E01033026,1609,799,810,0.49658172778123055,0.5034182722187694
E01033027,1502,741,761,0.4933422103861518,0.5066577896138482
E01023802,1692,795,897,0.4698581560283688,0.5301418439716312
E01023803,1549,762,787,0.4919302775984506,0.5080697224015494
E01023804,1496,697,799,0.4659090909090909,0.5340909090909091
E01023807,1581,775,806,0.49019607843137253,0.5098039215686274
E01035600,1483,755,728,0.5091031692515172,0.4908968307484828
E01035601,1235,635,600,0.5141700404858299,0.48582995951417
E01023829,1798,872,926,0.4849833147942158,0.5150166852057843
E01023830,1443,712,731,0.4934164934164934,0.5065835065835066
E01023832,2104,1030,1074,0.48954372623574144,0.5104562737642585
E01023834,1783,897,886,0.5030846887268648,0.49691531127313515
E01035602,1244,597,647,0.47990353697749194,0.520096463022508
E01035603,2440,1154,1286,0.47295081967213115,0.5270491803278688
E01023823,1637,784,853,0.47892486255345146,0.5210751374465485
E01023824,2187,1041,1146,0.47599451303155005,0.52400548696845
E01023831,2102,1044,1058,0.4966698382492864,0.5033301617507137
E01023854,1932,943,989,0.4880952380952381,0.5119047619047619
E01023812,1550,736,814,0.47483870967741937,0.5251612903225806
E01023813,1620,789,831,0.48703703703703705,0.512962962962963
E01023814,1080,521,559,0.4824074074074074,0.5175925925925926
E01023851,1934,899,1035,0.46483971044467426,0.5351602895553258
E01023815,1581,771,810,0.4876660341555977,0.5123339658444023
E01023816,1284,593,691,0.4618380062305296,0.5381619937694704
E01023817,1396,687,709,0.49212034383954156,0.5078796561604585
E01023818,1451,702,749,0.48380427291523087,0.5161957270847691
E01023819,1661,827,834,0.49789283564118003,0.50210716435882
E01023820,1347,641,706,0.4758723088344469,0.5241276911655531
E01023821,1301,622,679,0.47809377401998465,0.5219062259800153
E01023822,1399,677,722,0.4839170836311651,0.5160829163688349
E01023825,2358,1171,1187,0.496607294317218,0.503392705682782
E01023826,1643,815,828,0.4960438222763238,0.5039561777236762
E01023847,1893,901,992,0.47596407818277864,0.5240359218172214
E01023848,1862,904,958,0.48549946294307195,0.514500537056928
E01023850,1577,791,786,0.501585288522511,0.4984147114774889
E01023852,1519,753,766,0.4957208689927584,0.5042791310072416
E01023853,2174,1072,1102,0.49310027598896045,0.5068997240110396
E01023827,2417,1207,1210,0.49937939594538683,0.5006206040546132
E01023828,1682,800,882,0.4756242568370987,0.5243757431629013
E01023845,1848,899,949,0.48647186147186144,0.5135281385281385
E01023846,1618,803,815,0.496291718170581,0.5037082818294191
E01023835,1410,652,758,0.4624113475177305,0.5375886524822695
E01023836,1387,682,705,0.49170872386445563,0.5082912761355444
E01023837,1635,796,839,0.4868501529051988,0.5131498470948013
E01023838,1313,644,669,0.49047981721249045,0.5095201827875095
E01023805,1764,854,910,0.48412698412698413,0.5158730158730159
E01023809,1848,877,971,0.4745670995670996,0.5254329004329005
E01023810,1833,876,957,0.4779050736497545,0.5220949263502455
E01023811,1503,745,758,0.49567531603459747,0.5043246839654025
E01023839,2282,1106,1176,0.48466257668711654,0.5153374233128835
E01023840,1807,953,854,0.527393469839513,0.472606530160487
E01023841,1763,875,888,0.4963131026659104,0.5036868973340897
E01023849,1448,720,728,0.4972375690607735,0.5027624309392266
E01023806,2309,1111,1198,0.48116067561715026,0.5188393243828497
E01023842,1706,804,902,0.4712778429073857,0.5287221570926143
E01023843,2128,1048,1080,0.4924812030075188,0.5075187969924813
E01023844,1737,839,898,0.4830166954519286,0.5169833045480714
E01023904,2165,1039,1126,0.47990762124711317,0.5200923787528868
E01023905,2038,952,1086,0.46712463199214915,0.5328753680078508
E01023906,1565,753,812,0.48115015974440895,0.518849840255591
E01023907,1936,946,990,0.48863636363636365,0.5113636363636364
E01023890,1332,669,663,0.5022522522522522,0.49774774774774777
E01023891,1503,725,778,0.4823685961410512,0.5176314038589488
E01023892,1338,636,702,0.47533632286995514,0.5246636771300448
E01023893,1671,830,841,0.4967085577498504,0.5032914422501497
E01023894,1409,710,699,0.5039034776437189,0.49609652235628104
E01023873,1354,655,699,0.48375184638109303,0.516248153618907
E01023874,1321,639,682,0.4837244511733535,0.5162755488266465
E01023875,2205,1053,1152,0.4775510204081633,0.5224489795918368
E01023876,1795,827,968,0.46072423398328693,0.5392757660167131
E01023877,1724,824,900,0.4779582366589327,0.5220417633410673
E01023868,1892,906,986,0.4788583509513742,0.5211416490486258
E01023869,1485,752,733,0.5063973063973064,0.4936026936026936
E01023870,1729,843,886,0.4875650665124349,0.5124349334875651
E01023871,1845,904,941,0.48997289972899727,0.5100271002710027
E01023872,1714,850,864,0.4959159859976663,0.5040840140023337
E01023895,1678,829,849,0.4940405244338498,0.5059594755661502
E01023896,1303,635,668,0.4873369148119724,0.5126630851880276
E01023897,1592,807,785,0.5069095477386935,0.49309045226130654
E01023898,1600,779,821,0.486875,0.513125
E01023855,2254,1155,1099,0.5124223602484472,0.48757763975155277
E01023856,2618,1313,1305,0.501527883880825,0.49847211611917497
E01023857,1837,937,900,0.5100707675557975,0.4899292324442025
E01023858,1994,1037,957,0.5200601805416248,0.4799398194583751
E01023878,2133,1049,1084,0.49179559306141585,0.5082044069385842
E01023880,2239,1105,1134,0.4935238945958017,0.5064761054041983
E01023881,1674,796,878,0.4755077658303465,0.5244922341696535
E01035572,1429,692,737,0.4842547235829251,0.5157452764170749
E01035573,1596,788,808,0.49373433583959897,0.506265664160401
E01023886,2909,1436,1473,0.4936404262633207,0.5063595737366793
E01023887,1793,869,924,0.48466257668711654,0.5153374233128835
E01023888,1679,862,817,0.5134008338296605,0.4865991661703395
E01023889,1847,897,950,0.4856524093123985,0.5143475906876015
E01023860,2093,1056,1037,0.504538939321548,0.49546106067845197
E01023862,2664,1257,1407,0.47184684684684686,0.5281531531531531
E01035574,1297,676,621,0.5212027756360833,0.47879722436391675
E01035575,1313,683,630,0.5201827875095202,0.4798172124904798
E01035576,1066,535,531,0.50187617260788,0.4981238273921201
E01035577,1669,874,795,0.5236668663870582,0.4763331336129419
E01035578,1312,687,625,0.5236280487804879,0.4763719512195122
E01023899,1757,865,892,0.49231644849174727,0.5076835515082527
E01023900,1897,995,902,0.5245123879810226,0.4754876120189773
E01023901,2094,1078,1016,0.5148042024832856,0.48519579751671443
E01023902,1742,861,881,0.49425947187141217,0.5057405281285878
E01023903,1670,827,843,0.49520958083832334,0.5047904191616767
E01023863,1827,907,920,0.4964422550629447,0.5035577449370553
E01023864,1735,838,897,0.4829971181556196,0.5170028818443804
E01023865,1996,931,1065,0.4664328657314629,0.5335671342685371
E01023866,1668,772,896,0.4628297362110312,0.5371702637889688
E01035579,1833,914,919,0.49863611565739224,0.5013638843426077
E01035580,1238,593,645,0.4789983844911147,0.5210016155088854
E01023882,1659,802,857,0.48342374924653403,0.5165762507534659
E01023883,1784,870,914,0.4876681614349776,0.5123318385650224
E01023884,1963,962,1001,0.4900662251655629,0.5099337748344371
E01023885,1773,862,911,0.4861816130851664,0.5138183869148336
E01026436,2468,1210,1258,0.49027552674230146,0.5097244732576985
E01026461,1607,777,830,0.4835096453018046,0.5164903546981954
E01026483,1116,545,571,0.4883512544802867,0.5116487455197133
E01033042,2291,1202,1089,0.5246617197730249,0.4753382802269751
E01026442,2143,1072,1071,0.5002333177788147,0.49976668222118525
E01026443,2163,1070,1093,0.4946833102172908,0.5053166897827092
E01026445,2520,1239,1281,0.49166666666666664,0.5083333333333333
E01026462,2423,1174,1249,0.4845233182005778,0.5154766817994222
E01026428,2701,1287,1414,0.47649018881895594,0.523509811181044
E01026429,1433,682,751,0.47592463363572923,0.5240753663642708
E01026430,2346,1127,1219,0.4803921568627451,0.5196078431372549
E01026431,1177,563,614,0.47833474936278675,0.5216652506372133
E01026446,2147,1039,1108,0.48393106660456453,0.5160689333954355
E01026452,1711,847,864,0.4950321449444769,0.5049678550555231
E01026453,1552,804,748,0.5180412371134021,0.48195876288659795
E01026454,1606,780,826,0.48567870485678705,0.5143212951432129
E01026425,2034,996,1038,0.4896755162241888,0.5103244837758112
E01026426,2318,1150,1168,0.49611734253666956,0.5038826574633305
E01026427,2477,1219,1258,0.4921275736778361,0.5078724263221639
E01026432,1448,714,734,0.4930939226519337,0.5069060773480663
E01026433,1389,656,733,0.4722822174226062,0.5277177825773938
E01026434,1934,928,1006,0.47983453981385726,0.5201654601861427
E01026479,1501,745,756,0.49633577614923385,0.5036642238507661
E01026480,1605,792,813,0.4934579439252336,0.5065420560747663
E01026481,1344,681,663,0.5066964285714286,0.49330357142857145
E01026484,1583,789,794,0.4984207201516109,0.5015792798483891
E01026485,1216,616,600,0.506578947368421,0.4934210526315789
E01026456,1194,563,631,0.4715242881072027,0.5284757118927973
E01026457,1321,626,695,0.4738834216502649,0.526116578349735
E01026458,1729,828,901,0.47888953152111047,0.5211104684788895
E01026459,1537,762,775,0.49577098243331164,0.5042290175666884
E01035133,1232,569,663,0.46185064935064934,0.5381493506493507
E01035134,1552,757,795,0.4877577319587629,0.5122422680412371
E01026437,1251,620,631,0.495603517186251,0.504396482813749
E01026438,1048,534,514,0.5095419847328244,0.4904580152671756
E01026451,2460,1183,1277,0.48089430894308943,0.5191056910569106
E01026495,1446,707,739,0.48893499308437066,0.5110650069156293
E01026496,1120,551,569,0.4919642857142857,0.5080357142857143
E01026486,1973,965,1008,0.48910288900152055,0.5108971109984795
E01026487,2233,1112,1121,0.4979847738468428,0.5020152261531572
E01026488,1390,667,723,0.47985611510791365,0.5201438848920863
E01026489,1468,744,724,0.5068119891008175,0.49318801089918257
E01026490,1903,924,979,0.48554913294797686,0.5144508670520231
E01026419,1296,666,630,0.5138888888888888,0.4861111111111111
E01026420,1267,627,640,0.494869771112865,0.505130228887135
E01026464,1298,637,661,0.49075500770416025,0.5092449922958397
E01026491,2305,1135,1170,0.4924078091106291,0.5075921908893709
E01033040,2615,1731,884,0.6619502868068834,0.3380497131931166
E01033041,1325,667,658,0.5033962264150943,0.49660377358490565
E01026423,1887,914,973,0.48436671966083733,0.5156332803391627
E01026447,1715,828,887,0.482798833819242,0.5172011661807581
E01026449,1925,967,958,0.5023376623376623,0.49766233766233764
E01026450,1869,920,949,0.4922418405564473,0.5077581594435527
E01035135,1189,587,602,0.49369217830109335,0.5063078216989066
E01035136,2006,962,1044,0.4795613160518445,0.5204386839481555
E01026424,2131,1037,1094,0.48662599718442046,0.5133740028155795
E01026444,2101,1042,1059,0.4959543074726321,0.504045692527368
E01026492,1275,635,640,0.4980392156862745,0.5019607843137255
E01026493,1368,694,674,0.5073099415204678,0.4926900584795322
E01026421,1791,877,914,0.4896705750977108,0.5103294249022893
E01026435,2201,1113,1088,0.5056792367105861,0.4943207632894139
E01026448,2479,1251,1228,0.5046389673255345,0.4953610326744655
E01026439,1874,942,932,0.5026680896478122,0.4973319103521878
E01026440,1187,592,595,0.4987363100252738,0.5012636899747261
E01026441,1609,787,822,0.4891236793039155,0.5108763206960846
E01026494,2394,1194,1200,0.49874686716791977,0.5012531328320802
E01026465,1847,911,936,0.4932322685435842,0.5067677314564158
E01026466,1857,953,904,0.5131933225632741,0.4868066774367259
E01026467,2229,1051,1178,0.471511888739345,0.528488111260655
E01026468,2431,1191,1240,0.4899218428630193,0.5100781571369807
E01026469,1650,810,840,0.4909090909090909,0.509090909090909
E01026470,2807,1443,1364,0.5140719629497684,0.4859280370502316
E01026471,1207,609,598,0.5045567522783762,0.49544324772162385
E01026472,1198,616,582,0.5141903171953256,0.48580968280467446
E01026473,1399,708,691,0.5060757684060043,0.49392423159399573
E01026474,2066,1020,1046,0.4937076476282672,0.5062923523717329
E01026475,1550,764,786,0.49290322580645163,0.5070967741935484
E01026476,1521,737,784,0.48454963839579224,0.5154503616042078
E01026477,1842,857,985,0.46525515743756785,0.5347448425624322
E01026478,1655,828,827,0.5003021148036254,0.49969788519637465
E01026499,1534,718,816,0.4680573663624511,0.5319426336375489
E01026500,1613,771,842,0.47799132052076876,0.5220086794792312
E01026501,1598,781,817,0.48873591989987486,0.5112640801001251
E01026502,2063,980,1083,0.4750363548230732,0.5249636451769268
E01026503,2130,997,1133,0.468075117370892,0.531924882629108
E01026522,1447,719,728,0.4968901174844506,0.5031098825155494
E01026523,1827,909,918,0.4975369458128079,0.5024630541871922
E01026524,1462,727,735,0.49726402188782487,0.5027359781121751
E01026525,1256,647,609,0.5151273885350318,0.48487261146496813
E01026547,1376,669,707,0.48619186046511625,0.5138081395348837
E01026548,1283,604,679,0.47077162899454406,0.5292283710054559
E01026514,1522,768,754,0.5045992115637319,0.49540078843626806
E01026515,1164,577,587,0.4957044673539519,0.5042955326460481
E01026516,1206,594,612,0.4925373134328358,0.5074626865671642
E01026517,1605,756,849,0.47102803738317756,0.5289719626168224
E01026533,1234,596,638,0.4829821717990275,0.5170178282009724
E01026534,1668,827,841,0.4958033573141487,0.5041966426858513
E01026535,2320,1129,1191,0.4866379310344828,0.5133620689655173
E01026536,1902,935,967,0.49158780231335436,0.5084121976866456
E01026537,1486,728,758,0.4899057873485868,0.5100942126514132
E01026549,1792,909,883,0.5072544642857143,0.4927455357142857
E01026550,1083,537,546,0.49584487534626037,0.5041551246537396
E01026551,1131,568,563,0.502210433244916,0.497789566755084
E01026552,1325,645,680,0.4867924528301887,0.5132075471698113
E01026562,1198,577,621,0.48163606010016696,0.5183639398998331
E01026563,1375,688,687,0.5003636363636363,0.49963636363636366
E01026564,1622,798,824,0.4919852034525277,0.5080147965474723
E01026565,1088,526,562,0.4834558823529412,0.5165441176470589
E01026566,1447,706,741,0.4879060124395301,0.51209398756047
E01026567,1582,743,839,0.4696586599241466,0.5303413400758533
E01026568,1525,747,778,0.4898360655737705,0.5101639344262295
E01026518,1335,660,675,0.4943820224719101,0.5056179775280899
E01026519,1647,810,837,0.4918032786885246,0.5081967213114754
E01026520,1097,523,574,0.47675478577939834,0.5232452142206017
E01026521,1308,603,705,0.4610091743119266,0.5389908256880734
E01026545,2160,1082,1078,0.5009259259259259,0.49907407407407406
E01026546,1441,716,725,0.49687716863289383,0.5031228313671062
E01026578,2147,1046,1101,0.4871914299021891,0.5128085700978109
E01026579,1579,774,805,0.4901836605446485,0.5098163394553515
E01026580,1832,902,930,0.4923580786026201,0.50764192139738
E01026540,1382,685,697,0.4956584659913169,0.5043415340086831
E01026541,2492,1224,1268,0.4911717495987159,0.5088282504012841
E01026542,1413,691,722,0.48903043170559096,0.5109695682944091
E01026543,1466,722,744,0.4924965893587995,0.5075034106412005
E01026544,1743,869,874,0.4985656913367757,0.5014343086632244
E01026526,1334,651,683,0.48800599700149927,0.5119940029985007
E01026527,1382,662,720,0.47901591895803186,0.5209840810419681
E01026528,1394,650,744,0.46628407460545196,0.533715925394548
E01026529,1572,746,826,0.47455470737913485,0.5254452926208651
E01026530,1840,930,910,0.5054347826086957,0.4945652173913043
E01026531,1888,925,963,0.4899364406779661,0.5100635593220338
E01026532,1714,847,867,0.4941656942823804,0.5058343057176196
E01026553,1322,627,695,0.4742813918305598,0.5257186081694403
E01026554,1106,540,566,0.488245931283906,0.5117540687160941
E01026555,1501,720,781,0.47968021319120585,0.5203197868087941
E01026556,1415,688,727,0.4862190812720848,0.5137809187279152
E01026557,1324,667,657,0.5037764350453172,0.4962235649546828
E01026558,2259,1103,1156,0.48826914563966356,0.5117308543603364
E01026559,1448,713,735,0.4924033149171271,0.5075966850828729
E01026560,1314,632,682,0.4809741248097412,0.5190258751902588
E01034765,1701,853,848,0.5014697236919459,0.4985302763080541
E01034766,1486,713,773,0.4798115746971736,0.5201884253028264
E01026504,1476,716,760,0.48509485094850946,0.5149051490514905
E01026505,2020,963,1057,0.4767326732673267,0.5232673267326733
E01026506,1430,704,726,0.49230769230769234,0.5076923076923077
E01026507,1431,686,745,0.47938504542278126,0.5206149545772187
E01026512,1284,622,662,0.48442367601246106,0.5155763239875389
E01026513,1410,699,711,0.4957446808510638,0.5042553191489362
E01026569,1448,713,735,0.4924033149171271,0.5075966850828729
E01026570,1647,801,846,0.48633879781420764,0.5136612021857924
E01026571,1493,728,765,0.48760884125920967,0.5123911587407903
E01026572,1391,667,724,0.47951114306254494,0.5204888569374551
E01026573,1388,677,711,0.4877521613832853,0.5122478386167147
E01026574,1697,826,871,0.48674130819092515,0.5132586918090748
E01026575,1818,867,951,0.4768976897689769,0.523102310231023
E01026576,2002,1011,991,0.504995004995005,0.495004995004995
E01026577,1644,825,819,0.5018248175182481,0.4981751824817518
E01026508,1356,646,710,0.47640117994100295,0.523598820058997
E01026509,1923,943,980,0.4903796151846074,0.5096203848153926
E01026510,1759,854,905,0.4855031267765776,0.5144968732234224
E01026511,1176,592,584,0.5034013605442177,0.4965986394557823
E01026497,1462,694,768,0.4746922024623803,0.5253077975376197
E01026498,1326,601,725,0.45324283559577677,0.5467571644042232
E01026538,1606,782,824,0.48692403486924035,0.5130759651307597
E01026539,1631,800,831,0.49049662783568365,0.5095033721643164
E01026605,1795,876,919,0.48802228412256266,0.5119777158774373
E01026606,1412,686,726,0.48583569405099153,0.5141643059490085
E01026607,1772,871,901,0.4915349887133183,0.5084650112866818
E01026627,1341,658,683,0.4906785980611484,0.5093214019388516
E01026628,1873,912,961,0.48691938067271756,0.5130806193272824
E01026629,1490,732,758,0.4912751677852349,0.508724832214765
E01026608,1495,739,756,0.494314381270903,0.505685618729097
E01026609,1201,592,609,0.4929225645295587,0.5070774354704413
E01026636,1553,774,779,0.4983902124919511,0.501609787508049
E01026637,2103,1027,1076,0.48834997622444126,0.5116500237755587
E01026638,1663,822,841,0.49428743235117256,0.5057125676488274
E01026589,1312,637,675,0.48551829268292684,0.5144817073170732
E01026590,1356,649,707,0.4786135693215339,0.5213864306784661
E01026591,1652,809,843,0.4897094430992736,0.5102905569007264
E01026592,1337,649,688,0.48541510845175767,0.5145848915482424
E01026593,1323,638,685,0.48223733938019653,0.5177626606198035
E01026594,1822,900,922,0.49396267837541163,0.5060373216245884
E01026599,1430,711,719,0.4972027972027972,0.5027972027972027
E01026639,1565,767,798,0.49009584664536743,0.5099041533546326
E01026640,1496,702,794,0.4692513368983957,0.5307486631016043
E01026641,1409,686,723,0.4868701206529453,0.5131298793470547
E01026595,1758,842,916,0.4789533560864619,0.5210466439135382
E01026596,1580,775,805,0.49050632911392406,0.509493670886076
E01026597,1995,1032,963,0.5172932330827068,0.48270676691729325
E01026598,1879,977,902,0.5199574241617881,0.4800425758382118
E01026622,1635,823,812,0.5033639143730887,0.4966360856269113
E01026623,1838,956,882,0.5201305767138193,0.47986942328618065
E01026624,1939,1006,933,0.518824136152656,0.481175863847344
E01026625,1831,895,936,0.488803932277444,0.511196067722556
E01026626,2098,1059,1039,0.5047664442326025,0.4952335557673975
E01026600,1468,688,780,0.46866485013623976,0.5313351498637602
E01026633,1763,907,856,0.5144639818491208,0.48553601815087916
E01026634,1520,742,778,0.4881578947368421,0.5118421052631579
E01026635,2404,1189,1215,0.49459234608985025,0.5054076539101497
E01026581,1681,850,831,0.5056513979773944,0.4943486020226056
E01026582,2007,979,1028,0.4877927254608869,0.5122072745391131
E01026583,1321,638,683,0.4829674489023467,0.5170325510976533
E01026584,1468,713,755,0.48569482288828336,0.5143051771117166
E01026601,1416,687,729,0.4851694915254237,0.5148305084745762
E01026602,1610,768,842,0.47701863354037266,0.5229813664596273
E01026603,1650,783,867,0.47454545454545455,0.5254545454545455
E01026604,1588,766,822,0.482367758186398,0.517632241813602
E01026632,1659,781,878,0.4707655213984328,0.5292344786015672
E01026610,1494,749,745,0.501338688085676,0.49866131191432395
E01026611,1341,649,692,0.48396718866517524,0.5160328113348247
E01026612,2454,1164,1290,0.4743276283618582,0.5256723716381418
E01026630,1587,775,812,0.48834278512917456,0.5116572148708255
E01026631,1630,797,833,0.48895705521472393,0.5110429447852761
E01026617,1263,593,670,0.46951702296120346,0.5304829770387965
E01026618,1528,712,816,0.46596858638743455,0.5340314136125655
E01026619,1461,688,773,0.47091033538672145,0.5290896646132786
E01026620,1584,761,823,0.48042929292929293,0.5195707070707071
E01026621,1582,740,842,0.46776232616940583,0.5322376738305942
E01026613,1263,605,658,0.47901821060965954,0.5209817893903405
E01026614,1767,856,911,0.4844368986983588,0.5155631013016412
E01026615,1350,696,654,0.5155555555555555,0.48444444444444446
E01026616,1208,611,597,0.5057947019867549,0.49420529801324503
E01026587,2979,1513,1466,0.5078885532057738,0.49211144679422625
E01026588,2574,1261,1313,0.4898989898989899,0.51010101010101
E01034767,2175,1027,1148,0.472183908045977,0.527816091954023
E01026680,1601,728,873,0.4547158026233604,0.5452841973766396
E01026681,1209,581,628,0.48056244830438377,0.5194375516956162
E01026682,1146,514,632,0.44851657940663175,0.5514834205933682
E01026683,1275,622,653,0.48784313725490197,0.5121568627450981
E01026645,1130,553,577,0.4893805309734513,0.5106194690265486
E01026646,1477,718,759,0.4861205145565335,0.5138794854434665
E01026656,1799,887,912,0.49305169538632576,0.5069483046136742
E01026695,2135,1062,1073,0.497423887587822,0.502576112412178
E01026676,1627,741,886,0.45543945912722805,0.544560540872772
E01026677,1454,695,759,0.4779917469050894,0.5220082530949106
E01026678,1524,722,802,0.473753280839895,0.526246719160105
E01026701,1674,785,889,0.468936678614098,0.5310633213859021
E01026702,1334,615,719,0.46101949025487254,0.5389805097451275
E01026703,1107,556,551,0.5022583559168925,0.4977416440831075
E01026653,1781,826,955,0.46378439079169004,0.5362156092083099
E01026654,1554,723,831,0.46525096525096526,0.5347490347490348
E01026655,1418,661,757,0.46614950634696756,0.5338504936530324
E01026718,2294,1139,1155,0.496512641673932,0.5034873583260681
E01026691,1193,575,618,0.48197820620285,0.5180217937971501
E01026692,1140,553,587,0.4850877192982456,0.5149122807017544
E01026708,1377,671,706,0.48729121278140886,0.5127087872185911
E01026709,1924,925,999,0.4807692307692308,0.5192307692307693
E01026710,1198,589,609,0.49165275459098495,0.508347245409015
E01026669,1976,941,1035,0.47621457489878544,0.5237854251012146
E01026670,1618,767,851,0.47404202719406674,0.5259579728059333
E01026671,1352,655,697,0.4844674556213018,0.5155325443786982
E01026672,1411,673,738,0.47696669029057404,0.523033309709426
E01026673,1415,695,720,0.4911660777385159,0.508833922261484
E01026687,1962,935,1027,0.4765545361875637,0.5234454638124363
E01026688,1696,814,882,0.47995283018867924,0.5200471698113207
E01026689,1523,764,759,0.5016414970453054,0.4983585029546947
E01026690,1696,817,879,0.48172169811320753,0.5182783018867925
E01026647,2223,1084,1139,0.4876293297345929,0.5123706702654071
E01026711,1559,752,807,0.482360487491982,0.517639512508018
E01026712,1879,898,981,0.47791378392762107,0.5220862160723789
E01026713,1695,844,851,0.49793510324483775,0.5020648967551622
E01026666,1999,928,1071,0.464232116058029,0.535767883941971
E01026667,1488,736,752,0.4946236559139785,0.5053763440860215
E01026668,1635,823,812,0.5033639143730887,0.4966360856269113
E01026693,2236,1095,1141,0.48971377459749554,0.5102862254025045
E01026662,2858,1386,1472,0.48495451364590625,0.5150454863540938
E01026663,1751,860,891,0.49114791547687037,0.5088520845231297
E01026664,2217,1082,1135,0.48804691023906177,0.5119530897609382
E01026714,2260,1039,1221,0.4597345132743363,0.5402654867256638
E01026699,1618,828,790,0.511742892459827,0.48825710754017304
E01026700,1399,702,697,0.5017869907076483,0.4982130092923517
E01026704,1870,903,967,0.4828877005347594,0.5171122994652406
E01026705,1797,901,896,0.5013912075681691,0.4986087924318308
E01026706,2044,1028,1016,0.50293542074364,0.49706457925636005
E01034768,1113,536,577,0.481581311769991,0.518418688230009
E01034769,1042,492,550,0.472168905950096,0.527831094049904
E01026665,2462,1190,1272,0.4833468724614135,0.5166531275385865
E01026674,1125,540,585,0.48,0.52
E01026675,1237,596,641,0.48181083265966046,0.5181891673403395
E01026694,2635,1267,1368,0.4808349146110057,0.5191650853889943
E01026684,1431,713,718,0.49825296995108315,0.5017470300489169
E01026685,1242,614,628,0.4943639291465378,0.5056360708534622
E01026719,2506,1218,1288,0.4860335195530726,0.5139664804469274
E01026720,1397,700,697,0.5010737294201861,0.49892627057981387
E01026721,1481,743,738,0.5016880486158002,0.49831195138419987
E01026642,1421,669,752,0.4707952146375792,0.5292047853624209
E01026643,1384,668,716,0.48265895953757226,0.5173410404624278
E01026644,1838,1136,702,0.6180631120783461,0.381936887921654
E01026723,1679,836,843,0.49791542584871945,0.5020845741512805
E01026724,1856,900,956,0.4849137931034483,0.5150862068965517
E01026725,1470,709,761,0.482312925170068,0.5176870748299319
E01026696,1245,623,622,0.5004016064257029,0.4995983935742972
E01026697,1351,667,684,0.49370836417468544,0.5062916358253146
E01026722,2594,1266,1328,0.48804934464148036,0.5119506553585197
E01026726,2161,1118,1043,0.5173530772790375,0.4826469227209625
E01026659,1699,846,853,0.49793996468510887,0.5020600353148911
E01026660,1778,869,909,0.4887514060742407,0.5112485939257593
E01026661,1678,814,864,0.48510131108462456,0.5148986889153755
E01026715,1603,784,819,0.4890829694323144,0.5109170305676856
E01026716,1976,989,987,0.5005060728744939,0.49949392712550605
E01026717,1682,852,830,0.5065398335315101,0.4934601664684899
E01033036,1628,806,822,0.4950859950859951,0.504914004914005
E01033037,1640,810,830,0.49390243902439024,0.5060975609756098
E01033038,2127,998,1129,0.4692054536906441,0.5307945463093559
E01033039,1058,499,559,0.4716446124763705,0.5283553875236295
E01034770,1177,546,631,0.4638912489379779,0.536108751062022
E01034771,1370,632,738,0.46131386861313867,0.5386861313868613
E01034772,1117,520,597,0.4655326768128917,0.5344673231871083
E01034773,1232,578,654,0.46915584415584416,0.5308441558441559
E01026679,2434,1234,1200,0.5069843878389483,0.4930156121610518
E01026727,2602,1286,1316,0.49423520368946966,0.5057647963105304
E01026728,2559,1297,1262,0.5068386088315748,0.49316139116842517
E01026648,1659,840,819,0.5063291139240507,0.4936708860759494
E01026649,1795,903,892,0.5030640668523677,0.4969359331476323
E01026650,1268,643,625,0.5070977917981072,0.49290220820189273
E01026651,2582,1305,1277,0.505422153369481,0.49457784663051896
E01026652,1433,709,724,0.4947662247034194,0.5052337752965806
E01026770,1752,853,899,0.4868721461187215,0.5131278538812786
E01026771,1507,717,790,0.47577969475779697,0.5242203052422031
E01026772,1771,835,936,0.47148503670242803,0.528514963297572
E01026773,2058,963,1095,0.4679300291545189,0.532069970845481
E01026739,1913,906,1007,0.47360167276529014,0.5263983272347099
E01026763,1302,624,678,0.4792626728110599,0.5207373271889401
E01026764,1268,577,691,0.4550473186119874,0.5449526813880127
E01026765,1351,657,694,0.4863064396743153,0.5136935603256847
E01026734,1032,543,489,0.5261627906976745,0.4738372093023256
E01026735,1145,563,582,0.49170305676855897,0.508296943231441
E01026736,1293,621,672,0.4802784222737819,0.5197215777262181
E01026777,1308,621,687,0.47477064220183485,0.5252293577981652
E01026778,1366,630,736,0.4612005856515373,0.5387994143484627
E01026779,1399,662,737,0.4731951393852752,0.5268048606147248
E01026741,1736,809,927,0.46601382488479265,0.5339861751152074
E01026742,1824,880,944,0.4824561403508772,0.5175438596491229
E01026743,2191,1037,1154,0.4732998630762209,0.5267001369237791
E01026766,2356,1194,1162,0.5067911714770797,0.4932088285229202
E01026781,2015,999,1016,0.4957816377171216,0.5042183622828784
E01034774,1196,591,605,0.49414715719063546,0.5058528428093646
E01034775,1385,648,737,0.467870036101083,0.532129963898917
E01026733,2385,1163,1222,0.48763102725366875,0.5123689727463312
E01026737,2339,1186,1153,0.5070542967079948,0.49294570329200516
E01034776,2257,1082,1175,0.47939743021710235,0.5206025697828977
E01026738,2379,1173,1206,0.4930643127364439,0.5069356872635561
E01026750,1352,648,704,0.47928994082840237,0.5207100591715976
E01026751,1426,693,733,0.48597475455820477,0.5140252454417953
E01026752,1506,754,752,0.50066401062417,0.49933598937583
E01026729,2192,1080,1112,0.4927007299270073,0.5072992700729927
E01026730,2547,1233,1314,0.4840989399293286,0.5159010600706714
E01026788,1237,622,615,0.5028294260307195,0.4971705739692805
E01026780,2734,1356,1378,0.4959765910753475,0.5040234089246525
E01026782,2110,1036,1074,0.4909952606635071,0.5090047393364929
E01026787,1073,529,544,0.4930102516309413,0.5069897483690587
E01026745,1852,881,971,0.47570194384449244,0.5242980561555075
E01026746,1719,853,866,0.49621873182082604,0.5037812681791739
E01026747,1326,652,674,0.4917043740573152,0.5082956259426847
E01026748,1486,713,773,0.4798115746971736,0.5201884253028264
E01026749,1633,766,867,0.46907532149418246,0.5309246785058175
E01026740,2363,1203,1160,0.509098603470165,0.49090139652983494
E01026767,1223,601,622,0.49141455437448894,0.508585445625511
E01026768,1908,1242,666,0.6509433962264151,0.3490566037735849
E01026789,1160,573,587,0.4939655172413793,0.5060344827586207
E01026790,1192,561,631,0.47063758389261745,0.5293624161073825
E01026774,1703,840,863,0.4932472108044627,0.5067527891955372
E01026775,1296,629,667,0.4853395061728395,0.5146604938271605
E01026776,1784,873,911,0.48934977578475336,0.5106502242152466
E01026786,2020,1023,997,0.5064356435643564,0.49356435643564356
E01026744,2298,1112,1186,0.48389904264577893,0.516100957354221
E01026769,2061,993,1068,0.48180494905385735,0.5181950509461426
E01026783,1814,894,920,0.4928335170893054,0.5071664829106945
E01026784,1075,525,550,0.4883720930232558,0.5116279069767442
E01026785,1356,667,689,0.4918879056047198,0.5081120943952803
E01026753,1552,720,832,0.4639175257731959,0.5360824742268041
E01026754,1354,651,703,0.4807976366322009,0.5192023633677991
E01026755,1180,556,624,0.4711864406779661,0.5288135593220339
E01026756,1267,571,696,0.4506708760852407,0.5493291239147593
E01026757,1463,702,761,0.47983595352016406,0.5201640464798359
E01026758,1316,627,689,0.4764437689969605,0.5235562310030395
E01026759,1424,710,714,0.49859550561797755,0.5014044943820225
E01026760,1922,930,992,0.4838709677419355,0.5161290322580645
E01026761,1530,748,782,0.4888888888888889,0.5111111111111111
E01026797,2678,1394,1284,0.520537714712472,0.479462285287528
E01026798,1554,763,791,0.49099099099099097,0.509009009009009
E01026799,1566,769,797,0.49106002554278416,0.5089399744572158
E01026800,2138,1100,1038,0.5144995322731525,0.4855004677268475
E01026801,1570,781,789,0.49745222929936306,0.5025477707006369
E01026802,1672,854,818,0.5107655502392344,0.4892344497607656
E01026828,1692,810,882,0.4787234042553192,0.5212765957446809
E01026829,2175,1093,1082,0.5025287356321839,0.4974712643678161
E01026830,1367,670,697,0.49012435991221653,0.5098756400877835
E01026831,1317,684,633,0.5193621867881549,0.4806378132118451
E01026832,1495,761,734,0.5090301003344482,0.4909698996655518
E01026833,1564,800,764,0.5115089514066496,0.4884910485933504
E01026834,1594,781,813,0.48996235884567124,0.5100376411543287
E01026841,1434,732,702,0.5104602510460251,0.4895397489539749
E01026842,1751,882,869,0.5037121644774415,0.49628783552255856
E01026843,1910,945,965,0.49476439790575916,0.5052356020942408
E01026844,1866,940,926,0.5037513397642015,0.4962486602357985
E01026845,1576,782,794,0.49619289340101524,0.5038071065989848
E01026846,1815,909,906,0.5008264462809917,0.4991735537190083
E01026803,1557,725,832,0.46563904945407836,0.5343609505459217
E01026804,1531,750,781,0.48987589810581317,0.5101241018941868
E01026805,1533,738,795,0.48140900195694714,0.5185909980430529
E01026806,1566,1039,527,0.6634738186462324,0.33652618135376755
E01026807,1333,660,673,0.4951237809452363,0.5048762190547637
E01026808,1305,679,626,0.5203065134099617,0.4796934865900383
E01026809,1509,739,770,0.4897282968853545,0.5102717031146454
E01026791,1518,756,762,0.4980237154150198,0.5019762845849802
E01026792,1389,637,752,0.4586033117350612,0.5413966882649388
E01026793,1875,932,943,0.49706666666666666,0.5029333333333333
E01026794,2043,996,1047,0.48751835535976507,0.5124816446402349
E01026796,2065,964,1101,0.4668280871670702,0.5331719128329298
E01033435,2064,1039,1025,0.5033914728682171,0.49660852713178294
E01033436,2079,995,1084,0.4785954785954786,0.5214045214045214
E01026863,1981,976,1005,0.49268046441191315,0.5073195355880868
E01026864,1548,770,778,0.4974160206718346,0.5025839793281653
E01026865,2043,989,1054,0.48409202153695546,0.5159079784630446
E01026866,1687,852,835,0.5050385299347955,0.4949614700652045
E01026867,1681,822,859,0.48899464604402143,0.5110053539559786
E01026868,1785,853,932,0.4778711484593838,0.5221288515406163
E01026869,1539,771,768,0.5009746588693957,0.49902534113060426
E01026835,1512,742,770,0.49074074074074076,0.5092592592592593
E01026836,1504,723,781,0.480718085106383,0.519281914893617
E01026837,1472,712,760,0.483695652173913,0.5163043478260869
E01026838,1534,764,770,0.4980443285528031,0.5019556714471969
E01026839,1550,750,800,0.4838709677419355,0.5161290322580645
E01026840,1613,740,873,0.4587724736515809,0.5412275263484191
E01026858,1644,742,902,0.451338199513382,0.5486618004866181
E01026859,1628,724,904,0.44471744471744473,0.5552825552825553
E01026860,4487,2085,2402,0.4646757298863383,0.5353242701136617
E01026861,1753,867,886,0.4945807187678266,0.5054192812321734
E01026862,1356,640,716,0.471976401179941,0.528023598820059
E01026852,1323,609,714,0.4603174603174603,0.5396825396825397
E01026853,1949,956,993,0.4905079527963058,0.5094920472036942
E01026855,1709,806,903,0.4716208308952604,0.5283791691047396
E01026856,1781,825,956,0.46322290847838293,0.5367770915216171
E01026857,1545,683,862,0.44207119741100326,0.5579288025889968
E01033434,1146,579,567,0.5052356020942408,0.49476439790575916
E01033437,1486,765,721,0.5148048452220727,0.4851951547779273
E01026810,1621,748,873,0.46144355336212217,0.5385564466378778
E01026811,1573,741,832,0.47107438016528924,0.5289256198347108
E01026812,1615,797,818,0.4934984520123839,0.5065015479876162
E01026813,1418,674,744,0.47531734837799716,0.5246826516220028
E01026814,1650,750,900,0.45454545454545453,0.5454545454545454
E01026815,1499,696,803,0.46430953969312877,0.5356904603068713
E01026816,1880,923,957,0.4909574468085106,0.5090425531914894
E01026817,1494,756,738,0.5060240963855421,0.4939759036144578
E01026818,1591,762,829,0.47894406033940917,0.5210559396605908
E01026819,1488,727,761,0.4885752688172043,0.5114247311827957
E01026820,1883,889,994,0.4721189591078067,0.5278810408921933
E01026821,1632,768,864,0.47058823529411764,0.5294117647058824
E01033438,1923,983,940,0.5111804472178887,0.4888195527821113
E01033440,1561,853,708,0.5464445868033312,0.4535554131966688
E01033441,1400,751,649,0.5364285714285715,0.4635714285714286
E01035137,1009,578,431,0.5728444003964321,0.4271555996035679
E01035138,1218,657,561,0.5394088669950738,0.4605911330049261
E01026848,1865,958,907,0.5136729222520108,0.4863270777479893
E01026849,1778,956,822,0.5376827896512936,0.46231721034870643
E01026850,1920,984,936,0.5125,0.4875
E01026824,1780,898,882,0.5044943820224719,0.49550561797752807
E01026825,1430,724,706,0.5062937062937063,0.4937062937062937
E01026826,1636,818,818,0.5,0.5
E01026827,1617,794,823,0.49103277674706247,0.5089672232529375
E01026823,2157,1170,987,0.5424200278164116,0.4575799721835883
E01035139,2782,1295,1487,0.4654924514737599,0.5345075485262402
E01035140,1142,576,566,0.5043782837127846,0.4956217162872154
E01026881,1839,891,948,0.48450244698205547,0.5154975530179445
E01026883,2194,1059,1135,0.4826800364630811,0.5173199635369189
E01026895,1436,712,724,0.4958217270194986,0.5041782729805014
E01026896,1154,568,586,0.49220103986135183,0.5077989601386482
E01035141,1886,878,1008,0.46553552492046657,0.5344644750795334
E01035142,1446,688,758,0.47579529737206083,0.5242047026279392
E01026905,1021,473,548,0.4632713026444662,0.5367286973555337
E01026906,1771,872,899,0.4923771880293619,0.5076228119706381
E01026907,1906,886,1020,0.4648478488982162,0.5351521511017838
E01026908,2502,1221,1281,0.4880095923261391,0.511990407673861
E01026909,1464,680,784,0.4644808743169399,0.5355191256830601
E01026910,1619,788,831,0.48672019765287217,0.5132798023471279
E01026947,1424,681,743,0.4782303370786517,0.5217696629213483
E01026948,1900,936,964,0.4926315789473684,0.5073684210526316
E01026870,1535,747,788,0.4866449511400652,0.5133550488599349
E01026871,1214,591,623,0.4868204283360791,0.5131795716639209
E01026921,1274,623,651,0.489010989010989,0.510989010989011
E01026922,1440,670,770,0.4652777777777778,0.5347222222222222
E01026875,1107,540,567,0.4878048780487805,0.5121951219512195
E01026876,1531,734,797,0.47942521227955587,0.5205747877204442
E01026927,1777,884,893,0.4974676420934159,0.5025323579065841
E01026928,1902,920,982,0.48370136698212407,0.5162986330178759
E01026936,1752,845,907,0.4823059360730594,0.5176940639269406
E01026937,1552,746,806,0.4806701030927835,0.5193298969072165
E01035143,1377,664,713,0.4822076978939724,0.5177923021060276
E01035144,1710,813,897,0.47543859649122805,0.5245614035087719
E01026884,2508,1175,1333,0.46850079744816586,0.5314992025518341
E01026885,1603,802,801,0.5003119151590767,0.49968808484092325
E01035145,1452,712,740,0.4903581267217631,0.509641873278237
E01035146,1504,724,780,0.48138297872340424,0.5186170212765957
E01035147,1035,505,530,0.48792270531400966,0.5120772946859904
E01035148,1458,711,747,0.4876543209876543,0.5123456790123457
E01035149,3257,1556,1701,0.4777402517654283,0.5222597482345717
E01026879,1249,636,613,0.5092073658927142,0.49079263410728585
E01026880,1441,678,763,0.47050659264399725,0.5294934073560028
E01026911,1475,698,777,0.4732203389830508,0.5267796610169492
E01026912,1700,848,852,0.4988235294117647,0.5011764705882353
E01026929,1393,697,696,0.5003589375448672,0.4996410624551328
E01026930,1591,814,777,0.5116279069767442,0.4883720930232558
E01026913,1656,823,833,0.4969806763285024,0.5030193236714976
E01026914,1953,938,1015,0.48028673835125446,0.5197132616487455
E01026915,2048,1020,1028,0.498046875,0.501953125
E01026919,1494,705,789,0.4718875502008032,0.5281124497991968
E01026920,1196,594,602,0.49665551839464883,0.5033444816053512
E01026941,1239,618,621,0.49878934624697335,0.5012106537530266
E01026942,1099,546,553,0.4968152866242038,0.5031847133757962
E01026898,1464,733,731,0.5006830601092896,0.4993169398907104
E01026899,1610,772,838,0.4795031055900621,0.5204968944099378
E01026943,1511,761,750,0.5036399735274653,0.49636002647253474
E01026944,1254,644,610,0.5135566188197768,0.4864433811802233
E01026877,1566,760,806,0.48531289910600256,0.5146871008939975
E01026878,1230,604,626,0.49105691056910566,0.5089430894308943
E01026897,2798,1384,1414,0.49463902787705505,0.505360972122945
E01026938,2134,1038,1096,0.48641049671977504,0.5135895032802249
E01026939,1727,858,869,0.4968152866242038,0.5031847133757962
E01026940,2100,1026,1074,0.48857142857142855,0.5114285714285715
E01026892,1270,628,642,0.494488188976378,0.5055118110236221
E01026893,1281,640,641,0.4996096799375488,0.5003903200624512
E01026894,2547,1219,1328,0.4786022771888496,0.5213977228111504
E01026903,1161,580,581,0.49956933677863913,0.5004306632213609
E01026904,1370,662,708,0.4832116788321168,0.5167883211678832
E01026872,2293,1135,1158,0.4949847361535107,0.5050152638464893
E01026900,1495,735,760,0.4916387959866221,0.5083612040133779
E01026901,1312,637,675,0.48551829268292684,0.5144817073170732
E01026902,2448,1193,1255,0.48733660130718953,0.5126633986928104
E01026873,1236,618,618,0.5,0.5
E01026874,1544,766,778,0.4961139896373057,0.5038860103626943
E01026886,1324,648,676,0.48942598187311176,0.5105740181268882
E01026887,1600,775,825,0.484375,0.515625
E01026934,1037,524,513,0.5053037608486017,0.49469623915139826
E01026935,1349,670,679,0.4966641957005189,0.5033358042994811
E01026888,1647,784,863,0.47601700060716456,0.5239829993928354
E01026889,1541,744,797,0.4828033744321869,0.5171966255678131
E01026891,1740,862,878,0.4954022988505747,0.5045977011494253
E01026931,1083,526,557,0.4856879039704525,0.5143120960295475
E01026932,1335,663,672,0.4966292134831461,0.503370786516854
E01033539,2138,1038,1100,0.4855004677268475,0.5144995322731525
E01033541,1439,710,729,0.49339819318971506,0.5066018068102849
E01026924,1627,798,829,0.49047326367547633,0.5095267363245236
E01033540,1519,737,782,0.48518762343647137,0.5148123765635286
E01035150,1171,575,596,0.4910333048676345,0.5089666951323655
E01035151,1421,703,718,0.49472202674173116,0.5052779732582688
E01035152,1517,743,774,0.4897824653922215,0.5102175346077785
E01035153,1489,742,747,0.4983210208193418,0.5016789791806582
E01026916,2030,1007,1023,0.4960591133004926,0.5039408866995074
E01026917,1392,662,730,0.4755747126436782,0.5244252873563219
E01026918,1642,825,817,0.502436053593179,0.49756394640682094
E01026925,2470,1199,1271,0.4854251012145749,0.5145748987854251
E01029876,2201,1101,1100,0.5002271694684235,0.49977283053157656
E01029898,1922,917,1005,0.47710718002081165,0.5228928199791884
E01029907,2310,1120,1190,0.48484848484848486,0.5151515151515151
E01029881,2107,1006,1101,0.4774560987185572,0.5225439012814428
E01029884,1705,849,856,0.4979472140762463,0.5020527859237537
E01029885,2348,1179,1169,0.502129471890971,0.497870528109029
E01029900,1787,864,923,0.4834918858421936,0.5165081141578064
E01029901,2395,1178,1217,0.4918580375782881,0.508141962421712
E01029917,1998,964,1034,0.4824824824824825,0.5175175175175175
E01029892,1982,938,1044,0.47325933400605447,0.5267406659939455
E01029894,1121,544,577,0.4852809991079393,0.5147190008920607
E01029895,1176,569,607,0.483843537414966,0.516156462585034
E01029896,1295,581,714,0.4486486486486487,0.5513513513513514
E01029911,2257,1092,1165,0.4838280903854674,0.5161719096145325
E01034559,1748,861,887,0.4925629290617849,0.5074370709382151
E01034560,1433,668,765,0.46615491974877876,0.5338450802512212
E01029877,1374,709,665,0.5160116448326055,0.48398835516739447
E01029878,1207,584,623,0.48384424192212094,0.5161557580778791
E01029879,1684,838,846,0.497624703087886,0.502375296912114
E01029908,1607,804,803,0.5003111387678905,0.49968886123210954
E01029909,1560,768,792,0.49230769230769234,0.5076923076923077
E01029910,1198,569,629,0.4749582637729549,0.5250417362270451
E01029880,1876,925,951,0.49307036247334757,0.5069296375266524
E01029921,1234,604,630,0.48946515397082657,0.5105348460291734
E01029922,1580,769,811,0.48670886075949366,0.5132911392405063
E01029923,1431,703,728,0.4912648497554158,0.5087351502445842
E01029912,1887,911,976,0.48277689454160044,0.5172231054583996
E01029913,1078,494,584,0.4582560296846011,0.5417439703153989
E01029914,1583,783,800,0.49463044851547694,0.505369551484523
E01029915,1201,561,640,0.46711074104912575,0.5328892589508742
E01029916,1344,644,700,0.4791666666666667,0.5208333333333334
E01029918,1118,565,553,0.5053667262969589,0.49463327370304117
E01029919,1567,760,807,0.48500319081046583,0.5149968091895342
E01029920,1841,845,996,0.45898967952199893,0.5410103204780011
E01029886,1321,610,711,0.46177138531415596,0.538228614685844
E01029887,2022,978,1044,0.4836795252225519,0.516320474777448
E01029888,1305,615,690,0.47126436781609193,0.5287356321839081
E01029889,1377,640,737,0.4647785039941903,0.5352214960058097
E01029890,1741,870,871,0.4997128087306146,0.5002871912693854
E01029891,2184,1045,1139,0.4784798534798535,0.5215201465201466
E01029875,2382,1188,1194,0.4987405541561713,0.5012594458438288
E01029899,1795,879,916,0.48969359331476325,0.5103064066852367
E01029902,2167,1085,1082,0.5006922011998154,0.4993077988001846
E01029906,1856,880,976,0.47413793103448276,0.5258620689655172
E01029870,1153,551,602,0.4778837814397225,0.5221162185602776
E01029872,1456,725,731,0.49793956043956045,0.5020604395604396
E01029882,1522,725,797,0.4763469119579501,0.5236530880420499
E01029883,2026,1014,1012,0.5004935834155972,0.49950641658440276
E01029903,1489,731,758,0.49093351242444594,0.5090664875755541
E01029904,1618,773,845,0.4777503090234858,0.5222496909765142
E01029905,1174,567,607,0.4829642248722317,0.5170357751277683
E01029871,1344,633,711,0.47098214285714285,0.5290178571428571
E01029873,2154,1056,1098,0.49025069637883006,0.5097493036211699
E01029874,1644,794,850,0.4829683698296837,0.5170316301703163
E01029897,2457,1189,1268,0.48392348392348394,0.5160765160765161
E01030032,1518,754,764,0.49670619235836627,0.5032938076416338
E01030033,1505,731,774,0.4857142857142857,0.5142857142857142
E01030034,1439,680,759,0.47255038220986795,0.527449617790132
E01030035,1912,911,1001,0.4764644351464435,0.5235355648535565
E01030036,1913,943,970,0.4929430214323053,0.5070569785676947
E01029973,1471,730,741,0.49626104690686607,0.5037389530931339
E01029974,1559,767,792,0.4919820397690827,0.5080179602309173
E01029975,1305,641,664,0.49118773946360156,0.5088122605363985
E01029976,1564,768,796,0.49104859335038364,0.5089514066496164
E01029977,1533,771,762,0.50293542074364,0.49706457925636005
E01030027,2072,1070,1002,0.5164092664092664,0.48359073359073357
E01030028,1703,837,866,0.4914856136230182,0.5085143863769818
E01030029,1646,796,850,0.4835965978128797,0.5164034021871203
E01030030,2191,1097,1094,0.5006846188954815,0.4993153811045185
E01030031,1490,739,751,0.4959731543624161,0.5040268456375839
E01029997,1567,782,785,0.4990427568602425,0.5009572431397575
E01029998,1879,929,950,0.4944119212346993,0.5055880787653007
E01029999,1622,785,837,0.4839704069050555,0.5160295930949446
E01030000,1627,783,844,0.4812538414259373,0.5187461585740627
E01030001,1786,856,930,0.47928331466965285,0.5207166853303471
E01030007,2094,1044,1050,0.498567335243553,0.501432664756447
E01030008,1347,654,693,0.48552338530066813,0.5144766146993318
E01030009,1410,695,715,0.4929078014184397,0.5070921985815603
E01030010,1972,976,996,0.4949290060851927,0.5050709939148073
E01030011,1565,768,797,0.4907348242811502,0.5092651757188499
E01030022,2188,1122,1066,0.5127970749542962,0.48720292504570384
E01030023,2074,1022,1052,0.4927675988428158,0.5072324011571842
E01030024,2013,1076,937,0.5345255837059115,0.4654744162940884
E01030025,1927,1021,906,0.5298391281785159,0.4701608718214842
E01030026,1998,959,1039,0.47997997997998,0.52002002002002
E01029958,1392,677,715,0.4863505747126437,0.5136494252873564
E01029960,2021,990,1031,0.48985650667986147,0.5101434933201385
E01029961,1523,770,753,0.505581089954038,0.4944189100459619
E01029962,1628,841,787,0.5165847665847666,0.4834152334152334
E01033124,1051,642,409,0.6108468125594672,0.38915318744053284
E01033125,1405,741,664,0.5274021352313167,0.47259786476868326
E01033129,1672,915,757,0.5472488038277512,0.4527511961722488
E01030002,1980,1030,950,0.5202020202020202,0.4797979797979798
E01030003,1771,843,928,0.47600225861095424,0.5239977413890458
E01030004,1256,630,626,0.5015923566878981,0.4984076433121019
E01030005,2930,1433,1497,0.48907849829351535,0.5109215017064846
E01030006,1762,880,882,0.49943246311010214,0.5005675368898979
E01029963,1619,803,816,0.49598517603458925,0.5040148239654108
E01029964,1391,713,678,0.5125808770668584,0.4874191229331416
E01029965,1465,721,744,0.49215017064846417,0.5078498293515359
E01029966,1647,849,798,0.5154826958105647,0.48451730418943534
E01029967,1325,612,713,0.4618867924528302,0.5381132075471698
E01029984,1658,814,844,0.49095295536791317,0.5090470446320868
E01029985,2513,1308,1205,0.5204934341424592,0.4795065658575408
E01029986,1571,762,809,0.48504137492043287,0.5149586250795671
E01029987,1553,741,812,0.4771410173857051,0.5228589826142949
E01029988,2102,1113,989,0.5294957183634633,0.4705042816365366
E01029990,1544,777,767,0.5032383419689119,0.49676165803108807
E01029991,1589,807,782,0.5078665827564506,0.4921334172435494
E01029992,1328,624,704,0.46987951807228917,0.5301204819277109
E01033123,1758,888,870,0.5051194539249146,0.4948805460750853
E01033126,1902,930,972,0.4889589905362776,0.5110410094637224
E01029968,1581,786,795,0.4971537001897533,0.5028462998102466
E01029969,1545,721,824,0.4666666666666667,0.5333333333333333
E01029970,1725,866,859,0.5020289855072464,0.4979710144927536
E01029971,1546,743,803,0.48059508408796897,0.5194049159120311
E01033122,2307,1112,1195,0.48201127004768096,0.517988729952319
E01033130,1137,638,499,0.5611257695690414,0.4388742304309587
E01030012,1175,579,596,0.4927659574468085,0.5072340425531915
E01030013,1529,729,800,0.47678221059516024,0.5232177894048398
E01030014,1460,683,777,0.4678082191780822,0.5321917808219178
E01030015,1258,616,642,0.48966613672496023,0.5103338632750397
E01030016,1354,675,679,0.4985228951255539,0.5014771048744461
E01029994,1647,828,819,0.5027322404371585,0.4972677595628415
E01029995,1685,875,810,0.5192878338278932,0.4807121661721068
E01029996,1676,797,879,0.4755369928400955,0.5244630071599046
E01033127,1685,810,875,0.4807121661721068,0.5192878338278932
E01033128,1173,586,587,0.49957374254049447,0.5004262574595055
E01033131,1785,850,935,0.47619047619047616,0.5238095238095238
E01030017,1432,691,741,0.4825418994413408,0.5174581005586593
E01030018,1550,755,795,0.4870967741935484,0.5129032258064516
E01030019,1479,761,718,0.5145368492224476,0.4854631507775524
E01030020,1384,668,716,0.48265895953757226,0.5173410404624278
E01030021,1436,666,770,0.4637883008356546,0.5362116991643454
E01029978,1279,643,636,0.5027365129007036,0.49726348709929635
E01029979,1632,800,832,0.49019607843137253,0.5098039215686274
E01029980,1649,779,870,0.4724075197089145,0.5275924802910855
E01029981,1214,579,635,0.4769357495881384,0.5230642504118617
E01029982,1481,730,751,0.49291019581363943,0.5070898041863605
E01029983,1592,789,803,0.4956030150753769,0.5043969849246231
E01030052,2210,1032,1178,0.4669683257918552,0.5330316742081448
E01030058,2036,996,1040,0.48919449901768175,0.5108055009823183
E01030064,2478,1213,1265,0.48950766747376917,0.5104923325262308
E01030088,1232,592,640,0.4805194805194805,0.5194805194805194
E01030039,1413,698,715,0.49398443029016276,0.5060155697098372
E01030054,1435,711,724,0.49547038327526133,0.5045296167247387
E01030055,1482,749,733,0.5053981106612686,0.49460188933873145
E01030066,1586,783,803,0.4936948297604035,0.5063051702395964
E01030067,1318,616,702,0.4673748103186646,0.5326251896813353
E01030068,1759,868,891,0.49346219442865263,0.5065378055713473
E01030053,2280,1128,1152,0.49473684210526314,0.5052631578947369
E01030090,2496,1239,1257,0.4963942307692308,0.5036057692307693
E01034570,1753,855,898,0.4877353108956075,0.5122646891043925
E01034571,1004,515,489,0.5129482071713147,0.48705179282868527
E01030040,1267,611,656,0.48224151539068666,0.5177584846093133
E01030049,1874,943,931,0.5032017075773746,0.4967982924226254
E01030050,2393,1176,1217,0.49143334726285,0.5085666527371501
E01030084,1723,849,874,0.4927452118398143,0.5072547881601858
E01030085,1613,797,816,0.4941103533787973,0.5058896466212027
E01030037,1217,606,611,0.4979457682826623,0.5020542317173378
E01030038,1151,553,598,0.48045178105994785,0.5195482189400521
E01030059,2424,1175,1249,0.48473597359735976,0.5152640264026402
E01030081,2585,1260,1325,0.4874274661508704,0.5125725338491296
E01030051,1798,879,919,0.4888765294771969,0.5111234705228032
E01030056,2199,1065,1134,0.4843110504774898,0.5156889495225102
E01030065,2149,1082,1067,0.5034899953466728,0.4965100046533271
E01030086,1199,577,622,0.48123436196830693,0.5187656380316931
E01030089,2091,1024,1067,0.48971783835485416,0.5102821616451458
E01030048,2442,1170,1272,0.47911547911547914,0.5208845208845209
E01030057,2309,1153,1156,0.4993503681247293,0.5006496318752707
E01030083,2282,1158,1124,0.5074496056091148,0.4925503943908852
E01030087,1315,660,655,0.5019011406844106,0.49809885931558934
E01030073,1544,752,792,0.48704663212435234,0.5129533678756477
E01030077,1489,673,816,0.4519811954331766,0.5480188045668234
E01030079,1488,694,794,0.46639784946236557,0.5336021505376344
E01030080,1638,813,825,0.49633699633699635,0.5036630036630036
E01030063,2552,1250,1302,0.4898119122257053,0.5101880877742947
E01030069,1455,731,724,0.5024054982817869,0.49759450171821307
E01030072,1637,791,846,0.4832009773976787,0.5167990226023214
E01030075,2094,1033,1061,0.4933142311365807,0.5066857688634193
E01030060,1539,739,800,0.4801819363222872,0.5198180636777128
E01030071,1441,687,754,0.4767522553782096,0.5232477446217905
E01030076,1623,816,807,0.5027726432532348,0.49722735674676527
E01030078,1600,803,797,0.501875,0.498125
E01033316,2034,1011,1023,0.4970501474926254,0.5029498525073747
E01033317,1805,927,878,0.5135734072022161,0.48642659279778394
E01033319,2752,1370,1382,0.49781976744186046,0.5021802325581395
E01030041,2314,1144,1170,0.4943820224719101,0.5056179775280899
E01030043,2481,1238,1243,0.4989923417976622,0.5010076582023377
E01030061,1702,820,882,0.481786133960047,0.518213866039953
E01030062,1474,739,735,0.5013568521031208,0.49864314789687925
E01030070,1871,1141,730,0.6098343132014965,0.3901656867985035
E01030042,1726,853,873,0.4942062572421784,0.5057937427578215
E01030044,1309,623,686,0.47593582887700536,0.5240641711229946
E01030045,1724,842,882,0.48839907192575405,0.511600928074246
E01030046,1670,816,854,0.48862275449101794,0.511377245508982
E01030047,1223,595,628,0.48650858544562553,0.5134914145543745
E01023690,1740,830,910,0.47701149425287354,0.5229885057471264
E01023691,1477,734,743,0.4969532836831415,0.5030467163168585
E01023692,1252,584,668,0.46645367412140576,0.5335463258785943
E01023693,1519,756,763,0.4976958525345622,0.5023041474654378
E01023694,1742,879,863,0.5045924225028703,0.4954075774971297
E01023685,1733,858,875,0.49509521061742645,0.5049047893825735
E01023686,1593,786,807,0.4934086629001883,0.5065913370998116
E01023687,1517,728,789,0.4798945286750165,0.5201054713249835
E01023688,1541,773,768,0.5016223231667748,0.4983776768332252
E01023689,1494,762,732,0.5100401606425703,0.4899598393574297
E01023699,1622,777,845,0.4790382244143033,0.5209617755856967
E01023700,1375,680,695,0.49454545454545457,0.5054545454545455
E01023701,1932,912,1020,0.4720496894409938,0.5279503105590062
E01023702,1656,803,853,0.48490338164251207,0.5150966183574879
E01023703,1519,744,775,0.4897959183673469,0.5102040816326531
E01023746,1603,754,849,0.4703680598877105,0.5296319401122894
E01023747,1812,848,964,0.46799116997792495,0.5320088300220751
E01023748,1403,678,725,0.4832501781895937,0.5167498218104063
E01023749,1898,917,981,0.48314014752370915,0.5168598524762908
E01023695,1662,828,834,0.4981949458483754,0.5018050541516246
E01023696,1805,896,909,0.496398891966759,0.503601108033241
E01023697,1883,917,966,0.48698884758364314,0.5130111524163569
E01023698,1523,745,778,0.4891661195009849,0.5108338804990151
E01023722,1458,725,733,0.49725651577503427,0.5027434842249657
E01023723,1741,848,893,0.4870763928776565,0.5129236071223435
E01023724,1658,749,909,0.4517490952955368,0.5482509047044632
E01023725,1546,748,798,0.48382923673997413,0.5161707632600259
E01023713,2059,978,1081,0.47498785818358424,0.5250121418164158
E01023734,1629,819,810,0.5027624309392266,0.4972375690607735
E01023735,1676,798,878,0.47613365155131265,0.5238663484486874
E01023736,1640,793,847,0.48353658536585364,0.5164634146341464
E01023709,1725,818,907,0.4742028985507246,0.5257971014492754
E01023710,1599,799,800,0.4996873045653533,0.5003126954346466
E01023711,1632,808,824,0.4950980392156863,0.5049019607843137
E01023712,2019,1010,1009,0.5002476473501734,0.49975235264982665
E01023669,1777,835,942,0.469893078221722,0.530106921778278
E01023670,2101,991,1110,0.4716801523084246,0.5283198476915755
E01023671,1948,900,1048,0.4620123203285421,0.5379876796714579
E01023672,1916,912,1004,0.4759916492693111,0.524008350730689
E01023673,1441,693,748,0.48091603053435117,0.5190839694656488
E01023714,1786,878,908,0.4916013437849944,0.5083986562150056
E01023715,1601,776,825,0.48469706433479076,0.5153029356652092
E01023716,2112,1017,1095,0.4815340909090909,0.5184659090909091
E01023666,1979,983,996,0.4967155128852956,0.5032844871147044
E01023674,1884,920,964,0.4883227176220807,0.5116772823779193
E01023675,1382,685,697,0.4956584659913169,0.5043415340086831
E01023676,2557,1298,1259,0.5076261243644896,0.4923738756355104
E01023726,2059,1046,1013,0.5080135988343856,0.4919864011656144
E01023727,2191,1108,1083,0.505705157462346,0.49429484253765404
E01023728,2210,1087,1123,0.4918552036199095,0.5081447963800905
E01035566,1314,665,649,0.5060882800608828,0.4939117199391172
E01035567,1275,636,639,0.4988235294117647,0.5011764705882353
E01023664,1909,912,997,0.4777370350969094,0.5222629649030907
E01023665,1762,869,893,0.4931895573212259,0.5068104426787742
E01023667,1462,704,758,0.48153214774281805,0.518467852257182
E01023668,1407,711,696,0.5053304904051172,0.4946695095948827
E01023742,1910,905,1005,0.4738219895287958,0.5261780104712042
E01023743,2016,990,1026,0.49107142857142855,0.5089285714285714
E01023744,1567,790,777,0.5041480536056159,0.4958519463943842
E01023745,1800,876,924,0.4866666666666667,0.5133333333333333
E01023681,1578,785,793,0.49746514575411915,0.5025348542458808
E01023682,1828,891,937,0.48741794310722103,0.512582056892779
E01023683,1712,821,891,0.47955607476635514,0.5204439252336449
E01023684,1570,769,801,0.48980891719745223,0.5101910828025478
E01023737,1380,665,715,0.48188405797101447,0.5181159420289855
E01023738,1663,804,859,0.4834636199639206,0.5165363800360794
E01023739,1593,749,844,0.4701820464532329,0.5298179535467671
E01023740,1452,724,728,0.4986225895316804,0.5013774104683195
E01023741,1621,790,831,0.4873534855027761,0.512646514497224
E01023704,1549,745,804,0.48095545513234345,0.5190445448676565
E01023705,1791,852,939,0.47571189279731996,0.52428810720268
E01023706,1664,796,868,0.47836538461538464,0.5216346153846154
E01023708,1580,768,812,0.4860759493670886,0.5139240506329114
E01033028,1525,774,751,0.5075409836065574,0.49245901639344264
E01033029,1690,811,879,0.4798816568047337,0.5201183431952663
E01023718,1768,870,898,0.4920814479638009,0.5079185520361991
E01023719,1218,570,648,0.46798029556650245,0.5320197044334976
E01023720,2054,1047,1007,0.5097370983446933,0.4902629016553067
E01023721,1393,669,724,0.48025843503230436,0.5197415649676956
E01023717,1351,674,677,0.4988897113249445,0.5011102886750555
E01023730,1783,883,900,0.4952327537857543,0.5047672462142456
E01023731,1558,776,782,0.4980744544287548,0.5019255455712451
E01023732,1614,760,854,0.4708798017348203,0.5291201982651796
E01023733,1911,910,1001,0.47619047619047616,0.5238095238095238
E01023677,1277,639,638,0.5003915426781519,0.49960845732184805
E01023678,1932,952,980,0.4927536231884058,0.5072463768115942
E01023680,1480,765,715,0.5168918918918919,0.4831081081081081
E01035581,1577,765,812,0.4850982878883957,0.5149017121116043
E01023965,1447,721,726,0.49827228749136143,0.5017277125086386
E01023966,1700,830,870,0.48823529411764705,0.5117647058823529
E01023967,1409,679,730,0.48190205819730303,0.518097941802697
E01023971,1645,829,816,0.503951367781155,0.496048632218845
E01023968,1365,658,707,0.48205128205128206,0.517948717948718
E01023969,1449,690,759,0.47619047619047616,0.5238095238095238
E01023970,1983,957,1026,0.4826021180030257,0.5173978819969742
E01033310,1791,903,888,0.5041876046901173,0.49581239530988275
E01033313,1548,739,809,0.47739018087855295,0.522609819121447
E01023959,1349,658,691,0.4877687175685693,0.5122312824314307
E01023960,1643,804,839,0.4893487522824102,0.5106512477175897
E01023961,1474,683,791,0.4633649932157395,0.5366350067842606
E01023962,1505,727,778,0.4830564784053156,0.5169435215946844
E01023912,1546,774,772,0.500646830530401,0.49935316946959896
E01023913,1320,639,681,0.48409090909090907,0.5159090909090909
E01023914,1674,788,886,0.47072879330943845,0.5292712066905615
E01023915,1579,765,814,0.4844838505383154,0.5155161494616846
E01023950,1593,795,798,0.4990583804143126,0.5009416195856874
E01023951,1702,873,829,0.5129259694477086,0.4870740305522914
E01023952,1609,759,850,0.47172156619018024,0.5282784338098198
E01023953,1383,693,690,0.5010845986984815,0.49891540130151846
E01023916,1687,792,895,0.46947243627741553,0.5305275637225845
E01023917,1758,844,914,0.4800910125142207,0.5199089874857793
E01023918,1857,861,996,0.46365105008077545,0.5363489499192245
E01023919,1630,785,845,0.4815950920245399,0.5184049079754601
E01023955,1509,721,788,0.4777998674618953,0.5222001325381047
E01023956,1351,667,684,0.49370836417468544,0.5062916358253146
E01023957,1454,725,729,0.4986244841815681,0.5013755158184319
E01023958,1491,685,806,0.45942320590207913,0.5405767940979208
E01035604,1275,613,662,0.4807843137254902,0.5192156862745098
E01035605,1707,850,857,0.4979496192149971,0.502050380785003
E01023943,1592,755,837,0.4742462311557789,0.5257537688442211
E01023944,2219,1091,1128,0.4916629112212708,0.5083370887787292
E01023945,1693,823,870,0.4861193148257531,0.5138806851742469
E01023946,2291,1158,1133,0.505456132693147,0.4945438673068529
E01023939,1175,574,601,0.48851063829787233,0.5114893617021277
E01023940,1816,864,952,0.47577092511013214,0.5242290748898678
E01023942,1767,845,922,0.47821165817770234,0.5217883418222977
E01035606,1878,936,942,0.4984025559105431,0.5015974440894568
E01035607,1209,608,601,0.5028949545078577,0.49710504549214224
E01023929,1782,870,912,0.4882154882154882,0.5117845117845118
E01023930,1675,837,838,0.49970149253731344,0.5002985074626866
E01023938,2390,1155,1235,0.48326359832635984,0.5167364016736402
E01033308,2946,1462,1484,0.49626612355736593,0.5037338764426341
E01033311,1516,751,765,0.4953825857519789,0.5046174142480211
E01033314,2247,1190,1057,0.5295950155763239,0.470404984423676
E01023924,1787,953,834,0.5332960268606604,0.4667039731393397
E01023925,1747,861,886,0.4928448769318832,0.5071551230681167
E01023926,1885,955,930,0.506631299734748,0.493368700265252
E01023927,1866,937,929,0.5021436227224009,0.4978563772775991
E01023920,1626,821,805,0.504920049200492,0.495079950799508
E01023921,2372,1250,1122,0.5269814502529511,0.4730185497470489
E01023922,1902,957,945,0.5031545741324921,0.4968454258675079
E01023923,2331,1200,1131,0.5148005148005148,0.4851994851994852
E01023932,1883,933,950,0.49548592671269254,0.5045140732873075
E01023934,1375,742,633,0.5396363636363637,0.46036363636363636
E01023935,2642,1253,1389,0.47426192278576834,0.5257380772142316
E01023936,2189,1082,1107,0.49428962996802195,0.505710370031978
E01023937,2316,1172,1144,0.5060449050086355,0.4939550949913644
E01023908,1715,875,840,0.5102040816326531,0.4897959183673469
E01023909,1323,615,708,0.46485260770975056,0.5351473922902494
E01023910,1421,703,718,0.49472202674173116,0.5052779732582688
E01023911,1692,781,911,0.46158392434988177,0.5384160756501182
E01023947,1757,847,910,0.4820717131474104,0.5179282868525896
E01023948,1783,875,908,0.4907459338194055,0.5092540661805945
E01023949,2102,1040,1062,0.49476688867745006,0.50523311132255
E01023933,1515,733,782,0.48382838283828383,0.5161716171617162
E01023963,2361,1172,1189,0.4963998305802626,0.5036001694197374
E01035608,1610,721,889,0.44782608695652176,0.5521739130434783
E01023462,1387,686,701,0.494592645998558,0.505407354001442
E01023465,1633,829,804,0.5076546233925291,0.4923453766074709
E01023466,2140,1052,1088,0.491588785046729,0.508411214953271
E01035587,1751,840,911,0.47972587093089664,0.5202741290691034
E01035588,1291,622,669,0.4817970565453137,0.5182029434546863
E01035589,1116,567,549,0.5080645161290323,0.49193548387096775
E01023452,1303,617,686,0.47352264006139677,0.5264773599386032
E01023453,2074,1017,1057,0.49035679845708774,0.5096432015429122
E01023454,2227,1106,1121,0.49663224068253253,0.5033677593174675
E01023455,1363,672,691,0.4930300807043287,0.5069699192956714
E01023463,1351,672,679,0.49740932642487046,0.5025906735751295
E01023493,2512,1275,1237,0.5075636942675159,0.4924363057324841
E01023449,1819,914,905,0.502473886750962,0.49752611324903795
E01023451,2307,1098,1209,0.4759427828348505,0.5240572171651495
E01035590,1610,773,837,0.48012422360248447,0.5198757763975155
E01035591,1131,565,566,0.4995579133510168,0.5004420866489832
E01023438,1527,741,786,0.48526522593320237,0.5147347740667977
E01023439,1417,703,714,0.49611856033874385,0.5038814396612562
E01023440,1737,842,895,0.48474381116868165,0.5152561888313184
E01023441,1523,732,791,0.48063033486539725,0.5193696651346028
E01023442,2256,1101,1155,0.488031914893617,0.511968085106383
E01023506,1573,769,804,0.4888747616020343,0.5111252383979656
E01023507,1704,841,863,0.4935446009389671,0.5064553990610329
E01035592,1078,515,563,0.4777365491651206,0.5222634508348795
E01035593,1893,956,937,0.5050184891706286,0.49498151082937136
E01023443,1403,670,733,0.4775481111903065,0.5224518888096935
E01023444,1905,972,933,0.510236220472441,0.48976377952755906
E01023445,1734,851,883,0.49077277970011535,0.5092272202998847
E01023447,1326,604,722,0.4555052790346908,0.5444947209653092
E01023448,1472,723,749,0.49116847826086957,0.5088315217391305
E01035594,1451,671,780,0.46243969676085456,0.5375603032391454
E01035595,1083,540,543,0.4986149584487535,0.5013850415512465
E01023456,1336,665,671,0.4977544910179641,0.5022455089820359
E01023457,1472,715,757,0.4857336956521739,0.514266304347826
E01023458,1380,721,659,0.5224637681159421,0.47753623188405797
E01023459,1291,617,674,0.47792408985282725,0.5220759101471727
E01023460,1545,782,763,0.5061488673139158,0.49385113268608416
E01023461,1557,759,798,0.48747591522157996,0.51252408477842
E01023491,1361,658,703,0.4834680382072006,0.5165319617927994
E01023492,2205,1091,1114,0.4947845804988662,0.5052154195011338
E01023496,1416,705,711,0.4978813559322034,0.5021186440677966
E01023497,1680,819,861,0.4875,0.5125
E01023485,2270,1123,1147,0.4947136563876652,0.5052863436123348
E01023486,2643,1302,1341,0.492622020431328,0.5073779795686719
E01033609,2616,1299,1317,0.49655963302752293,0.5034403669724771
E01023499,2183,1072,1111,0.49106733852496565,0.5089326614750344
E01023500,1667,820,847,0.49190161967606477,0.5080983803239352
E01023501,1570,760,810,0.4840764331210191,0.5159235668789809
E01023502,1731,838,893,0.48411322934719814,0.5158867706528019
E01023503,1591,805,786,0.5059710873664363,0.4940289126335638
E01023512,2071,986,1085,0.4760985031385804,0.5239014968614196
E01023513,1506,733,773,0.4867197875166003,0.5132802124833997
E01023514,2130,960,1170,0.4507042253521127,0.5492957746478874
E01023518,2166,1041,1125,0.4806094182825485,0.5193905817174516
E01023519,1747,848,899,0.48540354894104176,0.5145964510589582
E01023520,1619,809,810,0.4996911673872761,0.5003088326127239
E01023510,1621,767,854,0.473164713140037,0.526835286859963
E01023511,1638,794,844,0.48473748473748474,0.5152625152625152
E01023515,1670,830,840,0.49700598802395207,0.5029940119760479
E01023516,1919,936,983,0.4877540385617509,0.5122459614382491
E01023517,1541,751,790,0.4873458792991564,0.5126541207008436
E01023470,1774,839,935,0.47294250281848926,0.5270574971815107
E01023471,1421,705,716,0.49612948627726955,0.5038705137227305
E01023472,1367,644,723,0.47110460863204096,0.528895391367959
E01023473,1768,869,899,0.4915158371040724,0.5084841628959276
E01023474,1569,770,799,0.49075844486934356,0.5092415551306565
E01023487,1564,753,811,0.48145780051150894,0.518542199488491
E01023488,1684,819,865,0.48634204275534443,0.5136579572446556
E01023489,1369,666,703,0.4864864864864865,0.5135135135135135
E01023490,1296,641,655,0.49459876543209874,0.5054012345679012
E01023482,1919,947,972,0.4934861907243356,0.5065138092756644
E01023483,2424,1198,1226,0.49422442244224424,0.5057755775577558
E01023484,1632,816,816,0.5,0.5
E01023475,1462,689,773,0.47127222982216144,0.5287277701778386
E01023476,1720,840,880,0.4883720930232558,0.5116279069767442
E01023477,2185,1067,1118,0.48832951945080094,0.5116704805491991
E01023479,1596,764,832,0.47869674185463656,0.5213032581453634
E01035596,1366,702,664,0.513909224011713,0.486090775988287
E01035597,1303,639,664,0.4904067536454336,0.5095932463545664
E01023468,1284,644,640,0.5015576323987538,0.4984423676012461
E01023469,1467,704,763,0.47989093387866394,0.520109066121336
E01023480,1665,784,881,0.4708708708708709,0.5291291291291291
E01023481,1877,942,935,0.5018646776771444,0.4981353223228556
E01023504,1435,684,751,0.47665505226480837,0.5233449477351917
E01023505,1659,812,847,0.48945147679324896,0.510548523206751
E01023467,2352,1155,1197,0.49107142857142855,0.5089285714285714
E01023494,1631,779,852,0.4776210913549969,0.522378908645003
E01023495,1326,692,634,0.521870286576169,0.4781297134238311
E01023509,1367,679,688,0.4967081199707388,0.5032918800292612
E01035609,1439,721,718,0.5010423905489924,0.49895760945100764
E01023787,1477,751,726,0.5084631008801624,0.4915368991198375
E01023788,1606,811,795,0.5049813200498132,0.4950186799501868
E01023790,1729,866,863,0.5008675534991325,0.4991324465008676
E01035568,1517,723,794,0.47659854976928145,0.5234014502307185
E01035569,1813,894,919,0.4931053502482074,0.5068946497517927
E01023776,2680,1341,1339,0.5003731343283582,0.4996268656716418
E01023777,1819,919,900,0.5052226498075866,0.4947773501924134
E01023778,1774,856,918,0.48252536640360766,0.5174746335963923
E01023799,1348,659,689,0.48887240356083084,0.5111275964391692
E01023800,2178,1048,1130,0.48117539026629935,0.5188246097337006
E01023801,2433,1208,1225,0.49650637073571724,0.5034936292642828
E01023771,1614,783,831,0.4851301115241636,0.5148698884758365
E01023772,1785,920,865,0.5154061624649859,0.484593837535014
E01023773,1341,635,706,0.4735272184936615,0.5264727815063386
E01023774,1683,846,837,0.5026737967914439,0.49732620320855614
E01023795,1662,782,880,0.470517448856799,0.529482551143201
E01023796,1531,734,797,0.47942521227955587,0.5205747877204442
E01023797,1357,653,704,0.4812085482682388,0.5187914517317612
E01023798,1528,783,745,0.512434554973822,0.487565445026178
E01023775,2302,1151,1151,0.5,0.5
E01023779,1743,853,890,0.48938611589214,0.51061388410786
E01023780,1441,751,690,0.5211658570437196,0.47883414295628035
E01023781,1916,911,1005,0.4754697286012526,0.5245302713987474
E01023782,1396,706,690,0.505730659025788,0.49426934097421205
E01023759,1502,693,809,0.4613848202396804,0.5386151797603196
E01023760,1551,728,823,0.4693745970341715,0.5306254029658285
E01023761,2178,1061,1117,0.4871441689623508,0.5128558310376492
E01023762,1595,782,813,0.490282131661442,0.509717868338558
E01023755,1699,828,871,0.48734549735138316,0.5126545026486168
E01023756,1701,849,852,0.4991181657848324,0.5008818342151675
E01023757,2010,958,1052,0.4766169154228856,0.5233830845771145
E01035570,1280,646,634,0.5046875,0.4953125
E01035571,1365,692,673,0.5069597069597069,0.49304029304029307
E01023750,1224,579,645,0.4730392156862745,0.5269607843137255
E01023751,1195,577,618,0.48284518828451883,0.5171548117154812
E01023752,1463,718,745,0.49077238550922764,0.5092276144907724
E01023753,1679,834,845,0.49672424061941634,0.5032757593805837
E01023754,1326,667,659,0.5030165912518854,0.49698340874811464
E01023791,1693,852,841,0.503248670998228,0.496751329001772
E01023792,1650,806,844,0.48848484848484847,0.5115151515151515
E01023793,1507,757,750,0.5023224950232249,0.49767750497677504
E01023794,1624,793,831,0.4883004926108374,0.5116995073891626
E01023783,1703,884,819,0.5190839694656488,0.48091603053435117
E01023784,1600,771,829,0.481875,0.518125
E01023785,1942,953,989,0.49073120494335737,0.5092687950566427
E01023786,1885,943,942,0.5002652519893899,0.4997347480106101
E01023763,1540,801,739,0.5201298701298701,0.4798701298701299
E01023764,1286,647,639,0.5031104199066874,0.4968895800933126
E01023765,1595,776,819,0.4865203761755486,0.5134796238244514
E01023766,1598,769,829,0.4812265331664581,0.518773466833542
E01023767,1512,743,769,0.4914021164021164,0.5085978835978836
E01023769,1754,873,881,0.4977194982896237,0.5022805017103763
E01023770,1498,739,759,0.493324432576769,0.5066755674232309
E01035582,1670,856,814,0.5125748502994012,0.4874251497005988
E01030201,2142,1069,1073,0.49906629318394025,0.5009337068160598
E01030219,2020,998,1022,0.49405940594059405,0.505940594059406
E01030222,2098,1029,1069,0.49046711153479505,0.509532888465205
E01030154,2174,1060,1114,0.48758049678012877,0.5124195032198712
E01030172,2153,1017,1136,0.47236414305620067,0.5276358569437993
E01030173,2256,1060,1196,0.4698581560283688,0.5301418439716312
E01030174,1401,689,712,0.4917915774446824,0.5082084225553176
E01030176,2073,1004,1069,0.4843222383019778,0.5156777616980222
E01030186,1650,795,855,0.4818181818181818,0.5181818181818182
E01030208,1287,623,664,0.4840714840714841,0.515928515928516
E01030209,2273,1106,1167,0.4865816102067752,0.5134183897932248
E01030210,2505,1170,1335,0.46706586826347307,0.5329341317365269
E01030212,1984,952,1032,0.4798387096774194,0.5201612903225806
E01030152,2043,919,1124,0.4498286833088595,0.5501713166911405
E01030153,1169,550,619,0.4704875962360992,0.5295124037639007
E01030187,1608,789,819,0.4906716417910448,0.5093283582089553
E01030188,1687,846,841,0.5014819205690575,0.4985180794309425
E01030189,1599,753,846,0.4709193245778612,0.5290806754221389
E01030193,2060,1026,1034,0.4980582524271845,0.5019417475728155
E01030194,1794,864,930,0.4816053511705686,0.5183946488294314
E01030195,1584,751,833,0.4741161616161616,0.5258838383838383
E01030220,2232,1050,1182,0.47043010752688175,0.5295698924731183
E01030175,2405,1165,1240,0.48440748440748443,0.5155925155925156
E01030200,2230,1096,1134,0.4914798206278027,0.5085201793721973
E01030221,2148,1056,1092,0.49162011173184356,0.5083798882681564
E01030199,1758,870,888,0.4948805460750853,0.5051194539249146
E01033443,1589,926,663,0.5827564505978603,0.4172435494021397
E01033445,1744,853,891,0.48910550458715596,0.510894495412844
E01033446,2876,1766,1110,0.614047287899861,0.3859527121001391
E01033448,1285,640,645,0.4980544747081712,0.5019455252918288
E01033449,1906,934,972,0.4900314795383001,0.5099685204616999
E01030155,1999,970,1029,0.4852426213106553,0.5147573786893447
E01030185,1995,949,1046,0.4756892230576441,0.5243107769423558
E01030203,1972,918,1054,0.46551724137931033,0.5344827586206896
E01030211,1913,847,1066,0.4427600627286984,0.5572399372713016
E01030179,2742,1323,1419,0.4824945295404814,0.5175054704595186
E01030180,1380,673,707,0.48768115942028983,0.5123188405797101
E01030183,1898,944,954,0.49736564805057953,0.5026343519494204
E01030184,1699,808,891,0.4755738669805768,0.5244261330194232
E01030207,1606,781,825,0.4863013698630137,0.5136986301369864
E01030181,1948,991,957,0.5087268993839835,0.4912731006160164
E01030190,2348,1148,1200,0.4889267461669506,0.5110732538330494
E01030191,1504,740,764,0.4920212765957447,0.5079787234042553
E01030192,1361,663,698,0.4871418074944893,0.5128581925055107
E01030198,1344,662,682,0.49255952380952384,0.5074404761904762
E01033442,1588,780,808,0.491183879093199,0.5088161209068011
E01033444,1540,764,776,0.4961038961038961,0.5038961038961038
E01033447,1459,704,755,0.48252227553118576,0.5174777244688142
E01030196,1562,779,783,0.49871959026888607,0.501280409731114
E01030197,1818,873,945,0.4801980198019802,0.5198019801980198
E01030204,1899,941,958,0.4955239599789363,0.5044760400210637
E01030205,1291,646,645,0.5003872966692486,0.49961270333075136
E01030206,1476,736,740,0.4986449864498645,0.5013550135501355
E01030171,1852,912,940,0.4924406047516199,0.5075593952483801
E01030214,1214,608,606,0.500823723228995,0.49917627677100496
E01030215,1676,851,825,0.5077565632458234,0.4922434367541766
E01030216,1480,706,774,0.47702702702702704,0.522972972972973
E01030217,1432,718,714,0.5013966480446927,0.49860335195530725
E01030218,1485,709,776,0.47744107744107744,0.5225589225589226
E01030158,1456,700,756,0.4807692307692308,0.5192307692307693
E01030159,1487,746,741,0.5016812373907196,0.49831876260928043
E01030164,1531,704,827,0.4598301763553233,0.5401698236446767
E01030166,1454,677,777,0.4656121045392022,0.5343878954607978
E01033450,2310,1078,1232,0.4666666666666667,0.5333333333333333
E01030160,1558,742,816,0.4762516046213094,0.5237483953786907
E01030161,1688,835,853,0.4946682464454976,0.5053317535545023
E01030168,1418,680,738,0.4795486600846262,0.5204513399153737
E01030169,1577,805,772,0.5104629042485732,0.4895370957514268
E01030170,1697,797,900,0.4696523276370065,0.5303476723629935
E01030162,1484,728,756,0.49056603773584906,0.5094339622641509
E01030163,1791,856,935,0.47794528196538244,0.5220547180346176
E01030165,1707,829,878,0.4856473345049795,0.5143526654950205
E01030167,1324,627,697,0.4735649546827795,0.5264350453172205
E01030240,1573,758,815,0.4818817546090273,0.5181182453909726
E01030241,1473,721,752,0.4894772572980312,0.5105227427019687
E01030242,1398,658,740,0.47067238912732473,0.5293276108726752
E01030259,1143,573,570,0.5013123359580053,0.49868766404199477
E01030260,1051,530,521,0.5042816365366318,0.49571836346336823
E01030261,1510,728,782,0.4821192052980132,0.5178807947019868
E01030262,1281,611,670,0.4769711163153786,0.5230288836846214
E01030277,1168,555,613,0.4751712328767123,0.5248287671232876
E01030279,1415,682,733,0.48197879858657244,0.5180212014134276
E01030281,2609,1232,1377,0.4722115753162131,0.5277884246837868
E01030266,1623,782,841,0.4818237831176833,0.5181762168823167
E01030267,2201,1082,1119,0.49159472966833256,0.5084052703316674
E01030271,1418,691,727,0.48730606488011285,0.5126939351198871
E01030278,1539,723,816,0.4697855750487329,0.530214424951267
E01030280,1366,673,693,0.49267935578330896,0.5073206442166911
E01030246,1413,694,719,0.49115357395612175,0.5088464260438783
E01030248,1573,737,836,0.46853146853146854,0.5314685314685315
E01030249,1784,872,912,0.48878923766816146,0.5112107623318386
E01030250,2032,1085,947,0.5339566929133859,0.4660433070866142
E01030264,1491,697,794,0.4674714956405097,0.5325285043594903
E01030265,1440,702,738,0.4875,0.5125
E01030255,1276,637,639,0.4992163009404389,0.5007836990595611
E01030263,1489,733,756,0.4922766957689725,0.5077233042310275
E01030270,1564,744,820,0.47570332480818417,0.5242966751918159
E01030289,1505,751,754,0.49900332225913624,0.5009966777408638
E01030290,1455,711,744,0.488659793814433,0.511340206185567
E01030233,1462,708,754,0.4842681258549932,0.5157318741450069
E01030235,1496,753,743,0.5033422459893048,0.4966577540106952
E01030268,1313,632,681,0.48134044173648133,0.5186595582635186
E01030269,1636,799,837,0.4883863080684597,0.5116136919315404
E01030288,1416,674,742,0.4759887005649718,0.5240112994350282
E01030247,1892,936,956,0.49471458773784355,0.5052854122621564
E01030254,1408,650,758,0.4616477272727273,0.5383522727272727
E01030256,1516,790,726,0.521108179419525,0.4788918205804749
E01030258,1598,882,716,0.5519399249061326,0.44806007509386736
E01030276,1220,589,631,0.48278688524590163,0.5172131147540984
E01030257,1538,733,805,0.476592977893368,0.523407022106632
E01030274,1201,547,654,0.45545378850957535,0.5445462114904246
E01030275,1153,539,614,0.46747614917606245,0.5325238508239376
E01030287,1376,627,749,0.45566860465116277,0.5443313953488372
E01030291,1473,730,743,0.4955872369314325,0.5044127630685675
E01030234,1552,736,816,0.4742268041237113,0.5257731958762887
E01030236,1861,895,966,0.48092423428264375,0.5190757657173563
E01030237,2912,1392,1520,0.47802197802197804,0.521978021978022
E01030238,1753,856,897,0.4883057615516258,0.5116942384483743
E01030223,1798,857,941,0.47664071190211343,0.5233592880978866
E01030224,1638,759,879,0.4633699633699634,0.5366300366300366
E01030225,1597,765,832,0.47902316844082654,0.5209768315591734
E01030227,1485,712,773,0.4794612794612795,0.5205387205387205
E01030228,1695,808,887,0.4766961651917404,0.5233038348082596
E01030226,1853,910,943,0.4910955207771182,0.5089044792228818
E01030286,2109,1047,1062,0.49644381223328593,0.5035561877667141
E01030292,1436,705,731,0.4909470752089137,0.5090529247910863
E01030293,1664,806,858,0.484375,0.515625
E01030294,1425,691,734,0.4849122807017544,0.5150877192982456
E01030239,1912,942,970,0.49267782426778245,0.5073221757322176
E01030251,1489,734,755,0.49294828744123576,0.5070517125587642
E01030252,1704,830,874,0.48708920187793425,0.5129107981220657
E01030253,1823,871,952,0.4777838727372463,0.5222161272627537
E01030272,1545,718,827,0.4647249190938511,0.5352750809061488
E01030273,1456,682,774,0.4684065934065934,0.5315934065934066
E01030230,1801,868,933,0.4819544697390339,0.5180455302609661
E01030231,1527,728,799,0.4767518009168304,0.5232481990831697
E01030232,1682,828,854,0.49227110582639716,0.5077288941736029
E01030285,2251,1155,1096,0.5131052865393159,0.48689471346068414
E01030283,1318,615,703,0.4666160849772382,0.5333839150227617
E01030295,2346,1188,1158,0.5063938618925832,0.4936061381074169
E01035154,2179,1008,1171,0.4625975217989904,0.5374024782010096
E01030229,2147,1043,1104,0.48579413134606425,0.5142058686539357
E01030243,1517,742,775,0.4891232696110745,0.5108767303889256
E01030244,1804,843,961,0.4672949002217295,0.5327050997782705
E01030245,1605,791,814,0.4928348909657321,0.5071651090342679
E01029926,1664,804,860,0.4831730769230769,0.5168269230769231
E01029927,2426,1215,1211,0.5008244023083265,0.4991755976916735
E01029928,1853,932,921,0.5029681597409607,0.4970318402590394
E01029929,2150,1094,1056,0.5088372093023256,0.49116279069767443
E01029930,1597,812,785,0.5084533500313086,0.4915466499686913
E01029942,1576,784,792,0.49746192893401014,0.5025380710659898
E01029944,1688,828,860,0.490521327014218,0.509478672985782
E01034561,1607,827,780,0.5146235220908525,0.48537647790914745
E01034562,2538,1522,1016,0.5996847911741529,0.40031520882584715
E01034563,1313,670,643,0.5102817974105103,0.4897182025894897
E01029945,2334,1159,1175,0.49657240788346185,0.5034275921165381
E01032523,2196,1247,949,0.5678506375227687,0.43214936247723135
E01032524,1224,611,613,0.4991830065359477,0.5008169934640523
E01032526,1891,974,917,0.5150713907985193,0.4849286092014807
E01034564,1251,725,526,0.5795363709032774,0.42046362909672264
E01034565,1333,651,682,0.4883720930232558,0.5116279069767442
E01029938,1522,728,794,0.4783180026281209,0.5216819973718791
E01029939,1601,869,732,0.542785758900687,0.4572142410993129
E01029940,1323,632,691,0.47770219198790626,0.5222978080120937
E01029946,2144,1076,1068,0.5018656716417911,0.498134328358209
E01029947,2253,1138,1115,0.5051043053706169,0.49489569462938304
E01029941,1843,908,935,0.49267498643516006,0.5073250135648399
E01029957,2252,1051,1201,0.466696269982238,0.533303730017762
E01033452,1662,827,835,0.49759326113116725,0.5024067388688327
E01033454,1788,919,869,0.5139821029082774,0.4860178970917226
E01034566,1970,978,992,0.4964467005076142,0.5035532994923858
E01034567,1125,545,580,0.48444444444444446,0.5155555555555555
E01029937,2318,1135,1183,0.4896462467644521,0.5103537532355479
E01029953,1353,676,677,0.49963045084996305,0.500369549150037
E01029955,1751,896,855,0.5117075956596231,0.4882924043403769
E01029956,1448,712,736,0.49171270718232046,0.5082872928176796
E01034568,1202,607,595,0.5049916805324459,0.4950083194675541
E01034569,1259,573,686,0.4551231135822081,0.5448768864177919
E01030095,1226,579,647,0.4722675367047308,0.5277324632952691
E01030096,1452,707,745,0.4869146005509642,0.5130853994490359
E01030097,1245,620,625,0.4979919678714859,0.5020080321285141
E01030145,1429,685,744,0.4793561931420574,0.5206438068579426
E01030146,1487,719,768,0.4835238735709482,0.5164761264290518
E01030094,1418,697,721,0.4915373765867419,0.5084626234132581
E01030121,2297,1099,1198,0.47845015237266,0.52154984762734
E01030132,1516,946,570,0.6240105540897097,0.3759894459102902
E01030133,1368,690,678,0.5043859649122807,0.4956140350877193
E01030130,1396,678,718,0.48567335243553006,0.5143266475644699
E01030131,1252,606,646,0.4840255591054313,0.5159744408945687
E01030139,1620,810,810,0.5,0.5
E01030140,1229,606,623,0.49308380797396256,0.5069161920260374
E01030141,1502,736,766,0.49001331557922767,0.5099866844207723
E01030104,2572,1255,1317,0.4879471228615863,0.5120528771384136
E01030138,2448,1208,1240,0.4934640522875817,0.5065359477124183
E01034572,1639,829,810,0.5057962172056132,0.4942037827943868
E01034573,1569,745,824,0.4748247291268324,0.5251752708731676
E01030127,1126,560,566,0.49733570159857904,0.5026642984014209
E01030128,1309,655,654,0.5003819709702063,0.49961802902979374
E01030129,1318,630,688,0.4779969650986343,0.5220030349013657
E01033044,1403,709,694,0.5053456878118318,0.4946543121881682
E01033045,1321,665,656,0.5034065102195306,0.49659348978046935
E01033050,1211,609,602,0.5028901734104047,0.49710982658959535
E01030091,1835,905,930,0.49318801089918257,0.5068119891008175
E01030093,1616,816,800,0.504950495049505,0.49504950495049505
E01030137,1605,812,793,0.5059190031152648,0.4940809968847352
E01033043,1149,525,624,0.45691906005221933,0.5430809399477807
E01033046,1078,594,484,0.5510204081632653,0.4489795918367347
E01033047,1096,540,556,0.4927007299270073,0.5072992700729927
E01030092,1485,722,763,0.4861952861952862,0.5138047138047138
E01030123,1653,892,761,0.5396249243799153,0.4603750756200847
E01030124,1596,774,822,0.4849624060150376,0.5150375939849624
E01030125,1383,665,718,0.48083875632682577,0.5191612436731743
E01030148,1179,560,619,0.47497879558948264,0.5250212044105174
E01030149,1451,712,739,0.4906960716747071,0.5093039283252929
E01030098,2592,1250,1342,0.48225308641975306,0.5177469135802469
E01030100,2202,1082,1120,0.4913714804722979,0.508628519527702
E01030119,2211,1055,1156,0.47715965626413387,0.5228403437358661
E01030134,1233,594,639,0.48175182481751827,0.5182481751824818
E01030135,1495,731,764,0.4889632107023411,0.5110367892976588
E01030142,1624,739,885,0.45504926108374383,0.5449507389162561
E01030143,1411,693,718,0.4911410347271439,0.5088589652728561
E01030144,1267,601,666,0.47434885556432516,0.5256511444356748
E01030147,1467,704,763,0.47989093387866394,0.520109066121336
E01033048,1414,647,767,0.45756718528995755,0.5424328147100425
E01033049,1141,519,622,0.4548641542506573,0.5451358457493427
E01030099,1953,971,982,0.4971838197644649,0.5028161802355351
E01030101,2279,1054,1225,0.46248354541465553,0.5375164545853445
E01030150,2289,1149,1140,0.5019659239842726,0.4980340760157274
E01030122,2215,1072,1143,0.48397291196388265,0.5160270880361174
E01030151,2581,1276,1305,0.4943820224719101,0.5056179775280899
E01034574,2350,1803,547,0.7672340425531915,0.2327659574468085
E01034575,1107,532,575,0.48057813911472447,0.5194218608852755
E01030109,1820,842,978,0.46263736263736266,0.5373626373626373
E01030110,2761,1334,1427,0.48315827598696126,0.5168417240130387
E01030111,1332,657,675,0.49324324324324326,0.5067567567567568
E01030112,1817,919,898,0.5057787561915245,0.4942212438084755
E01030115,2305,1132,1173,0.4911062906724512,0.5088937093275488
E01030116,2245,1125,1120,0.5011135857461024,0.49888641425389757
E01030117,1519,777,742,0.511520737327189,0.48847926267281105
E01030118,1480,734,746,0.49594594594594593,0.504054054054054
E01030105,1782,919,863,0.5157126823793491,0.48428731762065097
E01030106,2310,1104,1206,0.4779220779220779,0.522077922077922
E01030107,1590,806,784,0.5069182389937107,0.4930817610062893
E01030108,1852,898,954,0.48488120950323976,0.5151187904967602
E01030113,2111,1047,1064,0.49597347228801514,0.5040265277119849
E01030114,1504,744,760,0.4946808510638298,0.5053191489361702
E01029925,1852,1007,845,0.5437365010799136,0.4562634989200864
E01029949,1539,751,788,0.48797920727745286,0.5120207927225471
E01029950,1766,877,889,0.49660249150622876,0.5033975084937712
E01029951,1342,661,681,0.49254843517138597,0.507451564828614
E01029952,1220,562,658,0.460655737704918,0.5393442622950819
E01032612,2032,1061,971,0.5221456692913385,0.4778543307086614
E01000001,1475,789,686,0.5349152542372881,0.46508474576271186
E01000002,1384,777,607,0.5614161849710982,0.43858381502890176
E01000003,1613,858,755,0.5319280843149411,0.4680719156850589
E01000005,1100,555,545,0.5045454545454545,0.4954545454545455
E01032739,1619,982,637,0.6065472513897467,0.39345274861025326
E01032740,1392,761,631,0.5466954022988506,0.45330459770114945
E01000027,2082,965,1117,0.46349663784822287,0.5365033621517772
E01000028,1817,842,975,0.4634012107870116,0.5365987892129884
E01000029,1819,914,905,0.502473886750962,0.49752611324903795
E01000030,2563,1198,1365,0.46742099102614126,0.5325790089738588
E01000031,1770,866,904,0.48926553672316386,0.5107344632768361
E01000032,2078,1029,1049,0.4951876804619827,0.5048123195380173
E01000110,1573,785,788,0.4990464081373172,0.5009535918626827
E01000111,2152,1016,1136,0.4721189591078067,0.5278810408921933
E01000112,1971,968,1003,0.4911212582445459,0.5088787417554541
E01000113,1995,1044,951,0.5233082706766917,0.4766917293233083
E01000034,1575,750,825,0.47619047619047616,0.5238095238095238
E01000037,1697,861,836,0.5073659398939304,0.4926340601060695
E01000038,1616,771,845,0.4771039603960396,0.5228960396039604
E01000039,1751,863,888,0.49286122215876643,0.5071387778412336
E01000063,1779,914,865,0.5137717818999438,0.48622821810005623
E01000100,1942,912,1030,0.46961894953656025,0.5303810504634398
E01000101,1699,829,870,0.48793407886992346,0.5120659211300765
E01000114,2419,1204,1215,0.49772633319553533,0.5022736668044646
E01034469,1745,813,932,0.4659025787965616,0.5340974212034384
E01034470,1499,730,769,0.48699132755170116,0.5130086724482988
E01000033,1543,739,804,0.47893713545042127,0.5210628645495787
E01000060,2180,1025,1155,0.4701834862385321,0.5298165137614679
E01000061,1925,886,1039,0.46025974025974026,0.5397402597402597
E01000062,2218,1063,1155,0.4792605951307484,0.5207394048692516
E01000064,2296,1097,1199,0.477787456445993,0.5222125435540069
E01000065,1982,981,1001,0.49495459132189706,0.5050454086781029
E01000078,1899,903,996,0.4755134281200632,0.5244865718799369
E01000080,1779,887,892,0.4985947161326588,0.5014052838673412
E01000081,1976,963,1013,0.4873481781376518,0.5126518218623481
E01000082,1912,925,987,0.4837866108786611,0.516213389121339
E01000083,1919,881,1038,0.4590932777488275,0.5409067222511725
E01000102,1785,855,930,0.4789915966386555,0.5210084033613446
E01000021,1693,837,856,0.4943886591848789,0.505611340815121
E01000022,1476,714,762,0.483739837398374,0.516260162601626
E01000024,1485,739,746,0.49764309764309766,0.5023569023569023
E01000025,1917,989,928,0.5159102764736567,0.4840897235263432
E01000077,1721,849,872,0.49331783846600813,0.5066821615339918
E01034471,2686,1300,1386,0.48399106478034254,0.5160089352196575
E01034472,1885,872,1013,0.4625994694960212,0.5374005305039787
E01000015,2418,1131,1287,0.46774193548387094,0.532258064516129
E01000016,1851,870,981,0.4700162074554295,0.5299837925445705
E01000017,1724,826,898,0.4791183294663573,0.5208816705336426
E01000018,1776,868,908,0.48873873873873874,0.5112612612612613
E01000079,1716,818,898,0.4766899766899767,0.5233100233100233
E01000035,1859,920,939,0.49488972565895645,0.5051102743410436
E01000036,1470,721,749,0.49047619047619045,0.5095238095238095
E01000107,1786,860,926,0.48152295632698766,0.5184770436730123
E01000108,1915,920,995,0.4804177545691906,0.5195822454308094
E01000066,2496,1188,1308,0.47596153846153844,0.5240384615384616
E01000067,2237,1102,1135,0.49262405006705406,0.5073759499329459
E01000069,2096,1096,1000,0.5229007633587787,0.4770992366412214
E01000070,2073,1042,1031,0.502653159671973,0.497346840328027
E01000071,2606,1310,1296,0.5026861089792786,0.49731389102072143
E01000057,1550,715,835,0.4612903225806452,0.5387096774193548
E01000073,1848,895,953,0.4843073593073593,0.5156926406926406
E01000074,1759,846,913,0.480955088118249,0.519044911881751
E01000075,2078,1047,1031,0.5038498556304138,0.49615014436958615
E01000076,2161,1022,1139,0.4729291994447015,0.5270708005552984
E01000013,1871,901,970,0.481560662747194,0.518439337252806
E01000014,1751,856,895,0.48886350656767563,0.5111364934323244
E01000059,1705,812,893,0.47624633431085045,0.5237536656891496
E01000084,1438,702,736,0.48817802503477054,0.5118219749652295
E01000085,1646,780,866,0.4738760631834751,0.5261239368165249
E01000086,1449,690,759,0.47619047619047616,0.5238095238095238
E01000103,1774,865,909,0.48759864712514095,0.5124013528748591
E01000104,1915,912,1003,0.4762402088772846,0.5237597911227154
E01000105,2332,1122,1210,0.4811320754716981,0.5188679245283019
E01000106,2207,1057,1150,0.4789306751246035,0.5210693248753965
E01000007,2908,1447,1461,0.49759284731774417,0.5024071526822559
E01000008,1795,847,948,0.471866295264624,0.528133704735376
E01000012,2347,1153,1194,0.49126544524925436,0.5087345547507456
E01034473,1266,656,610,0.5181674565560821,0.48183254344391785
E01034474,2252,1118,1134,0.49644760213143874,0.5035523978685613
E01000006,1845,943,902,0.5111111111111111,0.4888888888888889
E01000009,1805,949,856,0.5257617728531856,0.4742382271468144
E01000011,1701,912,789,0.5361552028218695,0.4638447971781305
E01000044,1988,959,1029,0.4823943661971831,0.5176056338028169
E01000068,1795,951,844,0.5298050139275766,0.4701949860724234
E01000041,1842,906,936,0.49185667752442996,0.50814332247557
E01000042,1882,930,952,0.49415515409139216,0.5058448459086079
E01000045,1725,836,889,0.4846376811594203,0.5153623188405797
E01000046,1956,940,1016,0.48057259713701433,0.5194274028629857
E01000072,2149,1039,1110,0.48348068869241506,0.5165193113075849
E01000054,1873,901,972,0.4810464495461826,0.5189535504538174
E01000055,1705,844,861,0.4950146627565982,0.5049853372434018
E01000056,1702,786,916,0.4618096357226792,0.5381903642773208
E01000058,2135,1025,1110,0.48009367681498827,0.5199063231850117
E01000095,2252,1096,1156,0.4866785079928952,0.5133214920071048
E01000040,1879,932,947,0.4960085151676424,0.5039914848323577
E01000043,1537,776,761,0.5048796356538712,0.4951203643461288
E01000050,1839,918,921,0.499184339314845,0.5008156606851549
E01000052,2368,1165,1203,0.49197635135135137,0.5080236486486487
E01034475,1829,927,902,0.5068343357025697,0.4931656642974303
E01034476,1821,869,952,0.4772103239978034,0.5227896760021966
E01034477,1582,746,836,0.4715549936788875,0.5284450063211125
E01034478,1198,613,585,0.511686143572621,0.48831385642737896
E01000053,1617,791,826,0.48917748917748916,0.5108225108225108
E01000087,1636,796,840,0.48655256723716384,0.5134474327628362
E01000088,1975,961,1014,0.48658227848101265,0.5134177215189873
E01000089,1824,875,949,0.47971491228070173,0.5202850877192983
E01000090,1707,840,867,0.492091388400703,0.507908611599297
E01000049,1973,933,1040,0.4728839330968069,0.5271160669031931
E01000051,1107,547,560,0.4941282746160795,0.5058717253839206
E01033587,2453,1209,1244,0.49286587851610275,0.5071341214838972
E01034479,2205,1088,1117,0.49342403628117915,0.5065759637188209
E01000091,2091,1013,1078,0.4844571975131516,0.5155428024868484
E01000093,1809,886,923,0.4897733554449972,0.5102266445550028
E01000094,2461,1168,1293,0.4746038195855343,0.5253961804144657
E01000096,1658,773,885,0.4662243667068758,0.5337756332931243
E01000019,1657,838,819,0.5057332528666264,0.49426674713337354
E01000020,2191,1053,1138,0.48060246462802375,0.5193975353719763
E01000097,1933,929,1004,0.48060010346611487,0.5193998965338852
E01000098,1936,939,997,0.4850206611570248,0.5149793388429752
E01000099,2778,1320,1458,0.47516198704103674,0.5248380129589633
E01032580,1546,755,791,0.4883570504527814,0.5116429495472187
E01000248,1703,819,884,0.48091603053435117,0.5190839694656488
E01000249,1612,784,828,0.48635235732009924,0.5136476426799007
E01000250,2609,1229,1380,0.4710617094672288,0.5289382905327712
E01000254,1600,793,807,0.495625,0.504375
E01000292,1544,759,785,0.49158031088082904,0.508419689119171
E01000293,1772,826,946,0.46613995485327314,0.5338600451467269
E01000167,1389,676,713,0.4866810655147588,0.5133189344852411
E01000246,1520,728,792,0.4789473684210526,0.5210526315789473
E01000247,1696,825,871,0.486438679245283,0.5135613207547169
E01000251,2262,1040,1222,0.45977011494252873,0.5402298850574713
E01000252,1715,812,903,0.47346938775510206,0.5265306122448979
E01000166,1620,792,828,0.4888888888888889,0.5111111111111111
E01000168,1516,744,772,0.49076517150395776,0.5092348284960422
E01000169,1631,780,851,0.47823421213979156,0.5217657878602084
E01000172,1690,817,873,0.4834319526627219,0.5165680473372781
E01000285,1515,713,802,0.47062706270627064,0.5293729372937294
E01000287,1629,748,881,0.45917740945365254,0.5408225905463474
E01000288,1548,766,782,0.49483204134366926,0.5051679586563308
E01000289,1583,741,842,0.4680985470625395,0.5319014529374605
E01000291,1561,762,799,0.48814862267777065,0.5118513773222293
E01000294,1811,876,935,0.48371065709552735,0.5162893429044727
E01000267,1527,731,796,0.47871643745907005,0.5212835625409299
E01000268,2075,1018,1057,0.4906024096385542,0.5093975903614458
E01000269,1386,667,719,0.48124098124098125,0.5187590187590188
E01000270,1545,775,770,0.5016181229773463,0.49838187702265374
E01000170,1907,906,1001,0.47509176717357104,0.524908232826429
E01000171,2291,1118,1173,0.4879965080750764,0.5120034919249236
E01000173,1690,828,862,0.48994082840236686,0.5100591715976331
E01000174,1759,848,911,0.48209209778283113,0.5179079022171689
E01000175,2031,1051,980,0.517479074347612,0.48252092565238797
E01000228,1436,684,752,0.4763231197771588,0.5236768802228412
E01000253,1981,974,1007,0.491670873296315,0.508329126703685
E01000279,1365,661,704,0.48424908424908425,0.5157509157509158
E01000280,1334,634,700,0.4752623688155922,0.5247376311844077
E01000286,1717,839,878,0.48864298194525335,0.5113570180547466
E01000290,1621,809,812,0.49907464528069095,0.5009253547193091
E01000271,1638,777,861,0.47435897435897434,0.5256410256410257
E01000272,1426,670,756,0.46984572230014027,0.5301542776998598
E01000273,1670,757,913,0.4532934131736527,0.5467065868263473
E01000281,1789,858,931,0.4795975405254332,0.5204024594745668
E01000282,1808,894,914,0.4944690265486726,0.5055309734513275
E01000115,1395,691,704,0.4953405017921147,0.5046594982078854
E01000116,1745,835,910,0.4785100286532951,0.5214899713467048
E01000119,1793,878,915,0.48968209704406024,0.5103179029559398
E01000120,1495,748,747,0.5003344481605351,0.49966555183946487
E01000122,1511,753,758,0.4983454665784249,0.5016545334215751
E01000117,1737,832,905,0.4789867587795049,0.5210132412204951
E01000118,2049,986,1063,0.48121034651049294,0.5187896534895071
E01000121,1477,707,770,0.4786729857819905,0.5213270142180095
E01000123,1762,865,897,0.4909194097616345,0.5090805902383655
E01000124,1867,904,963,0.48419925013390464,0.5158007498660954
E01000265,1923,914,1009,0.4752990119604784,0.5247009880395216
E01000266,1435,713,722,0.4968641114982578,0.5031358885017422
E01000274,1936,939,997,0.4850206611570248,0.5149793388429752
E01000320,1934,919,1015,0.4751809720785936,0.5248190279214064
E01000322,1859,845,1014,0.45454545454545453,0.5454545454545454
E01000275,1740,834,906,0.4793103448275862,0.5206896551724138
E01000277,1652,785,867,0.475181598062954,0.524818401937046
E01000283,1371,670,701,0.4886943836615609,0.5113056163384391
E01000284,1806,876,930,0.4850498338870432,0.5149501661129569
E01000321,1961,964,997,0.4915859255481897,0.5084140744518103
E01000195,2019,1023,996,0.5066864784546805,0.4933135215453195
E01000229,1670,818,852,0.48982035928143713,0.5101796407185629
E01000230,1959,957,1002,0.4885145482388974,0.5114854517611026
E01000231,1789,849,940,0.47456679709334826,0.5254332029066517
E01000232,1871,919,952,0.4911811865312667,0.5088188134687333
E01000233,1938,932,1006,0.4809081527347781,0.5190918472652218
E01000186,1771,855,916,0.4827780914737436,0.5172219085262564
E01000187,1737,837,900,0.48186528497409326,0.5181347150259067
E01000188,1578,766,812,0.48542458808618505,0.514575411913815
E01000189,2469,1163,1306,0.4710409072498987,0.5289590927501012
E01000190,1731,840,891,0.4852686308492201,0.5147313691507799
E01000191,1549,787,762,0.5080697224015494,0.4919302775984506
E01000158,1464,691,773,0.4719945355191257,0.5280054644808743
E01000159,1786,880,906,0.49272116461366183,0.5072788353863382
E01000160,1955,970,985,0.4961636828644501,0.5038363171355499
E01000161,2034,962,1072,0.4729596853490659,0.5270403146509341
E01000162,1649,783,866,0.47483323226197693,0.5251667677380231
E01000324,1831,889,942,0.4855270344074276,0.5144729655925724
E01000256,1928,882,1046,0.4574688796680498,0.5425311203319502
E01000258,1892,946,946,0.5,0.5
E01000263,1524,753,771,0.4940944881889764,0.5059055118110236
E01000264,1823,913,910,0.5008228195282501,0.49917718047174986
E01000255,1700,822,878,0.4835294117647059,0.5164705882352941
E01000257,2090,985,1105,0.47129186602870815,0.5287081339712919
E01000261,1769,838,931,0.47371396269078575,0.5262860373092142
E01033911,1878,927,951,0.4936102236421725,0.5063897763578274
E01033912,1703,824,879,0.4838520258367587,0.5161479741632413
E01000192,1997,960,1037,0.48072108162243365,0.5192789183775663
E01000193,1948,939,1009,0.4820328542094456,0.5179671457905544
E01000194,1906,906,1000,0.4753410283315845,0.5246589716684156
E01000226,1735,821,914,0.4731988472622478,0.5268011527377522
E01000227,1869,929,940,0.4970572498662386,0.5029427501337613
E01000299,2219,1092,1127,0.4921135646687697,0.5078864353312302
E01000300,1667,794,873,0.47630473905218956,0.5236952609478105
E01000302,1799,881,918,0.48971650917176207,0.5102834908282379
E01000317,1582,748,834,0.47281921618204803,0.527180783817952
E01000318,1924,906,1018,0.4708939708939709,0.5291060291060291
E01000323,2367,1253,1114,0.5293620616814533,0.47063793831854667
E01000276,1537,741,796,0.48210800260247233,0.5178919973975277
E01000278,1479,748,731,0.5057471264367817,0.4942528735632184
E01000301,1495,726,769,0.48561872909698994,0.51438127090301
E01000303,1502,709,793,0.47203728362183756,0.5279627163781625
E01000304,1557,757,800,0.4861913937058446,0.5138086062941555
E01000130,1939,948,991,0.4889118102114492,0.5110881897885508
E01000132,1617,766,851,0.47371675943104513,0.5262832405689548
E01000133,1645,786,859,0.4778115501519757,0.5221884498480243
E01000234,1781,843,938,0.47332959011791126,0.5266704098820887
E01000235,1862,904,958,0.48549946294307195,0.514500537056928
E01000156,2026,964,1062,0.47581441263573543,0.5241855873642646
E01000157,1582,776,806,0.49051833122629585,0.5094816687737042
E01000163,1693,773,920,0.45658594211458947,0.5434140578854105
E01000164,1713,842,871,0.4915353181552831,0.5084646818447168
E01000165,1812,852,960,0.47019867549668876,0.5298013245033113
E01000315,1699,813,886,0.4785167745732784,0.5214832254267217
E01000197,1851,884,967,0.4775796866558617,0.5224203133441383
E01000295,1615,769,846,0.4761609907120743,0.5238390092879257
E01000296,1785,864,921,0.48403361344537815,0.5159663865546219
E01000298,1711,837,874,0.489187609585038,0.510812390414962
E01000127,1557,730,827,0.46885035324341684,0.5311496467565832
E01000128,2049,1010,1039,0.49292337725719865,0.5070766227428014
E01000129,1604,789,815,0.4918952618453865,0.5081047381546134
E01000131,2021,985,1036,0.487382483918852,0.5126175160811479
E01000134,1824,880,944,0.4824561403508772,0.5175438596491229
E01033913,1529,717,812,0.46893394375408765,0.5310660562459124
E01033914,1813,905,908,0.4991726420297849,0.5008273579702152
E01000198,2193,1059,1134,0.4829001367989056,0.5170998632010944
E01000199,1580,739,841,0.46772151898734177,0.5322784810126582
E01000204,1703,799,904,0.46917204932472106,0.5308279506752789
E01000259,2643,1264,1379,0.4782444192205827,0.5217555807794173
E01000260,2166,1025,1141,0.4732225300092336,0.5267774699907664
E01000126,2274,1073,1201,0.47185576077396657,0.5281442392260334
E01000151,1721,838,883,0.48692620569436373,0.5130737943056363
E01000152,2693,1302,1391,0.4834756776828815,0.5165243223171184
E01000153,1929,914,1015,0.4738206324520477,0.5261793675479524
E01000154,1915,907,1008,0.47362924281984337,0.5263707571801567
E01000176,1722,881,841,0.5116144018583043,0.4883855981416957
E01000178,1673,786,887,0.4698147041243276,0.5301852958756724
E01000184,1873,920,953,0.49119060331019754,0.5088093966898024
E01000297,1421,679,742,0.47783251231527096,0.5221674876847291
E01000316,2287,1129,1158,0.49365981635330125,0.5063401836466987
E01000319,1402,683,719,0.4871611982881598,0.5128388017118403
E01000196,2124,1040,1084,0.4896421845574388,0.5103578154425612
E01000200,1978,900,1078,0.455005055611729,0.544994944388271
E01000201,1541,766,775,0.4970798182998053,0.5029201817001947
E01000202,1674,811,863,0.48446833930704897,0.515531660692951
E01000203,1844,838,1006,0.4544468546637744,0.5455531453362256
E01000177,1663,798,865,0.4798556825015033,0.5201443174984967
E01000179,1789,823,966,0.46003353828954724,0.5399664617104528
E01000180,1616,745,871,0.46101485148514854,0.5389851485148515
E01000181,1688,806,882,0.4774881516587678,0.5225118483412322
E01000182,1619,771,848,0.4762198888202594,0.5237801111797405
E01000185,1474,706,768,0.4789687924016282,0.5210312075983717
E01000239,2058,1033,1025,0.5019436345966958,0.49805636540330417
E01000240,1734,826,908,0.47635524798154555,0.5236447520184544
E01000241,1788,915,873,0.511744966442953,0.48825503355704697
E01000309,2051,1007,1044,0.4909800097513408,0.5090199902486592
E01000237,2102,1051,1051,0.5,0.5
E01000242,1601,822,779,0.5134291068082448,0.48657089319175517
E01000243,2163,1052,1111,0.4863615349052242,0.5136384650947757
E01000244,1638,806,832,0.49206349206349204,0.5079365079365079
E01000245,2057,1002,1055,0.48711716091395235,0.5128828390860476
E01000314,2166,1046,1120,0.48291782086795937,0.5170821791320406
E01000183,1522,699,823,0.4592641261498029,0.5407358738501971
E01000206,1501,716,785,0.4770153231179214,0.5229846768820786
E01000207,1579,726,853,0.4597846738442052,0.5402153261557948
E01000208,1630,754,876,0.4625766871165644,0.5374233128834356
E01000210,1548,733,815,0.47351421188630494,0.5264857881136951
E01000213,1351,654,697,0.4840858623242043,0.5159141376757957
E01000236,1950,955,995,0.4897435897435897,0.5102564102564102
E01000238,2096,1039,1057,0.49570610687022904,0.504293893129771
E01000310,2194,1115,1079,0.50820419325433,0.49179580674567
E01000311,1771,854,917,0.48221343873517786,0.5177865612648221
E01000205,1506,684,822,0.4541832669322709,0.545816733067729
E01000209,1483,658,825,0.44369521240728255,0.5563047875927175
E01000211,2128,999,1129,0.4694548872180451,0.5305451127819549
E01000212,1349,664,685,0.4922164566345441,0.507783543365456
E01000216,1978,927,1051,0.46865520728008087,0.5313447927199191
E01000217,1785,858,927,0.48067226890756304,0.519327731092437
E01000150,2255,1120,1135,0.49667405764966743,0.5033259423503326
E01000305,1621,812,809,0.5009253547193091,0.49907464528069095
E01000306,1971,992,979,0.5032978183663115,0.49670218163368846
E01000308,2110,998,1112,0.4729857819905213,0.5270142180094787
E01000312,1768,872,896,0.49321266968325794,0.5067873303167421
E01000313,1901,930,971,0.48921620199894794,0.5107837980010521
E01000145,1615,789,826,0.4885448916408669,0.5114551083591331
E01000215,2147,1055,1092,0.4913833255705636,0.5086166744294365
E01000218,1844,898,946,0.48698481561822127,0.5130151843817787
E01000219,2196,1150,1046,0.52367941712204,0.4763205828779599
E01000220,1888,973,915,0.5153601694915254,0.4846398305084746
E01000225,1870,945,925,0.5053475935828877,0.4946524064171123
E01000135,1703,849,854,0.49853200234879624,0.5014679976512038
E01000136,1486,685,801,0.4609690444145357,0.5390309555854643
E01000144,1660,828,832,0.4987951807228916,0.5012048192771085
E01000146,1872,924,948,0.4935897435897436,0.5064102564102564
E01000214,1627,776,851,0.47695144437615244,0.5230485556238476
E01000141,1864,906,958,0.48605150214592274,0.5139484978540773
E01000221,1412,667,745,0.4723796033994334,0.5276203966005666
E01000223,2032,998,1034,0.4911417322834646,0.5088582677165354
E01000307,1650,819,831,0.49636363636363634,0.5036363636363637
E01000138,1618,793,825,0.4901112484548826,0.5098887515451175
E01000142,2236,1069,1167,0.47808586762075134,0.5219141323792487
E01000222,2038,973,1065,0.4774288518155054,0.5225711481844946
E01000224,1692,821,871,0.4852245862884161,0.514775413711584
E01000137,1658,742,916,0.44752714113389624,0.5524728588661038
E01000139,1388,685,703,0.4935158501440922,0.5064841498559077
E01000140,1957,931,1026,0.47572815533980584,0.5242718446601942
E01000143,1671,854,817,0.5110712148414124,0.4889287851585877
E01033915,1487,704,783,0.4734364492266308,0.5265635507733692
E01033916,1786,915,871,0.5123180291153415,0.4876819708846585
E01033917,1509,747,762,0.49502982107355864,0.5049701789264414
E01033918,1553,738,815,0.4752092723760464,0.5247907276239536
E01033919,1311,635,676,0.4843630816170862,0.5156369183829138
E01033920,1523,765,758,0.5022980958634274,0.49770190413657256
E01000147,1913,976,937,0.5101934134866701,0.48980658651332987
E01033921,1655,788,867,0.4761329305135952,0.5238670694864048
E01033922,1708,853,855,0.4994145199063232,0.5005854800936768
E01033923,1559,761,798,0.48813341885824246,0.5118665811417575
E01033924,1544,772,772,0.5,0.5
E01033925,1732,896,836,0.5173210161662818,0.48267898383371827
E01000466,1713,861,852,0.5026269702276708,0.4973730297723292
E01000467,1679,804,875,0.478856462179869,0.521143537820131
E01000468,2932,1425,1507,0.48601637107776263,0.5139836289222374
E01000469,1736,826,910,0.47580645161290325,0.5241935483870968
E01000416,1631,807,824,0.49478847332924586,0.5052115266707541
E01000418,1946,967,979,0.49691675231243576,0.5030832476875642
E01000422,1338,631,707,0.47159940209267565,0.5284005979073244
E01000464,1518,730,788,0.48089591567852435,0.5191040843214756
E01000465,1690,808,882,0.47810650887573963,0.5218934911242603
E01000470,1307,614,693,0.46977811782708495,0.5302218821729151
E01000333,1917,933,984,0.486697965571205,0.513302034428795
E01000335,2726,1328,1398,0.4871606749816581,0.5128393250183418
E01000336,1998,968,1030,0.4844844844844845,0.5155155155155156
E01000337,1736,849,887,0.4890552995391705,0.5109447004608295
E01000338,1854,928,926,0.5005393743257821,0.4994606256742179
E01000403,2403,1103,1300,0.4590095713691219,0.5409904286308781
E01000404,2423,1129,1294,0.46595130004127117,0.5340486999587288
E01000405,1576,750,826,0.47588832487309646,0.5241116751269036
E01000408,1774,871,903,0.49098083427282974,0.5090191657271702
E01000332,1593,750,843,0.4708097928436911,0.5291902071563088
E01000402,1605,753,852,0.4691588785046729,0.5308411214953271
E01000406,2144,1052,1092,0.4906716417910448,0.5093283582089553
E01000407,1870,907,963,0.48502673796791446,0.5149732620320856
E01000334,1675,789,886,0.471044776119403,0.528955223880597
E01000417,1740,841,899,0.48333333333333334,0.5166666666666667
E01000419,1495,721,774,0.4822742474916388,0.5177257525083612
E01000420,1522,711,811,0.4671484888304862,0.5328515111695138
E01000442,1679,812,867,0.4836212030970816,0.5163787969029184
E01000437,1374,660,714,0.48034934497816595,0.519650655021834
E01000438,1688,835,853,0.4946682464454976,0.5053317535545023
E01000439,1424,684,740,0.4803370786516854,0.5196629213483146
E01000440,1385,678,707,0.48953068592057764,0.5104693140794224
E01000441,1802,864,938,0.4794672586015538,0.5205327413984462
E01000373,1325,629,696,0.47471698113207544,0.5252830188679245
E01000429,1693,798,895,0.4713526284701713,0.5286473715298287
E01000430,2051,966,1085,0.4709897610921502,0.5290102389078498
E01000431,1200,554,646,0.46166666666666667,0.5383333333333333
E01000433,1957,969,988,0.49514563106796117,0.5048543689320388
E01000434,1593,741,852,0.4651600753295669,0.5348399246704332
E01033789,1768,825,943,0.4666289592760181,0.5333710407239819
E01033790,1338,615,723,0.45964125560538116,0.5403587443946188
E01000356,1566,749,817,0.4782886334610473,0.5217113665389528
E01000357,1403,680,723,0.48467569493941554,0.5153243050605845
E01000359,1263,613,650,0.48535233570863023,0.5146476642913698
E01000421,1521,724,797,0.4760026298487837,0.5239973701512163
E01000450,1801,882,919,0.48972792892837314,0.5102720710716269
E01000451,1750,865,885,0.4942857142857143,0.5057142857142857
E01000452,1420,705,715,0.4964788732394366,0.5035211267605634
E01000367,2266,1073,1193,0.4735216240070609,0.5264783759929391
E01000368,1680,758,922,0.4511904761904762,0.5488095238095239
E01000372,1689,802,887,0.47483718176435763,0.5251628182356424
E01000380,1736,853,883,0.4913594470046083,0.5086405529953917
E01000435,1490,709,781,0.47583892617449663,0.5241610738255034
E01000353,1637,786,851,0.48014660965180206,0.5198533903481979
E01000354,1492,700,792,0.4691689008042895,0.5308310991957105
E01000355,1441,701,740,0.4864677307425399,0.5135322692574601
E01000358,1658,801,857,0.48311218335343786,0.5168878166465621
E01000436,1758,865,893,0.4920364050056883,0.5079635949943118
E01000401,1814,819,995,0.45148842337375966,0.5485115766262404
E01000453,1479,709,770,0.4793779580797836,0.5206220419202163
E01000454,1631,785,846,0.48129981606376454,0.5187001839362354
E01000455,1792,885,907,0.49386160714285715,0.5061383928571429
E01000456,1422,670,752,0.4711673699015471,0.5288326300984529
E01000325,1647,816,831,0.49544626593806923,0.5045537340619308
E01000326,1384,680,704,0.4913294797687861,0.5086705202312138
E01000369,1727,810,917,0.46902142443543715,0.5309785755645628
E01000370,1558,770,788,0.4942233632862644,0.5057766367137355
E01000371,1620,765,855,0.4722222222222222,0.5277777777777778
E01000360,1910,913,997,0.4780104712041885,0.5219895287958115
E01000362,1864,873,991,0.46834763948497854,0.5316523605150214
E01000365,1728,789,939,0.4565972222222222,0.5434027777777778
E01000366,1640,802,838,0.48902439024390243,0.5109756097560976
E01000394,1628,760,868,0.4668304668304668,0.5331695331695332
E01000388,1513,732,781,0.4838070059484468,0.5161929940515532
E01000392,1955,949,1006,0.4854219948849105,0.5145780051150896
E01000409,1742,828,914,0.4753157290470723,0.5246842709529277
E01000411,1494,740,754,0.49531459170013387,0.5046854082998661
E01000414,1894,939,955,0.49577613516367475,0.5042238648363252
E01000415,1465,730,735,0.49829351535836175,0.5017064846416383
E01000327,1628,790,838,0.48525798525798525,0.5147420147420148
E01000328,1637,784,853,0.47892486255345146,0.5210751374465485
E01000329,1696,814,882,0.47995283018867924,0.5200471698113207
E01000330,1656,737,919,0.44504830917874394,0.5549516908212561
E01000331,1689,845,844,0.5002960331557135,0.4997039668442866
E01000340,1584,785,799,0.49558080808080807,0.5044191919191919
E01000395,1529,768,761,0.5022890778286462,0.4977109221713538
E01000396,1452,740,712,0.509641873278237,0.4903581267217631
E01000410,1658,812,846,0.4897466827503016,0.5102533172496985
E01000412,1766,870,896,0.49263873159682897,0.507361268403171
E01000413,1347,659,688,0.4892353377876763,0.5107646622123236
E01000374,1579,750,829,0.4749841671944269,0.5250158328055732
E01000375,2128,1044,1084,0.4906015037593985,0.5093984962406015
E01000376,1614,774,840,0.4795539033457249,0.5204460966542751
E01000377,1472,721,751,0.4898097826086957,0.5101902173913043
E01000379,1712,843,869,0.49240654205607476,0.5075934579439252
E01033791,1381,660,721,0.4779145546705286,0.5220854453294714
E01033792,1382,662,720,0.47901591895803186,0.5209840810419681
E01000348,1514,747,767,0.49339498018494055,0.5066050198150595
E01000349,1722,829,893,0.4814169570267131,0.5185830429732868
E01000361,1591,761,830,0.4783155248271527,0.5216844751728472
E01000363,1559,748,811,0.47979474021808854,0.5202052597819115
E01000389,1700,838,862,0.4929411764705882,0.5070588235294118
E01000390,1332,644,688,0.48348348348348347,0.5165165165165165
E01000393,1695,831,864,0.4902654867256637,0.5097345132743363
E01000346,1588,770,818,0.48488664987405544,0.5151133501259446
E01000347,1521,736,785,0.4838921761998685,0.5161078238001315
E01000350,1486,720,766,0.4845222072678331,0.5154777927321669
E01000352,1618,746,872,0.4610630407911001,0.5389369592088998
E01000391,1748,816,932,0.4668192219679634,0.5331807780320366
E01000341,1542,713,829,0.46238651102464334,0.5376134889753567
E01000342,1524,727,797,0.47703412073490814,0.5229658792650919
E01000343,1510,753,757,0.4986754966887417,0.5013245033112583
E01000345,1342,639,703,0.4761549925484352,0.5238450074515648
E01000460,1261,628,633,0.4980174464710547,0.5019825535289453
E01000364,1698,850,848,0.5005889281507656,0.4994110718492344
E01000444,1642,798,844,0.48599269183922045,0.5140073081607796
E01000447,1959,944,1015,0.48187850944359367,0.5181214905564063
E01000448,1348,662,686,0.4910979228486647,0.5089020771513353
E01000449,1562,760,802,0.48655569782330343,0.5134443021766966
E01000351,1612,761,851,0.47208436724565755,0.5279156327543424
E01000443,1331,649,682,0.48760330578512395,0.512396694214876
E01000445,1666,819,847,0.49159663865546216,0.5084033613445378
E01000446,1505,714,791,0.4744186046511628,0.5255813953488372
E01000461,1637,829,808,0.5064141722663409,0.4935858277336591
E01000339,1619,790,829,0.48795552810376774,0.5120444718962323
E01000344,1592,769,823,0.48304020100502515,0.5169597989949749
E01000423,1607,804,803,0.5003111387678905,0.49968886123210954
E01000425,1800,881,919,0.48944444444444446,0.5105555555555555
E01000463,1251,625,626,0.49960031974420466,0.5003996802557954
E01000424,1726,828,898,0.4797219003476246,0.5202780996523755
E01000426,1672,834,838,0.4988038277511962,0.5011961722488039
E01000427,2011,919,1092,0.45698657384385877,0.5430134261561412
E01000457,2175,958,1217,0.44045977011494253,0.5595402298850575
E01000462,2054,957,1097,0.46592015579357354,0.5340798442064265
E01000382,1573,767,806,0.48760330578512395,0.512396694214876
E01000384,1721,793,928,0.4607786170830912,0.5392213829169088
E01000387,1558,753,805,0.4833119383825417,0.5166880616174583
E01000428,1902,875,1027,0.46004206098843325,0.5399579390115667
E01000458,1539,731,808,0.47498375568551005,0.5250162443144899
E01000459,1871,867,1004,0.4633885622661678,0.5366114377338321
E01000381,1617,767,850,0.4743351886209029,0.525664811379097
E01000383,1593,770,823,0.48336472065285624,0.5166352793471437
E01000385,2006,923,1083,0.46011964107676967,0.5398803589232303
E01000386,1537,686,851,0.44632400780741704,0.5536759921925829
E01000398,1593,776,817,0.48713119899560575,0.5128688010043942
E01000399,1571,765,806,0.486950986632718,0.513049013367282
E01000400,1573,764,809,0.48569612205975843,0.5143038779402416
E01032566,1886,892,994,0.47295864262990456,0.5270413573700954
E01000587,1625,846,779,0.5206153846153846,0.4793846153846154
E01000589,2549,1313,1236,0.5151039623381718,0.48489603766182815
E01000590,1936,934,1002,0.4824380165289256,0.5175619834710744
E01000592,1831,894,937,0.4882577826324413,0.5117422173675588
E01000593,2121,1050,1071,0.49504950495049505,0.504950495049505
E01000594,1815,946,869,0.5212121212121212,0.47878787878787876
E01000513,1678,870,808,0.5184743742550656,0.48152562574493446
E01000514,1570,804,766,0.5121019108280255,0.4878980891719745
E01000516,2345,1188,1157,0.5066098081023455,0.4933901918976546
E01000520,1677,829,848,0.49433512224209897,0.505664877757901
E01033929,1344,655,689,0.48735119047619047,0.5126488095238095
E01033930,1846,904,942,0.48970747562296857,0.5102925243770314
E01000515,1875,920,955,0.49066666666666664,0.5093333333333333
E01000517,1623,805,818,0.4959950708564387,0.5040049291435613
E01000543,1625,813,812,0.5003076923076923,0.4996923076923077
E01000591,2183,1156,1027,0.5295464956481906,0.47045350435180944
E01033463,3155,1626,1529,0.5153724247226624,0.4846275752773376
E01000536,1562,766,796,0.49039692701664533,0.5096030729833547
E01000538,1622,795,827,0.49013563501849566,0.5098643649815043
E01000539,1581,796,785,0.5034788108791903,0.4965211891208096
E01000540,1456,708,748,0.48626373626373626,0.5137362637362637
E01000541,1411,700,711,0.4961020552799433,0.5038979447200567
E01000518,1915,950,965,0.4960835509138381,0.5039164490861618
E01000519,2013,995,1018,0.4942871336313959,0.505712866368604
E01000623,1882,943,939,0.5010626992561105,0.4989373007438895
E01000624,1745,860,885,0.49283667621776506,0.5071633237822349
E01000629,1977,1008,969,0.5098634294385432,0.49013657056145676
E01000480,1688,851,837,0.5041469194312796,0.4958530805687204
E01000484,1765,836,929,0.4736543909348442,0.5263456090651558
E01000485,1604,780,824,0.486284289276808,0.513715710723192
E01000486,1698,850,848,0.5005889281507656,0.4994110718492344
E01000487,1987,959,1028,0.482637141419225,0.517362858580775
E01000572,1495,738,757,0.4936454849498328,0.5063545150501673
E01000573,1671,848,823,0.5074805505685218,0.49251944943147813
E01000574,1655,898,757,0.5425981873111783,0.45740181268882174
E01000575,2154,1170,984,0.5431754874651811,0.4568245125348189
E01000577,2585,1236,1349,0.4781431334622824,0.5218568665377176
E01000562,1506,719,787,0.47742363877822047,0.5225763612217795
E01000563,1588,782,806,0.4924433249370277,0.5075566750629723
E01000566,1550,791,759,0.5103225806451613,0.4896774193548387
E01000568,2218,998,1220,0.4499549143372408,0.5500450856627592
E01000569,1456,725,731,0.49793956043956045,0.5020604395604396
E01000479,1762,848,914,0.48127128263337116,0.5187287173666288
E01000481,1635,756,879,0.46238532110091746,0.5376146788990825
E01000483,1852,881,971,0.47570194384449244,0.5242980561555075
E01000625,1672,824,848,0.49282296650717705,0.507177033492823
E01033931,1359,637,722,0.4687270051508462,0.5312729948491538
E01033932,1660,790,870,0.4759036144578313,0.5240963855421686
E01000498,1683,861,822,0.5115864527629234,0.48841354723707664
E01000622,1980,1000,980,0.5050505050505051,0.494949494949495
E01000626,1547,709,838,0.45830639948287005,0.5416936005171299
E01033933,1481,754,727,0.5091154625253207,0.49088453747467925
E01033934,1641,866,775,0.5277269957343084,0.47227300426569163
E01000497,2071,1024,1047,0.4944471269917914,0.5055528730082086
E01000499,1896,860,1036,0.45358649789029537,0.5464135021097046
E01000501,2031,952,1079,0.4687346134908912,0.5312653865091088
E01000502,1882,878,1004,0.4665249734325186,0.5334750265674814
E01000503,2093,1061,1032,0.5069278547539418,0.4930721452460583
E01000570,1546,788,758,0.5097024579560155,0.49029754204398446
E01000571,1761,885,876,0.5025553662691652,0.49744463373083475
E01000576,1874,948,926,0.5058697972251868,0.49413020277481323
E01000578,2324,1166,1158,0.5017211703958692,0.49827882960413084
E01000564,1624,824,800,0.5073891625615764,0.49261083743842365
E01000565,1536,744,792,0.484375,0.515625
E01000607,2593,1381,1212,0.5325877362128808,0.46741226378711914
E01000608,2339,1161,1178,0.4963659683625481,0.5036340316374519
E01000613,1755,865,890,0.4928774928774929,0.5071225071225072
E01000506,1657,802,855,0.484007242003621,0.515992757996379
E01000509,1438,763,675,0.5305980528511822,0.4694019471488178
E01000510,1672,824,848,0.49282296650717705,0.507177033492823
E01000511,1770,864,906,0.488135593220339,0.511864406779661
E01000627,2048,997,1051,0.48681640625,0.51318359375
E01000628,1768,941,827,0.5322398190045249,0.4677601809954751
E01000553,2040,1011,1029,0.49558823529411766,0.5044117647058823
E01000554,1970,958,1012,0.4862944162436548,0.5137055837563452
E01000555,1586,789,797,0.4974779319041614,0.5025220680958385
E01000556,2089,980,1109,0.4691239827668741,0.5308760172331259
E01000557,1864,979,885,0.5252145922746781,0.4747854077253219
E01000558,1389,657,732,0.47300215982721383,0.5269978401727862
E01000567,1400,678,722,0.48428571428571426,0.5157142857142857
E01000606,1872,935,937,0.49946581196581197,0.500534188034188
E01000609,2059,1040,1019,0.505099562894609,0.49490043710539094
E01000611,1928,962,966,0.49896265560165975,0.5010373443983402
E01000504,1799,858,941,0.47693162868260147,0.5230683713173986
E01000505,1677,810,867,0.48300536672629696,0.516994633273703
E01000507,1617,798,819,0.4935064935064935,0.5064935064935064
E01000512,1703,876,827,0.5143863769817968,0.48561362301820316
E01000559,1381,676,705,0.4895003620564808,0.5104996379435192
E01000610,2186,1104,1082,0.505032021957914,0.494967978042086
E01000612,1766,896,870,0.507361268403171,0.49263873159682897
E01000631,2073,1054,1019,0.5084418716835504,0.49155812831644957
E01000633,2616,1354,1262,0.5175840978593272,0.48241590214067276
E01000634,2643,1377,1266,0.5209988649262202,0.4790011350737798
E01000616,1938,991,947,0.5113519091847265,0.4886480908152735
E01000620,1750,859,891,0.4908571428571429,0.5091428571428571
E01000621,1811,925,886,0.5107675317504141,0.4892324682495859
E01000636,2600,1304,1296,0.5015384615384615,0.49846153846153846
E01033935,2008,1081,927,0.5383466135458167,0.46165338645418325
E01033936,1642,818,824,0.4981729598051157,0.5018270401948843
E01000596,1848,887,961,0.479978354978355,0.520021645021645
E01000601,1386,643,743,0.4639249639249639,0.536075036075036
E01000602,1453,705,748,0.48520302821748107,0.5147969717825189
E01000603,1446,662,784,0.4578146611341632,0.5421853388658368
E01000604,1736,796,940,0.45852534562211983,0.5414746543778802
E01000605,1762,861,901,0.48864926220204313,0.5113507377979569
E01000488,1647,761,886,0.4620522161505768,0.5379477838494232
E01000637,1508,741,767,0.49137931034482757,0.5086206896551724
E01000639,1715,839,876,0.4892128279883382,0.5107871720116618
E01000642,2214,1119,1095,0.505420054200542,0.494579945799458
E01000644,1912,963,949,0.5036610878661087,0.4963389121338912
E01000490,1771,870,901,0.4912478825522304,0.5087521174477696
E01000494,1761,856,905,0.48608745031232253,0.5139125496876774
E01000495,1591,835,756,0.5248271527341295,0.4751728472658705
E01000560,1561,718,843,0.45996156310057656,0.5400384368994234
E01000561,1937,983,954,0.5074858027878162,0.4925141972121838
E01000638,2141,1035,1106,0.4834189631013545,0.5165810368986455
E01000640,2215,1058,1157,0.47765237020316026,0.5223476297968397
E01000641,1951,925,1026,0.4741158380317786,0.5258841619682214
E01000643,2242,1012,1230,0.4513826940231936,0.5486173059768065
E01000508,2616,1185,1431,0.45298165137614677,0.5470183486238532
E01000521,2275,1056,1219,0.4641758241758242,0.5358241758241759
E01000522,2048,943,1105,0.46044921875,0.53955078125
E01000526,2197,993,1204,0.4519799726900319,0.5480200273099681
E01000527,1875,884,991,0.47146666666666665,0.5285333333333333
E01000528,1725,803,922,0.46550724637681157,0.5344927536231884
E01000471,1721,876,845,0.5090063916327716,0.49099360836722833
E01000474,2272,1123,1149,0.4942781690140845,0.5057218309859155
E01000476,2196,1110,1086,0.505464480874317,0.49453551912568305
E01000477,2376,1261,1115,0.5307239057239057,0.4692760942760943
E01000630,2728,1353,1375,0.4959677419354839,0.5040322580645161
E01000595,1785,773,1012,0.4330532212885154,0.5669467787114846
E01000599,1889,881,1008,0.4663843303335098,0.5336156696664902
E01033456,2624,1242,1382,0.4733231707317073,0.5266768292682927
E01033937,1165,593,572,0.5090128755364807,0.49098712446351933
E01033938,1231,604,627,0.49065800162469536,0.5093419983753046
E01033939,1931,972,959,0.5033661315380632,0.4966338684619368
E01000545,1922,913,1009,0.4750260145681582,0.5249739854318418
E01000546,1643,776,867,0.4723067559342666,0.5276932440657334
E01000547,1656,815,841,0.4921497584541063,0.5078502415458938
E01000548,1984,933,1051,0.47026209677419356,0.5297379032258065
E01000549,1813,843,970,0.46497517926089355,0.5350248207391064
E01000472,2404,1158,1246,0.48169717138103163,0.5183028286189684
E01000473,2704,1361,1343,0.5033284023668639,0.4966715976331361
E01000475,2124,1071,1053,0.5042372881355932,0.4957627118644068
E01000478,2528,1265,1263,0.5003955696202531,0.49960443037974683
E01000632,2480,1261,1219,0.5084677419354838,0.4915322580645161
E01000489,1725,873,852,0.5060869565217392,0.49391304347826087
E01000491,2066,988,1078,0.4782187802516941,0.5217812197483059
E01000492,1273,622,651,0.48860958366064416,0.5113904163393559
E01000493,1597,746,851,0.46712586098935505,0.532874139010645
E01000581,1513,699,814,0.4619960343688037,0.5380039656311963
E01000523,2297,1115,1182,0.48541575968654765,0.5145842403134523
E01000524,2423,1144,1279,0.47214197276104003,0.5278580272389599
E01000525,1851,870,981,0.4700162074554295,0.5299837925445705
E01000533,2172,1031,1141,0.47467771639042355,0.5253222836095764
E01000535,2053,949,1104,0.4622503653190453,0.5377496346809547
E01033455,1143,552,591,0.48293963254593175,0.5170603674540682
E01033485,1638,774,864,0.4725274725274725,0.5274725274725275
E01000579,1587,720,867,0.45368620037807184,0.5463137996219282
E01000580,2086,979,1107,0.46931927133269413,0.5306807286673059
E01000582,1851,850,1001,0.4592112371690978,0.5407887628309023
E01000583,2050,919,1131,0.4482926829268293,0.5517073170731708
E01000586,2380,1155,1225,0.4852941176470588,0.5147058823529411
E01000530,1820,855,965,0.4697802197802198,0.5302197802197802
E01000531,1797,839,958,0.46688925987757374,0.5331107401224263
E01000532,1509,683,826,0.4526176275679258,0.5473823724320742
E01000534,1748,853,895,0.4879862700228833,0.5120137299771167
E01000584,1560,750,810,0.4807692307692308,0.5192307692307693
E01000585,1504,690,814,0.4587765957446808,0.5412234042553191
E01000544,1768,900,868,0.5090497737556561,0.49095022624434387
E01000550,2021,961,1060,0.47550717466600695,0.5244928253339931
E01000551,2894,1367,1527,0.472356599861783,0.527643400138217
E01000552,1510,722,788,0.4781456953642384,0.5218543046357615
E01033457,1982,1013,969,0.5110998990918264,0.48890010090817354
E01033940,2352,1122,1230,0.4770408163265306,0.5229591836734694
E01033941,1567,721,846,0.4601148691767709,0.5398851308232291
E01033942,1607,743,864,0.46235220908525204,0.537647790914748
E01000615,3191,1664,1527,0.521466624882482,0.47853337511751803
E01000617,2267,1171,1096,0.5165416850463167,0.4834583149536833
E01000618,1677,832,845,0.49612403100775193,0.5038759689922481
E01000619,1696,834,862,0.49174528301886794,0.5082547169811321
E01000779,1400,679,721,0.485,0.515
E01000780,1612,764,848,0.4739454094292804,0.5260545905707196
E01000781,1572,721,851,0.4586513994910941,0.5413486005089059
E01000782,1545,738,807,0.47766990291262135,0.5223300970873787
E01000783,1624,757,867,0.4661330049261084,0.5338669950738916
E01000785,1577,708,869,0.4489537095751427,0.5510462904248573
E01000689,1636,852,784,0.5207823960880196,0.4792176039119804
E01000690,1391,683,708,0.4910136592379583,0.5089863407620417
E01000691,1535,728,807,0.4742671009771987,0.5257328990228013
E01000692,1670,803,867,0.4808383233532934,0.5191616766467065
E01000784,1557,724,833,0.46499678869621064,0.5350032113037894
E01000799,1803,859,944,0.4764281752634498,0.5235718247365502
E01000802,1848,849,999,0.4594155844155844,0.5405844155844156
E01000803,1609,748,861,0.4648850217526414,0.5351149782473587
E01000804,1470,709,761,0.482312925170068,0.5176870748299319
E01000805,1698,792,906,0.4664310954063604,0.5335689045936396
E01000741,1819,898,921,0.4936778449697636,0.5063221550302364
E01000742,2119,999,1120,0.4714487966021708,0.5285512033978291
E01000745,1883,927,956,0.492299522039299,0.5077004779607011
E01000746,2021,998,1023,0.4938149430974765,0.5061850569025235
E01034383,1308,603,705,0.4610091743119266,0.5389908256880734
E01034384,1335,586,749,0.4389513108614232,0.5610486891385768
E01000709,1370,672,698,0.4905109489051095,0.5094890510948905
E01000710,2359,1137,1222,0.48198389147944043,0.5180161085205596
E01000711,1880,926,954,0.4925531914893617,0.5074468085106383
E01000714,2168,1035,1133,0.47739852398523985,0.5226014760147601
E01000718,2057,975,1082,0.4739912493923189,0.526008750607681
E01000645,1450,708,742,0.4882758620689655,0.5117241379310344
E01000649,2068,978,1090,0.47292069632495165,0.5270793036750484
E01000694,2298,1098,1200,0.47780678851174935,0.5221932114882507
E01000695,1518,735,783,0.4841897233201581,0.5158102766798419
E01000696,1635,785,850,0.4801223241590214,0.5198776758409785
E01000697,1784,855,929,0.4792600896860987,0.5207399103139013
E01000674,1716,848,868,0.49417249417249415,0.5058275058275058
E01000676,2033,1004,1029,0.4938514510575504,0.5061485489424495
E01000820,1611,771,840,0.478584729981378,0.521415270018622
E01000822,1632,793,839,0.48590686274509803,0.5140931372549019
E01000823,1694,801,893,0.47284533648170013,0.5271546635182999
E01000824,1402,652,750,0.46504992867332384,0.5349500713266762
E01000825,1663,770,893,0.4630186410102225,0.5369813589897775
E01000743,1868,869,999,0.465203426124197,0.534796573875803
E01000744,1559,720,839,0.46183450930083386,0.5381654906991661
E01000796,1537,709,828,0.46128822381262197,0.538711776187378
E01000798,1527,753,774,0.4931237721021611,0.5068762278978389
E01000800,1663,775,888,0.4660252555622369,0.533974744437763
E01000806,1715,773,942,0.4507288629737609,0.5492711370262391
E01000693,1511,690,821,0.456651224354732,0.5433487756452681
E01000698,1193,589,604,0.49371332774518023,0.5062866722548198
E01000736,1636,795,841,0.48594132029339854,0.5140586797066015
E01000737,1406,659,747,0.46870554765291605,0.531294452347084
E01000672,1674,772,902,0.46117084826762245,0.5388291517323776
E01000673,1670,816,854,0.48862275449101794,0.511377245508982
E01000716,1651,772,879,0.467595396729255,0.532404603270745
E01000717,1704,804,900,0.47183098591549294,0.528169014084507
E01000828,1701,815,886,0.479129923574368,0.520870076425632
E01000712,1794,870,924,0.48494983277591974,0.5150501672240803
E01000713,1849,886,963,0.4791779340183883,0.5208220659816117
E01000715,1756,832,924,0.47380410022779046,0.5261958997722096
E01000770,1520,726,794,0.4776315789473684,0.5223684210526316
E01000772,1580,723,857,0.45759493670886076,0.5424050632911392
E01000700,1519,716,803,0.47136273864384465,0.5286372613561554
E01000702,1434,700,734,0.4881450488145049,0.5118549511854951
E01000703,1731,832,899,0.4806470248411323,0.5193529751588677
E01000706,1375,656,719,0.47709090909090907,0.5229090909090909
E01000797,1653,807,846,0.4882032667876588,0.5117967332123412
E01000729,1959,944,1015,0.48187850944359367,0.5181214905564063
E01000730,1808,847,961,0.4684734513274336,0.5315265486725663
E01000735,1548,752,796,0.48578811369509045,0.5142118863049095
E01000738,1688,806,882,0.4774881516587678,0.5225118483412322
E01000739,1677,769,908,0.45855694692904,0.5414430530709601
E01000699,1451,684,767,0.47139903514817366,0.5286009648518263
E01000701,1440,694,746,0.48194444444444445,0.5180555555555556
E01000704,1470,670,800,0.4557823129251701,0.54421768707483
E01000705,1357,647,710,0.4767870302137067,0.5232129697862933
E01000801,1514,735,779,0.4854689564068692,0.5145310435931307
E01000646,1828,849,979,0.4644420131291028,0.5355579868708972
E01000647,1710,812,898,0.47485380116959064,0.5251461988304094
E01000648,1890,884,1006,0.4677248677248677,0.5322751322751322
E01000653,1542,735,807,0.4766536964980545,0.5233463035019456
E01000678,1850,901,949,0.48702702702702705,0.512972972972973
E01000670,1941,960,981,0.4945904173106646,0.5054095826893354
E01000677,1902,915,987,0.4810725552050473,0.5189274447949527
E01000762,1748,839,909,0.4799771167048055,0.5200228832951945
E01000829,1769,859,910,0.48558507631430187,0.5144149236856982
E01034385,1452,694,758,0.47796143250688705,0.522038567493113
E01034386,1250,648,602,0.5184,0.4816
E01000719,2116,986,1130,0.4659735349716446,0.5340264650283554
E01000720,1802,799,1003,0.44339622641509435,0.5566037735849056
E01000721,1604,737,867,0.45947630922693267,0.5405236907730673
E01000724,1675,757,918,0.4519402985074627,0.5480597014925374
E01000728,1627,777,850,0.4775660725261217,0.5224339274738783
E01000651,1681,756,925,0.4497323022010708,0.5502676977989293
E01000668,2222,1060,1162,0.47704770477047703,0.5229522952295229
E01000669,1736,824,912,0.47465437788018433,0.5253456221198156
E01000671,2271,1089,1182,0.4795244385733157,0.5204755614266843
E01000679,1792,868,924,0.484375,0.515625
E01000826,1636,823,813,0.5030562347188264,0.4969437652811736
E01000827,1780,849,931,0.47696629213483144,0.5230337078651686
E01000830,1623,824,799,0.5077017868145409,0.492298213185459
E01000831,1702,841,861,0.49412455934195065,0.5058754406580493
E01000833,1447,729,718,0.5038009675190048,0.4961990324809952
E01000650,1805,882,923,0.4886426592797784,0.5113573407202217
E01000652,1712,812,900,0.4742990654205608,0.5257009345794392
E01000807,1665,796,869,0.47807807807807806,0.5219219219219219
E01000809,1542,752,790,0.4876783398184176,0.5123216601815823
E01000722,1848,880,968,0.47619047619047616,0.5238095238095238
E01000725,1752,864,888,0.4931506849315068,0.5068493150684932
E01000731,1381,657,724,0.47574221578566256,0.5242577842143374
E01000732,1515,722,793,0.4765676567656766,0.5234323432343234
E01000733,1670,799,871,0.4784431137724551,0.5215568862275449
E01000769,1389,712,677,0.5125989920806335,0.48740100791936647
E01000773,1584,742,842,0.4684343434343434,0.5315656565656566
E01000775,2284,1129,1155,0.49430823117338,0.5056917688266199
E01000777,1631,794,837,0.48681790312691603,0.513182096873084
E01000778,1626,757,869,0.465559655596556,0.534440344403444
E01000808,1561,754,807,0.48302370275464446,0.5169762972453555
E01000810,1542,749,793,0.48573281452658884,0.5142671854734111
E01000811,1367,667,700,0.4879297732260424,0.5120702267739575
E01000813,1563,741,822,0.4740882917466411,0.525911708253359
E01000815,1510,737,773,0.4880794701986755,0.5119205298013245
E01000661,2817,1309,1508,0.46467873624423145,0.5353212637557685
E01000662,1803,883,920,0.4897393233499723,0.5102606766500277
E01000663,1681,803,878,0.4776918500892326,0.5223081499107673
E01000664,1663,819,844,0.4924834636199639,0.5075165363800361
E01000763,1474,711,763,0.48236092265943015,0.5176390773405699
E01000764,1819,893,926,0.4909290819131391,0.5090709180868609
E01000766,1815,885,930,0.48760330578512395,0.512396694214876
E01000767,1631,791,840,0.48497854077253216,0.5150214592274678
E01000834,1369,664,705,0.4850255661066472,0.5149744338933528
E01000727,1690,787,903,0.46568047337278107,0.5343195266272189
E01000734,1388,684,704,0.49279538904899134,0.5072046109510087
E01000790,2297,1116,1181,0.48585111014366567,0.5141488898563343
E01000812,1632,814,818,0.4987745098039216,0.5012254901960784
E01000814,1521,770,751,0.5062458908612755,0.49375410913872453
E01000723,1241,593,648,0.47784045124899277,0.5221595487510072
E01000726,1304,629,675,0.48236196319018404,0.5176380368098159
E01000787,1482,699,783,0.4716599190283401,0.52834008097166
E01000788,1617,781,836,0.48299319727891155,0.5170068027210885
E01000791,1512,754,758,0.49867724867724866,0.5013227513227513
E01000832,1571,801,770,0.50986632718014,0.49013367281986
E01000835,1757,846,911,0.4815025611838361,0.518497438816164
E01000836,1388,684,704,0.49279538904899134,0.5072046109510087
E01000837,1566,762,804,0.48659003831417624,0.5134099616858238
E01000838,1431,662,769,0.46261355695317957,0.5373864430468204
E01000839,1390,694,696,0.49928057553956834,0.5007194244604316
E01000840,1491,700,791,0.4694835680751174,0.5305164319248826
E01000841,1698,829,869,0.4882214369846879,0.5117785630153121
E01000753,1935,926,1009,0.4785529715762274,0.5214470284237727
E01000754,1770,841,929,0.4751412429378531,0.5248587570621469
E01000755,1640,805,835,0.49085365853658536,0.5091463414634146
E01000757,1571,787,784,0.5009548058561426,0.4990451941438574
E01000758,1450,686,764,0.4731034482758621,0.526896551724138
E01000786,1461,691,770,0.4729637234770705,0.5270362765229295
E01000789,1873,849,1024,0.4532835024025627,0.5467164975974372
E01000792,1509,730,779,0.48376408217362493,0.5162359178263751
E01000793,1560,759,801,0.48653846153846153,0.5134615384615384
E01000795,1385,657,728,0.47436823104693143,0.5256317689530686
E01000665,1859,900,959,0.4841312533620226,0.5158687466379774
E01000666,1892,917,975,0.4846723044397463,0.5153276955602537
E01000667,1660,816,844,0.491566265060241,0.5084337349397591
E01000756,1708,819,889,0.47950819672131145,0.5204918032786885
E01000759,1646,814,832,0.4945321992709599,0.5054678007290401
E01000760,1629,775,854,0.47575199508901167,0.5242480049109883
E01000761,1545,767,778,0.4964401294498382,0.5035598705501618
E01000765,1786,853,933,0.4776035834266517,0.5223964165733482
E01000768,1502,739,763,0.49201065246338216,0.5079893475366178
E01000681,1755,853,902,0.486039886039886,0.513960113960114
E01000682,1605,780,825,0.48598130841121495,0.514018691588785
E01000683,1705,816,889,0.4785923753665689,0.521407624633431
E01000684,2092,1044,1048,0.49904397705544934,0.5009560229445507
E01000794,1545,745,800,0.48220064724919093,0.517799352750809
E01000749,1651,807,844,0.4887946698970321,0.5112053301029679
E01000750,1453,637,816,0.43840330350997936,0.5615966964900206
E01000751,2267,1049,1218,0.462726069695633,0.537273930304367
E01000752,1747,819,928,0.4688036634230109,0.5311963365769892
E01000680,1642,799,843,0.4866017052375152,0.5133982947624848
E01000685,1627,775,852,0.4763368162261832,0.5236631837738168
E01000686,1494,733,761,0.49062918340026773,0.5093708165997323
E01000687,1565,754,811,0.4817891373801917,0.5182108626198083
E01000688,1388,682,706,0.49135446685878964,0.5086455331412104
E01000654,1299,628,671,0.48344880677444185,0.5165511932255581
E01000655,1328,639,689,0.4811746987951807,0.5188253012048193
E01000656,1508,735,773,0.4874005305039788,0.5125994694960212
E01000657,1573,745,828,0.47361729179911,0.5263827082008901
E01000659,1464,758,706,0.51775956284153,0.4822404371584699
E01000816,1524,732,792,0.48031496062992124,0.5196850393700787
E01000818,1685,815,870,0.4836795252225519,0.516320474777448
E01000819,1850,863,987,0.4664864864864865,0.5335135135135135
E01032562,1615,727,888,0.4501547987616099,0.5498452012383901
E01032563,1450,674,776,0.46482758620689657,0.5351724137931034
E01000707,1509,743,766,0.4923790589794566,0.5076209410205434
E01000708,1690,792,898,0.4686390532544379,0.5313609467455621
E01000771,1666,832,834,0.49939975990396157,0.5006002400960384
E01000774,1504,745,759,0.4953457446808511,0.504654255319149
E01032568,1525,703,822,0.460983606557377,0.539016393442623
E01000658,1330,637,693,0.4789473684210526,0.5210526315789473
E01000747,2027,984,1043,0.4854464726196349,0.5145535273803651
E01000748,1687,851,836,0.5044457617071725,0.4955542382928275
E01032570,1736,823,913,0.4740783410138249,0.5259216589861752
E01000907,1483,703,780,0.47403910991233983,0.5259608900876601
E01000908,1523,673,850,0.44189100459619174,0.5581089954038083
E01000909,1549,708,841,0.45706907682375725,0.5429309231762427
E01000912,1587,744,843,0.46880907372400754,0.5311909262759924
E01000913,1602,759,843,0.4737827715355805,0.5262172284644194
E01000893,1377,653,724,0.47421931735657225,0.5257806826434277
E01000894,1271,620,651,0.4878048780487805,0.5121951219512195
E01000895,1552,739,813,0.47615979381443296,0.523840206185567
E01000896,1438,665,773,0.4624478442280946,0.5375521557719054
E01000899,1560,755,805,0.483974358974359,0.5160256410256411
E01000910,1343,638,705,0.47505584512285925,0.5249441548771407
E01000911,1438,684,754,0.4756606397774687,0.5243393602225312
E01000921,1875,879,996,0.4688,0.5312
E01000923,1447,687,760,0.474775397373877,0.525224602626123
E01000928,1713,784,929,0.45767659077641565,0.5423234092235844
E01000878,1714,794,920,0.4632438739789965,0.5367561260210035
E01000879,1300,608,692,0.4676923076923077,0.5323076923076923
E01000880,1412,687,725,0.48654390934844194,0.5134560906515581
E01000884,1471,710,761,0.48266485384092456,0.5173351461590755
E01000885,1280,607,673,0.47421875,0.52578125
E01000871,1657,799,858,0.4821967410983706,0.5178032589016295
E01000872,1740,852,888,0.4896551724137931,0.5103448275862069
E01000873,1582,742,840,0.4690265486725664,0.5309734513274337
E01000874,1479,726,753,0.4908722109533469,0.5091277890466531
E01000877,1458,670,788,0.45953360768175583,0.5404663923182441
E01000886,1330,632,698,0.47518796992481205,0.524812030075188
E01000887,1389,627,762,0.4514038876889849,0.5485961123110151
E01000888,1470,718,752,0.4884353741496599,0.5115646258503401
E01000892,1791,805,986,0.44946957007258515,0.5505304299274149
E01000903,1414,678,736,0.4794908062234795,0.5205091937765205
E01000889,1771,810,961,0.45736871823828346,0.5426312817617166
E01000890,1317,621,696,0.4715261958997722,0.5284738041002278
E01000891,1485,728,757,0.49023569023569025,0.5097643097643098
E01000901,1971,927,1044,0.4703196347031963,0.5296803652968036
E01000922,1920,879,1041,0.4578125,0.5421875
E01000927,1535,696,839,0.45342019543973944,0.5465798045602606
E01000881,1387,672,715,0.4844989185291997,0.5155010814708003
E01000882,1452,689,763,0.47451790633608815,0.5254820936639119
E01000883,1508,719,789,0.47679045092838196,0.523209549071618
E01000897,1558,750,808,0.4813863928112965,0.5186136071887034
E01000898,1586,708,878,0.44640605296343,0.5535939470365699
E01000866,1950,847,1103,0.43435897435897436,0.5656410256410257
E01000870,1601,732,869,0.4572142410993129,0.542785758900687
E01000924,1569,739,830,0.4710006373486297,0.5289993626513703
E01000925,1495,691,804,0.46220735785953176,0.5377926421404682
E01000926,1471,670,801,0.4554724677090415,0.5445275322909585
E01000969,1830,877,953,0.4792349726775956,0.5207650273224044
E01000970,1408,679,729,0.4822443181818182,0.5177556818181818
E01000971,1322,637,685,0.48184568835098335,0.5181543116490166
E01000972,1961,916,1045,0.46710861805201426,0.5328913819479857
E01000973,2562,1203,1359,0.46955503512880564,0.5304449648711944
E01000842,1432,663,769,0.46298882681564246,0.5370111731843575
E01000844,1635,787,848,0.4813455657492355,0.5186544342507645
E01000848,1485,706,779,0.4754208754208754,0.5245791245791246
E01000849,1362,606,756,0.44493392070484583,0.5550660792951542
E01000900,1689,741,948,0.43872113676731794,0.5612788632326821
E01000902,1414,652,762,0.4611032531824611,0.5388967468175389
E01000904,2064,974,1090,0.47189922480620156,0.5281007751937985
E01000905,1874,856,1018,0.4567769477054429,0.5432230522945571
E01000906,1445,671,774,0.4643598615916955,0.5356401384083045
E01000875,1570,769,801,0.48980891719745223,0.5101910828025478
E01000876,1924,924,1000,0.4802494802494803,0.5197505197505198
E01000931,2059,945,1114,0.458960660514813,0.541039339485187
E01000932,1759,806,953,0.45821489482660605,0.541785105173394
E01000974,1590,763,827,0.479874213836478,0.520125786163522
E01000843,1196,573,623,0.4790969899665552,0.5209030100334449
E01000845,1500,690,810,0.46,0.54
E01000846,1453,679,774,0.46730901582931866,0.5326909841706814
E01000847,1599,757,842,0.4734208880550344,0.5265791119449656
E01000867,1736,847,889,0.4879032258064516,0.5120967741935484
E01000868,1746,873,873,0.5,0.5
E01000869,1945,877,1068,0.45089974293059126,0.5491002570694088
E01035707,2451,1153,1298,0.4704202366381069,0.529579763361893
E01000962,1543,744,799,0.48217757615035645,0.5178224238496435
E01000964,1730,848,882,0.49017341040462425,0.5098265895953757
E01000965,1719,788,931,0.4584060500290867,0.5415939499709134
E01000966,1616,782,834,0.4839108910891089,0.5160891089108911
E01000968,1469,699,770,0.4758339006126617,0.5241660993873384
E01000960,1867,862,1005,0.46170326727370115,0.5382967327262989
E01000961,1791,823,968,0.45951982132886654,0.5404801786711334
E01000963,1920,905,1015,0.4713541666666667,0.5286458333333334
E01000967,1539,708,831,0.4600389863547758,0.5399610136452242
E01000857,1391,655,736,0.47088425593098493,0.5291157440690151
E01000858,1932,969,963,0.5015527950310559,0.4984472049689441
E01000859,1462,687,775,0.46990424076607384,0.5300957592339262
E01000860,1121,532,589,0.4745762711864407,0.5254237288135594
E01000862,1685,806,879,0.47833827893175074,0.5216617210682493
E01000856,1591,773,818,0.48585795097423007,0.51414204902577
E01000861,1366,697,669,0.5102489019033675,0.48975109809663253
E01000957,1320,636,684,0.4818181818181818,0.5181818181818182
E01000958,2940,1325,1615,0.45068027210884354,0.5493197278911565
E01000959,1691,840,851,0.4967474866942638,0.5032525133057363
E01000929,1915,902,1013,0.4710182767624021,0.528981723237598
E01000930,2085,964,1121,0.46235011990407676,0.5376498800959233
E01000933,1772,827,945,0.4667042889390519,0.5332957110609481
E01000934,1511,706,805,0.4672402382528127,0.5327597617471873
E01000935,1597,732,865,0.45835942391984974,0.5416405760801503
E01000863,1476,737,739,0.4993224932249323,0.5006775067750677
E01000946,1551,713,838,0.45970341715022567,0.5402965828497743
E01000947,1666,808,858,0.4849939975990396,0.5150060024009604
E01000948,1530,748,782,0.4888888888888889,0.5111111111111111
E01000952,1691,798,893,0.47191011235955055,0.5280898876404494
E01000954,1751,787,964,0.44945745288406624,0.5505425471159338
E01000955,1350,660,690,0.4888888888888889,0.5111111111111111
E01000956,1505,723,782,0.48039867109634554,0.5196013289036545
E01035708,1951,887,1064,0.4546386468477704,0.5453613531522297
E01035709,1539,744,795,0.4834307992202729,0.5165692007797271
E01000944,1464,707,757,0.48292349726775957,0.5170765027322405
E01000949,1600,719,881,0.449375,0.550625
E01000951,1539,730,809,0.4743339831059129,0.5256660168940871
E01035710,2576,1169,1407,0.453804347826087,0.5461956521739131
E01000850,1426,725,701,0.5084151472650772,0.49158485273492286
E01000851,1480,732,748,0.4945945945945946,0.5054054054054054
E01035711,2433,1161,1272,0.47718865598027127,0.5228113440197287
E01000915,1530,743,787,0.48562091503267973,0.5143790849673202
E01000916,1853,920,933,0.496492174851592,0.503507825148408
E01000917,1653,844,809,0.5105868118572293,0.48941318814277074
E01000920,1623,831,792,0.512014787430684,0.4879852125693161
E01000855,1309,651,658,0.49732620320855614,0.5026737967914439
E01000914,1419,690,729,0.48625792811839325,0.5137420718816068
E01000918,1792,913,879,0.5094866071428571,0.49051339285714285
E01000919,1440,753,687,0.5229166666666667,0.47708333333333336
E01000853,1405,668,737,0.47544483985765124,0.5245551601423487
E01000937,1119,527,592,0.4709562109025916,0.5290437890974083
E01000938,1365,685,680,0.5018315018315018,0.4981684981684982
E01000939,1448,704,744,0.4861878453038674,0.5138121546961326
E01000941,1195,580,615,0.48535564853556484,0.5146443514644351
E01000942,1012,493,519,0.4871541501976285,0.5128458498023716
E01000943,1585,719,866,0.45362776025236595,0.546372239747634
E01035712,2459,1153,1306,0.46888979259861735,0.5311102074013827
E01001137,2131,980,1151,0.45987799155326137,0.5401220084467386
E01001138,1514,722,792,0.47688243064729197,0.523117569352708
E01001156,1772,848,924,0.4785553047404063,0.5214446952595937
E01001162,1813,808,1005,0.4456701599558742,0.5543298400441258
E01001164,1981,1013,968,0.5113579000504795,0.48864209994952046
E01001084,1931,953,978,0.4935266701191093,0.5064733298808908
E01001157,1852,868,984,0.468682505399568,0.531317494600432
E01001159,1947,942,1005,0.48382126348228044,0.5161787365177196
E01001160,1947,924,1023,0.4745762711864407,0.5254237288135594
E01001163,1975,919,1056,0.46531645569620256,0.5346835443037975
E01001083,1615,797,818,0.4934984520123839,0.5065015479876162
E01001086,1731,822,909,0.4748700173310225,0.5251299826689775
E01001087,2829,1298,1531,0.4588193708024037,0.5411806291975964
E01001161,1739,845,894,0.48591144335825187,0.5140885566417481
E01001085,1709,855,854,0.5002925687536571,0.49970743124634287
E01001088,1679,800,879,0.47647409172126265,0.5235259082787374
E01001089,1786,820,966,0.45912653975363943,0.5408734602463606
E01001090,2276,1098,1178,0.48242530755711777,0.5175746924428822
E01001091,1575,764,811,0.48507936507936505,0.5149206349206349
E01001147,1782,802,980,0.4500561167227834,0.5499438832772167
E01001148,1760,793,967,0.4505681818181818,0.5494318181818182
E01001151,1749,819,930,0.46826758147512865,0.5317324185248714
E01001152,2062,1032,1030,0.5004849660523764,0.49951503394762364
E01001158,1534,747,787,0.4869621903520209,0.5130378096479792
E01001146,1530,733,797,0.47908496732026146,0.5209150326797386
E01001149,1587,772,815,0.4864524259609326,0.5135475740390675
E01001150,1704,815,889,0.4782863849765258,0.5217136150234741
E01001153,1632,775,857,0.47487745098039214,0.5251225490196079
E01001154,1961,939,1022,0.4788373278939317,0.5211626721060684
E01001136,2039,961,1078,0.4713094654242276,0.5286905345757724
E01001139,1699,805,894,0.47380812242495585,0.5261918775750442
E01001140,1630,774,856,0.47484662576687114,0.5251533742331288
E01001142,1923,905,1018,0.4706188247529901,0.5293811752470099
E01001144,1758,837,921,0.4761092150170648,0.5238907849829352
E01001141,1274,599,675,0.47017268445839877,0.5298273155416012
E01001143,1934,920,1014,0.4756980351602896,0.5243019648397105
E01001145,1827,830,997,0.45429666119321294,0.5457033388067871
E01001191,2072,960,1112,0.46332046332046334,0.5366795366795367
E01001192,1585,720,865,0.45425867507886436,0.5457413249211357
E01000994,1591,760,831,0.4776869893148963,0.5223130106851037
E01000995,1714,822,892,0.4795799299883314,0.5204200700116686
E01000996,1329,633,696,0.4762979683972912,0.5237020316027088
E01000997,1499,759,740,0.5063375583722481,0.49366244162775186
E01000999,1324,635,689,0.479607250755287,0.520392749244713
E01001002,1472,720,752,0.4891304347826087,0.5108695652173914
E01000998,1493,731,762,0.4896182183523108,0.5103817816476892
E01001000,1338,669,669,0.5,0.5
E01001003,1588,733,855,0.4615869017632242,0.5384130982367759
E01001111,1752,852,900,0.4863013698630137,0.5136986301369864
E01001155,1794,818,976,0.4559643255295429,0.5440356744704571
E01001174,1691,847,844,0.5008870490833827,0.4991129509166174
E01001175,1639,811,828,0.49481391092129345,0.5051860890787065
E01001176,1847,908,939,0.4916080129940444,0.5083919870059556
E01001182,1358,653,705,0.4808541973490427,0.5191458026509573
E01001183,1821,878,943,0.48215266337177376,0.5178473366282262
E01001184,1299,603,696,0.46420323325635104,0.535796766743649
E01001001,1410,694,716,0.4921985815602837,0.5078014184397163
E01001109,2350,1055,1295,0.44893617021276594,0.551063829787234
E01001112,2017,928,1089,0.4600892414476946,0.5399107585523054
E01001113,2006,977,1029,0.48703888334995016,0.5129611166500498
E01001114,1510,781,729,0.5172185430463576,0.4827814569536424
E01001116,1525,711,814,0.4662295081967213,0.5337704918032787
E01000992,1876,889,987,0.47388059701492535,0.5261194029850746
E01001185,1702,817,885,0.4800235017626322,0.5199764982373678
E01001186,1683,807,876,0.47950089126559714,0.5204991087344029
E01001188,1959,918,1041,0.4686064318529862,0.5313935681470138
E01001193,1682,758,924,0.450653983353151,0.549346016646849
E01001004,2180,1057,1123,0.48486238532110093,0.5151376146788991
E01001115,1819,838,981,0.4606926882902694,0.5393073117097307
E01001178,1627,795,832,0.48862937922556854,0.5113706207744315
E01001181,2190,1018,1172,0.4648401826484018,0.5351598173515981
E01034139,1804,905,899,0.5016629711751663,0.4983370288248337
E01034140,1244,575,669,0.4622186495176849,0.5377813504823151
E01001006,1790,873,917,0.4877094972067039,0.5122905027932961
E01001007,1984,979,1005,0.4934475806451613,0.5065524193548387
E01001177,1649,796,853,0.48271679805942996,0.5172832019405701
E01001179,1664,804,860,0.4831730769230769,0.5168269230769231
E01001180,1980,911,1069,0.4601010101010101,0.5398989898989899
E01000980,1495,715,780,0.4782608695652174,0.5217391304347826
E01000981,1730,841,889,0.4861271676300578,0.5138728323699422
E01000982,1684,812,872,0.4821852731591449,0.517814726840855
E01000983,1819,867,952,0.4766355140186916,0.5233644859813084
E01001187,1985,951,1034,0.47909319899244335,0.5209068010075567
E01000989,1734,854,880,0.4925028835063437,0.5074971164936563
E01000991,1736,851,885,0.4902073732718894,0.5097926267281107
E01001131,1568,721,847,0.45982142857142855,0.5401785714285714
E01001132,1621,770,851,0.47501542257865514,0.5249845774213449
E01001134,1612,763,849,0.47332506203473945,0.5266749379652605
E01001005,1733,871,862,0.502596653202539,0.49740334679746107
E01001008,1668,809,859,0.48501199040767384,0.5149880095923262
E01001009,2049,977,1072,0.47681795998047827,0.5231820400195217
E01001010,1700,789,911,0.4641176470588235,0.5358823529411765
E01001011,2311,1132,1179,0.4898312418866292,0.5101687581133708
E01001012,2097,1039,1058,0.4954697186456843,0.5045302813543157
E01001013,2195,1105,1090,0.5034168564920274,0.49658314350797267
E01001110,2148,1017,1131,0.473463687150838,0.526536312849162
E01001118,2153,1034,1119,0.48026010218300047,0.5197398978169996
E01034141,1420,730,690,0.5140845070422535,0.4859154929577465
E01034142,1479,765,714,0.5172413793103449,0.4827586206896552
E01034143,1307,651,656,0.49808722264728383,0.5019127773527161
E01000985,1454,690,764,0.47455295735900965,0.5254470426409904
E01000986,1774,862,912,0.4859075535512965,0.5140924464487034
E01000987,1356,675,681,0.497787610619469,0.5022123893805309
E01000993,1652,824,828,0.49878934624697335,0.5012106537530266
E01000975,2346,1151,1195,0.4906223358908781,0.5093776641091219
E01000976,2143,1064,1079,0.4965002333177788,0.5034997666822212
E01000977,1943,988,955,0.5084920226453937,0.4915079773546063
E01000978,1731,878,853,0.5072212593876372,0.4927787406123628
E01000979,1755,881,874,0.501994301994302,0.498005698005698
E01000984,1905,917,988,0.48136482939632547,0.5186351706036746
E01001044,2081,1028,1053,0.493993272465161,0.506006727534839
E01001046,1926,972,954,0.5046728971962616,0.4953271028037383
E01001049,1440,709,731,0.49236111111111114,0.5076388888888889
E01001050,1715,800,915,0.46647230320699706,0.5335276967930029
E01001042,2172,1027,1145,0.47283609576427255,0.5271639042357275
E01001165,1847,898,949,0.48619382782891174,0.5138061721710883
E01001166,1968,957,1011,0.48628048780487804,0.5137195121951219
E01001168,1817,938,879,0.5162355531095212,0.4837644468904788
E01034144,1349,660,689,0.4892512972572276,0.5107487027427724
E01034145,1330,653,677,0.49097744360902257,0.5090225563909775
E01034146,1442,663,779,0.45977808599167824,0.5402219140083218
E01001127,1626,801,825,0.492619926199262,0.507380073800738
E01001128,1602,716,886,0.4469413233458177,0.5530586766541823
E01001130,1762,771,991,0.4375709421112372,0.5624290578887627
E01001135,1679,800,879,0.47647409172126265,0.5235259082787374
E01001062,1514,717,797,0.47357992073976224,0.5264200792602378
E01001063,1535,727,808,0.4736156351791531,0.5263843648208469
E01001064,1604,787,817,0.4906483790523691,0.5093516209476309
E01001129,1392,671,721,0.48204022988505746,0.5179597701149425
E01001133,1588,726,862,0.45717884130982367,0.5428211586901763
E01001167,2325,1153,1172,0.49591397849462365,0.5040860215053763
E01001169,1831,846,985,0.4620425996723102,0.5379574003276898
E01001171,1758,843,915,0.47952218430034127,0.5204778156996587
E01001172,2204,1019,1185,0.46234119782214156,0.5376588021778584
E01001173,2740,1313,1427,0.4791970802919708,0.5208029197080292
E01001036,1623,805,818,0.4959950708564387,0.5040049291435613
E01001037,1536,732,804,0.4765625,0.5234375
E01001038,1903,927,976,0.48712559117183396,0.512874408828166
E01001039,1569,757,812,0.4824729126832377,0.5175270873167622
E01001040,1721,807,914,0.46891342242882045,0.5310865775711795
E01001051,1604,722,882,0.45012468827930174,0.5498753117206983
E01001052,1466,651,815,0.4440654843110505,0.5559345156889495
E01001054,1861,869,992,0.46695325094035467,0.5330467490596453
E01001056,1808,799,1009,0.44192477876106195,0.558075221238938
E01001057,1791,799,992,0.44611948632049137,0.5538805136795086
E01001033,1669,822,847,0.49251048532055125,0.5074895146794488
E01001034,1609,748,861,0.4648850217526414,0.5351149782473587
E01001041,1730,836,894,0.48323699421965316,0.5167630057803468
E01001095,1530,736,794,0.48104575163398694,0.5189542483660131
E01001100,1511,722,789,0.47782925215089345,0.5221707478491066
E01001053,1600,756,844,0.4725,0.5275
E01001055,1568,745,823,0.47512755102040816,0.5248724489795918
E01001077,1332,638,694,0.47897897897897895,0.521021021021021
E01001078,1448,688,760,0.47513812154696133,0.5248618784530387
E01001082,1551,711,840,0.4584139264990329,0.5415860735009671
E01001120,1347,665,682,0.49368968077208614,0.5063103192279139
E01001122,1440,733,707,0.5090277777777777,0.4909722222222222
E01001123,1617,773,844,0.4780457637600495,0.5219542362399505
E01001124,1566,745,821,0.47573435504469985,0.5242656449553001
E01001125,1645,803,842,0.48814589665653496,0.511854103343465
E01001058,1355,608,747,0.4487084870848708,0.5512915129151291
E01001059,1452,658,794,0.453168044077135,0.546831955922865
E01001060,1621,805,816,0.49660703269586676,0.5033929673041333
E01001061,1621,768,853,0.47378161628624305,0.526218383713757
E01001065,1325,617,708,0.4656603773584906,0.5343396226415095
E01001066,1453,640,813,0.440467997247075,0.559532002752925
E01001119,1439,702,737,0.48783877692842254,0.5121612230715775
E01001126,1417,672,745,0.47424135497529996,0.5257586450247
E01001032,1556,762,794,0.4897172236503856,0.5102827763496144
E01001101,1431,715,716,0.4996505939902166,0.5003494060097834
E01001102,1516,716,800,0.47229551451187335,0.5277044854881267
E01001107,1667,826,841,0.495500899820036,0.504499100179964
E01001108,1786,882,904,0.49384098544232924,0.5061590145576708
E01001076,1667,806,861,0.483503299340132,0.5164967006598681
E01001079,1614,776,838,0.48079306071871125,0.5192069392812887
E01001080,1481,690,791,0.4659014179608373,0.5340985820391627
E01001081,1473,714,759,0.4847250509164969,0.515274949083503
E01001073,1441,673,768,0.46703678001387927,0.5329632199861207
E01001092,1933,933,1000,0.4826694257630626,0.5173305742369374
E01001093,1793,897,896,0.5002788622420524,0.4997211377579476
E01001096,1478,736,742,0.4979702300405954,0.5020297699594046
E01001097,2389,1112,1277,0.4654667224780243,0.5345332775219758
E01001098,1470,757,713,0.5149659863945578,0.4850340136054422
E01001028,1656,818,838,0.4939613526570048,0.5060386473429952
E01001029,1720,842,878,0.48953488372093024,0.5104651162790698
E01001030,1454,694,760,0.47730398899587345,0.5226960110041265
E01001031,1456,729,727,0.5006868131868132,0.4993131868131868
E01001094,1644,791,853,0.4811435523114355,0.5188564476885644
E01001103,1633,790,843,0.48377219840783836,0.5162278015921616
E01001105,1737,812,925,0.4674726540011514,0.5325273459988485
E01001106,1503,708,795,0.47105788423153694,0.5289421157684631
E01001121,1324,630,694,0.47583081570996977,0.5241691842900302
E01001069,1369,660,709,0.4821037253469686,0.5178962746530315
E01001070,1785,846,939,0.47394957983193275,0.5260504201680672
E01001075,1629,800,829,0.4910988336402701,0.5089011663597299
E01001099,1581,754,827,0.4769133459835547,0.5230866540164453
E01001015,1493,694,799,0.46483590087073007,0.5351640991292699
E01001016,1758,836,922,0.47554038680318544,0.5244596131968146
E01001023,2596,1252,1344,0.48228043143297383,0.5177195685670262
E01001067,1654,858,796,0.5187424425634825,0.48125755743651755
E01001074,1948,911,1037,0.46765913757700206,0.5323408624229979
E01001068,1836,880,956,0.4793028322440087,0.5206971677559913
E01001071,1897,914,983,0.48181338956246705,0.518186610437533
E01001072,1484,757,727,0.5101078167115903,0.4898921832884097
E01001104,1674,794,880,0.4743130227001195,0.5256869772998806
E01001017,1649,823,826,0.4990903577926016,0.5009096422073984
E01001024,1341,666,675,0.4966442953020134,0.5033557046979866
E01001025,1349,676,673,0.5011119347664937,0.4988880652335063
E01001026,1881,903,978,0.4800637958532695,0.5199362041467305
E01001027,2910,1430,1480,0.49140893470790376,0.5085910652920962
E01001018,1649,790,859,0.4790782292298363,0.5209217707701638
E01001019,1460,717,743,0.4910958904109589,0.5089041095890411
E01001020,1653,785,868,0.4748941318814277,0.5251058681185723
E01001021,1357,616,741,0.4539425202652911,0.5460574797347089
E01001022,1482,723,759,0.48785425101214575,0.5121457489878543
E01000990,1436,652,784,0.45403899721448465,0.5459610027855153
E01001189,1218,565,653,0.4638752052545156,0.5361247947454844
E01001190,1552,731,821,0.47100515463917525,0.5289948453608248
E01001194,1615,770,845,0.47678018575851394,0.5232198142414861
E01032569,1790,789,1001,0.44078212290502794,0.5592178770949721
E01034147,1121,602,519,0.5370205173951829,0.46297948260481714
E01034148,1628,868,760,0.5331695331695332,0.4668304668304668
E01034149,2114,965,1149,0.456480605487228,0.543519394512772
E01034150,1347,698,649,0.51818856718634,0.48181143281366
E01034151,1163,587,576,0.5047291487532244,0.49527085124677556
E01001035,1860,916,944,0.4924731182795699,0.5075268817204301
E01001047,1734,890,844,0.5132641291810842,0.4867358708189158
E01001170,1940,931,1009,0.47989690721649486,0.5201030927835052
E01034152,1627,792,835,0.48678549477566074,0.5132145052243393
E01001269,2272,1125,1147,0.4951584507042254,0.5048415492957746
E01001271,1920,973,947,0.5067708333333333,0.49322916666666666
E01001309,1855,915,940,0.49326145552560646,0.5067385444743935
E01001310,2142,1100,1042,0.5135387488328664,0.4864612511671335
E01001311,2518,1269,1249,0.5039714058776807,0.4960285941223193
E01001307,1883,947,936,0.5029208709506108,0.4970791290493893
E01001308,1941,969,972,0.4992272024729521,0.500772797527048
E01001312,1966,944,1022,0.4801627670396745,0.5198372329603256
E01001313,1725,832,893,0.48231884057971014,0.5176811594202898
E01001314,1525,743,782,0.48721311475409834,0.5127868852459017
E01001315,1467,737,730,0.5023858214042263,0.49761417859577367
E01001316,1725,792,933,0.4591304347826087,0.5408695652173913
E01001317,2181,1049,1132,0.48097203117835857,0.5190279688216415
E01001318,1949,934,1015,0.47922011287839916,0.5207798871216008
E01001320,1623,778,845,0.4793592113370302,0.5206407886629698
E01001321,2263,1165,1098,0.5148033583738401,0.48519664162615994
E01001270,1760,854,906,0.48522727272727273,0.5147727272727273
E01001319,1549,777,772,0.5016139444803098,0.4983860555196901
E01001322,2070,1013,1057,0.4893719806763285,0.5106280193236715
E01001323,2015,968,1047,0.4803970223325062,0.5196029776674937
E01001341,1792,906,886,0.5055803571428571,0.49441964285714285
E01001342,1896,980,916,0.5168776371308017,0.4831223628691983
E01001343,1439,710,729,0.49339819318971506,0.5066018068102849
E01001345,1758,903,855,0.5136518771331058,0.4863481228668942
E01001265,1723,871,852,0.5055136390017412,0.4944863609982589
E01001266,1833,927,906,0.5057283142389526,0.49427168576104746
E01001267,2035,933,1102,0.45847665847665847,0.5415233415233415
E01001272,1719,891,828,0.518324607329843,0.4816753926701571
E01001349,1411,682,729,0.4833451452870305,0.5166548547129696
E01001344,2289,1154,1135,0.5041502839667977,0.49584971603320227
E01001346,1959,986,973,0.5033180193976519,0.49668198060234814
E01001347,1972,1084,888,0.5496957403651116,0.45030425963488846
E01001348,1672,857,815,0.5125598086124402,0.4874401913875598
E01001257,2233,1060,1173,0.47469771607702643,0.5253022839229736
E01001324,1663,829,834,0.4984966927239928,0.5015033072760072
E01001326,1960,957,1003,0.488265306122449,0.511734693877551
E01001330,1858,867,991,0.4666307857911733,0.5333692142088267
E01001332,1594,740,854,0.4642409033877039,0.5357590966122961
E01001325,1983,1005,978,0.5068078668683812,0.49319213313161875
E01001327,1896,956,940,0.5042194092827004,0.4957805907172996
E01001328,1823,890,933,0.4882062534284147,0.5117937465715853
E01001329,1963,965,998,0.4915944982170148,0.5084055017829853
E01001331,1796,877,919,0.48830734966592426,0.5116926503340757
E01001258,1874,929,945,0.4957310565635005,0.5042689434364994
E01001262,1620,756,864,0.4666666666666667,0.5333333333333333
E01001263,1947,941,1006,0.4833076527991782,0.5166923472008218
E01001264,1821,889,932,0.48819330038440417,0.5118066996155958
E01032743,2281,1077,1204,0.4721613327487944,0.5278386672512057
E01032744,1612,815,797,0.5055831265508685,0.4944168734491315
E01001276,1778,907,871,0.5101237345331834,0.4898762654668167
E01001277,2041,1044,997,0.5115139637432631,0.48848603625673687
E01001278,2081,1036,1045,0.49783757808745793,0.502162421912542
E01001280,1819,892,927,0.49037932930181416,0.5096206706981858
E01001218,2057,966,1091,0.46961594555177444,0.5303840544482256
E01001260,2039,1017,1022,0.49877390877881317,0.5012260912211869
E01001261,2319,1175,1144,0.5066839154808107,0.4933160845191893
E01001268,1963,964,999,0.49108507386653083,0.5089149261334692
E01001209,1683,824,859,0.48960190136660725,0.5103980986333928
E01001211,1736,833,903,0.4798387096774194,0.5201612903225806
E01001279,1492,741,751,0.49664879356568364,0.5033512064343163
E01001281,1572,747,825,0.4751908396946565,0.5248091603053435
E01001217,1452,738,714,0.5082644628099173,0.49173553719008267
E01001259,1599,798,801,0.49906191369606,0.50093808630394
E01001291,1762,907,855,0.514755959137344,0.48524404086265605
E01001292,1675,835,840,0.49850746268656715,0.5014925373134328
E01001293,1827,905,922,0.4953475643130816,0.5046524356869184
E01001196,1619,786,833,0.48548486720197653,0.5145151327980235
E01001239,1480,707,773,0.4777027027027027,0.5222972972972973
E01001246,1827,931,896,0.5095785440613027,0.4904214559386973
E01001247,2269,1125,1144,0.49581313353900397,0.5041868664609961
E01034026,2511,1103,1408,0.43926722421346076,0.5607327757865392
E01034027,2533,1297,1236,0.5120410580339518,0.48795894196604817
E01001210,1888,869,1019,0.4602754237288136,0.5397245762711864
E01001282,1619,798,821,0.4928968499073502,0.5071031500926498
E01001283,1781,847,934,0.4755755193711398,0.5244244806288602
E01001285,1769,866,903,0.4895421141888072,0.5104578858111928
E01001286,1669,783,886,0.4691431995206711,0.5308568004793289
E01001287,1619,745,874,0.46016059295861644,0.5398394070413836
E01001294,2029,1005,1024,0.49531789058649583,0.5046821094135042
E01001295,1795,900,895,0.5013927576601671,0.4986072423398329
E01001296,1439,752,687,0.5225851285615011,0.477414871438499
E01001297,1836,929,907,0.5059912854030502,0.4940087145969499
E01001298,2110,1074,1036,0.5090047393364929,0.4909952606635071
E01001204,1614,774,840,0.4795539033457249,0.5204460966542751
E01001205,1781,834,947,0.4682762492981471,0.5317237507018528
E01001206,1578,740,838,0.46894803548795944,0.5310519645120405
E01001207,1762,847,915,0.4807037457434733,0.5192962542565267
E01001208,1360,665,695,0.4889705882352941,0.5110294117647058
E01001212,1767,865,902,0.48953027730616866,0.5104697226938314
E01001224,1560,770,790,0.4935897435897436,0.5064102564102564
E01001226,1513,757,756,0.5003304692663583,0.4996695307336418
E01001227,1521,742,779,0.4878369493754109,0.5121630506245891
E01001228,1834,916,918,0.4994547437295529,0.5005452562704471
E01034028,1230,593,637,0.4821138211382114,0.5178861788617887
E01034029,1525,727,798,0.47672131147540986,0.5232786885245901
E01001195,1824,919,905,0.5038377192982456,0.4961622807017544
E01001197,1853,950,903,0.5126821370750135,0.4873178629249865
E01001198,1561,756,805,0.484304932735426,0.515695067264574
E01001199,1663,797,866,0.4792543595911004,0.5207456404088996
E01001284,1720,876,844,0.5093023255813953,0.4906976744186046
E01001288,1479,734,745,0.49628127112914133,0.5037187288708587
E01001289,1338,649,689,0.4850523168908819,0.5149476831091181
E01001290,2050,988,1062,0.4819512195121951,0.5180487804878049
E01001213,2010,1063,947,0.5288557213930348,0.4711442786069652
E01001214,1745,891,854,0.5106017191977077,0.48939828080229225
E01001215,2057,1013,1044,0.4924647544968401,0.50753524550316
E01001216,1749,873,876,0.49914236706689535,0.5008576329331046
E01001361,2276,1192,1084,0.523725834797891,0.47627416520210897
E01001240,1826,946,880,0.5180722891566265,0.4819277108433735
E01001241,1855,913,942,0.4921832884097035,0.5078167115902965
E01001242,1622,753,869,0.4642416769420469,0.5357583230579531
E01001243,2387,1167,1220,0.48889819857561795,0.5111018014243821
E01001244,2792,1341,1451,0.4803008595988539,0.5196991404011462
E01001245,2170,959,1211,0.44193548387096776,0.5580645161290323
E01001200,1594,801,793,0.5025094102885822,0.4974905897114178
E01001201,1591,751,840,0.47203016970458833,0.5279698302954117
E01001202,2502,1192,1310,0.47641886490807356,0.5235811350919265
E01001203,1688,838,850,0.49644549763033174,0.5035545023696683
E01001351,1973,965,1008,0.48910288900152055,0.5108971109984795
E01001359,2464,1304,1160,0.5292207792207793,0.4707792207792208
E01001360,2213,1152,1061,0.5205603253502034,0.47943967464979664
E01001362,2624,1347,1277,0.5133384146341463,0.48666158536585363
E01001363,1994,1040,954,0.5215646940822467,0.47843530591775324
E01001364,1834,897,937,0.48909487459105777,0.5109051254089422
E01001365,2577,1365,1212,0.529685681024447,0.470314318975553
E01001231,2045,1097,948,0.5364303178484108,0.4635696821515892
E01001234,1370,659,711,0.481021897810219,0.518978102189781
E01001350,1437,688,749,0.47877522616562285,0.5212247738343772
E01001352,1584,761,823,0.48042929292929293,0.5195707070707071
E01001354,2056,1015,1041,0.49367704280155644,0.5063229571984436
E01001249,2436,1129,1307,0.46346469622331693,0.5365353037766831
E01001250,2181,1017,1164,0.46629986244841815,0.5337001375515819
E01001255,1589,778,811,0.4896161107614852,0.5103838892385147
E01001383,1754,884,870,0.5039908779931584,0.4960091220068415
E01001388,1447,715,732,0.4941257774706289,0.5058742225293711
E01001389,1827,936,891,0.5123152709359606,0.4876847290640394
E01001219,2195,1059,1136,0.4824601366742597,0.5175398633257403
E01001220,1514,724,790,0.47820343461030385,0.5217965653896962
E01001334,1665,840,825,0.5045045045045045,0.4954954954954955
E01001337,2123,1047,1076,0.49317004239284035,0.5068299576071597
E01001338,1867,934,933,0.5002678093197643,0.49973219068023567
E01001339,2184,1039,1145,0.4757326007326007,0.5242673992673993
E01001340,1564,799,765,0.5108695652173914,0.4891304347826087
E01001251,1809,856,953,0.47318960751796574,0.5268103924820343
E01001252,2466,1209,1257,0.4902676399026764,0.5097323600973236
E01001253,2128,1035,1093,0.48637218045112784,0.5136278195488722
E01001254,1747,841,906,0.4813966800228964,0.5186033199771036
E01001229,1518,719,799,0.4736495388669302,0.5263504611330698
E01001230,1370,654,716,0.47737226277372263,0.5226277372262774
E01001232,1558,751,807,0.4820282413350449,0.517971758664955
E01001233,1443,684,759,0.47401247401247404,0.525987525987526
E01001237,1563,797,766,0.5099168266154831,0.49008317338451696
E01001386,1798,891,907,0.4955506117908788,0.5044493882091212
E01001303,1725,779,946,0.45159420289855073,0.5484057971014493
E01001382,1480,701,779,0.47364864864864864,0.5263513513513514
E01001384,1748,844,904,0.482837528604119,0.517162471395881
E01001385,1678,810,868,0.4827175208581645,0.5172824791418356
E01001387,1535,775,760,0.504885993485342,0.495114006514658
E01001353,1415,664,751,0.46925795053003533,0.5307420494699646
E01001355,1957,956,1001,0.4885028104241185,0.5114971895758814
E01001356,1495,710,785,0.47491638795986624,0.5250836120401338
E01001357,2750,1300,1450,0.4727272727272727,0.5272727272727272
E01001358,1990,1001,989,0.5030150753768844,0.49698492462311555
E01001375,1698,801,897,0.4717314487632509,0.5282685512367491
E01001377,1639,786,853,0.4795607077486272,0.5204392922513728
E01001379,1736,828,908,0.4769585253456221,0.5230414746543779
E01001381,1877,870,1007,0.46350559403303143,0.5364944059669685
E01001248,1593,786,807,0.4934086629001883,0.5065913370998116
E01001299,1755,843,912,0.48034188034188036,0.5196581196581197
E01001305,1728,869,859,0.5028935185185185,0.49710648148148145
E01001306,1637,770,867,0.4703726328649969,0.529627367135003
E01001333,2464,1254,1210,0.5089285714285714,0.49107142857142855
E01001335,1800,914,886,0.5077777777777778,0.4922222222222222
E01001336,1841,928,913,0.5040738728951657,0.4959261271048343
E01001369,2064,1046,1018,0.5067829457364341,0.4932170542635659
E01001300,1615,815,800,0.5046439628482973,0.4953560371517028
E01001301,1886,912,974,0.4835630965005302,0.5164369034994698
E01001302,1602,778,824,0.48564294631710364,0.5143570536828964
E01001304,1658,777,881,0.4686369119420989,0.5313630880579011
E01001374,1945,978,967,0.502827763496144,0.49717223650385606
E01001376,1707,802,905,0.46983011130638547,0.5301698886936145
E01001380,2306,1103,1203,0.47831743278404165,0.5216825672159584
E01032572,1608,767,841,0.47699004975124376,0.5230099502487562
E01001223,1454,691,763,0.4752407152682256,0.5247592847317745
E01001225,1811,896,915,0.4947542794036444,0.5052457205963556
E01001273,1675,829,846,0.4949253731343284,0.5050746268656716
E01001274,1610,802,808,0.49813664596273294,0.5018633540372671
E01001275,1800,868,932,0.4822222222222222,0.5177777777777778
E01001235,1775,866,909,0.48788732394366197,0.512112676056338
E01001236,1476,731,745,0.49525745257452575,0.5047425474254743
E01034030,1861,904,957,0.48576034390112843,0.5142396560988716
E01034031,1312,666,646,0.5076219512195121,0.4923780487804878
E01001367,2710,1449,1261,0.5346863468634686,0.4653136531365314
E01001372,2555,1343,1212,0.5256360078277886,0.47436399217221137
E01001373,2078,1084,994,0.5216554379210779,0.47834456207892206
E01001366,2050,1065,985,0.5195121951219512,0.48048780487804876
E01001368,1764,908,856,0.5147392290249433,0.4852607709750567
E01001370,2172,1084,1088,0.4990791896869245,0.5009208103130756
E01001371,2309,1174,1135,0.5084452143785189,0.49155478562148114
E01001444,1908,889,1019,0.4659329140461216,0.5340670859538784
E01001446,1858,890,968,0.4790096878363832,0.5209903121636168
E01001546,1813,863,950,0.4760066188637617,0.5239933811362383
E01001552,1945,951,994,0.48894601542416455,0.5110539845758355
E01001442,1732,764,968,0.44110854503464203,0.558891454965358
E01001545,1885,867,1018,0.459946949602122,0.540053050397878
E01001547,2092,1010,1082,0.48279158699808794,0.517208413001912
E01001548,1927,893,1034,0.4634146341463415,0.5365853658536586
E01001551,1794,843,951,0.4698996655518395,0.5301003344481605
E01001445,2800,1290,1510,0.4607142857142857,0.5392857142857143
E01001447,1991,936,1055,0.47011551983927674,0.5298844801607232
E01001448,1982,933,1049,0.470736629667003,0.529263370332997
E01001449,1643,800,843,0.48691418137553255,0.5130858186244674
E01033148,2216,1054,1162,0.4756317689530686,0.5243682310469314
E01033150,1690,761,929,0.4502958579881657,0.5497041420118344
E01001408,1670,773,897,0.462874251497006,0.537125748502994
E01001411,1903,896,1007,0.4708355228586443,0.5291644771413557
E01001412,1755,839,916,0.47806267806267805,0.5219373219373219
E01001413,1635,782,853,0.4782874617737003,0.5217125382262997
E01001414,1671,784,887,0.46918013165769,0.53081986834231
E01001407,1591,771,820,0.4846008799497172,0.5153991200502829
E01001409,2034,948,1086,0.46607669616519176,0.5339233038348082
E01001410,2188,1000,1188,0.4570383912248629,0.5429616087751371
E01001516,2123,1032,1091,0.4861045690061234,0.5138954309938766
E01001537,1715,789,926,0.46005830903790085,0.5399416909620991
E01001439,2131,977,1154,0.45847020178320036,0.5415297982167996
E01001441,1646,782,864,0.47509113001215064,0.5249088699878494
E01001517,2045,948,1097,0.4635696821515892,0.5364303178484108
E01001549,2357,1036,1321,0.43954179041154007,0.5604582095884599
E01001550,1770,835,935,0.4717514124293785,0.5282485875706214
E01001433,1822,842,980,0.4621295279912184,0.5378704720087816
E01001434,1591,758,833,0.4764299182903834,0.5235700817096166
E01001435,1517,730,787,0.4812129202373105,0.5187870797626896
E01001436,1933,949,984,0.49094671495085357,0.5090532850491464
E01001438,1675,807,868,0.4817910447761194,0.5182089552238806
E01001469,1767,840,927,0.47538200339558573,0.5246179966044142
E01001536,1970,964,1006,0.48934010152284263,0.5106598984771573
E01001540,1906,943,963,0.4947534102833158,0.5052465897166841
E01001541,1532,704,828,0.4595300261096606,0.5404699738903395
E01001542,1566,708,858,0.4521072796934866,0.5478927203065134
E01001538,1677,798,879,0.47584973166368516,0.5241502683363148
E01001539,1654,794,860,0.4800483675937122,0.5199516324062878
E01001543,1617,786,831,0.48608534322820035,0.5139146567717996
E01001544,1695,824,871,0.4861356932153392,0.5138643067846608
E01001457,1813,821,992,0.45284059569773855,0.5471594043022614
E01001468,1416,674,742,0.4759887005649718,0.5240112994350282
E01001471,1908,867,1041,0.45440251572327045,0.5455974842767296
E01001472,1653,747,906,0.4519056261343013,0.5480943738656987
E01001474,1898,920,978,0.48472075869336145,0.5152792413066386
E01001415,2050,982,1068,0.4790243902439024,0.5209756097560976
E01001417,1887,919,968,0.48701642819289875,0.5129835718071012
E01001418,1740,836,904,0.4804597701149425,0.5195402298850574
E01001422,1677,806,871,0.4806201550387597,0.5193798449612403
E01001440,1677,808,869,0.48181276088252833,0.5181872391174717
E01001504,2139,1055,1084,0.49322113136979895,0.506778868630201
E01001505,1959,961,998,0.4905564063297601,0.50944359367024
E01001507,2583,1180,1403,0.45683313975996903,0.543166860240031
E01001508,2444,1139,1305,0.4660392798690671,0.5339607201309329
E01001513,1982,912,1070,0.4601412714429869,0.5398587285570131
E01001416,1726,850,876,0.492468134414832,0.507531865585168
E01001470,1649,793,856,0.4808975136446331,0.5191024863553669
E01001473,1596,754,842,0.4724310776942356,0.5275689223057645
E01001475,1803,884,919,0.49029395452024405,0.509706045479756
E01001437,2275,1071,1204,0.4707692307692308,0.5292307692307693
E01001509,1773,850,923,0.47941342357586014,0.5205865764241399
E01033926,2635,1232,1403,0.46755218216318783,0.5324478178368122
E01001405,1802,843,959,0.46781354051054386,0.5321864594894562
E01001406,1658,784,874,0.47285886610373945,0.5271411338962606
E01001450,2381,1104,1277,0.4636707265854683,0.5363292734145317
E01001512,2277,1066,1211,0.4681598594642073,0.5318401405357928
E01001515,2047,1000,1047,0.48851978505129456,0.5114802149487054
E01001401,1389,675,714,0.48596112311015116,0.5140388768898488
E01001478,1658,789,869,0.4758745476477684,0.5241254523522316
E01001484,1414,676,738,0.4780763790664781,0.521923620933522
E01001511,1923,889,1034,0.4622984919396776,0.5377015080603225
E01001514,1765,811,954,0.4594900849858357,0.5405099150141643
E01001518,1688,810,878,0.47985781990521326,0.5201421800947867
E01001451,1664,838,826,0.5036057692307693,0.4963942307692308
E01001452,1373,680,693,0.49526584122359796,0.504734158776402
E01001453,1659,806,853,0.48583484026522,0.5141651597347799
E01001454,1701,797,904,0.46854791299235743,0.5314520870076426
E01001476,1751,848,903,0.4842946887492861,0.5157053112507138
E01001477,1980,964,1016,0.4868686868686869,0.5131313131313131
E01001481,1796,868,928,0.48329621380846327,0.5167037861915368
E01001502,1954,916,1038,0.4687819856704197,0.5312180143295804
E01001503,1888,877,1011,0.4645127118644068,0.5354872881355932
E01001520,1857,902,955,0.4857296715131933,0.5142703284868066
E01001522,1817,833,984,0.45844799119427626,0.5415520088057237
E01001523,1847,894,953,0.4840281537628587,0.5159718462371413
E01001524,1562,755,807,0.4833546734955186,0.5166453265044815
E01001526,1608,773,835,0.48072139303482586,0.5192786069651741
E01001419,1971,934,1037,0.47387113140537795,0.526128868594622
E01001420,1783,824,959,0.4621424565339316,0.5378575434660684
E01001421,1673,797,876,0.47638971906754335,0.5236102809324567
E01001525,1964,925,1039,0.4709775967413442,0.5290224032586558
E01033927,1654,805,849,0.4866989117291415,0.5133010882708585
E01033928,1298,653,645,0.5030816640986132,0.49691833590138673
E01001398,1340,663,677,0.49477611940298505,0.505223880597015
E01001399,1482,744,738,0.5020242914979757,0.4979757085020243
E01001400,1562,718,844,0.45966709346991036,0.5403329065300896
E01001402,1852,900,952,0.48596112311015116,0.5140388768898488
E01001403,1705,860,845,0.5043988269794721,0.49560117302052786
E01001455,1456,718,738,0.49313186813186816,0.5068681318681318
E01001456,1396,693,703,0.49641833810888253,0.5035816618911175
E01001564,1662,786,876,0.4729241877256318,0.5270758122743683
E01001567,1541,737,804,0.4782608695652174,0.5217391304347826
E01001568,1884,964,920,0.5116772823779193,0.4883227176220807
E01001569,1770,865,905,0.4887005649717514,0.5112994350282486
E01001479,1793,856,937,0.4774121583937535,0.5225878416062465
E01001482,1923,923,1000,0.4799791991679667,0.5200208008320333
E01001487,1941,903,1038,0.4652241112828439,0.5347758887171561
E01001489,1888,916,972,0.4851694915254237,0.5148305084745762
E01001491,1950,925,1025,0.47435897435897434,0.5256410256410257
E01001459,1720,813,907,0.47267441860465115,0.5273255813953488
E01001460,2113,1039,1074,0.4917179365830573,0.5082820634169427
E01001462,1455,713,742,0.49003436426116836,0.5099656357388316
E01001480,1591,745,846,0.46825895663104966,0.5317410433689503
E01001488,1979,924,1055,0.4669024759979788,0.5330975240020213
E01001483,1187,545,642,0.45914069081718617,0.5408593091828138
E01001485,1858,879,979,0.4730893433799785,0.5269106566200216
E01001486,2148,988,1160,0.45996275605214154,0.5400372439478585
E01001492,2038,971,1067,0.4764474975466143,0.5235525024533857
E01033146,1537,674,863,0.4385165907612232,0.5614834092387768
E01033151,1451,656,795,0.45210199862164024,0.5478980013783598
E01001404,1480,732,748,0.4945945945945946,0.5054054054054054
E01001493,1911,945,966,0.4945054945054945,0.5054945054945055
E01001494,1477,719,758,0.4867975626269465,0.5132024373730535
E01001496,1901,986,915,0.518674381904261,0.4813256180957391
E01001570,1900,914,986,0.48105263157894734,0.5189473684210526
E01001423,1731,812,919,0.4690930098209128,0.5309069901790873
E01001425,2022,922,1100,0.4559841740850643,0.5440158259149357
E01001428,1723,831,892,0.4822983168891468,0.5177016831108532
E01001461,1579,754,825,0.47751741608613046,0.5224825839138696
E01001464,1315,637,678,0.4844106463878327,0.5155893536121673
E01001521,1875,905,970,0.4826666666666667,0.5173333333333333
E01001531,1436,697,739,0.4853760445682451,0.5146239554317549
E01001532,1663,805,858,0.4840649428743235,0.5159350571256764
E01001533,1662,817,845,0.4915764139590854,0.5084235860409145
E01001535,1405,663,742,0.4718861209964413,0.5281138790035588
E01001495,1846,917,929,0.4967497291440953,0.5032502708559047
E01001498,1837,894,943,0.48666303756124113,0.5133369624387588
E01001563,1736,823,913,0.4740783410138249,0.5259216589861752
E01001565,1678,804,874,0.4791418355184744,0.5208581644815257
E01001566,1781,882,899,0.4952274003368894,0.5047725996631106
E01001424,1227,531,696,0.43276283618581907,0.5672371638141809
E01001426,1822,854,968,0.46871569703622395,0.531284302963776
E01001427,1744,866,878,0.49655963302752293,0.5034403669724771
E01001429,2328,1054,1274,0.4527491408934708,0.5472508591065293
E01001430,2013,943,1070,0.468455042225534,0.531544957774466
E01001463,1559,741,818,0.47530468248877483,0.5246953175112251
E01001465,1561,802,759,0.5137732222934016,0.48622677770659833
E01001466,1996,893,1103,0.4473947895791583,0.5526052104208417
E01001467,1999,955,1044,0.4777388694347174,0.5222611305652827
E01001497,1456,703,753,0.48282967032967034,0.5171703296703297
E01001499,1540,760,780,0.4935064935064935,0.5064935064935064
E01001392,1866,916,950,0.4908896034297964,0.5091103965702036
E01001528,1688,786,902,0.4656398104265403,0.5343601895734598
E01001529,1790,932,858,0.5206703910614525,0.4793296089385475
E01001530,1727,835,892,0.4834973943254198,0.5165026056745802
E01001534,1689,858,831,0.5079928952042628,0.4920071047957371
E01001431,1786,837,949,0.4686450167973124,0.5313549832026876
E01001432,1867,863,1004,0.46223888591322976,0.5377611140867702
E01001555,2232,1121,1111,0.5022401433691757,0.4977598566308244
E01001557,1715,868,847,0.5061224489795918,0.49387755102040815
E01001558,2063,1065,998,0.5162384876393602,0.48376151236063986
E01001559,2129,990,1139,0.4650070455612964,0.5349929544387036
E01001394,1997,1050,947,0.5257886830245369,0.4742113169754632
E01001395,1634,750,884,0.4589963280293758,0.5410036719706243
E01001397,2164,1062,1102,0.4907578558225508,0.5092421441774492
E01001500,1591,774,817,0.4864864864864865,0.5135135135135135
E01001556,1590,770,820,0.48427672955974843,0.5157232704402516
E01001560,1571,761,810,0.48440483768300446,0.5155951623169955
E01001390,1817,881,936,0.4848651623555311,0.5151348376444689
E01001391,1779,864,915,0.4856661045531197,0.5143338954468802
E01001393,1970,986,984,0.500507614213198,0.49949238578680205
E01001396,1461,708,753,0.48459958932238195,0.5154004106776181
E01001501,2220,1091,1129,0.4914414414414414,0.5085585585585586
E01001527,2053,1016,1037,0.49488553336580615,0.5051144666341939
E01001458,1788,840,948,0.4697986577181208,0.5302013422818792
E01001553,1753,871,882,0.4968625213918996,0.5031374786081004
E01001554,1798,820,978,0.4560622914349277,0.5439377085650723
E01001562,2234,978,1256,0.4377797672336616,0.5622202327663384
E01032574,2071,963,1108,0.4649927571221632,0.5350072428778367
E01001690,1713,839,874,0.4897840046701693,0.5102159953298308
E01001692,1470,737,733,0.501360544217687,0.49863945578231295
E01001693,1560,739,821,0.4737179487179487,0.5262820512820513
E01001694,1745,836,909,0.47908309455587395,0.520916905444126
E01001687,1654,1008,646,0.6094316807738815,0.3905683192261185
E01001688,2670,1268,1402,0.4749063670411985,0.5250936329588015
E01033739,1726,835,891,0.48377752027809967,0.5162224797219004
E01033740,1634,774,860,0.47368421052631576,0.5263157894736842
E01033741,2698,1751,947,0.6489992587101556,0.3510007412898443
E01033743,1941,903,1038,0.4652241112828439,0.5347758887171561
E01033745,1783,873,910,0.4896242288278183,0.5103757711721817
E01001575,1816,853,963,0.4697136563876652,0.5302863436123348
E01001576,1998,969,1029,0.484984984984985,0.515015015015015
E01001577,2017,998,1019,0.4947942488844819,0.5052057511155181
E01001578,2306,1143,1163,0.4956634865568083,0.5043365134431916
E01001579,1734,832,902,0.4798154555940023,0.5201845444059977
E01001705,2248,1099,1149,0.4888790035587189,0.5111209964412812
E01001708,1698,822,876,0.4840989399293286,0.5159010600706714
E01001710,1760,833,927,0.4732954545454545,0.5267045454545455
E01034173,1855,885,970,0.477088948787062,0.522911051212938
E01001672,1933,960,973,0.4966373512674599,0.5033626487325401
E01001673,2403,1165,1238,0.4848106533499792,0.5151893466500208
E01001674,2195,1059,1136,0.4824601366742597,0.5175398633257403
E01001675,2370,1163,1207,0.4907172995780591,0.5092827004219409
E01001677,2163,1099,1064,0.5080906148867314,0.4919093851132686
E01001631,2108,1060,1048,0.5028462998102466,0.4971537001897533
E01001632,2038,1044,994,0.5122669283611384,0.48773307163886165
E01001635,1644,797,847,0.48479318734793186,0.5152068126520681
E01001636,1684,824,860,0.48931116389548696,0.5106888361045131
E01033742,1341,684,657,0.5100671140939598,0.4899328859060403
E01033744,1803,880,923,0.48807542983915697,0.511924570160843
E01001571,1809,902,907,0.4986180210060807,0.5013819789939193
E01001572,1733,862,871,0.49740334679746107,0.502596653202539
E01001573,1575,797,778,0.506031746031746,0.49396825396825395
E01001574,1924,921,1003,0.4786902286902287,0.5213097713097713
E01001629,2141,979,1162,0.45726296123306864,0.5427370387669314
E01001633,2043,967,1076,0.4733235438081253,0.5266764561918746
E01001634,1736,807,929,0.46486175115207373,0.5351382488479263
E01001637,1801,884,917,0.49083842309827874,0.5091615769017213
E01001695,1549,754,795,0.486765655261459,0.513234344738541
E01001696,2572,1197,1375,0.4653965785381026,0.5346034214618973
E01001697,2643,1280,1363,0.48429814604615967,0.5157018539538404
E01001700,2369,1156,1213,0.48796960742929507,0.5120303925707049
E01001703,2079,961,1118,0.46224146224146223,0.5377585377585378
E01001704,1649,805,844,0.4881746513038205,0.5118253486961795
E01001588,1692,826,866,0.48817966903073284,0.5118203309692672
E01001589,1853,873,980,0.471127900701565,0.5288720992984349
E01001591,2100,1036,1064,0.49333333333333335,0.5066666666666667
E01001595,2222,1038,1184,0.4671467146714671,0.5328532853285328
E01001590,1704,828,876,0.4859154929577465,0.5140845070422535
E01001592,1934,942,992,0.4870734229576008,0.5129265770423992
E01001593,1793,879,914,0.4902398215281651,0.509760178471835
E01001594,2368,1190,1178,0.5025337837837838,0.49746621621621623
E01001698,1912,910,1002,0.47594142259414224,0.5240585774058577
E01001699,1465,676,789,0.4614334470989761,0.5385665529010238
E01001701,1763,886,877,0.5025524673851389,0.497447532614861
E01001702,1485,719,766,0.4841750841750842,0.5158249158249159
E01001581,1578,722,856,0.45754119138149557,0.5424588086185045
E01001585,1529,744,785,0.486592544146501,0.513407455853499
E01001586,1422,628,794,0.44163150492264414,0.5583684950773559
E01001587,1981,1011,970,0.5103483089348814,0.48965169106511863
E01001678,1773,855,918,0.48223350253807107,0.5177664974619289
E01001683,1551,746,805,0.4809800128949065,0.5190199871050934
E01001684,1446,689,757,0.47648686030428766,0.5235131396957123
E01001685,1562,751,811,0.48079385403329067,0.5192061459667093
E01001646,2820,1313,1507,0.4656028368794326,0.5343971631205674
E01001650,1834,888,946,0.4841875681570338,0.5158124318429662
E01001651,1875,930,945,0.496,0.504
E01001652,1706,820,886,0.4806565064478312,0.5193434935521688
E01001679,1353,662,691,0.4892830746489283,0.5107169253510717
E01001680,1518,753,765,0.49604743083003955,0.5039525691699605
E01001681,1403,723,680,0.5153243050605845,0.48467569493941554
E01001682,1377,652,725,0.4734931009440813,0.5265068990559186
E01001686,1800,876,924,0.4866666666666667,0.5133333333333333
E01001580,1639,805,834,0.49115314215985356,0.5088468578401464
E01001582,1533,705,828,0.4598825831702544,0.5401174168297456
E01001583,1568,764,804,0.4872448979591837,0.5127551020408163
E01001584,1502,720,782,0.4793608521970706,0.5206391478029294
E01001645,1852,911,941,0.4919006479481641,0.5080993520518359
E01001647,1487,721,766,0.48486886348352387,0.5151311365164761
E01001648,1724,858,866,0.4976798143851508,0.5023201856148491
E01001649,1576,756,820,0.4796954314720812,0.5203045685279187
E01001605,1520,733,787,0.48223684210526313,0.5177631578947368
E01001606,1627,780,847,0.4794099569760295,0.5205900430239705
E01001610,1761,851,910,0.4832481544576945,0.5167518455423055
E01001611,1767,865,902,0.48953027730616866,0.5104697226938314
E01001620,1582,773,809,0.488621997471555,0.511378002528445
E01001621,1673,835,838,0.49910340705319783,0.5008965929468021
E01001623,1806,845,961,0.4678848283499446,0.5321151716500554
E01001624,1628,787,841,0.4834152334152334,0.5165847665847666
E01001625,1782,851,931,0.4775533108866442,0.5224466891133558
E01001604,1549,734,815,0.47385409941898,0.5261459005810201
E01001607,1610,746,864,0.46335403726708074,0.5366459627329192
E01001608,1443,688,755,0.4767844767844768,0.5232155232155232
E01001609,1687,848,839,0.5026674570243035,0.4973325429756965
E01001613,1753,833,920,0.47518539646320596,0.5248146035367941
E01001614,1493,740,753,0.4956463496316142,0.5043536503683858
E01001615,1991,994,997,0.4992466097438473,0.5007533902561527
E01001617,1628,766,862,0.4705159705159705,0.5294840294840295
E01001653,1592,752,840,0.4723618090452261,0.5276381909547738
E01001654,1606,739,867,0.4601494396014944,0.5398505603985057
E01001655,1575,774,801,0.49142857142857144,0.5085714285714286
E01001660,1559,730,829,0.46824887748556765,0.5317511225144324
E01001661,1664,772,892,0.4639423076923077,0.5360576923076923
E01001618,1906,903,1003,0.4737670514165792,0.5262329485834207
E01001619,1964,904,1060,0.46028513238289204,0.539714867617108
E01033729,2477,1097,1380,0.44287444489301575,0.5571255551069842
E01001597,1556,783,773,0.5032133676092545,0.4967866323907455
E01001598,1609,796,813,0.4947172156619018,0.5052827843380981
E01001602,2126,1037,1089,0.48777046095954846,0.5122295390404515
E01001603,1756,817,939,0.4652619589977221,0.534738041002278
E01001596,1737,832,905,0.4789867587795049,0.5210132412204951
E01001599,1676,822,854,0.4904534606205251,0.5095465393794749
E01001600,1509,749,760,0.4963552021206097,0.5036447978793903
E01001601,1507,770,737,0.5109489051094891,0.48905109489051096
E01001669,2495,1173,1322,0.4701402805611222,0.5298597194388778
E01001671,1670,751,919,0.4497005988023952,0.5502994011976048
E01001676,1802,888,914,0.49278579356270813,0.5072142064372919
E01032567,1591,773,818,0.48585795097423007,0.51414204902577
E01001656,1341,636,705,0.4742729306487696,0.5257270693512305
E01001657,1570,739,831,0.47070063694267517,0.5292993630573248
E01001658,1654,781,873,0.47218863361547764,0.5278113663845224
E01001659,1618,748,870,0.4622991347342398,0.5377008652657602
E01034174,1253,609,644,0.4860335195530726,0.5139664804469274
E01034175,1302,648,654,0.4976958525345622,0.5023041474654378
E01034176,2027,954,1073,0.4706462752836704,0.5293537247163296
E01034177,1602,733,869,0.4575530586766542,0.5424469413233458
E01033727,2711,1263,1448,0.46587974917004793,0.5341202508299521
E01033728,1763,891,872,0.5053885422575156,0.4946114577424844
E01034178,1692,780,912,0.46099290780141844,0.5390070921985816
E01034179,1423,671,752,0.4715390021082221,0.5284609978917779
E01034180,1293,598,695,0.46249033255993816,0.5375096674400619
E01034181,1812,882,930,0.4867549668874172,0.5132450331125827
E01034182,1399,684,715,0.4889206576125804,0.5110793423874196
E01001664,2076,1060,1016,0.5105973025048169,0.48940269749518306
E01001665,1890,979,911,0.517989417989418,0.482010582010582
E01033738,1860,909,951,0.48870967741935484,0.5112903225806451
E01034183,1522,738,784,0.48488830486202367,0.5151116951379764
E01034184,1289,625,664,0.4848719937936385,0.5151280062063616
E01034185,1206,592,614,0.49087893864013266,0.5091210613598673
E01001638,1763,822,941,0.46625070901871807,0.5337492909812819
E01001641,1867,931,936,0.4986609534011784,0.5013390465988217
E01001642,1732,847,885,0.48903002309468824,0.5109699769053118
E01001644,2629,1287,1342,0.4895397489539749,0.5104602510460251
E01033746,1471,702,769,0.4772263766145479,0.5227736233854521
E01033734,1465,722,743,0.4928327645051195,0.5071672354948805
E01033736,2244,1178,1066,0.5249554367201426,0.4750445632798574
E01034186,1356,692,664,0.5103244837758112,0.4896755162241888
E01034187,1255,595,660,0.47410358565737054,0.5258964143426295
E01034188,1397,706,691,0.5053686471009305,0.49463135289906945
E01034189,1268,624,644,0.4921135646687697,0.5078864353312302
E01034190,1686,775,911,0.4596678529062871,0.5403321470937129
E01034191,1644,804,840,0.48905109489051096,0.5109489051094891
E01034192,2235,1052,1183,0.47069351230425055,0.5293064876957494
E01001666,1984,1013,971,0.5105846774193549,0.4894153225806452
E01033732,1067,552,515,0.5173383317713215,0.48266166822867856
E01034193,1479,739,740,0.49966193373901285,0.5003380662609872
E01034194,1300,632,668,0.48615384615384616,0.5138461538461538
E01034195,1290,582,708,0.4511627906976744,0.5488372093023256
E01034196,1280,647,633,0.50546875,0.49453125
E01001712,2120,1042,1078,0.49150943396226415,0.5084905660377359
E01033735,1262,626,636,0.4960380348652932,0.5039619651347068
E01033737,1934,937,997,0.48448810754912097,0.515511892450879
E01034198,2324,1125,1199,0.48407917383821,0.51592082616179
E01001808,1634,786,848,0.4810281517747858,0.5189718482252142
E01001809,1884,897,987,0.47611464968152867,0.5238853503184714
E01001814,1699,855,844,0.5032371983519718,0.4967628016480283
E01001823,1633,819,814,0.5015309246785058,0.4984690753214942
E01001825,1350,676,674,0.5007407407407407,0.49925925925925924
E01001714,2051,1046,1005,0.5099951243295954,0.4900048756704047
E01001811,1791,819,972,0.457286432160804,0.542713567839196
E01001813,1955,882,1073,0.451150895140665,0.548849104859335
E01035638,1891,914,977,0.4833421470121629,0.5166578529878372
E01035639,1710,836,874,0.4888888888888889,0.5111111111111111
E01001799,1506,739,767,0.4907038512616202,0.5092961487383798
E01001802,1377,651,726,0.47276688453159044,0.5272331154684096
E01001804,1671,777,894,0.4649910233393178,0.5350089766606823
E01001807,1809,871,938,0.48148148148148145,0.5185185185185185
E01001812,1792,918,874,0.5122767857142857,0.4877232142857143
E01001725,1832,920,912,0.5021834061135371,0.4978165938864629
E01001726,1327,588,739,0.4431047475508666,0.5568952524491334
E01001800,1749,860,889,0.4917095483133219,0.5082904516866781
E01001824,1626,800,826,0.4920049200492005,0.5079950799507995
E01001826,1573,763,810,0.48506039415130325,0.5149396058486968
E01001723,1969,959,1010,0.48704926358557643,0.5129507364144236
E01001724,2894,1406,1488,0.48583275742916376,0.5141672425708362
E01001727,1988,972,1016,0.48893360160965793,0.5110663983903421
E01001768,1870,927,943,0.49572192513368984,0.5042780748663102
E01001769,1521,683,838,0.44904667981591057,0.5509533201840894
E01001715,1286,646,640,0.5023328149300156,0.4976671850699845
E01001716,1788,830,958,0.46420581655480986,0.5357941834451901
E01001717,1126,523,603,0.4644760213143872,0.5355239786856127
E01001718,1740,870,870,0.5,0.5
E01001719,1639,778,861,0.474679682733374,0.525320317266626
E01001720,1707,784,923,0.45928529584065614,0.5407147041593439
E01001742,1754,763,991,0.43500570125427596,0.564994298745724
E01001801,1722,834,888,0.4843205574912892,0.5156794425087108
E01001803,1804,898,906,0.4977827050997783,0.5022172949002217
E01001806,1469,653,816,0.44452008168822327,0.5554799183117767
E01001741,1441,667,774,0.4628730048577377,0.5371269951422624
E01001805,1227,606,621,0.4938875305623472,0.5061124694376528
E01001829,1756,836,920,0.4760820045558087,0.5239179954441914
E01001831,1679,829,850,0.4937462775461584,0.5062537224538416
E01001832,1660,796,864,0.4795180722891566,0.5204819277108433
E01001764,1752,876,876,0.5,0.5
E01001765,1801,884,917,0.49083842309827874,0.5091615769017213
E01001767,1608,735,873,0.457089552238806,0.542910447761194
E01001770,1714,777,937,0.4533255542590432,0.5466744457409568
E01033703,1413,632,781,0.4472753007784855,0.5527246992215145
E01033713,1323,630,693,0.47619047619047616,0.5238095238095238
E01001792,1933,950,983,0.49146404552509054,0.5085359544749095
E01001793,1579,690,889,0.4369854338188727,0.5630145661811273
E01001794,1898,877,1021,0.46206533192834565,0.5379346680716544
E01001795,1308,609,699,0.46559633027522934,0.5344036697247706
E01001796,1476,709,767,0.4803523035230352,0.5196476964769647
E01001736,1549,725,824,0.46804389928986445,0.5319561007101355
E01001737,1768,860,908,0.48642533936651583,0.5135746606334841
E01001738,1740,848,892,0.48735632183908045,0.5126436781609195
E01001739,1977,922,1055,0.4663631765300961,0.5336368234699039
E01001786,2224,1102,1122,0.49550359712230213,0.5044964028776978
E01001787,1611,765,846,0.4748603351955307,0.5251396648044693
E01001788,1497,686,811,0.458249832999332,0.541750167000668
E01001790,1513,713,800,0.4712491738268341,0.5287508261731659
E01001740,1545,708,837,0.458252427184466,0.541747572815534
E01001747,2329,1112,1217,0.47745813653928726,0.5225418634607127
E01001830,1878,862,1016,0.4589989350372737,0.5410010649627263
E01001833,2117,999,1118,0.4718941898913557,0.5281058101086443
E01001834,1988,926,1062,0.46579476861167,0.53420523138833
E01001835,1233,616,617,0.49959448499594483,0.5004055150040552
E01001733,1872,901,971,0.4813034188034188,0.5186965811965812
E01001785,1593,729,864,0.4576271186440678,0.5423728813559322
E01001789,1773,790,983,0.4455724760293288,0.5544275239706712
E01001791,1459,699,760,0.47909527073337904,0.520904729266621
E01001745,2159,1016,1143,0.47058823529411764,0.5294117647058824
E01001746,1686,796,890,0.4721233689205219,0.527876631079478
E01001757,1585,748,837,0.47192429022082016,0.5280757097791798
E01001758,2614,1283,1331,0.4908186687069625,0.5091813312930374
E01001759,1647,792,855,0.4808743169398907,0.5191256830601093
E01001761,1818,858,960,0.47194719471947194,0.528052805280528
E01001731,2666,1272,1394,0.477119279819955,0.522880720180045
E01001734,1835,847,988,0.46158038147138963,0.5384196185286103
E01001760,1885,890,995,0.47214854111405835,0.5278514588859416
E01001762,1673,761,912,0.4548714883442917,0.5451285116557083
E01001846,1210,560,650,0.4628099173553719,0.5371900826446281
E01001847,1332,650,682,0.487987987987988,0.512012012012012
E01001848,1970,1038,932,0.5269035532994923,0.4730964467005076
E01001849,2449,1188,1261,0.4850959575336872,0.5149040424663128
E01001729,1985,928,1057,0.46750629722921916,0.5324937027707809
E01001730,2765,1302,1463,0.4708860759493671,0.529113924050633
E01001732,1900,862,1038,0.4536842105263158,0.5463157894736842
E01001735,1570,725,845,0.46178343949044587,0.5382165605095541
E01001838,1815,834,981,0.45950413223140496,0.540495867768595
E01001850,1845,859,986,0.4655826558265583,0.5344173441734418
E01001749,1488,705,783,0.4737903225806452,0.5262096774193549
E01001763,1770,810,960,0.4576271186440678,0.5423728813559322
E01001816,1551,716,835,0.4616376531270148,0.5383623468729851
E01001819,1587,776,811,0.48897290485192185,0.5110270951480781
E01035640,1394,664,730,0.4763271162123386,0.5236728837876614
E01035641,1429,719,710,0.503149055283415,0.49685094471658503
E01001836,1854,871,983,0.4697950377562028,0.5302049622437972
E01001840,1603,744,859,0.4641297567061759,0.535870243293824
E01001841,1368,646,722,0.4722222222222222,0.5277777777777778
E01001844,1917,918,999,0.4788732394366197,0.5211267605633803
E01001845,1585,741,844,0.46750788643533125,0.5324921135646687
E01001837,1446,675,771,0.46680497925311204,0.533195020746888
E01001839,2354,1117,1237,0.4745114698385726,0.5254885301614274
E01001842,1528,700,828,0.4581151832460733,0.5418848167539267
E01001843,1205,562,643,0.46639004149377594,0.5336099585062241
E01033704,2344,1209,1135,0.5157849829351536,0.48421501706484643
E01033712,1543,719,824,0.4659753726506805,0.5340246273493195
E01001772,1789,881,908,0.4924538848518726,0.5075461151481274
E01001774,1987,943,1044,0.474584801207851,0.5254151987921489
E01001775,1634,718,916,0.4394124847001224,0.5605875152998776
E01001815,1772,848,924,0.4785553047404063,0.5214446952595937
E01001820,1390,654,736,0.47050359712230216,0.5294964028776978
E01001821,1350,615,735,0.45555555555555555,0.5444444444444444
E01001753,1538,729,809,0.4739921976592978,0.5260078023407022
E01001755,1678,794,884,0.4731823599523242,0.5268176400476758
E01001773,2483,1251,1232,0.5038260169150222,0.49617398308497784
E01001776,1709,807,902,0.4722059684025746,0.5277940315974254
E01035642,1843,916,927,0.49701573521432446,0.5029842647856755
E01035643,1722,855,867,0.4965156794425087,0.5034843205574913
E01035644,1178,597,581,0.5067911714770797,0.4932088285229202
E01035645,1308,610,698,0.46636085626911317,0.5336391437308868
E01001781,1602,773,829,0.48252184769038703,0.517478152309613
E01001783,1606,765,841,0.4763387297633873,0.5236612702366127
E01035646,1539,725,814,0.4710851202079272,0.5289148797920727
E01035647,1116,562,554,0.503584229390681,0.496415770609319
E01035648,1539,729,810,0.47368421052631576,0.5263157894736842
E01035649,1462,705,757,0.48221614227086185,0.5177838577291382
E01001798,2329,1124,1205,0.4826105624731645,0.5173894375268355
E01001828,2053,922,1131,0.44909887968826107,0.5509011203117389
E01033702,1451,704,747,0.48518263266712613,0.5148173673328739
E01033705,1434,691,743,0.4818688981868898,0.5181311018131102
E01033710,1131,547,584,0.48364279398762156,0.5163572060123784
E01001722,2304,1116,1188,0.484375,0.515625
E01001728,1979,937,1042,0.47347145022738757,0.5265285497726124
E01001822,1997,854,1143,0.4276414621932899,0.5723585378067101
E01001827,1647,769,878,0.46690953248330297,0.533090467516697
E01001756,2037,1005,1032,0.49337260677466865,0.5066273932253313
E01033699,1413,729,684,0.5159235668789809,0.4840764331210191
E01033700,2491,1291,1200,0.5182657567242072,0.48173424327579284
E01001744,2004,955,1049,0.47654690618762474,0.5234530938123753
E01001750,2122,999,1123,0.4707822808671065,0.5292177191328935
E01001751,1478,722,756,0.4884979702300406,0.5115020297699594
E01035650,2010,945,1065,0.4701492537313433,0.5298507462686567
E01001780,1816,879,937,0.4840308370044053,0.5159691629955947
E01001784,1771,836,935,0.4720496894409938,0.5279503105590062
E01033709,1831,931,900,0.5084653194975424,0.4915346805024577
E01033711,1913,892,1021,0.46628332462101413,0.5337166753789859
E01001777,2633,1282,1351,0.48689707557918727,0.5131029244208127
E01033706,1447,724,723,0.5003455425017277,0.4996544574982723
E01033708,1869,1001,868,0.5355805243445693,0.46441947565543074
E01001875,1835,852,983,0.4643051771117166,0.5356948228882834
E01001876,2372,1339,1033,0.5645025295109612,0.4354974704890388
E01001877,1360,638,722,0.46911764705882353,0.5308823529411765
E01001878,1618,739,879,0.45673671199011123,0.5432632880098888
E01035484,1697,775,922,0.45668827342368884,0.5433117265763111
E01035485,1102,524,578,0.47549909255898365,0.5245009074410163
E01001955,2108,986,1122,0.46774193548387094,0.532258064516129
E01001957,1626,765,861,0.470479704797048,0.5295202952029521
E01001958,1725,772,953,0.44753623188405794,0.552463768115942
E01001961,1577,685,892,0.4343690551680406,0.5656309448319594
E01001954,1526,716,810,0.4692005242463958,0.5307994757536042
E01001956,1576,744,832,0.4720812182741117,0.5279187817258884
E01001959,2019,915,1104,0.45319465081723626,0.5468053491827637
E01001960,1794,778,1016,0.4336677814938685,0.5663322185061316
E01001943,2263,1084,1179,0.47901016349977904,0.5209898365002209
E01001944,1680,801,879,0.4767857142857143,0.5232142857142857
E01001945,1665,768,897,0.46126126126126127,0.5387387387387388
E01001946,1877,920,957,0.49014384656366544,0.5098561534363346
E01001862,1759,857,902,0.4872086412734508,0.5127913587265491
E01001940,1538,707,831,0.4596879063719116,0.5403120936280884
E01001941,1566,780,786,0.49808429118773945,0.5019157088122606
E01001942,1838,903,935,0.4912948857453754,0.5087051142546246
E01001858,1754,807,947,0.4600912200684151,0.5399087799315849
E01001860,1710,802,908,0.46900584795321637,0.5309941520467836
E01001861,1405,668,737,0.47544483985765124,0.5245551601423487
E01001863,1409,674,735,0.47835344215755854,0.5216465578424414
E01001864,1514,744,770,0.4914134742404227,0.5085865257595773
E01001852,1629,766,863,0.47022713321055865,0.5297728667894414
E01001853,1497,712,785,0.4756179024716099,0.5243820975283902
E01001854,1760,789,971,0.44829545454545455,0.5517045454545455
E01001857,1546,763,783,0.4935316946959897,0.5064683053040103
E01001859,2703,1205,1498,0.44580096189419166,0.5541990381058084
E01001865,1585,752,833,0.4744479495268139,0.5255520504731861
E01001927,1364,652,712,0.4780058651026393,0.5219941348973607
E01001930,1736,814,922,0.46889400921658986,0.5311059907834101
E01001895,1460,694,766,0.47534246575342465,0.5246575342465754
E01001896,1398,693,705,0.4957081545064378,0.5042918454935622
E01001897,1303,609,694,0.4673829623944743,0.5326170376055257
E01001929,1347,642,705,0.4766146993318486,0.5233853006681515
E01001851,1465,673,792,0.4593856655290102,0.5406143344709897
E01001855,1662,762,900,0.4584837545126354,0.5415162454873647
E01001856,1645,789,856,0.4796352583586626,0.5203647416413374
E01001869,1353,661,692,0.4885439763488544,0.5114560236511456
E01001873,1502,691,811,0.4600532623169108,0.5399467376830892
E01001928,1806,854,952,0.4728682170542636,0.5271317829457365
E01001931,1296,649,647,0.5007716049382716,0.4992283950617284
E01001932,1592,757,835,0.47550251256281406,0.5244974874371859
E01001933,1496,702,794,0.4692513368983957,0.5307486631016043
E01001866,1505,696,809,0.46245847176079735,0.5375415282392026
E01001867,1138,509,629,0.44727592267135324,0.5527240773286467
E01001868,1261,566,695,0.44885011895321175,0.5511498810467883
E01001870,1686,772,914,0.4578884934756821,0.5421115065243179
E01001871,1514,720,794,0.47556142668428003,0.52443857331572
E01001872,1361,640,721,0.47024246877296105,0.529757531227039
E01001893,1491,689,802,0.46210596914822266,0.5378940308517773
E01001894,1374,635,739,0.4621542940320233,0.5378457059679768
E01001898,2090,1005,1085,0.48086124401913877,0.5191387559808612
E01001899,1599,746,853,0.466541588492808,0.533458411507192
E01001900,1713,788,925,0.46001167542323407,0.5399883245767659
E01001889,1389,667,722,0.48020158387329015,0.5197984161267099
E01001910,1335,649,686,0.4861423220973783,0.5138576779026217
E01001913,1386,666,720,0.4805194805194805,0.5194805194805194
E01001914,1504,750,754,0.49867021276595747,0.5013297872340425
E01001885,1276,606,670,0.47492163009404387,0.5250783699059561
E01001908,1379,668,711,0.4844089920232052,0.5155910079767948
E01001909,1763,838,925,0.4753261486103233,0.5246738513896767
E01001911,1710,756,954,0.4421052631578947,0.5578947368421052
E01001912,1454,666,788,0.4580467675378267,0.5419532324621733
E01001886,1522,704,818,0.46254927726675427,0.5374507227332457
E01001887,1458,682,776,0.46776406035665297,0.532235939643347
E01001890,1714,823,891,0.48016336056009334,0.5198366394399067
E01001892,1330,620,710,0.46616541353383456,0.5338345864661654
E01001880,1468,712,756,0.48501362397820164,0.5149863760217984
E01001881,1876,908,968,0.4840085287846482,0.5159914712153518
E01001882,1644,758,886,0.4610705596107056,0.5389294403892944
E01001883,1869,888,981,0.4751203852327448,0.5248796147672552
E01001884,1800,888,912,0.49333333333333335,0.5066666666666667
E01001888,1551,789,762,0.5087040618955513,0.4912959381044487
E01001891,2544,1167,1377,0.45872641509433965,0.5412735849056604
E01001917,1495,741,754,0.4956521739130435,0.5043478260869565
E01001918,1510,677,833,0.44834437086092715,0.5516556291390728
E01001919,1545,730,815,0.47249190938511326,0.5275080906148867
E01001879,1451,698,753,0.4810475534114404,0.5189524465885597
E01001901,1651,766,885,0.4639612356147789,0.536038764385221
E01001902,1657,734,923,0.44296922148461076,0.5570307785153893
E01001903,1436,682,754,0.47493036211699163,0.5250696378830083
E01001920,1449,769,680,0.5307108350586611,0.4692891649413389
E01001921,1451,683,768,0.47070985527222603,0.5292901447277739
E01001922,1625,773,852,0.4756923076923077,0.5243076923076923
E01001923,1517,708,809,0.46671061305207645,0.5332893869479235
E01001924,1545,717,828,0.4640776699029126,0.5359223300970873
E01001947,1417,630,787,0.4446012702893437,0.5553987297106563
E01001948,1873,865,1008,0.46182594767752266,0.5381740523224773
E01001949,1475,672,803,0.45559322033898303,0.5444067796610169
E01001950,1486,679,807,0.4569313593539704,0.5430686406460296
E01001951,1514,672,842,0.4438573315719947,0.5561426684280053
E01001953,1463,647,816,0.44224196855775805,0.557758031442242
E01001904,1617,777,840,0.4805194805194805,0.5194805194805194
E01001905,1658,717,941,0.4324487334137515,0.5675512665862484
E01001906,1453,629,824,0.4328974535443909,0.5671025464556091
E01001907,1247,576,671,0.4619085805934242,0.5380914194065758
E01001935,2038,899,1139,0.4411187438665358,0.5588812561334642
E01032788,1585,715,870,0.45110410094637227,0.5488958990536278
E01032789,1202,555,647,0.4617304492512479,0.538269550748752
E01032790,1130,509,621,0.4504424778761062,0.5495575221238939
E01035486,1769,831,938,0.4697569248162804,0.5302430751837196
E01035487,1557,724,833,0.46499678869621064,0.5350032113037894
E01001915,1453,677,776,0.46593255333792155,0.5340674466620785
E01001916,1224,549,675,0.4485294117647059,0.5514705882352942
E01001926,1357,631,726,0.46499631540162123,0.5350036845983788
E01001952,1647,741,906,0.44990892531876137,0.5500910746812386
E01001925,1572,748,824,0.4758269720101781,0.5241730279898219
E01001934,1961,896,1065,0.45690973992860784,0.5430902600713922
E01001937,1792,846,946,0.4720982142857143,0.5279017857142857
E01001938,1576,739,837,0.46890862944162437,0.5310913705583756
E01001969,1966,987,979,0.5020345879959308,0.4979654120040692
E01001971,1906,910,996,0.4774396642182581,0.5225603357817419
E01001974,2213,1060,1153,0.4789877993673746,0.5210122006326254
E01001975,1822,886,936,0.4862788144895719,0.5137211855104281
E01002036,1864,874,990,0.4688841201716738,0.5311158798283262
E01002037,1717,833,884,0.48514851485148514,0.5148514851485149
E01002039,1672,787,885,0.4706937799043062,0.5293062200956937
E01002040,2266,1098,1168,0.48455428067078554,0.5154457193292145
E01001962,1823,871,952,0.4777838727372463,0.5222161272627537
E01001970,1904,870,1034,0.4569327731092437,0.5430672268907563
E01001972,1713,810,903,0.47285464098073554,0.5271453590192644
E01001973,2548,1214,1334,0.4764521193092622,0.5235478806907379
E01002090,1736,825,911,0.47523041474654376,0.5247695852534562
E01002093,1839,893,946,0.4855899945622621,0.5144100054377378
E01002096,1692,791,901,0.46749408983451535,0.5325059101654847
E01002097,1598,744,854,0.4655819774718398,0.5344180225281602
E01002091,1843,852,991,0.4622897449810092,0.5377102550189907
E01002092,1597,740,857,0.4633688165309956,0.5366311834690044
E01002094,1443,658,785,0.455994455994456,0.544005544005544
E01002095,1589,707,882,0.44493392070484583,0.5550660792951542
E01002098,1530,766,764,0.5006535947712418,0.4993464052287582
E01002101,1980,996,984,0.503030303030303,0.49696969696969695
E01002102,1927,866,1061,0.4494032174364297,0.5505967825635704
E01002105,2076,1031,1045,0.49662813102119463,0.5033718689788054
E01002099,2020,958,1062,0.47425742574257423,0.5257425742574258
E01002100,1785,859,926,0.4812324929971989,0.5187675070028012
E01002103,1852,912,940,0.4924406047516199,0.5075593952483801
E01002104,1454,706,748,0.4855570839064649,0.5144429160935351
E01001963,1800,870,930,0.48333333333333334,0.5166666666666667
E01001964,1628,779,849,0.4785012285012285,0.5214987714987716
E01001965,1636,764,872,0.4669926650366748,0.5330073349633252
E01001966,1410,686,724,0.48652482269503544,0.5134751773049645
E01002027,1430,684,746,0.4783216783216783,0.5216783216783217
E01002028,1660,795,865,0.4789156626506024,0.5210843373493976
E01002032,1844,864,980,0.4685466377440347,0.5314533622559653
E01002033,1802,840,962,0.46614872364039955,0.5338512763596004
E01001976,1864,942,922,0.5053648068669528,0.4946351931330472
E01001977,1518,732,786,0.48221343873517786,0.5177865612648221
E01001978,1927,982,945,0.5096004151530877,0.4903995848469123
E01001979,2292,1078,1214,0.47033158813263526,0.5296684118673648
E01002074,2246,1079,1167,0.4804096170970614,0.5195903829029386
E01002077,2269,1095,1174,0.4825914499779639,0.5174085500220361
E01002079,1810,861,949,0.47569060773480665,0.5243093922651934
E01002081,1928,879,1049,0.4559128630705394,0.5440871369294605
E01002082,1418,654,764,0.461212976022567,0.538787023977433
E01002086,1497,715,782,0.47762191048764197,0.5223780895123581
E01002088,1800,880,920,0.4888888888888889,0.5111111111111111
E01002089,1346,618,728,0.4591381872213967,0.5408618127786032
E01001967,1495,701,794,0.4688963210702341,0.5311036789297658
E01001968,1650,797,853,0.48303030303030303,0.516969696969697
E01001996,1493,739,754,0.49497655726724715,0.5050234427327528
E01001997,1782,806,976,0.45230078563411896,0.547699214365881
E01002075,1972,969,1003,0.49137931034482757,0.5086206896551724
E01002076,1855,882,973,0.47547169811320755,0.5245283018867924
E01002078,2552,1242,1310,0.48667711598746083,0.5133228840125392
E01033943,2514,1315,1199,0.5230708035003978,0.47692919649960225
E01033944,2535,1128,1407,0.44497041420118344,0.5550295857988166
E01002026,1781,871,910,0.48905109489051096,0.5109489051094891
E01002029,2109,1063,1046,0.5040303461356093,0.4959696538643907
E01002030,1564,755,809,0.4827365728900256,0.5172634271099744
E01002031,1869,913,956,0.4884965222043874,0.5115034777956127
E01001991,1663,767,896,0.4612146722790138,0.5387853277209862
E01001992,1751,857,894,0.4894346087949743,0.5105653912050258
E01001993,1669,811,858,0.4859197124026363,0.5140802875973637
E01001995,2683,1232,1451,0.4591874767051808,0.5408125232948192
E01001980,1816,945,871,0.5203744493392071,0.47962555066079293
E01001981,1803,859,944,0.4764281752634498,0.5235718247365502
E01001982,1801,910,891,0.5052748473070516,0.49472515269294837
E01001983,1661,805,856,0.48464780252859724,0.5153521974714028
E01002083,1393,660,733,0.4737975592246949,0.5262024407753051
E01002084,1763,822,941,0.46625070901871807,0.5337492909812819
E01002085,2173,1060,1113,0.4878048780487805,0.5121951219512195
E01002087,1913,950,963,0.4966021955044433,0.5033978044955567
E01002014,1734,863,871,0.49769319492502884,0.5023068050749712
E01002015,1425,678,747,0.47578947368421054,0.5242105263157895
E01002018,1375,613,762,0.44581818181818184,0.5541818181818182
E01033086,1190,529,661,0.4445378151260504,0.5554621848739496
E01033945,1369,687,682,0.5018261504747992,0.4981738495252009
E01033946,1360,683,677,0.5022058823529412,0.49779411764705883
E01002020,1546,752,794,0.48641655886157825,0.5135834411384217
E01002022,2166,1046,1120,0.48291782086795937,0.5170821791320406
E01002023,1368,650,718,0.47514619883040937,0.5248538011695907
E01002025,1476,746,730,0.505420054200542,0.494579945799458
E01002013,1361,634,727,0.46583394562821456,0.5341660543717854
E01002019,1370,651,719,0.4751824817518248,0.5248175182481751
E01002021,1429,700,729,0.489853044086774,0.510146955913226
E01002024,1273,600,673,0.4713275726630008,0.5286724273369993
E01001998,1934,945,989,0.4886246122026887,0.5113753877973113
E01001999,2436,1216,1220,0.49917898193760263,0.5008210180623974
E01002003,2557,1266,1291,0.4951114587407118,0.5048885412592883
E01002004,1810,882,928,0.487292817679558,0.512707182320442
E01002067,1741,854,887,0.49052268811028144,0.5094773118897186
E01002069,2049,979,1070,0.4777940458760371,0.5222059541239629
E01002070,2550,1222,1328,0.4792156862745098,0.5207843137254902
E01002073,1648,794,854,0.4817961165048544,0.5182038834951457
E01002066,2611,1311,1300,0.502106472615856,0.497893527384144
E01002068,2245,1090,1155,0.48552338530066813,0.5144766146993318
E01002071,1780,804,976,0.451685393258427,0.5483146067415731
E01002072,1877,889,988,0.47362812999467235,0.5263718700053277
E01002043,1810,886,924,0.4895027624309392,0.5104972375690607
E01002045,2129,1007,1122,0.4729920150305308,0.5270079849694692
E01002046,1618,779,839,0.4814585908529048,0.5185414091470952
E01002049,1899,924,975,0.48657187993680884,0.5134281200631912
E01002042,1567,797,770,0.5086151882578175,0.4913848117421825
E01002044,1780,867,913,0.48707865168539327,0.5129213483146068
E01002047,1655,784,871,0.47371601208459213,0.5262839879154079
E01002048,1905,963,942,0.5055118110236221,0.494488188976378
E01002016,1912,843,1069,0.4408995815899582,0.5591004184100419
E01002017,1571,779,792,0.4958625079567155,0.5041374920432845
E01002059,1562,702,860,0.4494238156209987,0.5505761843790012
E01002060,1708,759,949,0.44437939110070257,0.5556206088992974
E01002050,1990,991,999,0.4979899497487437,0.5020100502512563
E01002051,1871,967,904,0.5168359166221272,0.4831640833778728
E01002052,2205,1124,1081,0.509750566893424,0.490249433106576
E01002055,2103,1067,1036,0.5073704232049453,0.4926295767950547
E01001994,1809,886,923,0.4897733554449972,0.5102266445550028
E01002008,1343,638,705,0.47505584512285925,0.5249441548771407
E01002010,1594,723,871,0.4535759096612296,0.5464240903387704
E01002011,1748,838,910,0.4794050343249428,0.5205949656750573
E01002000,1761,885,876,0.5025553662691652,0.49744463373083475
E01002001,1596,761,835,0.4768170426065163,0.5231829573934837
E01002002,1691,900,791,0.5322294500295683,0.4677705499704317
E01002058,1575,748,827,0.4749206349206349,0.525079365079365
E01002053,2025,971,1054,0.4795061728395062,0.5204938271604939
E01002054,1693,787,906,0.4648552864737153,0.5351447135262847
E01002056,2921,1478,1443,0.5059910989387196,0.49400890106128037
E01002057,1794,900,894,0.5016722408026756,0.4983277591973244
E01001984,1747,820,927,0.4693760732684602,0.5306239267315398
E01001985,1622,777,845,0.4790382244143033,0.5209617755856967
E01001987,1705,870,835,0.5102639296187683,0.4897360703812317
E01001989,1719,806,913,0.4688772542175684,0.5311227457824317
E01001986,1565,785,780,0.5015974440894568,0.4984025559105431
E01001988,1667,767,900,0.46010797840431916,0.5398920215956808
E01001990,1950,923,1027,0.47333333333333333,0.5266666666666666
E01002062,1740,839,901,0.482183908045977,0.517816091954023
E01002005,1458,694,764,0.47599451303155005,0.52400548696845
E01002006,1537,741,796,0.48210800260247233,0.5178919973975277
E01002007,1439,667,772,0.46351633078526755,0.5364836692147325
E01002009,1414,683,731,0.48302687411598305,0.516973125884017
E01002061,1544,799,745,0.5174870466321243,0.48251295336787564
E01002063,1502,686,816,0.4567243675099867,0.5432756324900133
E01002064,1479,679,800,0.45909398242055444,0.5409060175794456
E01002065,1596,795,801,0.4981203007518797,0.5018796992481203
E01002034,2489,1131,1358,0.45439935717155483,0.5456006428284451
E01002038,1794,891,903,0.49665551839464883,0.5033444816053512
E01002041,1868,916,952,0.49036402569593146,0.5096359743040685
E01032575,2134,977,1157,0.457825679475164,0.5421743205248359
E01002112,1994,964,1030,0.4834503510531595,0.5165496489468405
E01002114,2230,1030,1200,0.4618834080717489,0.5381165919282511
E01002225,1753,778,975,0.44381061038220193,0.5561893896177981
E01002226,2623,1213,1410,0.46244757910789175,0.5375524208921083
E01002113,1560,770,790,0.4935897435897436,0.5064102564102564
E01002115,1464,721,743,0.4924863387978142,0.5075136612021858
E01002116,1590,750,840,0.4716981132075472,0.5283018867924528
E01002118,1880,933,947,0.49627659574468086,0.5037234042553191
E01034589,2000,964,1036,0.482,0.518
E01034590,1354,647,707,0.4778434268833087,0.5221565731166913
E01002227,2275,1055,1220,0.46373626373626375,0.5362637362637362
E01002228,2251,1073,1178,0.4766770324300311,0.5233229675699689
E01002229,1828,861,967,0.4710065645514223,0.5289934354485777
E01002230,1837,913,924,0.49700598802395207,0.5029940119760479
E01002144,1620,810,810,0.5,0.5
E01002146,1462,694,768,0.4746922024623803,0.5253077975376197
E01002147,1356,643,713,0.474188790560472,0.525811209439528
E01002149,1320,654,666,0.4954545454545455,0.5045454545454545
E01002140,1794,875,919,0.48773690078037907,0.512263099219621
E01002141,1792,853,939,0.4760044642857143,0.5239955357142857
E01002142,1858,915,943,0.492465016146394,0.5075349838536061
E01002143,1631,806,825,0.4941753525444513,0.5058246474555488
E01002145,1685,788,897,0.4676557863501484,0.5323442136498516
E01002139,1503,696,807,0.4630738522954092,0.5369261477045908
E01002148,1463,735,728,0.5023923444976076,0.49760765550239233
E01002150,2400,1055,1345,0.4395833333333333,0.5604166666666667
E01002151,1563,724,839,0.46321177223288545,0.5367882277671145
E01002152,1615,758,857,0.4693498452012384,0.5306501547987617
E01002119,2509,1236,1273,0.49262654444001597,0.507373455559984
E01002120,1362,650,712,0.47723935389133626,0.5227606461086637
E01002121,1822,927,895,0.508781558726674,0.49121844127332603
E01002122,1860,935,925,0.5026881720430108,0.49731182795698925
E01002123,1714,873,841,0.5093348891481914,0.49066511085180864
E01002106,2030,996,1034,0.49064039408866994,0.50935960591133
E01002108,1840,904,936,0.49130434782608695,0.508695652173913
E01002109,1871,904,967,0.4831640833778728,0.5168359166221272
E01002110,1664,831,833,0.49939903846153844,0.5006009615384616
E01002111,2200,1108,1092,0.5036363636363637,0.49636363636363634
E01002185,1855,888,967,0.4787061994609164,0.5212938005390836
E01002186,1935,949,986,0.4904392764857881,0.5095607235142119
E01002187,1983,941,1042,0.4745335350479072,0.5254664649520928
E01002190,1708,823,885,0.4818501170960187,0.5181498829039812
E01002124,1793,884,909,0.49302844394868933,0.5069715560513106
E01002125,1970,1039,931,0.5274111675126903,0.47258883248730965
E01002198,1812,917,895,0.5060706401766004,0.4939293598233996
E01002200,2200,1250,950,0.5681818181818182,0.4318181818181818
E01002203,1811,934,877,0.5157371617890668,0.4842628382109332
E01002232,2152,1081,1071,0.5023234200743495,0.49767657992565056
E01002233,2424,1174,1250,0.48432343234323433,0.5156765676567657
E01002234,1962,955,1007,0.48674821610601426,0.5132517838939857
E01002235,1881,923,958,0.49069643806485913,0.5093035619351409
E01002236,2327,1121,1206,0.48173614095401807,0.5182638590459819
E01002107,1819,913,906,0.5019241341396372,0.49807586586036284
E01002197,1417,695,722,0.49047282992237123,0.5095271700776288
E01002199,1570,788,782,0.5019108280254777,0.4980891719745223
E01002201,1713,865,848,0.5049620548744892,0.4950379451255108
E01002202,2196,1116,1080,0.5081967213114754,0.4918032786885246
E01002179,2632,1284,1348,0.4878419452887538,0.5121580547112462
E01002183,2107,1048,1059,0.4973896535358329,0.502610346464167
E01002184,1928,987,941,0.5119294605809128,0.4880705394190871
E01002231,2056,1031,1025,0.5014591439688716,0.4985408560311284
E01034591,1805,926,879,0.5130193905817174,0.48698060941828253
E01034592,1245,570,675,0.4578313253012048,0.5421686746987951
E01002156,1568,772,796,0.4923469387755102,0.5076530612244898
E01002162,1927,941,986,0.48832381940840686,0.5116761805915931
E01002163,1651,835,816,0.5057540884312538,0.4942459115687462
E01034593,1485,719,766,0.4841750841750842,0.5158249158249159
E01034594,1561,802,759,0.5137732222934016,0.48622677770659833
E01002188,1608,767,841,0.47699004975124376,0.5230099502487562
E01002189,1734,839,895,0.48385236447520186,0.5161476355247981
E01002192,1683,816,867,0.48484848484848486,0.5151515151515151
E01002193,2045,980,1065,0.4792176039119804,0.5207823960880196
E01002165,1764,918,846,0.5204081632653061,0.47959183673469385
E01002166,1708,846,862,0.4953161592505855,0.5046838407494145
E01002167,1609,796,813,0.4947172156619018,0.5052827843380981
E01002168,1548,761,787,0.49160206718346255,0.5083979328165374
E01002169,1667,842,825,0.5050989802039592,0.4949010197960408
E01002153,1880,926,954,0.4925531914893617,0.5074468085106383
E01002155,1726,821,905,0.4756662804171495,0.5243337195828505
E01002157,1698,833,865,0.4905771495877503,0.5094228504122497
E01002158,1407,695,712,0.4939587775408671,0.5060412224591329
E01002128,2116,1044,1072,0.4933837429111531,0.5066162570888468
E01002130,2909,1470,1439,0.5053282915091096,0.4946717084908903
E01002181,2336,1144,1192,0.4897260273972603,0.5102739726027398
E01002182,2142,1091,1051,0.5093370681605975,0.4906629318394024
E01002159,1929,962,967,0.4987039917055469,0.5012960082944531
E01002160,2475,1237,1238,0.4997979797979798,0.5002020202020202
E01002161,2058,1014,1044,0.49271137026239065,0.5072886297376094
E01002164,1925,942,983,0.48935064935064937,0.5106493506493507
E01002191,2021,987,1034,0.4883720930232558,0.5116279069767442
E01002194,1838,897,941,0.4880304678998912,0.5119695321001088
E01002195,1658,799,859,0.4819059107358263,0.5180940892641737
E01002196,1822,871,951,0.47804610318331503,0.5219538968166849
E01002127,1840,895,945,0.48641304347826086,0.5135869565217391
E01002129,2731,1364,1367,0.4994507506407909,0.5005492493592091
E01002131,1711,859,852,0.5020455873758036,0.4979544126241964
E01034595,1407,703,704,0.4996446339729922,0.5003553660270078
E01034596,1280,617,663,0.48203125,0.51796875
E01034597,1434,731,703,0.5097629009762901,0.4902370990237099
E01034598,1266,631,635,0.49842022116903634,0.5015797788309637
E01002237,2114,1155,959,0.5463576158940397,0.45364238410596025
E01002238,1886,937,949,0.4968186638388123,0.5031813361611877
E01002240,1957,932,1025,0.4762391415431783,0.5237608584568216
E01002242,1866,899,967,0.4817792068595927,0.5182207931404073
E01002208,1360,684,676,0.5029411764705882,0.4970588235294118
E01002209,1862,929,933,0.49892588614393124,0.5010741138560687
E01002239,1936,972,964,0.5020661157024794,0.49793388429752067
E01002241,1902,925,977,0.4863301787592008,0.5136698212407992
E01002133,2041,949,1092,0.46496815286624205,0.535031847133758
E01002136,2032,1018,1014,0.5009842519685039,0.49901574803149606
E01002138,1610,783,827,0.4863354037267081,0.513664596273292
E01034599,1672,820,852,0.4904306220095694,0.5095693779904307
E01034600,1972,946,1026,0.47971602434077076,0.5202839756592292
E01002211,1486,732,754,0.49259757738896365,0.5074024226110363
E01002212,1888,901,987,0.4772245762711864,0.5227754237288136
E01002216,1735,866,869,0.49913544668587895,0.500864553314121
E01002217,2206,1037,1169,0.4700815956482321,0.529918404351768
E01002132,2037,1007,1030,0.4943544428080511,0.5056455571919489
E01002134,1491,752,739,0.5043594902749833,0.4956405097250168
E01002135,2015,982,1033,0.48734491315136474,0.5126550868486353
E01002137,1747,1219,528,0.6977676016027475,0.3022323983972524
E01002218,1817,863,954,0.47495872317006055,0.5250412768299395
E01002219,1930,945,985,0.4896373056994819,0.5103626943005182
E01002221,1630,831,799,0.5098159509202455,0.4901840490797546
E01002222,1605,796,809,0.49595015576323986,0.5040498442367601
E01002214,1909,962,947,0.5039287585123101,0.4960712414876899
E01002215,1736,829,907,0.47753456221198154,0.5224654377880185
E01002220,1643,836,807,0.5088253195374315,0.49117468046256846
E01002223,1794,865,929,0.4821627647714604,0.5178372352285395
E01002224,1624,790,834,0.48645320197044334,0.5135467980295566
E01002204,1881,959,922,0.5098351940457203,0.49016480595427964
E01002206,1388,713,675,0.5136887608069164,0.48631123919308356
E01002207,1774,918,856,0.5174746335963923,0.48252536640360766
E01002210,1548,755,793,0.4877260981912145,0.5122739018087855
E01032576,1679,845,834,0.5032757593805837,0.49672424061941634
E01002170,1369,658,711,0.4806428049671293,0.5193571950328707
E01002171,1704,858,846,0.5035211267605634,0.4964788732394366
E01002172,1613,811,802,0.5027898326100434,0.4972101673899566
E01002173,1909,953,956,0.49921424829753797,0.500785751702462
E01002174,1568,773,795,0.492984693877551,0.5070153061224489
E01002175,1420,720,700,0.5070422535211268,0.49295774647887325
E01002176,1695,807,888,0.4761061946902655,0.5238938053097345
E01002177,1478,746,732,0.5047361299052774,0.4952638700947226
E01002178,1638,809,829,0.4938949938949939,0.5061050061050061
E01002276,2074,965,1109,0.4652844744455159,0.5347155255544841
E01002278,1726,828,898,0.4797219003476246,0.5202780996523755
E01002312,1698,814,884,0.4793875147232038,0.5206124852767963
E01002313,2260,1076,1184,0.4761061946902655,0.5238938053097345
E01002277,1621,786,835,0.4848858729179519,0.5151141270820481
E01002279,1746,864,882,0.4948453608247423,0.5051546391752577
E01002281,2463,1195,1268,0.48518067397482745,0.5148193260251726
E01002283,1699,857,842,0.5044143613890524,0.4955856386109476
E01002299,1817,869,948,0.4782608695652174,0.5217391304347826
E01002301,1637,795,842,0.48564447159437996,0.51435552840562
E01002303,2154,1009,1145,0.46843082636954503,0.531569173630455
E01002304,1541,760,781,0.49318624269954575,0.5068137573004543
E01002306,1839,858,981,0.466557911908646,0.533442088091354
E01002307,1898,914,984,0.4815595363540569,0.5184404636459431
E01002280,1860,880,980,0.4731182795698925,0.5268817204301075
E01002282,1958,942,1016,0.4811031664964249,0.5188968335035751
E01002284,2068,999,1069,0.48307543520309476,0.5169245647969052
E01002297,1642,822,820,0.5006090133982948,0.4993909866017052
E01002314,1856,863,993,0.46497844827586204,0.5350215517241379
E01002316,2074,980,1094,0.4725168756027001,0.5274831243972999
E01002302,1723,804,919,0.4666279744631457,0.5333720255368544
E01002305,1714,807,907,0.470828471411902,0.529171528588098
E01002308,1854,869,985,0.46871628910463864,0.5312837108953614
E01002326,1696,809,887,0.47700471698113206,0.5229952830188679
E01002331,1663,789,874,0.4744437763078773,0.5255562236921226
E01002309,1786,871,915,0.4876819708846585,0.5123180291153415
E01002310,1876,892,984,0.47547974413646055,0.5245202558635395
E01002311,1894,900,994,0.4751847940865892,0.5248152059134108
E01002315,1727,847,880,0.49044585987261147,0.5095541401273885
E01002294,1540,772,768,0.5012987012987012,0.4987012987012987
E01002296,1696,794,902,0.4681603773584906,0.5318396226415094
E01002298,1605,774,831,0.4822429906542056,0.5177570093457944
E01002300,2001,973,1028,0.4862568715642179,0.5137431284357821
E01033784,1559,759,800,0.4868505452212957,0.5131494547787043
E01033785,1381,698,683,0.5054308472121651,0.4945691527878349
E01002333,1329,639,690,0.48081264108352145,0.5191873589164786
E01002334,1732,863,869,0.4982678983833718,0.5017321016166282
E01002336,1634,787,847,0.48164014687882495,0.518359853121175
E01002339,1648,821,827,0.4981796116504854,0.5018203883495146
E01002341,1478,724,754,0.489851150202977,0.510148849797023
E01002327,1556,722,834,0.4640102827763496,0.5359897172236504
E01002328,1794,869,925,0.48439241917502784,0.5156075808249722
E01002332,1754,851,903,0.48517673888255414,0.5148232611174458
E01002335,1480,707,773,0.4777027027027027,0.5222972972972973
E01002338,1410,717,693,0.5085106382978724,0.49148936170212765
E01002340,1477,736,741,0.4983073798239675,0.5016926201760324
E01002268,1488,723,765,0.48588709677419356,0.5141129032258065
E01002269,1857,919,938,0.49488422186322023,0.5051157781367798
E01002295,2002,933,1069,0.466033966033966,0.5339660339660339
E01002377,1774,847,927,0.4774520856820744,0.5225479143179256
E01002378,1706,823,883,0.4824150058616647,0.5175849941383353
E01002383,1666,839,827,0.5036014405762305,0.4963985594237695
E01002244,1815,877,938,0.4831955922865014,0.5168044077134987
E01002245,1647,771,876,0.4681238615664845,0.5318761384335154
E01002325,2142,961,1181,0.44864612511671337,0.5513538748832867
E01002329,1737,857,880,0.4933793897524468,0.5066206102475532
E01002330,1845,898,947,0.4867208672086721,0.5132791327913279
E01002337,1322,643,679,0.4863842662632375,0.5136157337367625
E01002354,1386,642,744,0.46320346320346323,0.5367965367965368
E01002376,1454,722,732,0.4965612104539202,0.5034387895460798
E01002379,1600,754,846,0.47125,0.52875
E01002380,2286,1128,1158,0.49343832020997375,0.5065616797900262
E01002381,1561,725,836,0.464445868033312,0.535554131966688
E01002243,1972,954,1018,0.48377281947261663,0.5162271805273834
E01002353,2045,1025,1020,0.5012224938875306,0.49877750611246946
E01002356,2112,1021,1091,0.4834280303030303,0.5165719696969697
E01032741,1468,718,750,0.4891008174386921,0.510899182561308
E01032742,1766,842,924,0.47678369195922987,0.5232163080407701
E01002272,1361,655,706,0.48126377663482733,0.5187362233651727
E01002274,1665,821,844,0.49309309309309307,0.5069069069069069
E01002317,1546,745,801,0.481888745148771,0.518111254851229
E01002318,1656,797,859,0.48128019323671495,0.518719806763285
E01002355,1492,737,755,0.49396782841823056,0.5060321715817694
E01002382,1815,877,938,0.4831955922865014,0.5168044077134987
E01002270,1739,856,883,0.49223691776883266,0.5077630822311673
E01002271,1592,763,829,0.4792713567839196,0.5207286432160804
E01002273,1341,674,667,0.5026099925428784,0.49739000745712153
E01002275,1318,656,662,0.4977238239757208,0.5022761760242792
E01002319,1861,840,1021,0.45137023105857066,0.5486297689414293
E01002350,1724,837,887,0.48549883990719256,0.5145011600928074
E01002351,1768,849,919,0.4802036199095023,0.5197963800904978
E01002352,1987,967,1020,0.48666331152491193,0.5133366884750881
E01002358,2109,987,1122,0.46799431009957326,0.5320056899004267
E01002246,1842,865,977,0.46959826275787186,0.5304017372421281
E01002247,2486,1159,1327,0.4662107803700724,0.5337892196299276
E01002248,1754,840,914,0.4789053591790194,0.5210946408209807
E01002250,1833,886,947,0.4833606110201855,0.5166393889798145
E01002251,1595,778,817,0.4877742946708464,0.5122257053291536
E01033786,1313,651,662,0.49581111957349583,0.5041888804265042
E01033787,1461,661,800,0.45242984257357977,0.5475701574264202
E01033788,1558,772,786,0.49550706033376124,0.5044929396662388
E01002252,1590,761,829,0.47861635220125787,0.5213836477987421
E01002256,1518,719,799,0.4736495388669302,0.5263504611330698
E01002258,1839,857,982,0.4660141381185427,0.5339858618814574
E01002259,1548,729,819,0.47093023255813954,0.5290697674418605
E01002391,1739,837,902,0.48131109833237495,0.518688901667625
E01002253,1583,773,810,0.4883133291219204,0.5116866708780796
E01002254,1630,792,838,0.48588957055214727,0.5141104294478528
E01002257,1736,827,909,0.4763824884792627,0.5236175115207373
E01002384,1639,807,832,0.4923733984136669,0.5076266015863331
E01002359,1312,647,665,0.49314024390243905,0.506859756097561
E01002360,1484,680,804,0.4582210242587601,0.5417789757412399
E01002361,1981,943,1038,0.47602221100454317,0.5239777889954569
E01002363,1480,716,764,0.4837837837837838,0.5162162162162162
E01002367,1744,852,892,0.48853211009174313,0.5114678899082569
E01002320,1499,716,783,0.47765176784523017,0.5223482321547699
E01002321,1796,891,905,0.49610244988864144,0.5038975501113586
E01002322,1931,944,987,0.48886587260486797,0.5111341273951321
E01002323,1725,835,890,0.48405797101449277,0.5159420289855072
E01002324,1541,757,784,0.49123945489941595,0.508760545100584
E01002255,1543,730,813,0.47310434219053793,0.5268956578094621
E01002289,1665,799,866,0.4798798798798799,0.5201201201201201
E01002292,1705,818,887,0.4797653958944281,0.5202346041055719
E01002362,1507,738,769,0.48971466489714666,0.5102853351028533
E01002386,2057,1004,1053,0.48808945065629555,0.5119105493437044
E01002287,1597,765,832,0.47902316844082654,0.5209768315591734
E01002291,1512,757,755,0.5006613756613757,0.49933862433862436
E01002364,1355,619,736,0.45682656826568263,0.5431734317343173
E01002365,1343,680,663,0.5063291139240507,0.4936708860759494
E01002366,1548,782,766,0.5051679586563308,0.49483204134366926
E01002385,1575,763,812,0.48444444444444446,0.5155555555555555
E01002387,1607,766,841,0.47666459240821407,0.523335407591786
E01002388,1649,760,889,0.46088538508186777,0.5391146149181322
E01002389,1593,774,819,0.4858757062146893,0.5141242937853108
E01002390,1488,718,770,0.4825268817204301,0.5174731182795699
E01002265,1508,734,774,0.48673740053050396,0.513262599469496
E01002285,1365,657,708,0.48131868131868133,0.5186813186813187
E01002286,1616,795,821,0.49195544554455445,0.5080445544554455
E01002288,1598,777,821,0.4862327909887359,0.513767209011264
E01002290,1492,732,760,0.4906166219839142,0.5093833780160858
E01002260,1810,877,933,0.4845303867403315,0.5154696132596686
E01002261,1789,876,913,0.48965902738960315,0.5103409726103969
E01002262,1758,829,929,0.47155858930602956,0.5284414106939704
E01002263,1608,796,812,0.49502487562189057,0.5049751243781094
E01002264,1673,764,909,0.456664674237896,0.543335325762104
E01002266,1543,738,805,0.4782890473104342,0.5217109526895658
E01002267,1798,836,962,0.4649610678531702,0.5350389321468298
E01002372,1695,855,840,0.504424778761062,0.49557522123893805
E01002373,1701,838,863,0.49265138154027044,0.5073486184597296
E01002374,1732,851,881,0.4913394919168591,0.5086605080831409
E01002368,2486,1205,1281,0.48471440064360416,0.5152855993563958
E01002369,2045,992,1053,0.48508557457212714,0.5149144254278729
E01002370,2469,1196,1273,0.4844066423653301,0.51559335763467
E01002371,1707,829,878,0.4856473345049795,0.5143526654950205
E01002375,1931,952,979,0.49300880372863803,0.506991196271362
E01002343,1755,859,896,0.4894586894586895,0.5105413105413106
E01002344,1970,942,1028,0.4781725888324873,0.5218274111675127
E01002348,1560,760,800,0.48717948717948717,0.5128205128205128
E01002349,1545,750,795,0.4854368932038835,0.5145631067961165
E01002342,1723,831,892,0.4822983168891468,0.5177016831108532
E01002345,1957,907,1050,0.4634644864588656,0.5365355135411344
E01002346,1553,751,802,0.48358016741790083,0.5164198325820991
E01002347,1504,733,771,0.48736702127659576,0.5126329787234043
E01002473,1682,815,867,0.4845422116527943,0.5154577883472057
E01002475,1635,746,889,0.4562691131498471,0.5437308868501529
E01002476,1631,781,850,0.47884733292458614,0.5211526670754139
E01002477,1349,626,723,0.46404744255003705,0.535952557449963
E01002482,1661,784,877,0.4720048163756773,0.5279951836243227
E01002472,1673,781,892,0.46682606096832036,0.5331739390316796
E01002474,1741,850,891,0.48822515795519816,0.5117748420448018
E01002478,1599,766,833,0.4790494058786742,0.5209505941213258
E01002483,1945,940,1005,0.4832904884318766,0.5167095115681234
E01002484,1428,671,757,0.4698879551820728,0.5301120448179272
E01002485,2031,984,1047,0.4844903988183161,0.5155096011816839
E01002438,1442,702,740,0.4868238557558946,0.5131761442441054
E01002439,1549,764,785,0.4932214331826985,0.5067785668173015
E01002440,1584,765,819,0.48295454545454547,0.5170454545454546
E01002441,1601,802,799,0.5009369144284822,0.4990630855715178
E01002442,1625,786,839,0.4836923076923077,0.5163076923076924
E01002433,2497,1169,1328,0.4681617941529836,0.5318382058470165
E01002436,1679,817,862,0.4865991661703395,0.5134008338296605
E01002479,1842,896,946,0.48642779587404994,0.5135722041259501
E01002480,1860,906,954,0.4870967741935484,0.5129032258064516
E01002481,1642,793,849,0.48294762484774667,0.5170523751522533
E01002533,1457,685,772,0.47014413177762526,0.5298558682223747
E01002534,1523,733,790,0.4812869336835194,0.5187130663164806
E01002538,1688,811,877,0.48045023696682465,0.5195497630331753
E01002539,1709,817,892,0.47805734347571677,0.5219426565242832
E01002418,1777,877,900,0.4935284186831739,0.5064715813168261
E01002419,1690,822,868,0.4863905325443787,0.5136094674556213
E01002431,1339,665,674,0.49663928304705,0.5033607169529499
E01002432,1503,712,791,0.4737192282102462,0.5262807717897539
E01002437,1418,701,717,0.49435825105782794,0.5056417489421721
E01002430,1391,688,703,0.49460819554277496,0.505391804457225
E01002434,1332,626,706,0.46996996996997,0.53003003003003
E01002435,1536,727,809,0.4733072916666667,0.5266927083333334
E01002470,1834,916,918,0.4994547437295529,0.5005452562704471
E01002535,2188,1068,1120,0.48811700182815354,0.5118829981718465
E01002416,1744,847,897,0.4856651376146789,0.5143348623853211
E01002417,1779,860,919,0.4834176503653738,0.5165823496346262
E01002420,1616,738,878,0.4566831683168317,0.5433168316831684
E01002421,1703,827,876,0.48561362301820316,0.5143863769817968
E01002471,1632,789,843,0.4834558823529412,0.5165441176470589
E01002465,1714,803,911,0.4684947491248541,0.5315052508751459
E01002467,1605,770,835,0.4797507788161994,0.5202492211838006
E01002494,1800,894,906,0.49666666666666665,0.5033333333333333
E01002536,1330,653,677,0.49097744360902257,0.5090225563909775
E01002537,2483,1207,1276,0.48610551751913006,0.5138944824808699
E01002415,1714,838,876,0.48891481913652274,0.5110851808634772
E01002466,1724,866,858,0.5023201856148491,0.4976798143851508
E01002468,1716,830,886,0.4836829836829837,0.5163170163170163
E01002469,1656,819,837,0.4945652173913043,0.5054347826086957
E01002495,1880,897,983,0.47712765957446807,0.5228723404255319
E01002458,1437,703,734,0.4892136395267919,0.510786360473208
E01002459,1669,803,866,0.4811264230077891,0.5188735769922109
E01002460,1422,673,749,0.4732770745428973,0.5267229254571026
E01002462,1498,765,733,0.5106809078771696,0.4893190921228304
E01002464,1617,793,824,0.4904143475572047,0.5095856524427953
E01002461,1511,758,753,0.5016545334215751,0.4983454665784249
E01002463,1488,739,749,0.49663978494623656,0.5033602150537635
E01002512,2056,1041,1015,0.5063229571984436,0.49367704280155644
E01002513,1438,673,765,0.46801112656467314,0.5319888734353269
E01002516,1467,729,738,0.49693251533742333,0.5030674846625767
E01002450,1497,760,737,0.5076820307281229,0.4923179692718771
E01002451,1504,733,771,0.48736702127659576,0.5126329787234043
E01002452,1538,790,748,0.5136540962288687,0.48634590377113135
E01002453,1784,845,939,0.4736547085201794,0.5263452914798207
E01002454,1920,916,1004,0.47708333333333336,0.5229166666666667
E01002414,2696,1441,1255,0.5344955489614244,0.4655044510385757
E01002514,1960,956,1004,0.48775510204081635,0.5122448979591837
E01034601,1452,684,768,0.47107438016528924,0.5289256198347108
E01034602,1399,668,731,0.47748391708363114,0.5225160829163689
E01034603,1380,684,696,0.4956521739130435,0.5043478260869565
E01034604,1424,683,741,0.47963483146067415,0.5203651685393258
E01034605,1638,804,834,0.4908424908424908,0.5091575091575091
E01002520,2034,1045,989,0.5137659783677483,0.4862340216322517
E01002521,2056,1007,1049,0.4897859922178988,0.5102140077821011
E01002523,1557,806,751,0.5176621708413616,0.48233782915863843
E01034606,2606,1366,1240,0.5241749808135073,0.4758250191864927
E01034607,2302,1166,1136,0.5065160729800173,0.4934839270199826
E01002410,1939,972,967,0.5012893243940175,0.4987106756059825
E01002412,2323,1131,1192,0.4868704261730521,0.5131295738269479
E01002456,1735,825,910,0.4755043227665706,0.5244956772334294
E01002509,1492,724,768,0.48525469168900803,0.514745308310992
E01002511,1624,766,858,0.47167487684729065,0.5283251231527094
E01002422,1564,759,805,0.4852941176470588,0.5147058823529411
E01002423,1819,925,894,0.508521165475536,0.491478834524464
E01002424,1695,828,867,0.48849557522123893,0.511504424778761
E01002425,1696,853,843,0.5029481132075472,0.4970518867924528
E01002427,1596,766,830,0.4799498746867168,0.5200501253132832
E01002428,1565,793,772,0.5067092651757189,0.49329073482428115
E01002408,1651,823,828,0.4984857662023016,0.5015142337976983
E01002409,2009,974,1035,0.4848183175709308,0.5151816824290691
E01002429,1576,810,766,0.5139593908629442,0.4860406091370558
E01002455,1982,959,1023,0.48385469223007066,0.5161453077699294
E01002457,1608,778,830,0.48383084577114427,0.5161691542288557
E01002392,1760,859,901,0.48806818181818185,0.5119318181818182
E01002393,2132,1070,1062,0.50187617260788,0.4981238273921201
E01002540,1825,903,922,0.4947945205479452,0.5052054794520547
E01002542,2120,1028,1092,0.4849056603773585,0.5150943396226415
E01002543,1923,912,1011,0.47425897035881437,0.5257410296411856
E01002394,1746,887,859,0.5080183276059564,0.4919816723940435
E01002395,1385,719,666,0.5191335740072203,0.4808664259927798
E01002397,1958,1082,876,0.5526046986721144,0.4473953013278856
E01002398,1855,970,885,0.522911051212938,0.477088948787062
E01002399,1677,809,868,0.4824090638044126,0.5175909361955874
E01002426,2053,1011,1042,0.49245007306380906,0.5075499269361909
E01002411,2129,1132,997,0.5317050258337247,0.46829497416627525
E01002413,1634,807,827,0.4938800489596083,0.5061199510403916
E01002518,1320,661,659,0.5007575757575757,0.49924242424242427
E01002519,1981,995,986,0.5022715800100959,0.4977284199899041
E01002550,1845,912,933,0.4943089430894309,0.5056910569105691
E01034608,2410,1211,1199,0.5024896265560166,0.4975103734439834
E01034609,1975,995,980,0.5037974683544304,0.4962025316455696
E01002541,2005,984,1021,0.4907730673316708,0.5092269326683292
E01002544,1694,883,811,0.5212514757969303,0.4787485242030697
E01002545,1495,678,817,0.4535117056856187,0.5464882943143813
E01002546,1736,895,841,0.5155529953917051,0.48444700460829493
E01002547,1716,859,857,0.5005827505827506,0.4994172494172494
E01002400,1996,992,1004,0.4969939879759519,0.503006012024048
E01002401,2337,1146,1191,0.49037227214377405,0.5096277278562259
E01002402,1638,822,816,0.5018315018315018,0.4981684981684982
E01002403,2474,1213,1261,0.4902991107518189,0.5097008892481811
E01002404,2025,987,1038,0.4874074074074074,0.5125925925925926
E01002548,2119,959,1160,0.45257196790939125,0.5474280320906088
E01002549,1870,907,963,0.48502673796791446,0.5149732620320856
E01002551,2136,1023,1113,0.4789325842696629,0.5210674157303371
E01002552,1747,841,906,0.4813966800228964,0.5186033199771036
E01002553,1759,847,912,0.4815235929505401,0.51847640704946
E01002396,1834,904,930,0.49291166848418755,0.5070883315158125
E01002501,1742,904,838,0.5189437428243399,0.48105625717566014
E01002502,2007,960,1047,0.47832585949177875,0.5216741405082213
E01002505,1783,870,913,0.4879416713404375,0.5120583286595626
E01002508,2188,1101,1087,0.503199268738574,0.496800731261426
E01002405,1959,999,960,0.5099540581929556,0.4900459418070444
E01002503,1931,984,947,0.5095805282237182,0.4904194717762817
E01002506,2076,1032,1044,0.49710982658959535,0.5028901734104047
E01002507,1971,993,978,0.5038051750380518,0.4961948249619482
E01034610,1768,841,927,0.4756787330316742,0.5243212669683258
E01034611,1277,608,669,0.47611589663273296,0.523884103367267
E01034612,2075,1075,1000,0.5180722891566265,0.4819277108433735
E01034613,1005,544,461,0.5412935323383085,0.45870646766169154
E01002486,2245,1127,1118,0.5020044543429845,0.4979955456570156
E01002487,1922,966,956,0.5026014568158168,0.49739854318418314
E01002526,2963,1464,1499,0.4940938238272022,0.5059061761727979
E01002528,1888,905,983,0.4793432203389831,0.520656779661017
E01034614,2005,977,1028,0.48728179551122197,0.512718204488778
E01034615,2167,1064,1103,0.49100138440239965,0.5089986155976004
E01002445,1769,860,909,0.4861503674392312,0.5138496325607688
E01002525,1802,898,904,0.4983351831298557,0.5016648168701443
E01002529,2535,1247,1288,0.49191321499013807,0.5080867850098619
E01002530,1788,888,900,0.4966442953020134,0.5033557046979866
E01002531,1682,868,814,0.5160523186682521,0.4839476813317479
E01002488,1767,887,880,0.5019807583474816,0.4980192416525184
E01002489,1934,1025,909,0.5299896587383661,0.47001034126163393
E01002490,2138,1078,1060,0.5042095416276894,0.49579045837231056
E01002492,1701,875,826,0.51440329218107,0.48559670781893005
E01034616,1497,797,700,0.5323981295925184,0.46760187040748163
E01034617,2331,1164,1167,0.49935649935649934,0.5006435006435006
E01002444,1894,1046,848,0.5522703273495249,0.4477296726504752
E01002446,1965,985,980,0.5012722646310432,0.49872773536895676
E01002447,2073,1078,995,0.5200192957067052,0.47998070429329476
E01002527,1603,798,805,0.4978165938864629,0.5021834061135371
E01002443,2041,1045,996,0.5120039196472318,0.48799608035276826
E01002448,2153,1074,1079,0.4988388295401765,0.5011611704598236
E01002449,2146,1104,1042,0.5144454799627214,0.48555452003727867
E01002491,1722,867,855,0.5034843205574913,0.4965156794425087
E01002493,2000,955,1045,0.4775,0.5225
E01002496,1960,985,975,0.5025510204081632,0.49744897959183676
E01002497,2481,1213,1268,0.4889157597742846,0.5110842402257154
E01002498,1414,703,711,0.4971711456859972,0.5028288543140028
E01002499,2056,1105,951,0.5374513618677043,0.46254863813229574
E01032577,1784,848,936,0.47533632286995514,0.5246636771300448
E01002569,2120,1020,1100,0.4811320754716981,0.5188679245283019
E01002570,1619,790,829,0.48795552810376774,0.5120444718962323
E01002573,1548,762,786,0.49224806201550386,0.5077519379844961
E01002574,1733,815,918,0.4702827466820542,0.5297172533179457
E01002575,1619,786,833,0.48548486720197653,0.5145151327980235
E01002620,2754,1350,1404,0.49019607843137253,0.5098039215686274
E01002625,1712,861,851,0.5029205607476636,0.49707943925233644
E01002626,1623,807,816,0.49722735674676527,0.5027726432532348
E01002627,1791,867,924,0.48408710217755446,0.5159128978224455
E01002631,1837,902,935,0.49101796407185627,0.5089820359281437
E01002633,2231,1085,1146,0.4863290004482295,0.5136709995517705
E01002634,1767,840,927,0.47538200339558573,0.5246179966044142
E01002637,1908,976,932,0.5115303983228512,0.48846960167714887
E01002638,2212,1070,1142,0.4837251356238698,0.5162748643761302
E01002563,1910,907,1003,0.474869109947644,0.525130890052356
E01002565,2506,1200,1306,0.4788507581803671,0.5211492418196328
E01002567,1826,947,879,0.5186199342825849,0.4813800657174151
E01002686,1775,866,909,0.48788732394366197,0.512112676056338
E01034032,1814,835,979,0.46030871003307605,0.539691289966924
E01034033,1752,893,859,0.509703196347032,0.490296803652968
E01002571,1283,670,613,0.5222135619641465,0.47778643803585347
E01002572,1545,737,808,0.47702265372168284,0.5229773462783172
E01002577,1662,870,792,0.5234657039711191,0.47653429602888087
E01002578,1548,729,819,0.47093023255813954,0.5290697674418605
E01002689,1559,724,835,0.4644002565747274,0.5355997434252726
E01002690,1379,665,714,0.48223350253807107,0.5177664974619289
E01002576,1682,829,853,0.4928656361474435,0.5071343638525565
E01002579,1726,841,885,0.48725376593279257,0.5127462340672074
E01002580,1451,701,750,0.48311509303928324,0.5168849069607168
E01002581,1881,923,958,0.49069643806485913,0.5093035619351409
E01002582,1662,780,882,0.4693140794223827,0.5306859205776173
E01002675,2572,1214,1358,0.47200622083981336,0.5279937791601866
E01002678,2052,1067,985,0.5199805068226121,0.4800194931773879
E01002679,1856,929,927,0.5005387931034483,0.4994612068965517
E01002680,2078,1035,1043,0.4980750721847931,0.5019249278152069
E01002619,2091,1089,1002,0.5208034433285509,0.47919655667144906
E01002622,1920,958,962,0.49895833333333334,0.5010416666666667
E01002632,1918,940,978,0.49009384775808135,0.5099061522419187
E01002635,2001,1009,992,0.504247876061969,0.495752123938031
E01002636,2120,1092,1028,0.5150943396226415,0.4849056603773585
E01002618,2061,1011,1050,0.49053857350800584,0.5094614264919942
E01002621,2007,1014,993,0.5052316890881914,0.4947683109118087
E01002623,1925,957,968,0.49714285714285716,0.5028571428571429
E01002628,2169,1031,1138,0.47533425541724295,0.524665744582757
E01002629,2681,1339,1342,0.49944050727340544,0.5005594927265945
E01002630,2070,1129,941,0.5454106280193237,0.45458937198067634
E01002639,1783,895,888,0.5019629837352776,0.49803701626472235
E01002640,2255,1264,991,0.5605321507760532,0.43946784922394677
E01002674,2088,1032,1056,0.4942528735632184,0.5057471264367817
E01002676,1649,821,828,0.49787750151607035,0.5021224984839296
E01002583,1809,904,905,0.49972360420121614,0.5002763957987839
E01002584,2125,1103,1022,0.5190588235294118,0.48094117647058826
E01002585,1831,942,889,0.5144729655925724,0.4855270344074276
E01002586,1837,949,888,0.5166031573217202,0.4833968426782798
E01002589,2507,1256,1251,0.5009972078181093,0.4990027921818907
E01002668,2283,1054,1229,0.46167323696890056,0.5383267630310994
E01002669,1912,887,1025,0.4639121338912134,0.5360878661087866
E01002681,2436,1171,1265,0.48070607553366174,0.5192939244663383
E01002682,2337,1138,1199,0.48694908001711595,0.513050919982884
E01034034,1673,799,874,0.4775851763299462,0.5224148236700538
E01034035,1582,763,819,0.4823008849557522,0.5176991150442478
E01002643,2733,1314,1419,0.4807903402854007,0.5192096597145993
E01002645,2258,1177,1081,0.521257750221435,0.4787422497785651
E01002658,1348,660,688,0.4896142433234421,0.5103857566765578
E01002677,2075,1007,1068,0.48530120481927713,0.5146987951807229
E01034036,1854,938,916,0.505933117583603,0.49406688241639696
E01034037,1854,906,948,0.4886731391585761,0.511326860841424
E01002587,2386,1214,1172,0.5088013411567477,0.4911986588432523
E01002588,2026,1012,1014,0.49950641658440276,0.5004935834155972
E01002660,2091,1087,1004,0.5198469631755142,0.4801530368244859
E01002661,2375,1260,1115,0.5305263157894737,0.4694736842105263
E01002665,1746,892,854,0.5108820160366552,0.48911798396334477
E01002624,1778,908,870,0.5106861642294713,0.48931383577052867
E01002646,2324,1183,1141,0.5090361445783133,0.49096385542168675
E01002662,2509,1313,1196,0.5233160621761658,0.47668393782383417
E01002663,2160,1061,1099,0.4912037037037037,0.5087962962962963
E01034038,1800,918,882,0.51,0.49
E01034039,1732,898,834,0.5184757505773672,0.4815242494226328
E01002641,2692,1352,1340,0.5022288261515602,0.49777117384843983
E01002649,2053,1035,1018,0.504140282513395,0.49585971748660496
E01002657,1931,993,938,0.5142413257379596,0.4857586742620404
E01033083,2217,1157,1060,0.5218764095624718,0.47812359043752817
E01033084,1976,972,1004,0.49190283400809715,0.5080971659919028
E01034040,1656,850,806,0.5132850241545893,0.4867149758454106
E01034041,1477,764,713,0.5172647257955315,0.4827352742044685
E01002653,1899,958,941,0.5044760400210637,0.4955239599789363
E01002654,1912,953,959,0.49843096234309625,0.5015690376569037
E01002655,1868,948,920,0.5074946466809421,0.4925053533190578
E01002656,1419,707,712,0.49823819591261453,0.5017618040873855
E01002659,1459,741,718,0.5078821110349554,0.49211788896504455
E01002667,2193,1058,1135,0.48244414044687645,0.5175558595531236
E01002670,1952,926,1026,0.47438524590163933,0.5256147540983607
E01002671,1847,852,995,0.46128857606930157,0.5387114239306985
E01002672,1589,759,830,0.4776589049716803,0.5223410950283197
E01002673,1658,753,905,0.45416164053075997,0.5458383594692401
E01002647,2213,1085,1128,0.4902846814279259,0.5097153185720741
E01002650,2525,1243,1282,0.49227722772277227,0.5077227722772277
E01002651,1909,967,942,0.5065479308538502,0.4934520691461498
E01002652,1917,1032,885,0.5383411580594679,0.4616588419405321
E01002666,1862,1034,828,0.5553168635875403,0.4446831364124597
E01002555,2068,1058,1010,0.511605415860735,0.488394584139265
E01002556,1855,885,970,0.477088948787062,0.522911051212938
E01002590,2666,1359,1307,0.5097524381095274,0.49024756189047264
E01002592,2151,1053,1098,0.4895397489539749,0.5104602510460251
E01002595,2259,1113,1146,0.49269588313413015,0.5073041168658698
E01002557,2077,977,1100,0.4703899855560905,0.5296100144439095
E01002558,2198,1065,1133,0.48453139217470426,0.5154686078252957
E01002559,2576,1230,1346,0.47748447204968947,0.5225155279503105
E01002560,2011,983,1028,0.48881153654898063,0.5111884634510194
E01002561,1714,846,868,0.4935822637106184,0.5064177362893816
E01002591,1906,933,973,0.4895068205666317,0.5104931794333684
E01002593,2263,1121,1142,0.49536014140521434,0.5046398585947857
E01002594,2314,1174,1140,0.5073465859982714,0.49265341400172863
E01002611,2025,1036,989,0.5116049382716049,0.4883950617283951
E01002612,2104,1053,1051,0.5004752851711026,0.4995247148288973
E01002613,1926,994,932,0.5160955347871236,0.48390446521287644
E01002598,1927,973,954,0.5049299429164504,0.49507005708354956
E01002599,1579,768,811,0.4863837872070931,0.5136162127929069
E01002600,1655,825,830,0.4984894259818731,0.5015105740181269
E01002603,1947,950,997,0.4879301489470981,0.5120698510529019
E01033000,1752,824,928,0.4703196347031963,0.5296803652968036
E01033030,1852,929,923,0.5016198704103672,0.49838012958963285
E01002604,1638,794,844,0.48473748473748474,0.5152625152625152
E01002605,2354,1168,1186,0.49617672047578587,0.5038232795242141
E01002606,1689,822,867,0.4866785079928952,0.5133214920071048
E01002607,2447,1287,1160,0.5259501430322844,0.47404985696771557
E01002615,1624,778,846,0.479064039408867,0.520935960591133
E01002596,2143,1163,980,0.5426971535230984,0.45730284647690156
E01002601,1875,944,931,0.5034666666666666,0.4965333333333333
E01002602,1494,749,745,0.501338688085676,0.49866131191432395
E01002614,2122,1093,1029,0.5150801131008482,0.4849198868991517
E01002616,1624,814,810,0.5012315270935961,0.4987684729064039
E01002608,1898,928,970,0.48893572181243417,0.5110642781875658
E01002609,1821,916,905,0.5030203185063152,0.49697968149368477
E01002610,1762,859,903,0.4875141884222474,0.5124858115777525
E01002617,1634,833,801,0.5097919216646267,0.49020807833537333
E01002687,1673,844,829,0.5044829647340108,0.4955170352659892
E01002691,1629,855,774,0.5248618784530387,0.47513812154696133
E01002692,2106,992,1114,0.4710351377018044,0.5289648622981956
E01002693,1790,879,911,0.4910614525139665,0.5089385474860335
E01032573,1802,905,897,0.5022197558268591,0.49778024417314093
E01002562,1484,744,740,0.5013477088948787,0.49865229110512127
E01034042,1256,542,714,0.4315286624203822,0.5684713375796179
E01034043,1441,694,747,0.4816099930603747,0.5183900069396252
E01034044,1232,613,619,0.49756493506493504,0.502435064935065
E01002564,1895,900,995,0.47493403693931396,0.525065963060686
E01033081,1595,800,795,0.5015673981191222,0.49843260188087773
E01033082,1261,611,650,0.4845360824742268,0.5154639175257731
E01034045,1793,883,910,0.4924707194645845,0.5075292805354155
E01034046,1952,925,1027,0.4738729508196721,0.5261270491803278
E01002755,1319,621,698,0.47081122062168307,0.5291887793783169
E01002756,1314,638,676,0.4855403348554033,0.5144596651445966
E01002758,1736,780,956,0.44930875576036866,0.5506912442396313
E01002804,1539,697,842,0.45289148797920725,0.5471085120207927
E01002807,1705,792,913,0.4645161290322581,0.535483870967742
E01002811,1743,850,893,0.4876649454962708,0.5123350545037292
E01002753,1447,665,782,0.45957152729785766,0.5404284727021423
E01002754,1549,714,835,0.460942543576501,0.539057456423499
E01002757,1449,676,773,0.4665286404416839,0.533471359558316
E01002759,1504,680,824,0.4521276595744681,0.5478723404255319
E01002760,1736,785,951,0.4521889400921659,0.5478110599078341
E01002772,1886,935,951,0.4957582184517497,0.5042417815482503
E01002735,2957,1347,1610,0.45552925262089955,0.5444707473791004
E01002805,1433,693,740,0.48360083740404747,0.5163991625959525
E01002806,1646,753,893,0.4574726609963548,0.5425273390036452
E01002808,1913,893,1020,0.46680606377417666,0.5331939362258233
E01002809,1698,784,914,0.4617196702002356,0.5382803297997645
E01002810,1748,813,935,0.46510297482837526,0.5348970251716247
E01002768,1611,724,887,0.44941030415890754,0.5505896958410925
E01002770,1846,871,975,0.47183098591549294,0.528169014084507
E01002771,1544,685,859,0.44365284974093266,0.5563471502590673
E01002773,1645,825,820,0.5015197568389058,0.49848024316109424
E01002774,2139,971,1168,0.4539504441327723,0.5460495558672277
E01002732,1807,890,917,0.49252905368013283,0.5074709463198672
E01002734,2366,1078,1288,0.4556213017751479,0.5443786982248521
E01002736,1477,693,784,0.46919431279620855,0.5308056872037915
E01002737,1946,940,1006,0.4830421377183967,0.5169578622816033
E01002751,1837,861,976,0.46869896570495373,0.5313010342950463
E01002742,2000,931,1069,0.4655,0.5345
E01002747,1557,745,812,0.47848426461143223,0.5215157353885678
E01002748,1654,789,865,0.47702539298669894,0.5229746070133011
E01002749,1526,711,815,0.4659239842726081,0.5340760157273918
E01033493,1313,686,627,0.5224676313785225,0.4775323686214775
E01033494,1534,742,792,0.48370273794002605,0.516297262059974
E01002730,1755,870,885,0.49572649572649574,0.5042735042735043
E01002733,1443,720,723,0.498960498960499,0.501039501039501
E01002763,1302,629,673,0.48310291858678955,0.5168970814132104
E01035651,1575,760,815,0.48253968253968255,0.5174603174603175
E01035652,1282,637,645,0.4968798751950078,0.5031201248049922
E01002769,1856,907,949,0.4886853448275862,0.5113146551724138
E01002785,1861,914,947,0.4911337990327781,0.5088662009672219
E01002788,1822,890,932,0.4884742041712404,0.5115257958287596
E01002789,1847,869,978,0.4704926908500271,0.5295073091499729
E01002738,1873,891,982,0.47570742124933263,0.5242925787506674
E01002741,1533,738,795,0.48140900195694714,0.5185909980430529
E01002743,1525,735,790,0.4819672131147541,0.5180327868852459
E01002744,1313,658,655,0.5011424219345011,0.49885757806549885
E01002752,1621,758,863,0.4676125848241826,0.5323874151758174
E01002764,1816,843,973,0.4642070484581498,0.5357929515418502
E01002783,1701,835,866,0.49088771310993534,0.5091122868900647
E01002784,1755,862,893,0.4911680911680912,0.5088319088319089
E01002786,1939,900,1039,0.46415678184631254,0.5358432181536875
E01002787,1471,719,752,0.48878314072059825,0.5112168592794017
E01002762,1872,916,956,0.4893162393162393,0.5106837606837606
E01002767,2152,975,1177,0.45306691449814124,0.5469330855018587
E01033486,1035,496,539,0.4792270531400966,0.5207729468599034
E01033487,1200,594,606,0.495,0.505
E01033488,1645,739,906,0.4492401215805471,0.5507598784194528
E01033491,1932,1001,931,0.5181159420289855,0.48188405797101447
E01035653,1422,732,690,0.5147679324894515,0.48523206751054854
E01035654,1163,537,626,0.46173688736027513,0.5382631126397248
E01002777,1678,786,892,0.4684147794994041,0.531585220500596
E01002778,1940,937,1003,0.4829896907216495,0.5170103092783506
E01002779,1752,831,921,0.4743150684931507,0.5256849315068494
E01002781,1741,840,901,0.48248133256748993,0.5175186674325101
E01002782,1432,664,768,0.46368715083798884,0.5363128491620112
E01002739,1839,865,974,0.4703643284393692,0.5296356715606307
E01002740,2260,1028,1232,0.45486725663716815,0.5451327433628319
E01002745,1412,673,739,0.476628895184136,0.523371104815864
E01002795,1936,896,1040,0.4628099173553719,0.5371900826446281
E01002796,1109,567,542,0.5112714156898106,0.48872858431018934
E01002716,2260,1016,1244,0.4495575221238938,0.5504424778761062
E01002718,1577,778,799,0.4933417882054534,0.5066582117945466
E01002721,1635,750,885,0.45871559633027525,0.5412844036697247
E01002775,1408,656,752,0.4659090909090909,0.5340909090909091
E01002776,1859,843,1016,0.45346960731576114,0.5465303926842389
E01002780,1699,813,886,0.4785167745732784,0.5214832254267217
E01002708,2117,969,1148,0.4577231931979216,0.5422768068020785
E01002712,1378,626,752,0.45428156748911463,0.5457184325108854
E01002713,2815,1633,1182,0.5801065719360569,0.41989342806394314
E01002765,2856,1334,1522,0.46708683473389356,0.5329131652661064
E01002766,2182,1047,1135,0.4798350137488543,0.5201649862511457
E01002717,1207,572,635,0.4739022369511185,0.5260977630488816
E01002719,1490,728,762,0.4885906040268456,0.5114093959731544
E01002720,2123,930,1193,0.4380593499764484,0.5619406500235515
E01002790,1412,692,720,0.49008498583569404,0.509915014164306
E01002791,1861,839,1022,0.4508328855454057,0.5491671144545943
E01002793,1845,854,991,0.46287262872628726,0.5371273712737127
E01002698,2041,1016,1025,0.4977951984321411,0.5022048015678588
E01002699,1485,741,744,0.498989898989899,0.501010101010101
E01002700,1376,701,675,0.5094476744186046,0.49055232558139533
E01002714,1539,762,777,0.4951267056530214,0.5048732943469786
E01002792,1845,858,987,0.46504065040650405,0.5349593495934959
E01002722,1445,675,770,0.4671280276816609,0.532871972318339
E01002797,1824,871,953,0.47752192982456143,0.5224780701754386
E01002798,1977,1018,959,0.514921598381386,0.48507840161861404
E01002799,1908,904,1004,0.47379454926624737,0.5262054507337526
E01002800,1769,887,882,0.5014132278123233,0.49858677218767666
E01002694,1666,746,920,0.4477791116446579,0.5522208883553421
E01002697,1966,894,1072,0.4547304170905392,0.5452695829094608
E01002709,1685,763,922,0.45281899109792284,0.5471810089020771
E01002710,1599,696,903,0.4352720450281426,0.5647279549718575
E01002715,1685,762,923,0.45222551928783383,0.5477744807121662
E01002696,1750,840,910,0.48,0.52
E01002794,2040,968,1072,0.4745098039215686,0.5254901960784314
E01002801,1460,712,748,0.4876712328767123,0.5123287671232877
E01002802,1851,894,957,0.4829821717990275,0.5170178282009724
E01035655,1730,857,873,0.4953757225433526,0.5046242774566474
E01035656,1485,723,762,0.4868686868686869,0.5131313131313131
E01002695,1476,738,738,0.5,0.5
E01002711,2029,964,1065,0.4751108920650567,0.5248891079349434
E01002727,1514,723,791,0.4775429326287979,0.5224570673712021
E01002728,1317,602,715,0.45709946848899013,0.5429005315110099
E01002729,1497,698,799,0.46626586506346024,0.5337341349365398
E01002707,1821,937,884,0.5145524437122461,0.485447556287754
E01002723,1640,788,852,0.48048780487804876,0.5195121951219512
E01002724,1923,958,965,0.49817992719708787,0.5018200728029121
E01002725,1359,660,699,0.4856512141280353,0.5143487858719646
E01002726,1711,779,932,0.4552893045002922,0.5447106954997077
E01033489,1460,784,676,0.536986301369863,0.46301369863013697
E01033490,1399,680,719,0.4860614724803431,0.5139385275196569
E01002701,1470,721,749,0.49047619047619045,0.5095238095238095
E01002702,2469,1146,1323,0.4641555285540705,0.5358444714459295
E01002703,2341,1151,1190,0.4916702263989748,0.5083297736010252
E01002704,2356,1170,1186,0.4966044142614601,0.5033955857385399
E01002706,2038,967,1071,0.4744847890088322,0.5255152109911678
E01002852,2213,1023,1190,0.4622684139177587,0.5377315860822413
E01002853,1430,760,670,0.5314685314685315,0.46853146853146854
E01002854,1103,485,618,0.4397098821396192,0.5602901178603807
E01002855,1592,756,836,0.4748743718592965,0.5251256281407035
E01002857,1375,719,656,0.5229090909090909,0.47709090909090907
E01002904,1295,614,681,0.47413127413127415,0.5258687258687259
E01002905,1672,808,864,0.48325358851674644,0.5167464114832536
E01002906,1752,820,932,0.4680365296803653,0.5319634703196348
E01002907,1285,566,719,0.4404669260700389,0.5595330739299611
E01002876,1832,794,1038,0.4334061135371179,0.5665938864628821
E01002877,2186,1009,1177,0.4615736505032022,0.5384263494967978
E01002878,1447,719,728,0.4968901174844506,0.5031098825155494
E01002908,1394,669,725,0.4799139167862267,0.5200860832137734
E01002909,2134,1009,1125,0.47282099343955014,0.5271790065604499
E01002829,1391,691,700,0.49676491732566497,0.503235082674335
E01002830,1724,859,865,0.4982598607888631,0.5017401392111369
E01002831,1718,835,883,0.4860302677532014,0.5139697322467986
E01002832,1632,708,924,0.4338235294117647,0.5661764705882353
E01002856,1430,649,781,0.45384615384615384,0.5461538461538461
E01002870,1594,793,801,0.4974905897114178,0.5025094102885822
E01002872,1349,620,729,0.45959970348406226,0.5404002965159377
E01002879,1945,953,992,0.489974293059126,0.510025706940874
E01002880,1144,571,573,0.4991258741258741,0.5008741258741258
E01002881,1361,655,706,0.48126377663482733,0.5187362233651727
E01002882,1046,445,601,0.4254302103250478,0.5745697896749522
E01002883,1476,681,795,0.4613821138211382,0.5386178861788617
E01002884,1384,559,825,0.40390173410404623,0.5960982658959537
E01002885,1318,607,711,0.460546282245827,0.539453717754173
E01002886,1319,629,690,0.47687642153146326,0.5231235784685367
E01002833,1212,559,653,0.4612211221122112,0.5387788778877888
E01002871,1463,693,770,0.47368421052631576,0.5263157894736842
E01002873,1361,666,695,0.4893460690668626,0.5106539309331374
E01002874,1134,515,619,0.4541446208112875,0.5458553791887125
E01002875,1259,561,698,0.4455917394757744,0.5544082605242255
E01002824,1229,583,646,0.4743694060211554,0.5256305939788446
E01002825,1785,845,940,0.4733893557422969,0.5266106442577031
E01002826,1256,578,678,0.4601910828025478,0.5398089171974523
E01002827,1715,813,902,0.4740524781341108,0.5259475218658892
E01002828,1190,588,602,0.49411764705882355,0.5058823529411764
E01002864,1480,682,798,0.4608108108108108,0.5391891891891892
E01002866,1832,835,997,0.4557860262008734,0.5442139737991266
E01002867,1680,715,965,0.4255952380952381,0.5744047619047619
E01002868,1355,641,714,0.47306273062730625,0.5269372693726937
E01002869,1741,760,981,0.4365307294658242,0.5634692705341757
E01002887,1044,488,556,0.4674329501915709,0.5325670498084292
E01002889,1558,701,857,0.44993581514762515,0.5500641848523748
E01002890,1398,639,759,0.4570815450643777,0.5429184549356223
E01002891,1184,561,623,0.47381756756756754,0.5261824324324325
E01002892,1290,634,656,0.49147286821705427,0.5085271317829457
E01002813,1484,697,787,0.4696765498652291,0.5303234501347709
E01002815,1161,521,640,0.4487510766580534,0.5512489233419466
E01002816,1056,468,588,0.4431818181818182,0.5568181818181818
E01002817,1346,620,726,0.4606240713224368,0.5393759286775631
E01002865,1449,708,741,0.4886128364389234,0.5113871635610766
E01002818,1385,683,702,0.49314079422382673,0.5068592057761733
E01002819,1088,513,575,0.47150735294117646,0.5284926470588235
E01002859,1249,573,676,0.45876701361088873,0.5412329863891113
E01002860,1144,545,599,0.4763986013986014,0.5236013986013986
E01002863,1117,518,599,0.4637421665174575,0.5362578334825425
E01002812,1502,739,763,0.49201065246338216,0.5079893475366178
E01002834,1243,573,670,0.46098149637972646,0.5390185036202735
E01002839,1539,764,775,0.4964262508122157,0.5035737491877843
E01002850,1405,766,639,0.5451957295373665,0.45480427046263344
E01002888,1562,754,808,0.4827144686299616,0.5172855313700384
E01002821,1081,505,576,0.4671600370027752,0.5328399629972248
E01002823,1224,562,662,0.4591503267973856,0.5408496732026143
E01002858,1323,576,747,0.43537414965986393,0.564625850340136
E01002861,1256,574,682,0.4570063694267516,0.5429936305732485
E01002862,1089,439,650,0.40312213039485767,0.5968778696051423
E01002814,2230,1071,1159,0.4802690582959641,0.5197309417040359
E01002847,1393,682,711,0.4895908111988514,0.5104091888011486
E01002848,1251,572,679,0.4572342126298961,0.542765787370104
E01002851,1338,601,737,0.4491778774289985,0.5508221225710015
E01002835,1410,681,729,0.4829787234042553,0.5170212765957447
E01002836,1310,626,684,0.4778625954198473,0.5221374045801527
E01002837,1045,493,552,0.4717703349282297,0.5282296650717704
E01035713,1998,969,1029,0.484984984984985,0.515015015015015
E01002846,1290,600,690,0.46511627906976744,0.5348837209302325
E01002849,1542,784,758,0.5084306095979247,0.4915693904020752
E01002893,1579,784,795,0.49651678277390754,0.5034832172260925
E01002894,1319,669,650,0.5072024260803639,0.4927975739196361
E01002898,1667,784,883,0.47030593881223753,0.5296940611877624
E01002899,1248,558,690,0.44711538461538464,0.5528846153846154
E01002900,1690,512,1178,0.3029585798816568,0.6970414201183432
E01002901,1042,615,427,0.5902111324376199,0.40978886756238003
E01002902,1226,572,654,0.466557911908646,0.533442088091354
E01002903,1276,583,693,0.45689655172413796,0.5431034482758621
E01002844,1147,526,621,0.45858761987794244,0.5414123801220575
E01002845,1169,550,619,0.4704875962360992,0.5295124037639007
E01002910,1369,549,820,0.4010226442658875,0.5989773557341125
E01002911,1285,569,716,0.44280155642023344,0.5571984435797666
E01002914,1194,516,678,0.4321608040201005,0.5678391959798995
E01002896,1587,784,803,0.49401386263390046,0.5059861373660995
E01002897,1491,717,774,0.48088531187122735,0.5191146881287726
E01002912,1481,654,827,0.4415935178933153,0.5584064821066846
E01035714,2059,1010,1049,0.4905293831957261,0.509470616804274
E01002840,1043,463,580,0.4439117929050815,0.5560882070949185
E01002841,1218,564,654,0.4630541871921182,0.5369458128078818
E01002842,1015,447,568,0.4403940886699507,0.5596059113300492
E01002843,1298,576,722,0.4437596302003082,0.5562403697996918
E01002913,1761,821,940,0.46621237932992615,0.5337876206700738
E01003006,1523,724,799,0.47537754432042023,0.5246224556795798
E01003007,1626,800,826,0.4920049200492005,0.5079950799507995
E01003008,1447,681,766,0.47062888735314445,0.5293711126468555
E01003009,2056,1009,1047,0.4907587548638132,0.5092412451361867
E01003010,1441,701,740,0.4864677307425399,0.5135322692574601
E01002952,1394,657,737,0.4713055954088953,0.5286944045911047
E01002953,1333,604,729,0.45311327831957987,0.5468867216804201
E01002955,1501,723,778,0.4816788807461692,0.5183211192538307
E01002956,1391,664,727,0.47735442127965494,0.5226455787203451
E01002959,1389,678,711,0.48812095032397407,0.5118790496760259
E01002935,1900,906,994,0.4768421052631579,0.5231578947368422
E01002938,2000,996,1004,0.498,0.502
E01002951,1502,713,789,0.47470039946737685,0.5252996005326231
E01002954,1371,622,749,0.4536834427425237,0.5463165572574763
E01002957,1587,712,875,0.44864524259609323,0.5513547574039067
E01002933,2039,981,1058,0.4811181951937224,0.5188818048062775
E01002934,1900,917,983,0.4826315789473684,0.5173684210526316
E01002937,1825,888,937,0.4865753424657534,0.5134246575342466
E01003011,1693,809,884,0.4778499704666273,0.5221500295333728
E01033569,1817,917,900,0.5046780407264722,0.4953219592735278
E01034576,1256,632,624,0.5031847133757962,0.4968152866242038
E01034577,1377,662,715,0.4807552650689906,0.5192447349310094
E01002964,2514,1160,1354,0.4614160700079554,0.5385839299920445
E01002969,1892,876,1016,0.4630021141649049,0.5369978858350951
E01002971,1800,874,926,0.4855555555555556,0.5144444444444445
E01002972,2050,943,1107,0.46,0.54
E01002974,2058,978,1080,0.4752186588921283,0.5247813411078717
E01002932,2046,938,1108,0.458455522971652,0.541544477028348
E01002960,1591,781,810,0.4908862350722816,0.5091137649277184
E01002962,1612,771,841,0.478287841191067,0.521712158808933
E01002970,1808,897,911,0.4961283185840708,0.5038716814159292
E01002973,1579,740,839,0.46865104496516785,0.5313489550348321
E01002929,1696,835,861,0.49233490566037735,0.5076650943396226
E01002930,1967,934,1033,0.4748347737671581,0.5251652262328419
E01002931,2013,960,1053,0.47690014903129657,0.5230998509687034
E01002963,1846,881,965,0.4772481040086674,0.5227518959913326
E01002985,1720,800,920,0.46511627906976744,0.5348837209302325
E01002927,1681,809,872,0.4812611540749554,0.5187388459250446
E01002928,1946,911,1035,0.4681397738951696,0.5318602261048304
E01002958,1738,846,892,0.48676639815880324,0.5132336018411968
E01002961,1754,856,898,0.4880273660205245,0.5119726339794755
E01002986,1370,671,699,0.4897810218978102,0.5102189781021897
E01002965,2521,1197,1324,0.4748115827052757,0.5251884172947243
E01002967,1860,898,962,0.4827956989247312,0.5172043010752688
E01002968,2908,1364,1544,0.469050894085282,0.530949105914718
E01002990,1708,837,871,0.49004683840749413,0.5099531615925058
E01002991,1564,770,794,0.49232736572890023,0.5076726342710998
E01002922,1639,810,829,0.4942037827943868,0.5057962172056132
E01002926,1606,809,797,0.5037359900373599,0.4962640099626401
E01002966,1981,970,1011,0.48965169106511863,0.5103483089348814
E01002992,1568,658,910,0.41964285714285715,0.5803571428571429
E01002921,1726,872,854,0.5052143684820394,0.4947856315179606
E01002987,1895,942,953,0.49709762532981533,0.5029023746701847
E01002988,1678,808,870,0.48152562574493446,0.5184743742550656
E01002989,1900,933,967,0.49105263157894735,0.5089473684210526
E01002975,1490,749,741,0.5026845637583892,0.49731543624161073
E01002977,1699,836,863,0.4920541494997057,0.5079458505002943
E01002980,1407,709,698,0.503909026297086,0.496090973702914
E01002981,1603,782,821,0.4878353087960075,0.5121646912039926
E01002984,1431,697,734,0.48707197763801535,0.5129280223619846
E01002923,1672,821,851,0.4910287081339713,0.5089712918660287
E01002925,1571,765,806,0.486950986632718,0.513049013367282
E01002993,1576,755,821,0.47906091370558374,0.5209390862944162
E01002995,1599,768,831,0.4803001876172608,0.5196998123827392
E01002999,1535,726,809,0.47296416938110747,0.5270358306188925
E01002915,1394,678,716,0.48637015781922527,0.5136298421807748
E01002916,1478,710,768,0.4803788903924222,0.5196211096075778
E01002917,1429,712,717,0.4982505248425472,0.5017494751574527
E01002920,1593,768,825,0.4821092278719397,0.5178907721280602
E01002924,1546,770,776,0.49805950840879687,0.5019404915912031
E01002976,1712,835,877,0.4877336448598131,0.5122663551401869
E01002978,1857,887,970,0.47765212708669896,0.522347872913301
E01002979,1529,744,785,0.486592544146501,0.513407455853499
E01002982,1485,699,786,0.4707070707070707,0.5292929292929293
E01002983,1669,835,834,0.5002995805871779,0.49970041941282206
E01002994,1507,698,809,0.46317186463171867,0.5368281353682813
E01002996,1545,751,794,0.486084142394822,0.513915857605178
E01002997,1522,766,756,0.5032851511169514,0.4967148488830486
E01002998,1612,757,855,0.4696029776674938,0.5303970223325062
E01003002,1907,906,1001,0.47509176717357104,0.524908232826429
E01002918,1791,872,919,0.4868788386376326,0.5131211613623674
E01002919,1990,968,1022,0.4864321608040201,0.5135678391959799
E01003000,1870,920,950,0.4919786096256685,0.5080213903743316
E01003001,1916,940,976,0.4906054279749478,0.5093945720250522
E01003003,1727,849,878,0.4916039374638101,0.50839606253619
E01002939,1648,798,850,0.4842233009708738,0.5157766990291263
E01002941,1649,787,862,0.47725894481503944,0.5227410551849606
E01002942,1401,700,701,0.49964311206281226,0.5003568879371877
E01003004,1644,783,861,0.4762773722627737,0.5237226277372263
E01003005,1541,736,805,0.47761194029850745,0.5223880597014925
E01002944,1334,650,684,0.487256371814093,0.512743628185907
E01002945,1573,773,800,0.49141767323585506,0.5085823267641449
E01002946,1508,730,778,0.48408488063660476,0.5159151193633952
E01002947,1644,814,830,0.4951338199513382,0.5048661800486618
E01002940,1673,798,875,0.4769874476987448,0.5230125523012552
E01002943,1477,725,752,0.49085985104942453,0.5091401489505755
E01002948,2211,1056,1155,0.47761194029850745,0.5223880597014925
E01002949,1848,911,937,0.49296536796536794,0.5070346320346321
E01002950,1654,762,892,0.4607013301088271,0.5392986698911729
E01003015,1723,799,924,0.4637260591990714,0.5362739408009286
E01003108,1554,761,793,0.4897039897039897,0.5102960102960103
E01003110,2050,1050,1000,0.5121951219512195,0.4878048780487805
E01003111,1980,914,1066,0.4616161616161616,0.5383838383838384
E01003112,1796,917,879,0.5105790645879733,0.48942093541202675
E01003101,1432,698,734,0.48743016759776536,0.5125698324022346
E01003105,1706,835,871,0.4894490035169988,0.5105509964830012
E01003106,2135,1064,1071,0.49836065573770494,0.5016393442622951
E01003107,1851,1004,847,0.5424095083738519,0.457590491626148
E01033862,1395,726,669,0.5204301075268817,0.47956989247311826
E01033863,1325,674,651,0.5086792452830189,0.4913207547169811
E01003102,1705,913,792,0.535483870967742,0.4645161290322581
E01003104,1733,866,867,0.4997114829774957,0.5002885170225043
E01003122,1905,988,917,0.5186351706036746,0.48136482939632547
E01003129,1797,903,894,0.5025041736227045,0.4974958263772955
E01033208,1707,864,843,0.5061511423550088,0.4938488576449912
E01033864,1032,505,527,0.4893410852713178,0.5106589147286822
E01033865,1520,781,739,0.5138157894736842,0.4861842105263158
E01033866,1120,568,552,0.5071428571428571,0.4928571428571429
E01003098,1485,736,749,0.49562289562289563,0.5043771043771044
E01003099,1701,895,806,0.5261610817166372,0.4738389182833627
E01003100,2014,1110,904,0.551142005958292,0.44885799404170806
E01003180,1600,765,835,0.478125,0.521875
E01003183,1604,778,826,0.4850374064837905,0.5149625935162094
E01003097,1558,810,748,0.5198973042362003,0.48010269576379977
E01003121,1569,719,850,0.45825366475462076,0.5417463352453792
E01003123,1597,839,758,0.5253600500939261,0.4746399499060739
E01003124,1353,658,695,0.48632668144863267,0.5136733185513673
E01003125,1782,816,966,0.45791245791245794,0.5420875420875421
E01003181,1519,705,814,0.4641211323238973,0.5358788676761027
E01003184,1422,720,702,0.5063291139240507,0.4936708860759494
E01003185,1930,978,952,0.5067357512953368,0.49326424870466323
E01003186,2440,1286,1154,0.5270491803278688,0.47295081967213115
E01003187,2317,1150,1167,0.4963314630988347,0.5036685369011653
E01003089,1935,958,977,0.49509043927648577,0.5049095607235142
E01003091,1711,849,862,0.4962010520163647,0.5037989479836353
E01003092,2351,1153,1198,0.4904296044236495,0.5095703955763505
E01003126,1666,837,829,0.5024009603841537,0.49759903961584634
E01003128,1641,790,851,0.48141377209018893,0.5185862279098111
E01003046,1680,837,843,0.4982142857142857,0.5017857142857143
E01003048,1913,899,1014,0.46994249869315213,0.5300575013068479
E01003075,1716,758,958,0.4417249417249417,0.5582750582750583
E01003182,1787,869,918,0.48628987129266926,0.5137101287073307
E01003188,1266,600,666,0.47393364928909953,0.5260663507109005
E01003088,1588,784,804,0.49370277078085645,0.5062972292191436
E01003093,2297,1024,1273,0.4457988680888115,0.5542011319111885
E01003094,1482,684,798,0.46153846153846156,0.5384615384615384
E01003096,2094,1008,1086,0.4813753581661891,0.5186246418338109
E01003127,2092,1013,1079,0.48422562141491393,0.515774378585086
E01003045,1990,960,1030,0.4824120603015075,0.5175879396984925
E01003047,1789,865,924,0.4835103409726104,0.5164896590273896
E01003049,1768,824,944,0.4660633484162896,0.5339366515837104
E01003059,2216,1167,1049,0.5266245487364621,0.4733754512635379
E01003060,1696,783,913,0.46167452830188677,0.5383254716981132
E01003061,1329,669,660,0.5033860045146726,0.4966139954853273
E01003034,1642,799,843,0.4866017052375152,0.5133982947624848
E01003035,1687,826,861,0.4896265560165975,0.5103734439834025
E01003036,1759,893,866,0.5076748152359295,0.4923251847640705
E01003090,2387,1195,1192,0.5006284038542103,0.4993715961457897
E01003095,1640,805,835,0.49085365853658536,0.5091463414634146
E01003037,1442,698,744,0.4840499306518724,0.5159500693481276
E01003038,1702,829,873,0.4870740305522914,0.5129259694477086
E01003039,2042,1017,1025,0.4980411361410382,0.5019588638589618
E01003040,1245,599,646,0.4811244979919679,0.5188755020080321
E01003042,1107,511,596,0.46160794941282746,0.5383920505871725
E01003072,1737,824,913,0.4743811168681635,0.5256188831318365
E01003073,1600,767,833,0.479375,0.520625
E01003076,2701,1334,1367,0.493891151425398,0.506108848574602
E01003077,1860,881,979,0.4736559139784946,0.5263440860215054
E01003078,1626,780,846,0.4797047970479705,0.5202952029520295
E01003019,2035,994,1041,0.48845208845208843,0.5115479115479116
E01003053,1674,827,847,0.494026284348865,0.505973715651135
E01003054,2191,1065,1126,0.48607941579187586,0.5139205842081241
E01003056,1707,845,862,0.49502050380785,0.50497949619215
E01003058,1982,960,1022,0.4843592330978809,0.515640766902119
E01003020,1821,840,981,0.4612850082372323,0.5387149917627677
E01003050,1585,764,821,0.48201892744479496,0.5179810725552051
E01003052,2226,1061,1165,0.4766397124887691,0.5233602875112309
E01003055,1600,818,782,0.51125,0.48875
E01003176,1929,895,1034,0.46397096941420424,0.5360290305857958
E01003029,1827,901,926,0.4931581828133552,0.5068418171866448
E01003032,1721,817,904,0.4747239976757699,0.5252760023242301
E01003041,1520,656,864,0.43157894736842106,0.5684210526315789
E01003057,1705,794,911,0.4656891495601173,0.5343108504398827
E01003043,1618,763,855,0.4715698393077874,0.5284301606922126
E01003044,1411,651,760,0.46137491141034725,0.5386250885896527
E01003051,2099,1060,1039,0.505002382086708,0.49499761791329205
E01003071,2326,1094,1232,0.470335339638865,0.529664660361135
E01003074,2358,1175,1183,0.498303647158609,0.501696352841391
E01003026,1501,690,811,0.4596935376415723,0.5403064623584277
E01003027,1396,677,719,0.48495702005730656,0.5150429799426934
E01003028,1479,733,746,0.495605138607167,0.504394861392833
E01003030,1722,841,881,0.4883855981416957,0.5116144018583043
E01003033,1618,788,830,0.48702101359703337,0.5129789864029666
E01003018,2019,977,1042,0.48390292223873205,0.516097077761268
E01003171,1645,817,828,0.4966565349544073,0.5033434650455927
E01003173,1634,729,905,0.44614443084455324,0.5538555691554468
E01003177,1603,755,848,0.470991890205864,0.529008109794136
E01003178,1501,733,768,0.4883411059293804,0.5116588940706196
E01003021,2154,1354,800,0.6285979572887651,0.3714020427112349
E01003022,1619,795,824,0.49104385423100677,0.5089561457689932
E01003023,2595,1180,1415,0.45472061657032753,0.5452793834296724
E01003024,1841,858,983,0.4660510592069527,0.5339489407930472
E01003025,2048,946,1102,0.4619140625,0.5380859375
E01003136,1659,802,857,0.48342374924653403,0.5165762507534659
E01003137,1581,773,808,0.48893105629348516,0.5110689437065149
E01003159,1774,894,880,0.503945885005637,0.496054114994363
E01003160,1449,720,729,0.4968944099378882,0.5031055900621118
E01003162,1858,906,952,0.4876210979547901,0.5123789020452099
E01003031,1574,711,863,0.45171537484116897,0.548284625158831
E01003156,1597,762,835,0.4771446462116468,0.5228553537883531
E01003157,1582,740,842,0.46776232616940583,0.5322376738305942
E01003158,1624,760,864,0.46798029556650245,0.5320197044334976
E01003161,1317,606,711,0.4601366742596811,0.5398633257403189
E01003163,1598,756,842,0.47309136420525655,0.5269086357947435
E01003132,1450,652,798,0.4496551724137931,0.5503448275862068
E01003172,1945,913,1032,0.46940874035989716,0.5305912596401028
E01003174,2038,937,1101,0.45976447497546613,0.5402355250245339
E01003175,1575,673,902,0.4273015873015873,0.5726984126984127
E01003179,1620,749,871,0.4623456790123457,0.5376543209876543
E01003164,2247,1068,1179,0.4753004005340454,0.5246995994659546
E01003165,1644,790,854,0.4805352798053528,0.5194647201946472
E01003168,1658,760,898,0.4583835946924005,0.5416164053075995
E01003169,2353,1149,1204,0.4883127921801955,0.5116872078198045
E01003170,1907,904,1003,0.4740429994756162,0.5259570005243839
E01003130,1867,918,949,0.4916979110873058,0.5083020889126941
E01003131,2150,1056,1094,0.49116279069767443,0.5088372093023256
E01003135,1930,962,968,0.49844559585492226,0.5015544041450777
E01003138,1474,714,760,0.4843962008141113,0.5156037991858887
E01003151,1954,945,1009,0.4836233367451382,0.5163766632548619
E01003079,1681,801,880,0.4765020820939917,0.5234979179060083
E01003080,1681,792,889,0.4711481261154075,0.5288518738845925
E01003133,1656,791,865,0.4776570048309179,0.5223429951690821
E01003134,1597,761,836,0.4765184721352536,0.5234815278647464
E01003152,1906,910,996,0.4774396642182581,0.5225603357817419
E01003064,1464,683,781,0.46653005464480873,0.5334699453551912
E01003066,1888,881,1007,0.4666313559322034,0.5333686440677966
E01003081,1857,929,928,0.5002692514808832,0.49973074851911686
E01003166,2566,1181,1385,0.4602494154325799,0.5397505845674201
E01003167,1760,847,913,0.48125,0.51875
E01003116,1785,859,926,0.4812324929971989,0.5187675070028012
E01003117,1851,863,988,0.4662344678552134,0.5337655321447866
E01003118,1863,880,983,0.4723564143853999,0.5276435856146001
E01003153,2172,1009,1163,0.464548802946593,0.535451197053407
E01003155,1828,917,911,0.5016411378555798,0.49835886214442016
E01003083,1541,753,788,0.48864373783257625,0.5113562621674238
E01003084,1507,691,816,0.45852687458526875,0.5414731254147312
E01003085,1793,842,951,0.46960401561628556,0.5303959843837145
E01003149,1756,873,883,0.4971526195899772,0.5028473804100227
E01003154,1993,953,1040,0.4781736076266934,0.5218263923733065
E01003065,1673,731,942,0.43693962940824865,0.5630603705917513
E01003068,1576,747,829,0.4739847715736041,0.5260152284263959
E01003082,1375,625,750,0.45454545454545453,0.5454545454545454
E01003086,1557,711,846,0.45664739884393063,0.5433526011560693
E01003087,1644,734,910,0.4464720194647202,0.5535279805352799
E01003113,1796,837,959,0.46603563474387527,0.5339643652561247
E01003114,2424,1248,1176,0.5148514851485149,0.48514851485148514
E01003119,2066,1011,1055,0.489351403678606,0.510648596321394
E01003120,2413,1245,1168,0.5159552424368007,0.4840447575631993
E01003148,1837,867,970,0.4719651605879151,0.528034839412085
E01003150,1945,918,1027,0.4719794344473008,0.5280205655526993
E01003062,1834,856,978,0.46673936750272627,0.5332606324972737
E01003063,1362,637,725,0.46769456681350957,0.5323054331864905
E01003067,1555,753,802,0.4842443729903537,0.5157556270096463
E01003069,1368,628,740,0.4590643274853801,0.5409356725146199
E01003070,1547,740,807,0.4783451842275372,0.5216548157724629
E01003115,1619,750,869,0.46324891908585547,0.5367510809141446
E01003141,1845,893,952,0.48401084010840106,0.5159891598915989
E01003144,1549,798,751,0.5151710781149128,0.48482892188508714
E01003145,1654,803,851,0.48548972188633616,0.5145102781136639
E01003147,2073,972,1101,0.46888567293777134,0.5311143270622286
E01003139,1529,765,764,0.5003270111183781,0.499672988881622
E01003140,1507,729,778,0.48374253483742535,0.5162574651625746
E01003142,1374,680,694,0.4949053857350801,0.50509461426492
E01003143,1500,714,786,0.476,0.524
E01003146,1649,796,853,0.48271679805942996,0.5172832019405701
E01003013,1947,926,1021,0.4756034925526451,0.5243965074473549
E01003014,1504,733,771,0.48736702127659576,0.5126329787234043
E01003016,1203,546,657,0.4538653366583541,0.5461346633416458
E01003017,1631,854,777,0.5236051502145923,0.47639484978540775
E01032582,2282,1122,1160,0.49167397020157755,0.5083260297984225
E01003244,1902,937,965,0.49263932702418506,0.5073606729758149
E01003245,1993,891,1102,0.44706472654290014,0.5529352734570998
E01003247,2103,1046,1057,0.4973846885401807,0.5026153114598193
E01003249,2057,991,1066,0.48176956733106463,0.5182304326689353
E01034387,1604,835,769,0.520573566084788,0.47942643391521195
E01034388,1279,607,672,0.47458952306489444,0.5254104769351056
E01034389,1670,866,804,0.518562874251497,0.481437125748503
E01003246,2411,1166,1245,0.4836167565325591,0.5163832434674409
E01003248,1641,783,858,0.47714808043875684,0.5228519195612431
E01003251,1734,796,938,0.4590542099192618,0.5409457900807382
E01003252,1579,717,862,0.45408486383787205,0.545915136162128
E01003253,1422,672,750,0.47257383966244726,0.5274261603375527
E01003297,1702,860,842,0.5052878965922444,0.49471210340775557
E01003299,1790,896,894,0.5005586592178771,0.4994413407821229
E01003301,2632,1144,1488,0.43465045592705165,0.5653495440729484
E01003302,1867,892,975,0.4777718264595608,0.5222281735404392
E01003305,2292,1118,1174,0.48778359511343805,0.512216404886562
E01003207,2333,1120,1213,0.4800685812258894,0.5199314187741105
E01003209,1897,847,1050,0.44649446494464945,0.5535055350553506
E01003210,1774,830,944,0.46786922209695603,0.532130777903044
E01003212,2011,978,1033,0.48632521133764295,0.513674788662357
E01003215,1891,833,1058,0.4405076679005817,0.5594923320994183
E01003338,2027,949,1078,0.4681795757276764,0.5318204242723237
E01003339,1689,825,864,0.48845470692717585,0.5115452930728241
E01003340,2068,1005,1063,0.4859767891682785,0.5140232108317214
E01003341,1383,651,732,0.47071583514099785,0.5292841648590022
E01003343,1450,670,780,0.46206896551724136,0.5379310344827586
E01003199,1971,932,1039,0.4728564180618975,0.5271435819381025
E01003201,1680,789,891,0.46964285714285714,0.5303571428571429
E01003204,1612,745,867,0.4621588089330025,0.5378411910669976
E01003205,1391,667,724,0.47951114306254494,0.5204888569374551
E01003206,1409,714,695,0.5067423704755145,0.49325762952448543
E01003211,1557,763,794,0.4900449582530507,0.5099550417469493
E01003213,1964,892,1072,0.45417515274949083,0.5458248472505092
E01003214,1781,822,959,0.46153846153846156,0.5384615384615384
E01033324,1539,731,808,0.47498375568551005,0.5250162443144899
E01033325,1367,682,685,0.49890270665691294,0.5010972933430871
E01003198,1494,697,797,0.46653279785809904,0.5334672021419009
E01003200,1475,732,743,0.49627118644067797,0.5037288135593221
E01003202,1558,684,874,0.43902439024390244,0.5609756097560976
E01003203,1966,937,1029,0.4766022380467955,0.5233977619532044
E01003336,1532,722,810,0.47127937336814624,0.5287206266318538
E01003337,1433,664,769,0.4633635729239358,0.5366364270760642
E01003342,1696,795,901,0.46875,0.53125
E01003344,1672,780,892,0.4665071770334928,0.5334928229665071
E01003345,1960,943,1017,0.48112244897959183,0.5188775510204081
E01003273,1507,707,800,0.46914399469143997,0.53085600530856
E01003277,1674,760,914,0.4540023894862604,0.5459976105137395
E01003278,2085,975,1110,0.4676258992805755,0.5323741007194245
E01003279,1530,721,809,0.47124183006535947,0.5287581699346405
E01003282,2416,1121,1295,0.4639900662251656,0.5360099337748344
E01003283,2127,1051,1076,0.49412317818523743,0.5058768218147626
E01003284,1877,905,972,0.4821523708044752,0.5178476291955247
E01003286,1736,834,902,0.4804147465437788,0.5195852534562212
E01003272,1994,922,1072,0.46238716148445336,0.5376128385155466
E01003274,1590,740,850,0.46540880503144655,0.5345911949685535
E01003275,1698,762,936,0.44876325088339225,0.5512367491166078
E01003276,1907,906,1001,0.47509176717357104,0.524908232826429
E01003225,1594,785,809,0.49247176913425345,0.5075282308657465
E01003231,1551,714,837,0.46034816247582205,0.539651837524178
E01003232,1705,806,899,0.4727272727272727,0.5272727272727272
E01003233,1837,861,976,0.46869896570495373,0.5313010342950463
E01003280,1644,775,869,0.47141119221411193,0.5285888077858881
E01003281,1496,720,776,0.48128342245989303,0.5187165775401069
E01003285,1751,814,937,0.4648772130211308,0.5351227869788692
E01003287,1969,972,997,0.4936515997968512,0.5063484002031488
E01003292,1791,874,917,0.4879955332216639,0.5120044667783361
E01003293,1569,754,815,0.4805608667941364,0.5194391332058637
E01003295,1783,851,932,0.47728547392035897,0.5227145260796411
E01033320,1569,769,800,0.49012109623964306,0.5098789037603569
E01033322,1257,608,649,0.48369132856006364,0.5163086714399363
E01003319,1794,855,939,0.4765886287625418,0.5234113712374582
E01003320,1585,737,848,0.4649842271293375,0.5350157728706625
E01003323,1510,731,779,0.48410596026490066,0.5158940397350993
E01003325,1816,859,957,0.47301762114537443,0.5269823788546255
E01003226,1838,878,960,0.4776931447225245,0.5223068552774756
E01003227,1639,792,847,0.48322147651006714,0.5167785234899329
E01003228,1578,741,837,0.4695817490494297,0.5304182509505704
E01003229,1688,783,905,0.46386255924170616,0.5361374407582938
E01003230,1997,949,1048,0.4752128192288433,0.5247871807711567
E01003318,2075,995,1080,0.4795180722891566,0.5204819277108433
E01003321,1748,847,901,0.4845537757437071,0.5154462242562929
E01003322,1635,794,841,0.4856269113149847,0.5143730886850153
E01003324,1688,794,894,0.4703791469194313,0.5296208530805687
E01034390,1503,748,755,0.4976713240186294,0.5023286759813705
E01034391,1624,817,807,0.5030788177339901,0.49692118226600984
E01003254,1438,692,746,0.4812239221140473,0.5187760778859527
E01003255,1990,944,1046,0.4743718592964824,0.5256281407035176
E01003260,1661,820,841,0.49367850692354004,0.50632149307646
E01003261,1526,715,811,0.46854521625163825,0.5314547837483617
E01003262,1524,745,779,0.48884514435695536,0.5111548556430446
E01003217,1930,920,1010,0.47668393782383417,0.5233160621761658
E01003218,1551,734,817,0.4732430689877498,0.5267569310122502
E01003220,1668,828,840,0.49640287769784175,0.5035971223021583
E01003222,1573,765,808,0.4863318499682136,0.5136681500317863
E01003224,1732,822,910,0.4745958429561201,0.5254041570438799
E01003263,1801,853,948,0.47362576346474183,0.5263742365352582
E01003268,1854,887,967,0.4784250269687163,0.5215749730312838
E01003269,1605,785,820,0.48909657320872274,0.5109034267912772
E01003270,1645,785,860,0.47720364741641336,0.5227963525835866
E01003271,1627,805,822,0.4947756607252612,0.5052243392747388
E01003307,1599,750,849,0.46904315196998125,0.5309568480300187
E01003308,1789,785,1004,0.4387926215762996,0.5612073784237004
E01003314,1645,773,872,0.46990881458966566,0.5300911854103344
E01003315,1306,620,686,0.47473200612557426,0.5252679938744257
E01003316,1477,668,809,0.45226811103588355,0.5477318889641164
E01003216,1672,840,832,0.5023923444976076,0.49760765550239233
E01003219,1723,761,962,0.4416715031921068,0.5583284968078932
E01003221,2160,1032,1128,0.4777777777777778,0.5222222222222223
E01003223,1655,795,860,0.48036253776435045,0.5196374622356495
E01003346,1669,803,866,0.4811264230077891,0.5188735769922109
E01003349,1545,733,812,0.47443365695792883,0.5255663430420712
E01003351,1690,804,886,0.4757396449704142,0.5242603550295858
E01003354,2059,918,1141,0.44584749878581836,0.5541525012141817
E01003309,1621,787,834,0.4855027760641579,0.5144972239358421
E01003310,1589,711,878,0.44745122718691,0.55254877281309
E01003311,1597,772,825,0.4834063869755792,0.5165936130244208
E01003312,1756,868,888,0.49430523917995445,0.5056947608200456
E01003313,1573,715,858,0.45454545454545453,0.5454545454545454
E01003256,2134,1031,1103,0.4831302717900656,0.5168697282099344
E01003257,1601,758,843,0.47345409119300436,0.5265459088069956
E01003258,1547,718,829,0.46412411118293473,0.5358758888170653
E01003259,1753,813,940,0.4637763833428408,0.5362236166571591
E01003193,1799,807,992,0.44858254585881047,0.5514174541411896
E01003194,1767,816,951,0.4617996604414261,0.5382003395585738
E01003195,1486,696,790,0.46837146702557203,0.531628532974428
E01003196,1759,869,890,0.49403069926094373,0.5059693007390563
E01003197,1655,820,835,0.4954682779456193,0.5045317220543807
E01003347,1750,768,982,0.43885714285714283,0.5611428571428572
E01003348,1788,837,951,0.46812080536912754,0.5318791946308725
E01003350,1321,631,690,0.47766843300529904,0.522331566994701
E01003352,2288,1102,1186,0.48164335664335667,0.5183566433566433
E01003353,1785,867,918,0.4857142857142857,0.5142857142857142
E01003264,1643,789,854,0.480219111381619,0.519780888618381
E01003265,1646,784,862,0.47630619684082626,0.5236938031591738
E01003266,1721,804,917,0.4671702498547356,0.5328297501452643
E01003267,1758,843,915,0.47952218430034127,0.5204778156996587
E01003329,1639,747,892,0.45576571079926786,0.5442342892007321
E01003330,1591,710,881,0.4462602137020742,0.5537397862979259
E01003331,1522,685,837,0.450065703022339,0.5499342969776609
E01003332,1592,747,845,0.4692211055276382,0.5307788944723618
E01003334,1785,861,924,0.4823529411764706,0.5176470588235295
E01003189,1767,857,910,0.48500282965478214,0.5149971703452179
E01003190,2319,1020,1299,0.4398447606727037,0.5601552393272963
E01003191,1659,789,870,0.4755877034358047,0.5244122965641953
E01003192,1789,889,900,0.49692565679150363,0.5030743432084964
E01003326,1814,836,978,0.46085997794928335,0.5391400220507166
E01003327,1631,767,864,0.4702636419374617,0.5297363580625383
E01003328,1770,808,962,0.45649717514124294,0.5435028248587571
E01003333,1535,697,838,0.45407166123778503,0.545928338762215
E01003335,1514,721,793,0.476221928665786,0.5237780713342141
E01003236,1689,743,946,0.4399052693901717,0.5600947306098283
E01003237,1689,809,880,0.4789816459443458,0.5210183540556542
E01003238,1480,697,783,0.47094594594594597,0.529054054054054
E01003239,1612,771,841,0.478287841191067,0.521712158808933
E01032564,1302,546,756,0.41935483870967744,0.5806451612903226
E01003235,1422,692,730,0.4866385372714487,0.5133614627285513
E01003240,1997,976,1021,0.4887330996494742,0.5112669003505258
E01003241,1589,741,848,0.46633102580239144,0.5336689741976086
E01003243,1509,709,800,0.46984758117958914,0.5301524188204109
E01032565,1451,699,752,0.48173673328738803,0.518263266712612
E01003298,1280,585,695,0.45703125,0.54296875
E01003300,1487,744,743,0.5003362474781439,0.4996637525218561
E01003303,1719,850,869,0.4944735311227458,0.5055264688772542
E01003304,2246,1150,1096,0.5120213713268033,0.4879786286731968
E01032579,2156,1050,1106,0.487012987012987,0.512987012987013
E01034392,1728,784,944,0.4537037037037037,0.5462962962962963
E01034393,1090,540,550,0.4954128440366973,0.5045871559633027
E01034394,1251,642,609,0.513189448441247,0.486810551558753
E01034395,1695,773,922,0.456047197640118,0.543952802359882
E01003288,2158,994,1164,0.4606116774791474,0.5393883225208527
E01003290,1910,954,956,0.49947643979057593,0.5005235602094241
E01003291,1544,751,793,0.48639896373056996,0.5136010362694301
E01033327,2208,1152,1056,0.5217391304347826,0.4782608695652174
E01033341,1324,625,699,0.47205438066465255,0.5279456193353474
E01003472,1352,637,715,0.47115384615384615,0.5288461538461539
E01003473,1473,706,767,0.4792939579090292,0.5207060420909708
E01003474,1355,650,705,0.4797047970479705,0.5202952029520295
E01003478,1911,918,993,0.4803767660910518,0.5196232339089482
E01034578,1089,511,578,0.4692378328741965,0.5307621671258035
E01034579,1875,897,978,0.4784,0.5216
E01003460,1405,659,746,0.4690391459074733,0.5309608540925267
E01003462,1419,689,730,0.485553206483439,0.514446793516561
E01003464,1389,632,757,0.45500359971202303,0.5449964002879769
E01003465,1311,629,682,0.4797864225781846,0.5202135774218154
E01003400,1461,708,753,0.48459958932238195,0.5154004106776181
E01003454,1362,640,722,0.4698972099853157,0.5301027900146843
E01003456,1598,775,823,0.48498122653316644,0.5150187734668336
E01003476,1335,650,685,0.4868913857677903,0.5131086142322098
E01003477,1596,793,803,0.4968671679197995,0.5031328320802005
E01003401,1408,654,754,0.46448863636363635,0.5355113636363636
E01003402,1486,712,774,0.4791386271870794,0.5208613728129206
E01003403,1481,694,787,0.4686022957461175,0.5313977042538826
E01003404,1831,880,951,0.4806116876024031,0.519388312397597
E01003461,1448,678,770,0.468232044198895,0.5317679558011049
E01003369,1641,794,847,0.4838513101767215,0.5161486898232784
E01003370,1992,957,1035,0.48042168674698793,0.5195783132530121
E01003371,1551,773,778,0.498388136686009,0.501611863313991
E01003455,1670,810,860,0.48502994011976047,0.5149700598802395
E01034580,1481,742,739,0.5010128291694801,0.4989871708305199
E01034581,1518,713,805,0.4696969696969697,0.5303030303030303
E01003359,1748,819,929,0.4685354691075515,0.5314645308924485
E01003360,1788,872,916,0.48769574944071586,0.5123042505592841
E01003457,1629,825,804,0.5064456721915286,0.49355432780847147
E01003458,1757,864,893,0.491747296528173,0.5082527034718269
E01003459,2181,1015,1166,0.4653828519027969,0.5346171480972031
E01003394,2064,1070,994,0.5184108527131783,0.48158914728682173
E01003395,1636,857,779,0.523838630806846,0.47616136919315405
E01003396,1508,707,801,0.46883289124668437,0.5311671087533156
E01003397,1525,752,773,0.49311475409836064,0.5068852459016393
E01003398,1912,963,949,0.5036610878661087,0.4963389121338912
E01003368,1671,849,822,0.5080789946140036,0.4919210053859964
E01003372,1704,822,882,0.4823943661971831,0.5176056338028169
E01003393,1620,801,819,0.49444444444444446,0.5055555555555555
E01003406,1688,827,861,0.48992890995260663,0.5100710900473934
E01003407,1945,975,970,0.5012853470437018,0.4987146529562982
E01003355,1768,907,861,0.5130090497737556,0.48699095022624433
E01003356,1838,933,905,0.5076169749727966,0.4923830250272035
E01003358,1792,883,909,0.4927455357142857,0.5072544642857143
E01003383,1647,821,826,0.49848208864602306,0.5015179113539769
E01003384,1683,804,879,0.47771836007130125,0.5222816399286988
E01003442,1681,786,895,0.4675788221296847,0.5324211778703153
E01003443,1630,775,855,0.4754601226993865,0.5245398773006135
E01003444,1611,756,855,0.4692737430167598,0.5307262569832403
E01003445,1808,866,942,0.47898230088495575,0.5210176991150443
E01003463,1505,718,787,0.4770764119601329,0.5229235880398672
E01003380,1745,860,885,0.49283667621776506,0.5071633237822349
E01003382,1783,866,917,0.485698261357263,0.514301738642737
E01003385,1636,825,811,0.5042787286063569,0.495721271393643
E01003399,1407,682,725,0.48471926083866385,0.5152807391613362
E01003423,1643,804,839,0.4893487522824102,0.5106512477175897
E01003357,1867,855,1012,0.4579539367970005,0.5420460632029994
E01003376,1571,745,826,0.47422024188415024,0.5257797581158498
E01003377,1641,795,846,0.4844606946983547,0.5155393053016454
E01003408,1948,953,995,0.48921971252566737,0.5107802874743327
E01003410,1634,813,821,0.4975520195838433,0.5024479804161567
E01003386,2272,1121,1151,0.4933978873239437,0.5066021126760564
E01003388,1727,799,928,0.4626519976838448,0.5373480023161552
E01003389,1796,914,882,0.5089086859688196,0.4910913140311804
E01003392,1416,697,719,0.4922316384180791,0.507768361581921
E01003409,1800,883,917,0.4905555555555556,0.5094444444444445
E01003387,2085,975,1110,0.4676258992805755,0.5323741007194245
E01003391,1322,664,658,0.5022692889561271,0.4977307110438729
E01003411,2035,943,1092,0.46339066339066337,0.5366093366093366
E01003412,1753,846,907,0.48260125499144324,0.5173987450085568
E01003435,2126,1037,1089,0.48777046095954846,0.5122295390404515
E01003361,1672,808,864,0.48325358851674644,0.5167464114832536
E01003424,1533,778,755,0.507501630789302,0.49249836921069795
E01003425,1488,729,759,0.4899193548387097,0.5100806451612904
E01003426,1756,877,879,0.4994305239179954,0.5005694760820045
E01003428,1515,731,784,0.48250825082508253,0.5174917491749175
E01003366,1736,873,863,0.5028801843317973,0.4971198156682028
E01003381,1570,733,837,0.46687898089171975,0.5331210191082802
E01003446,1964,937,1027,0.4770875763747454,0.5229124236252546
E01003447,1608,742,866,0.4614427860696517,0.5385572139303483
E01003471,1723,847,876,0.4915844457341846,0.5084155542658154
E01003413,2082,1014,1068,0.48703170028818443,0.5129682997118156
E01003414,1724,852,872,0.494199535962877,0.505800464037123
E01003415,2390,1151,1239,0.4815899581589958,0.5184100418410041
E01003416,1586,824,762,0.519546027742749,0.48045397225725095
E01003434,1545,779,766,0.5042071197411003,0.49579288025889967
E01003373,1551,737,814,0.475177304964539,0.524822695035461
E01003378,2240,1080,1160,0.48214285714285715,0.5178571428571429
E01003379,2025,947,1078,0.4676543209876543,0.5323456790123456
E01003390,1787,848,939,0.4745383324006715,0.5254616675993284
E01003405,2432,1178,1254,0.484375,0.515625
E01003429,1629,807,822,0.4953959484346225,0.5046040515653776
E01003430,1675,826,849,0.493134328358209,0.5068656716417911
E01003431,1702,788,914,0.46298472385428907,0.5370152761457109
E01003432,1705,794,911,0.4656891495601173,0.5343108504398827
E01003433,1595,805,790,0.5047021943573667,0.4952978056426332
E01003466,1711,819,892,0.47866744593804794,0.5213325540619521
E01003467,1766,890,876,0.5039637599093998,0.4960362400906002
E01003468,1761,862,899,0.4894946053378762,0.5105053946621237
E01003469,1651,798,853,0.483343428225318,0.516656571774682
E01003470,1998,985,1013,0.492992992992993,0.507007007007007
E01003362,1382,665,717,0.48118668596237335,0.5188133140376266
E01003363,1698,871,827,0.5129564193168433,0.4870435806831567
E01003364,1817,871,946,0.47936158503026965,0.5206384149697303
E01003365,1486,726,760,0.48855989232839836,0.5114401076716016
E01003421,1594,781,813,0.48996235884567124,0.5100376411543287
E01003374,1811,865,946,0.47763666482606293,0.5223633351739371
E01003375,1777,884,893,0.4974676420934159,0.5025323579065841
E01003437,2032,986,1046,0.48523622047244097,0.514763779527559
E01003440,1669,782,887,0.46854403834631514,0.5314559616536848
E01003441,1898,937,961,0.49367755532139096,0.5063224446786091
E01003427,1976,993,983,0.5025303643724697,0.4974696356275304
E01003436,1742,853,889,0.4896670493685419,0.5103329506314581
E01003439,1590,787,803,0.4949685534591195,0.5050314465408805
E01003448,2301,1096,1205,0.4763146458061712,0.5236853541938288
E01003453,1837,905,932,0.492651061513337,0.5073489384866631
E01003438,1827,891,936,0.4876847290640394,0.5123152709359606
E01003449,1873,931,942,0.4970635344367325,0.5029364655632674
E01003450,1801,892,909,0.49528039977790117,0.5047196002220988
E01003451,1942,964,978,0.4963954685890834,0.5036045314109165
E01003452,2226,1100,1126,0.4941599281221923,0.5058400718778078
E01003417,1591,767,824,0.4820867379006914,0.5179132620993087
E01003418,1442,713,729,0.4944521497919556,0.5055478502080444
E01003419,1824,911,913,0.4994517543859649,0.5005482456140351
E01003420,1483,709,774,0.47808496291301417,0.5219150370869858
E01003422,1462,695,767,0.47537619699042405,0.5246238030095759
E01003543,2333,1167,1166,0.5002143163309044,0.4997856836690956
E01003544,1811,905,906,0.49972390944229705,0.500276090557703
E01003546,1788,826,962,0.46196868008948544,0.5380313199105146
E01003550,1780,879,901,0.49382022471910114,0.5061797752808989
E01003576,1801,854,947,0.47418101054969464,0.5258189894503054
E01003581,1803,896,907,0.49694952856350527,0.5030504714364947
E01003582,1598,765,833,0.4787234042553192,0.5212765957446809
E01003583,2096,1057,1039,0.504293893129771,0.49570610687022904
E01003578,1994,1028,966,0.5155466399197592,0.4844533600802407
E01003584,1916,969,947,0.505741127348643,0.494258872651357
E01003586,1833,1011,822,0.5515548281505729,0.44844517184942717
E01003590,1607,739,868,0.4598630989421282,0.5401369010578718
E01003579,1987,981,1006,0.4937091092098641,0.5062908907901359
E01003585,1629,842,787,0.5168815224063843,0.4831184775936157
E01003587,2486,1226,1260,0.49316170555108607,0.5068382944489139
E01003591,2256,1149,1107,0.5093085106382979,0.49069148936170215
E01003528,1359,630,729,0.46357615894039733,0.5364238410596026
E01003575,1659,857,802,0.5165762507534659,0.48342374924653403
E01003577,2387,1128,1259,0.47255969836614997,0.52744030163385
E01003580,2002,966,1036,0.4825174825174825,0.5174825174825175
E01003545,1753,843,910,0.48088990302338847,0.5191100969766115
E01003548,2248,1115,1133,0.4959964412811388,0.5040035587188612
E01003549,2119,1050,1069,0.49551675318546484,0.5044832468145352
E01003557,1956,987,969,0.504601226993865,0.495398773006135
E01003547,1955,1019,936,0.521227621483376,0.478772378516624
E01003555,1884,936,948,0.4968152866242038,0.5031847133757962
E01003561,1714,860,854,0.5017502917152858,0.4982497082847141
E01003567,1938,978,960,0.5046439628482973,0.4953560371517028
E01003556,1969,1002,967,0.5088877602844083,0.49111223971559165
E01003558,1715,853,862,0.49737609329446064,0.5026239067055394
E01003570,1908,970,938,0.5083857442348009,0.4916142557651992
E01003571,2278,1185,1093,0.5201931518876207,0.4798068481123793
E01003572,1674,852,822,0.5089605734767025,0.4910394265232975
E01003551,1830,889,941,0.48579234972677593,0.514207650273224
E01003553,2021,1000,1021,0.49480455220188024,0.5051954477981198
E01003554,1899,956,943,0.5034228541337546,0.4965771458662454
E01003559,2391,1190,1201,0.49769970723546636,0.5023002927645337
E01003529,2417,1290,1127,0.5337194869673149,0.46628051303268514
E01003530,1893,964,929,0.5092445853143159,0.4907554146856841
E01003531,2253,1162,1091,0.5157567687527741,0.4842432312472259
E01003532,2309,1257,1052,0.5443915114768298,0.4556084885231702
E01003534,2323,1205,1118,0.5187257856220404,0.48127421437795953
E01003533,2315,1224,1091,0.5287257019438445,0.4712742980561555
E01003560,1676,846,830,0.5047732696897375,0.49522673031026254
E01003563,2620,1274,1346,0.4862595419847328,0.5137404580152671
E01003588,1560,787,773,0.5044871794871795,0.49551282051282053
E01003589,1856,947,909,0.5102370689655172,0.48976293103448276
E01003616,1846,950,896,0.514626218851571,0.48537378114842905
E01003618,2269,1193,1076,0.5257822829440282,0.4742177170559718
E01003619,2483,1207,1276,0.48610551751913006,0.5138944824808699
E01034199,1819,837,982,0.4601429356789445,0.5398570643210555
E01034200,1570,834,736,0.5312101910828025,0.46878980891719746
E01003562,2100,1083,1017,0.5157142857142857,0.48428571428571426
E01003564,2367,1188,1179,0.5019011406844106,0.49809885931558934
E01003565,2089,1036,1053,0.49593106749640975,0.5040689325035902
E01003566,1962,1019,943,0.5193679918450561,0.48063200815494395
E01003625,1682,826,856,0.49108204518430437,0.5089179548156956
E01003626,1682,890,792,0.5291319857312723,0.4708680142687277
E01003627,1525,795,730,0.521311475409836,0.4786885245901639
E01003628,1691,885,806,0.5233589591957422,0.47664104080425784
E01003629,1947,964,983,0.49512069851052903,0.504879301489471
E01003552,1597,792,805,0.49592986850344395,0.504070131496556
E01003596,1717,824,893,0.47990681421083287,0.5200931857891672
E01003597,2189,1177,1012,0.5376884422110553,0.4623115577889447
E01003635,1825,931,894,0.5101369863013698,0.4898630136986301
E01003568,2586,1421,1165,0.5494972931167826,0.4505027068832173
E01003569,2465,1382,1083,0.5606490872210953,0.43935091277890465
E01003573,2331,1241,1090,0.5323895323895323,0.4676104676104676
E01003574,2550,1306,1244,0.5121568627450981,0.48784313725490197
E01003520,1983,993,990,0.5007564296520424,0.49924357034795763
E01003521,2172,1138,1034,0.5239410681399632,0.47605893186003684
E01003522,1851,936,915,0.5056726094003241,0.49432739059967584
E01003525,2075,1017,1058,0.49012048192771085,0.5098795180722892
E01003526,1880,932,948,0.4957446808510638,0.5042553191489362
E01003488,1983,952,1031,0.4800806858295512,0.5199193141704488
E01003489,2993,1476,1517,0.4931506849315068,0.5068493150684932
E01003490,1994,1033,961,0.5180541624874624,0.4819458375125376
E01003524,1930,978,952,0.5067357512953368,0.49326424870466323
E01003631,1866,916,950,0.4908896034297964,0.5091103965702036
E01003632,2425,1220,1205,0.5030927835051546,0.49690721649484537
E01003633,1857,900,957,0.48465266558966075,0.5153473344103393
E01003634,1751,860,891,0.49114791547687037,0.5088520845231297
E01003636,2197,1082,1115,0.4924897587619481,0.5075102412380519
E01003598,1894,920,974,0.4857444561774023,0.5142555438225976
E01003600,1629,814,815,0.49969306322897483,0.5003069367710252
E01003630,1890,923,967,0.4883597883597884,0.5116402116402117
E01003637,1889,1005,884,0.5320275277924827,0.4679724722075172
E01003491,1980,996,984,0.503030303030303,0.49696969696969695
E01003592,1888,952,936,0.5042372881355932,0.4957627118644068
E01003599,1650,840,810,0.509090909090909,0.4909090909090909
E01034201,1447,699,748,0.48306841741534207,0.5169315825846579
E01034202,1645,799,846,0.4857142857142857,0.5142857142857142
E01003535,1856,890,966,0.4795258620689655,0.5204741379310345
E01003536,2120,1056,1064,0.4981132075471698,0.5018867924528302
E01003621,1652,843,809,0.5102905569007264,0.4897094430992736
E01003622,1821,931,890,0.5112575507962658,0.4887424492037342
E01003623,1755,900,855,0.5128205128205128,0.48717948717948717
E01003523,2464,1120,1344,0.45454545454545453,0.5454545454545454
E01003527,1828,891,937,0.48741794310722103,0.512582056892779
E01003537,2161,1085,1076,0.5020823692734845,0.4979176307265155
E01003542,2234,1087,1147,0.4865711727842435,0.5134288272157564
E01003624,1692,822,870,0.4858156028368794,0.5141843971631206
E01003492,2032,1039,993,0.5113188976377953,0.48868110236220474
E01003494,2116,1043,1073,0.4929111531190926,0.5070888468809074
E01003495,2072,1025,1047,0.4946911196911197,0.5053088803088803
E01034203,1361,757,604,0.556208670095518,0.443791329904482
E01034204,1993,1023,970,0.5132965378825891,0.48670346211741095
E01003594,1829,911,918,0.4980863860032805,0.5019136139967195
E01003595,1813,853,960,0.47049089906232766,0.5295091009376723
E01003602,2186,1091,1095,0.4990850869167429,0.5009149130832571
E01003607,1895,895,1000,0.47229551451187335,0.5277044854881267
E01003496,1340,607,733,0.45298507462686566,0.5470149253731343
E01003498,1868,940,928,0.5032119914346895,0.49678800856531047
E01003500,2049,998,1051,0.4870668618838458,0.5129331381161543
E01003593,1508,704,804,0.46684350132625996,0.53315649867374
E01003601,2201,1052,1149,0.47796456156292594,0.522035438437074
E01003603,1940,919,1021,0.47371134020618555,0.5262886597938145
E01003605,2070,1031,1039,0.4980676328502415,0.5019323671497584
E01003608,2034,1020,1014,0.5014749262536873,0.49852507374631266
E01003538,2136,1039,1097,0.48642322097378277,0.5135767790262172
E01003539,2516,1246,1270,0.49523052464228934,0.5047694753577107
E01003540,2031,1013,1018,0.49876907927129494,0.5012309207287051
E01003541,2022,1022,1000,0.5054401582591493,0.49455984174085066
E01003499,2373,1141,1232,0.4808259587020649,0.5191740412979351
E01003501,2355,1143,1212,0.4853503184713376,0.5146496815286624
E01003502,2671,1340,1331,0.5016847622613253,0.49831523773867464
E01003503,2882,1488,1394,0.5163081193615545,0.48369188063844554
E01003507,2261,1107,1154,0.4896063688633348,0.5103936311366651
E01003508,2558,1242,1316,0.48553557466770914,0.5144644253322909
E01003509,2064,986,1078,0.47771317829457366,0.5222868217054264
E01003604,2292,1090,1202,0.4755671902268761,0.5244328097731239
E01003483,1654,809,845,0.48911729141475213,0.5108827085852479
E01003484,1798,860,938,0.4783092324805339,0.5216907675194661
E01003516,1888,937,951,0.4962923728813559,0.503707627118644
E01003518,1637,796,841,0.4862553451435553,0.5137446548564447
E01003519,1619,813,806,0.5021618282890673,0.4978381717109327
E01003480,2012,954,1058,0.474155069582505,0.525844930417495
E01003486,1206,566,640,0.4693200663349917,0.5306799336650083
E01003487,1353,631,722,0.4663710273466371,0.5336289726533628
E01034205,1555,750,805,0.48231511254019294,0.5176848874598071
E01034206,1766,849,917,0.48074745186862966,0.5192525481313703
E01034207,1536,769,767,0.5006510416666666,0.4993489583333333
E01003497,1648,832,816,0.5048543689320388,0.49514563106796117
E01003506,1425,683,742,0.4792982456140351,0.5207017543859649
E01033584,1703,832,871,0.48854961832061067,0.5114503816793893
E01034208,1944,973,971,0.5005144032921811,0.49948559670781895
E01034209,1480,725,755,0.48986486486486486,0.5101351351351351
E01034210,1536,802,734,0.5221354166666666,0.4778645833333333
E01034211,1437,776,661,0.5400139178844816,0.45998608211551845
E01034212,1925,985,940,0.5116883116883116,0.4883116883116883
E01003479,1547,740,807,0.4783451842275372,0.5216548157724629
E01003481,1476,746,730,0.505420054200542,0.494579945799458
E01003485,1688,810,878,0.47985781990521326,0.5201421800947867
E01003513,1562,755,807,0.4833546734955186,0.5166453265044815
E01003511,1922,932,990,0.48491155046826223,0.5150884495317378
E01003512,1980,967,1013,0.48838383838383836,0.5116161616161616
E01003514,1658,817,841,0.4927623642943305,0.5072376357056695
E01003515,2106,1028,1078,0.4881291547958215,0.5118708452041786
E01003517,1884,860,1024,0.4564755838641189,0.5435244161358811
E01034213,1788,890,898,0.49776286353467564,0.5022371364653244
E01034214,1565,834,731,0.5329073482428115,0.4670926517571885
E01034215,1536,791,745,0.5149739583333334,0.4850260416666667
E01034216,1704,851,853,0.4994131455399061,0.5005868544600939
E01034217,2046,1055,991,0.5156402737047898,0.4843597262952102
E01003615,1700,847,853,0.49823529411764705,0.5017647058823529
E01034218,1821,936,885,0.514003294892916,0.48599670510708404
E01034219,1885,900,985,0.47745358090185674,0.5225464190981433
E01034220,1234,658,576,0.5332252836304701,0.46677471636953
E01034221,1783,901,882,0.5053280987100393,0.49467190128996075
E01033579,1886,929,957,0.492576882290562,0.5074231177094379
E01033586,2100,1112,988,0.5295238095238095,0.4704761904761905
E01034222,1527,822,705,0.5383104125736738,0.46168958742632615
E01034223,1375,710,665,0.5163636363636364,0.48363636363636364
E01003611,1961,900,1061,0.4589495155532891,0.5410504844467109
E01033581,1923,928,995,0.4825793031721269,0.5174206968278731
E01033582,1449,715,734,0.49344375431331955,0.5065562456866805
E01034224,1753,839,914,0.47860810039931545,0.5213918996006845
E01033580,1412,760,652,0.5382436260623229,0.46175637393767704
E01034225,1504,735,769,0.4886968085106383,0.5113031914893617
E01034226,1414,725,689,0.5127298444130127,0.4872701555869873
E01034227,1577,710,867,0.45022194039315155,0.5497780596068484
E01034228,1348,694,654,0.5148367952522255,0.48516320474777447
E01034229,1409,679,730,0.48190205819730303,0.518097941802697
E01034230,1237,637,600,0.5149555375909458,0.4850444624090542
E01034231,1343,686,657,0.5107967237527923,0.4892032762472077
E01003744,1453,711,742,0.4893324156916724,0.5106675843083276
E01003745,1412,697,715,0.4936260623229462,0.5063739376770539
E01003746,1619,782,837,0.4830142063001853,0.5169857936998147
E01003747,1361,660,701,0.4849375459221161,0.5150624540778839
E01003748,1636,795,841,0.48594132029339854,0.5140586797066015
E01003749,1765,878,887,0.49745042492917846,0.5025495750708215
E01003750,1914,960,954,0.5015673981191222,0.49843260188087773
E01003720,1922,923,999,0.4802289281997919,0.5197710718002081
E01003722,2418,1179,1239,0.48759305210918114,0.5124069478908189
E01003723,1915,878,1037,0.4584856396866841,0.5415143603133159
E01003726,2527,1237,1290,0.4895132568262762,0.5104867431737238
E01003721,1895,914,981,0.48232189973614775,0.5176781002638522
E01003724,1482,735,747,0.4959514170040486,0.5040485829959515
E01003725,1761,802,959,0.4554230550823396,0.5445769449176604
E01003727,1781,871,910,0.48905109489051096,0.5109489051094891
E01003654,1702,831,871,0.4882491186839013,0.5117508813160987
E01003655,1571,775,796,0.49331635900700194,0.5066836409929981
E01003658,1720,834,886,0.4848837209302326,0.5151162790697674
E01003660,1775,891,884,0.5019718309859155,0.49802816901408453
E01003656,1559,749,810,0.4804361770365619,0.5195638229634381
E01003657,2168,1033,1135,0.4764760147601476,0.5235239852398524
E01003659,1756,852,904,0.48519362186788156,0.5148063781321185
E01003698,1526,760,766,0.4980340760157274,0.5019659239842726
E01003699,1554,773,781,0.4974259974259974,0.5025740025740025
E01003700,2525,1246,1279,0.49346534653465346,0.5065346534653465
E01003701,2053,978,1075,0.47637603507062837,0.5236239649293717
E01003702,2253,1065,1188,0.47270306258322237,0.5272969374167776
E01003703,2651,1237,1414,0.46661637118068655,0.5333836288193134
E01003704,2032,1002,1030,0.49311023622047245,0.5068897637795275
E01003668,1717,864,853,0.5032032615026208,0.49679673849737915
E01003669,1549,775,774,0.500322788896062,0.49967721110393803
E01003670,1532,736,796,0.4804177545691906,0.5195822454308094
E01003671,1557,759,798,0.48747591522157996,0.51252408477842
E01003672,1697,792,905,0.4667059516794343,0.5332940483205657
E01003673,1917,891,1026,0.4647887323943662,0.5352112676056338
E01003674,2424,1235,1189,0.5094884488448845,0.4905115511551155
E01003707,1529,775,754,0.5068672334859385,0.49313276651406146
E01003708,2064,946,1118,0.4583333333333333,0.5416666666666666
E01003709,1772,880,892,0.4966139954853273,0.5033860045146726
E01003710,1520,748,772,0.4921052631578947,0.5078947368421053
E01003759,1586,777,809,0.48991172761664564,0.5100882723833543
E01003760,1895,935,960,0.49340369393139843,0.5065963060686016
E01003761,1824,877,947,0.48081140350877194,0.5191885964912281
E01003762,1729,862,867,0.4985540775014459,0.5014459224985541
E01003763,2010,990,1020,0.4925373134328358,0.5074626865671642
E01003764,2105,989,1116,0.469833729216152,0.5301662707838479
E01003765,1939,910,1029,0.4693140794223827,0.5306859205776173
E01003705,2420,1163,1257,0.4805785123966942,0.5194214876033058
E01003706,1702,816,886,0.4794359576968273,0.5205640423031728
E01003711,1912,906,1006,0.47384937238493724,0.5261506276150628
E01003712,1500,735,765,0.49,0.51
E01003646,1916,973,943,0.5078288100208769,0.4921711899791232
E01003648,1513,738,775,0.48777263714474556,0.5122273628552545
E01003649,1676,830,846,0.49522673031026254,0.5047732696897375
E01003651,1516,747,769,0.49274406332453824,0.5072559366754618
E01003639,2256,1117,1139,0.4951241134751773,0.5048758865248227
E01003640,1958,943,1015,0.4816138917262513,0.5183861082737488
E01003641,2035,1055,980,0.5184275184275184,0.48157248157248156
E01003642,1769,853,916,0.4821933295647258,0.5178066704352742
E01003774,1934,923,1011,0.4772492244053775,0.5227507755946226
E01003775,1658,780,878,0.4704463208685163,0.5295536791314838
E01003776,1735,766,969,0.44149855907780977,0.5585014409221902
E01003777,1824,840,984,0.4605263157894737,0.5394736842105263
E01003778,1943,924,1019,0.4755532681420484,0.5244467318579517
E01003779,1648,793,855,0.4811893203883495,0.5188106796116505
E01003780,1564,770,794,0.49232736572890023,0.5076726342710998
E01003647,1969,953,1016,0.48400203148806503,0.515997968511935
E01003650,1779,880,899,0.4946599213041034,0.5053400786958966
E01003652,1615,826,789,0.5114551083591331,0.4885448916408669
E01003653,2163,1124,1039,0.5196486361534906,0.4803513638465095
E01003638,1907,940,967,0.4929208180388044,0.5070791819611956
E01003643,2275,1109,1166,0.48747252747252745,0.5125274725274725
E01003644,1657,820,837,0.4948702474351237,0.5051297525648762
E01003645,2787,1390,1397,0.4987441693577323,0.5012558306422676
E01003789,1426,682,744,0.4782608695652174,0.5217391304347826
E01003794,1549,751,798,0.48482892188508714,0.5151710781149128
E01003795,1235,621,614,0.5028340080971659,0.497165991902834
E01003796,1580,769,811,0.48670886075949366,0.5132911392405063
E01003751,2274,1125,1149,0.4947229551451187,0.5052770448548812
E01003753,1987,1010,977,0.5083039758429794,0.49169602415702063
E01003754,1719,851,868,0.49505526468877253,0.5049447353112274
E01003757,2143,1073,1070,0.5006999533364442,0.49930004666355576
E01003769,1878,949,929,0.5053248136315229,0.4946751863684771
E01003770,2886,1409,1477,0.48821898821898824,0.5117810117810118
E01003771,1793,902,891,0.5030674846625767,0.49693251533742333
E01003773,1827,882,945,0.4827586206896552,0.5172413793103449
E01003752,2772,1351,1421,0.48737373737373735,0.5126262626262627
E01003755,2413,1266,1147,0.5246581019477828,0.47534189805221716
E01003756,2496,1244,1252,0.4983974358974359,0.5016025641025641
E01034480,1346,643,703,0.47771173848439824,0.5222882615156018
E01034481,1706,779,927,0.4566236811254396,0.5433763188745604
E01003766,2175,1126,1049,0.5177011494252873,0.48229885057471267
E01003767,2196,1160,1036,0.5282331511839709,0.47176684881602915
E01003768,1919,997,922,0.5195414278269932,0.48045857217300675
E01003772,1816,911,905,0.5016519823788547,0.4983480176211454
E01003781,2018,1011,1007,0.5009910802775025,0.4990089197224975
E01003782,1740,901,839,0.517816091954023,0.482183908045977
E01003786,1636,812,824,0.4963325183374083,0.5036674816625917
E01003787,1645,895,750,0.5440729483282675,0.45592705167173253
E01003790,1498,720,778,0.48064085447263016,0.5193591455273698
E01003791,1501,749,752,0.4990006662225183,0.5009993337774816
E01003792,1423,711,712,0.49964862965565704,0.500351370344343
E01003793,1582,748,834,0.47281921618204803,0.527180783817952
E01003783,2529,1261,1268,0.4986160537761961,0.5013839462238039
E01003784,2007,996,1011,0.4962630792227205,0.5037369207772795
E01003785,2046,1004,1042,0.49071358748778104,0.509286412512219
E01003788,1835,916,919,0.4991825613079019,0.500817438692098
E01003737,2973,1574,1399,0.5294315506222671,0.47056844937773296
E01003738,2378,1160,1218,0.4878048780487805,0.5121951219512195
E01003739,2396,1156,1240,0.48247078464106846,0.5175292153589316
E01003740,2222,1112,1110,0.5004500450045004,0.49954995499549953
E01003741,2047,973,1074,0.47532975085490964,0.5246702491450904
E01003742,2374,1257,1117,0.529486099410278,0.470513900589722
E01003743,1902,947,955,0.4978969505783386,0.5021030494216614
E01003729,1773,877,896,0.4946418499717992,0.5053581500282008
E01003730,1838,954,884,0.5190424374319913,0.4809575625680087
E01003732,1832,893,939,0.4874454148471616,0.5125545851528385
E01003733,1838,918,920,0.499455930359086,0.500544069640914
E01034482,1083,525,558,0.48476454293628807,0.5152354570637119
E01034483,1418,660,758,0.46544428772919605,0.5345557122708039
E01034484,1705,858,847,0.5032258064516129,0.4967741935483871
E01003731,1411,707,704,0.5010630758327428,0.49893692416725727
E01003734,1836,933,903,0.5081699346405228,0.4918300653594771
E01003735,2109,1002,1107,0.4751066856330014,0.5248933143669986
E01003736,2037,1120,917,0.5498281786941581,0.45017182130584193
E01003713,1884,941,943,0.4994692144373673,0.5005307855626328
E01003714,2424,1238,1186,0.5107260726072608,0.4892739273927393
E01003715,2216,1179,1037,0.5320397111913358,0.46796028880866425
E01003716,1819,959,860,0.5272127542605828,0.4727872457394173
E01003718,2003,973,1030,0.4857713429855217,0.5142286570144783
E01003719,2404,1213,1191,0.5045757071547421,0.4954242928452579
E01032581,1930,920,1010,0.47668393782383417,0.5233160621761658
E01003690,2155,1074,1081,0.49837587006960554,0.5016241299303944
E01003691,1606,806,800,0.50186799501868,0.49813200498132004
E01003692,1641,781,860,0.47592931139549055,0.5240706886045094
E01003693,1704,823,881,0.482981220657277,0.517018779342723
E01003694,1465,734,731,0.5010238907849829,0.49897610921501706
E01003695,1521,798,723,0.52465483234714,0.47534516765285995
E01003696,1782,880,902,0.49382716049382713,0.5061728395061729
E01003697,1728,859,869,0.49710648148148145,0.5028935185185185
E01003675,1723,872,851,0.506094022054556,0.493905977945444
E01003676,1941,965,976,0.497166409067491,0.502833590932509
E01003677,1808,954,854,0.5276548672566371,0.4723451327433628
E01003678,1639,802,837,0.48932275777913364,0.5106772422208664
E01003679,1759,899,860,0.511085844229676,0.48891415577032404
E01003680,1667,827,840,0.49610077984403117,0.5038992201559688
E01003681,2025,967,1058,0.4775308641975309,0.5224691358024691
E01003682,1858,948,910,0.5102260495156081,0.4897739504843918
E01003663,1959,939,1020,0.4793261868300153,0.5206738131699847
E01003664,1911,943,968,0.4934589220303506,0.5065410779696494
E01003665,1711,852,859,0.4979544126241964,0.5020455873758036
E01033590,1250,588,662,0.4704,0.5296
E01033592,1984,985,999,0.4964717741935484,0.5035282258064516
E01003661,2225,1132,1093,0.5087640449438202,0.4912359550561798
E01003662,2142,1067,1075,0.4981325863678805,0.5018674136321195
E01003666,2903,1397,1506,0.4812263176024802,0.5187736823975198
E01003689,2231,1164,1067,0.5217391304347826,0.4782608695652174
E01033589,1954,968,986,0.4953940634595701,0.5046059365404298
E01033591,2977,1491,1486,0.5008397715821297,0.49916022841787033
E01003683,2187,1118,1069,0.5112025605852767,0.48879743941472337
E01003684,1866,931,935,0.49892818863879956,0.5010718113612004
E01003685,1925,1021,904,0.5303896103896104,0.4696103896103896
E01003686,2020,1011,1009,0.5004950495049505,0.4995049504950495
E01003688,1842,952,890,0.5168295331161781,0.4831704668838219
E01003797,1425,652,773,0.4575438596491228,0.5424561403508772
E01003798,1406,686,720,0.4879089615931721,0.5120910384068279
E01003799,1573,769,804,0.4888747616020343,0.5111252383979656
E01003800,1503,660,843,0.43912175648702595,0.5608782435129741
E01003801,1281,641,640,0.5003903200624512,0.4996096799375488
E01003802,1387,698,689,0.5032444124008651,0.4967555875991348
E01003803,1555,725,830,0.4662379421221865,0.5337620578778135
E01003846,1709,810,899,0.4739613809245173,0.5260386190754828
E01003847,1692,810,882,0.4787234042553192,0.5212765957446809
E01003849,1531,711,820,0.4644023514043109,0.5355976485956891
E01003851,1602,750,852,0.4681647940074906,0.5318352059925093
E01003860,1716,862,854,0.5023310023310024,0.4976689976689977
E01003864,1464,705,759,0.48155737704918034,0.5184426229508197
E01003852,1360,684,676,0.5029411764705882,0.4970588235294118
E01003853,1432,638,794,0.44553072625698326,0.5544692737430168
E01003854,1416,662,754,0.4675141242937853,0.5324858757062146
E01003855,1930,899,1031,0.4658031088082902,0.5341968911917099
E01003856,1690,786,904,0.4650887573964497,0.5349112426035503
E01003857,1884,893,991,0.4739915074309979,0.5260084925690022
E01003858,1658,779,879,0.46984318455971047,0.5301568154402895
E01003848,1905,894,1011,0.4692913385826772,0.5307086614173229
E01003861,1955,950,1005,0.4859335038363171,0.5140664961636828
E01003862,1930,912,1018,0.47253886010362695,0.5274611398963731
E01003863,1451,682,769,0.47002067539627845,0.5299793246037215
E01003865,1445,695,750,0.4809688581314879,0.5190311418685121
E01033570,1904,926,978,0.48634453781512604,0.5136554621848739
E01033571,1496,733,763,0.4899732620320856,0.5100267379679144
E01003804,1904,924,980,0.4852941176470588,0.5147058823529411
E01003807,1967,936,1031,0.4758515505846467,0.5241484494153533
E01003808,1890,862,1028,0.4560846560846561,0.5439153439153439
E01003809,1711,844,867,0.49327878433664524,0.5067212156633548
E01003859,1623,813,810,0.5009242144177449,0.49907578558225507
E01003873,1632,790,842,0.4840686274509804,0.5159313725490197
E01003874,1526,710,816,0.46526867627785057,0.5347313237221494
E01003875,1675,818,857,0.48835820895522386,0.5116417910447761
E01003878,1468,665,803,0.4529972752043597,0.5470027247956403
E01003866,1694,822,872,0.4852420306965762,0.5147579693034239
E01003868,1568,751,817,0.4789540816326531,0.5210459183673469
E01003871,1756,833,923,0.474373576309795,0.525626423690205
E01003872,1567,771,796,0.4920229738353542,0.5079770261646458
E01003821,1691,840,851,0.4967474866942638,0.5032525133057363
E01003876,1867,901,966,0.4825923942153187,0.5174076057846813
E01003877,1498,715,783,0.4773030707610147,0.5226969292389854
E01003879,1416,673,743,0.4752824858757062,0.5247175141242938
E01003892,2090,1009,1081,0.48277511961722486,0.5172248803827751
E01003893,1623,809,814,0.4984596426370918,0.5015403573629081
E01003894,1662,803,859,0.4831528279181709,0.5168471720818292
E01003895,1773,825,948,0.4653130287648054,0.5346869712351946
E01003905,1281,638,643,0.49804839968774395,0.501951600312256
E01003906,1699,871,828,0.5126545026486168,0.48734549735138316
E01003907,1675,842,833,0.5026865671641791,0.4973134328358209
E01003908,1815,903,912,0.4975206611570248,0.5024793388429752
E01003909,1634,819,815,0.5012239902080783,0.49877600979192166
E01003867,1598,818,780,0.5118898623279099,0.4881101376720901
E01003869,1662,799,863,0.48074608904933813,0.5192539109506619
E01003870,2100,1020,1080,0.4857142857142857,0.5142857142857142
E01003910,1655,820,835,0.4954682779456193,0.5045317220543807
E01003805,1727,847,880,0.49044585987261147,0.5095541401273885
E01003806,1471,729,742,0.495581237253569,0.504418762746431
E01003816,1739,847,892,0.4870615296147211,0.5129384703852788
E01003817,1987,929,1058,0.46753900352289884,0.5324609964771012
E01003840,1826,883,943,0.4835706462212486,0.5164293537787513
E01003841,2161,1084,1077,0.5016196205460435,0.4983803794539565
E01003842,1716,851,865,0.4959207459207459,0.504079254079254
E01003843,2215,1061,1154,0.47900677200902936,0.5209932279909707
E01003844,1462,707,755,0.4835841313269494,0.5164158686730507
E01003845,1707,839,868,0.4915055653192736,0.5084944346807264
E01003882,2000,972,1028,0.486,0.514
E01003883,2024,975,1049,0.4817193675889328,0.5182806324110671
E01003896,1882,918,964,0.487778958554729,0.512221041445271
E01003897,1962,973,989,0.49592252803261977,0.5040774719673802
E01003898,1693,816,877,0.4819846426461902,0.5180153573538098
E01003899,1484,669,815,0.4508086253369272,0.5491913746630728
E01003900,1685,793,892,0.47062314540059347,0.5293768545994065
E01003901,1789,866,923,0.4840693124650643,0.5159306875349358
E01003902,1374,651,723,0.4737991266375546,0.5262008733624454
E01003903,1655,788,867,0.4761329305135952,0.5238670694864048
E01003904,1626,736,890,0.45264452644526443,0.5473554735547356
E01003880,1563,780,783,0.4990403071017274,0.5009596928982726
E01003881,1768,864,904,0.48868778280542985,0.5113122171945701
E01003884,1735,798,937,0.45994236311239195,0.5400576368876081
E01003885,1539,724,815,0.47043534762833006,0.5295646523716699
E01003818,1607,770,837,0.4791537025513379,0.5208462974486621
E01003819,1773,845,928,0.47659334461364916,0.5234066553863508
E01003820,2031,974,1057,0.4795667159034958,0.5204332840965041
E01003811,1841,881,960,0.47854426941879413,0.5214557305812059
E01003812,1856,892,964,0.48060344827586204,0.5193965517241379
E01003890,1667,761,906,0.45650869826034796,0.5434913017396521
E01003891,1746,816,930,0.46735395189003437,0.5326460481099656
E01003810,1630,819,811,0.5024539877300613,0.49754601226993866
E01003813,1618,795,823,0.49134734239802225,0.5086526576019778
E01003814,1786,835,951,0.467525195968645,0.5324748040313549
E01003815,1988,929,1059,0.46730382293762573,0.5326961770623743
E01003828,1527,733,794,0.48002619515389655,0.5199738048461034
E01003829,1690,789,901,0.4668639053254438,0.5331360946745562
E01003830,1858,895,963,0.48170075349838537,0.5182992465016146
E01003831,1681,803,878,0.4776918500892326,0.5223081499107673
E01003832,1487,735,752,0.49428379287155344,0.5057162071284466
E01003833,1473,695,778,0.47182620502376105,0.528173794976239
E01003886,1646,785,861,0.47691373025516404,0.523086269744836
E01003887,1796,852,944,0.47438752783964366,0.5256124721603563
E01003888,2045,909,1136,0.4444987775061125,0.5555012224938876
E01003889,1662,812,850,0.48856799037304455,0.5114320096269555
E01003834,1600,789,811,0.493125,0.506875
E01003835,1644,819,825,0.4981751824817518,0.5018248175182481
E01003836,1381,673,708,0.4873280231716148,0.5126719768283853
E01003837,2058,1038,1020,0.5043731778425656,0.4956268221574344
E01003838,1790,881,909,0.4921787709497207,0.5078212290502794
E01003839,2282,1066,1216,0.4671340929009641,0.5328659070990359
E01003822,1477,704,773,0.4766418415707515,0.5233581584292485
E01003823,1701,805,896,0.4732510288065844,0.5267489711934157
E01003824,1630,819,811,0.5024539877300613,0.49754601226993866
E01003825,1774,892,882,0.5028184892897407,0.4971815107102593
E01003826,1782,845,937,0.47418630751964086,0.5258136924803591
E01003827,1934,945,989,0.4886246122026887,0.5113753877973113
E01004029,1996,978,1018,0.48997995991983967,0.5100200400801603
E01004032,1498,781,717,0.5213618157543392,0.4786381842456609
E01004053,1874,991,883,0.5288153681963714,0.47118463180362863
E01004054,1530,794,736,0.5189542483660131,0.48104575163398694
E01004055,1331,641,690,0.48159278737791134,0.5184072126220887
E01003929,1999,1064,935,0.5322661330665333,0.46773386693346675
E01003934,1954,1032,922,0.5281473899692938,0.4718526100307062
E01003935,1284,619,665,0.48208722741433024,0.5179127725856698
E01003939,1975,1009,966,0.5108860759493671,0.4891139240506329
E01033867,1547,703,844,0.4544279250161603,0.5455720749838396
E01033868,1409,672,737,0.47693399574166073,0.5230660042583393
E01003975,1780,853,927,0.47921348314606743,0.5207865168539326
E01004023,1649,875,774,0.5306246209824136,0.4693753790175864
E01004028,2417,1134,1283,0.46917666528754653,0.5308233347124535
E01033869,1468,683,785,0.4652588555858311,0.534741144414169
E01033870,1769,876,893,0.4951950254381006,0.5048049745618994
E01033871,1512,747,765,0.49404761904761907,0.5059523809523809
E01033872,1301,693,608,0.5326671790930054,0.46733282090699463
E01003938,1830,827,1003,0.45191256830601095,0.5480874316939891
E01003940,1590,741,849,0.4660377358490566,0.5339622641509434
E01003941,1988,1004,984,0.5050301810865191,0.4949698189134809
E01003942,1886,881,1005,0.46712619300106045,0.5328738069989396
E01003979,1984,994,990,0.501008064516129,0.49899193548387094
E01003981,1508,703,805,0.4661803713527852,0.5338196286472149
E01004030,1489,751,738,0.5043653458697113,0.4956346541302888
E01004031,2601,1333,1268,0.5124951941560938,0.4875048058439062
E01004033,2417,1167,1250,0.482829954489036,0.517170045510964
E01004034,1602,740,862,0.46192259675405745,0.5380774032459426
E01004036,2114,997,1117,0.4716177861873226,0.5283822138126774
E01004056,2317,1165,1152,0.5028053517479499,0.49719464825205006
E01004057,2240,1108,1132,0.49464285714285716,0.5053571428571428
E01004058,1695,886,809,0.5227138643067847,0.4772861356932153
E01004059,2070,1098,972,0.5304347826086957,0.46956521739130436
E01004060,1969,969,1000,0.49212798374809547,0.5078720162519045
E01003936,1661,768,893,0.46237206502107164,0.5376279349789284
E01003937,1536,788,748,0.5130208333333334,0.4869791666666667
E01003943,1494,740,754,0.49531459170013387,0.5046854082998661
E01033873,1773,864,909,0.4873096446700508,0.5126903553299492
E01033874,1151,518,633,0.45004344048653344,0.5499565595134666
E01003977,1872,902,970,0.48183760683760685,0.5181623931623932
E01004037,2025,1007,1018,0.497283950617284,0.5027160493827161
E01004038,2399,1117,1282,0.4656106711129637,0.5343893288870363
E01004042,1957,935,1022,0.47777210015329585,0.5222278998467041
E01004043,1356,692,664,0.5103244837758112,0.4896755162241888
E01003986,1588,786,802,0.49496221662468515,0.5050377833753149
E01003987,1839,872,967,0.47417074497009243,0.5258292550299075
E01004024,1968,944,1024,0.4796747967479675,0.5203252032520326
E01004035,1426,712,714,0.4992987377279102,0.5007012622720898
E01003960,1773,848,925,0.47828539199097575,0.5217146080090242
E01003961,2074,998,1076,0.4811957569913211,0.5188042430086789
E01003994,1829,955,874,0.5221432476763258,0.47785675232367414
E01033875,1320,638,682,0.48333333333333334,0.5166666666666667
E01033876,1250,668,582,0.5344,0.4656
E01033877,1545,785,760,0.5080906148867314,0.4919093851132686
E01003980,2000,985,1015,0.4925,0.5075
E01004039,1543,766,777,0.4964355152300713,0.5035644847699287
E01004040,1885,872,1013,0.4625994694960212,0.5374005305039787
E01004041,1632,816,816,0.5,0.5
E01004044,1441,704,737,0.48854961832061067,0.5114503816793893
E01003992,1587,722,865,0.4549464398235665,0.5450535601764335
E01003995,1374,698,676,0.5080058224163028,0.49199417758369723
E01003998,1426,722,704,0.5063113604488079,0.49368863955119213
E01003999,1499,720,779,0.48032021347565046,0.5196797865243495
E01032639,1915,956,959,0.49921671018276764,0.5007832898172324
E01032719,1445,747,698,0.5169550173010381,0.48304498269896196
E01003966,2136,1025,1111,0.4798689138576779,0.5201310861423221
E01003971,1426,652,774,0.45722300140252453,0.5427769985974754
E01033878,1108,509,599,0.45938628158844763,0.5406137184115524
E01033879,2555,1178,1377,0.46105675146771036,0.5389432485322896
E01033880,2131,1107,1024,0.5194744251525105,0.4805255748474894
E01003963,1718,810,908,0.47147846332945287,0.5285215366705471
E01003972,1467,687,780,0.46830265848670755,0.5316973415132924
E01003973,1651,813,838,0.4924288310115082,0.5075711689884919
E01033881,1883,889,994,0.4721189591078067,0.5278810408921933
E01003923,1634,795,839,0.4865361077111383,0.5134638922888617
E01003969,2460,1174,1286,0.4772357723577236,0.5227642276422764
E01003991,1273,618,655,0.48546739984289083,0.5145326001571092
E01003993,2019,932,1087,0.4616146607231303,0.5383853392768697
E01003997,1296,622,674,0.4799382716049383,0.5200617283950617
E01003983,1871,864,1007,0.46178514163548906,0.538214858364511
E01003988,2023,977,1046,0.4829461196243203,0.5170538803756797
E01003989,2259,1101,1158,0.48738379814077026,0.5126162018592297
E01003990,2306,1076,1230,0.4666088464874241,0.5333911535125759
E01004007,1443,657,786,0.4553014553014553,0.5446985446985447
E01003912,1952,872,1080,0.44672131147540983,0.5532786885245902
E01004011,2114,934,1180,0.44181646168401134,0.5581835383159887
E01004012,2346,1128,1218,0.48081841432225064,0.5191815856777494
E01004013,1684,798,886,0.47387173396674587,0.5261282660332541
E01004014,2129,1049,1080,0.49271958666040394,0.5072804133395961
E01003911,2088,924,1164,0.4425287356321839,0.5574712643678161
E01003916,2412,1218,1194,0.5049751243781094,0.49502487562189057
E01003917,1885,896,989,0.4753315649867374,0.5246684350132625
E01003918,1465,724,741,0.49419795221843005,0.50580204778157
E01003925,2031,993,1038,0.48892171344165436,0.5110782865583456
E01003919,1564,765,799,0.4891304347826087,0.5108695652173914
E01003920,2107,998,1109,0.4736592311343142,0.5263407688656858
E01003921,1917,955,962,0.4981742305685968,0.5018257694314032
E01003922,2234,1012,1222,0.4529991047448523,0.5470008952551477
E01003924,2092,1066,1026,0.5095602294455067,0.4904397705544933
E01003926,1397,673,724,0.4817465998568361,0.5182534001431639
E01004008,2086,1010,1076,0.4841802492809204,0.5158197507190796
E01004010,1507,732,775,0.48573324485733244,0.5142667551426675
E01004067,2212,1052,1160,0.4755877034358047,0.5244122965641953
E01033882,1408,677,731,0.48082386363636365,0.5191761363636364
E01033883,1600,715,885,0.446875,0.553125
E01003984,2290,1095,1195,0.4781659388646288,0.5218340611353712
E01004003,1823,838,985,0.4596818431157433,0.5403181568842568
E01004004,2625,1221,1404,0.46514285714285714,0.5348571428571428
E01004005,2326,1087,1239,0.46732588134135855,0.5326741186586414
E01004006,1861,864,997,0.46426652337452984,0.5357334766254702
E01003913,2042,1025,1017,0.5019588638589618,0.4980411361410382
E01003914,1855,921,934,0.4964959568733154,0.5035040431266846
E01003915,1850,921,929,0.49783783783783786,0.5021621621621621
E01004050,1389,672,717,0.4838012958963283,0.5161987041036717
E01004052,1747,865,882,0.4951345163136806,0.5048654836863194
E01004061,1658,799,859,0.4819059107358263,0.5180940892641737
E01004062,2214,1035,1179,0.46747967479674796,0.532520325203252
E01004063,1880,880,1000,0.46808510638297873,0.5319148936170213
E01004065,1508,711,797,0.47148541114058357,0.5285145888594165
E01004066,2091,1006,1085,0.4811095169775227,0.5188904830224773
E01004000,1948,930,1018,0.47741273100616016,0.5225872689938398
E01004001,1768,802,966,0.45361990950226244,0.5463800904977375
E01004019,2125,1077,1048,0.5068235294117647,0.49317647058823527
E01004064,1941,909,1032,0.46831530139103555,0.5316846986089645
E01004068,1906,870,1036,0.4564533053515215,0.5435466946484785
E01004045,1587,752,835,0.47385003150598615,0.5261499684940139
E01004047,1643,742,901,0.45161290322580644,0.5483870967741935
E01004048,1627,720,907,0.4425322679778734,0.5574677320221266
E01004049,1345,673,672,0.5003717472118959,0.4996282527881041
E01004051,1285,618,667,0.48093385214007783,0.5190661478599222
E01003953,2016,973,1043,0.4826388888888889,0.5173611111111112
E01003955,1891,912,979,0.48228450555261765,0.5177154944473823
E01004015,1805,732,1073,0.4055401662049862,0.5944598337950139
E01004021,2115,989,1126,0.46761229314420805,0.532387706855792
E01004046,1561,754,807,0.48302370275464446,0.5169762972453555
E01004002,1704,834,870,0.4894366197183099,0.5105633802816901
E01004016,2589,1170,1419,0.4519119351100811,0.5480880648899189
E01004017,1641,776,865,0.4728823887873248,0.5271176112126752
E01004020,1746,800,946,0.4581901489117984,0.5418098510882016
E01003952,1655,812,843,0.4906344410876133,0.5093655589123867
E01003954,1592,766,826,0.48115577889447236,0.5188442211055276
E01003956,1848,897,951,0.48538961038961037,0.5146103896103896
E01004071,1527,728,799,0.4767518009168304,0.5232481990831697
E01004072,1674,830,844,0.4958183990442055,0.5041816009557945
E01004069,1294,629,665,0.4860896445131376,0.5139103554868625
E01004070,1952,956,996,0.48975409836065575,0.5102459016393442
E01004073,1895,905,990,0.47757255936675463,0.5224274406332454
E01004074,1706,819,887,0.48007033997655335,0.5199296600234466
E01004075,1713,825,888,0.4816112084063047,0.5183887915936952
E01003949,1880,883,997,0.4696808510638298,0.5303191489361702
E01003950,1992,950,1042,0.47690763052208834,0.5230923694779116
E01003957,1790,846,944,0.47262569832402235,0.5273743016759777
E01003958,1936,944,992,0.48760330578512395,0.512396694214876
E01004018,1901,891,1010,0.4687006838506049,0.5312993161493951
E01003945,1733,803,930,0.4633583381419504,0.5366416618580496
E01003946,1900,938,962,0.4936842105263158,0.5063157894736842
E01003947,1608,749,859,0.4657960199004975,0.5342039800995025
E01003948,1751,842,909,0.480868075385494,0.519131924614506
E01003951,1488,811,677,0.5450268817204301,0.4549731182795699
E01003930,1967,942,1025,0.47890188103711234,0.5210981189628876
E01003932,1541,767,774,0.49772874756651525,0.5022712524334848
E01003933,2370,1199,1171,0.5059071729957806,0.4940928270042194
E01032583,2050,1033,1017,0.5039024390243902,0.49609756097560975
E01032584,1348,681,667,0.505192878338279,0.4948071216617211
E01032637,1048,528,520,0.5038167938931297,0.4961832061068702
E01032638,1102,597,505,0.5417422867513612,0.45825771324863884
E01032640,1035,569,466,0.5497584541062802,0.4502415458937198
E01032834,1025,541,484,0.5278048780487805,0.4721951219512195
E01033884,1102,605,497,0.5490018148820327,0.45099818511796735
E01003976,2395,1130,1265,0.4718162839248434,0.5281837160751566
E01032646,1515,757,758,0.4996699669966997,0.5003300330033004
E01032803,1506,767,739,0.5092961487383798,0.4907038512616202
E01033885,1330,661,669,0.49699248120300754,0.5030075187969925
E01004125,1609,776,833,0.48228713486637664,0.5177128651336234
E01004183,1775,832,943,0.4687323943661972,0.5312676056338028
E01004184,1705,808,897,0.47390029325513194,0.5260997067448681
E01004185,2117,1020,1097,0.4818138875767596,0.5181861124232404
E01004189,2115,1018,1097,0.4813238770685579,0.518676122931442
E01004123,2279,1093,1186,0.47959631417288284,0.5204036858271172
E01004124,2007,964,1043,0.4803188839063279,0.5196811160936722
E01004126,1567,712,855,0.4543714103382259,0.5456285896617741
E01004128,1447,682,765,0.47131997235659984,0.5286800276434002
E01004129,1888,891,997,0.4719279661016949,0.528072033898305
E01004130,1764,870,894,0.4931972789115646,0.5068027210884354
E01004131,1888,895,993,0.4740466101694915,0.5259533898305084
E01004134,1610,776,834,0.48198757763975153,0.5180124223602485
E01004135,1453,693,760,0.4769442532690984,0.5230557467309016
E01004136,1565,785,780,0.5015974440894568,0.4984025559105431
E01004164,1443,714,729,0.49480249480249483,0.5051975051975052
E01004166,1567,735,832,0.46904913848117424,0.5309508615188258
E01004169,1806,852,954,0.4717607973421927,0.5282392026578073
E01004186,1721,852,869,0.495061011040093,0.5049389889599071
E01034153,1402,681,721,0.48573466476462196,0.514265335235378
E01034154,1536,743,793,0.4837239583333333,0.5162760416666666
E01004127,1844,879,965,0.47668112798264645,0.5233188720173536
E01004163,1729,837,892,0.48409485251590517,0.5159051474840949
E01004165,1779,848,931,0.47667228780213605,0.523327712197864
E01004167,1632,764,868,0.4681372549019608,0.5318627450980392
E01004187,1676,867,809,0.5173031026252983,0.48269689737470167
E01004117,1432,709,723,0.49511173184357543,0.5048882681564246
E01004121,1584,786,798,0.4962121212121212,0.5037878787878788
E01004192,1864,866,998,0.4645922746781116,0.5354077253218884
E01004193,2845,1368,1477,0.48084358523725834,0.5191564147627417
E01004195,1695,819,876,0.4831858407079646,0.5168141592920354
E01004144,1770,890,880,0.5028248587570622,0.4971751412429379
E01004145,2280,1082,1198,0.4745614035087719,0.525438596491228
E01004146,1983,955,1028,0.4815935451336359,0.518406454866364
E01004147,1582,748,834,0.47281921618204803,0.527180783817952
E01004116,1586,757,829,0.47730138713745274,0.5226986128625473
E01004122,1390,689,701,0.4956834532374101,0.50431654676259
E01004190,1387,706,681,0.5090122566690699,0.49098774333093004
E01004191,1886,933,953,0.49469777306468715,0.5053022269353128
E01004194,1596,768,828,0.48120300751879697,0.518796992481203
E01004196,1577,760,817,0.4819277108433735,0.5180722891566265
E01004115,1838,905,933,0.4923830250272035,0.5076169749727966
E01004118,1810,879,931,0.4856353591160221,0.5143646408839779
E01004119,1441,713,728,0.49479528105482307,0.5052047189451769
E01004132,1486,730,756,0.49125168236877526,0.5087483176312247
E01004133,1564,781,783,0.4993606138107417,0.5006393861892583
E01004171,1609,790,819,0.49098819142324424,0.5090118085767558
E01004172,1941,940,1001,0.4842864502833591,0.515713549716641
E01004173,1365,646,719,0.47326007326007324,0.5267399267399268
E01004175,1737,842,895,0.48474381116868165,0.5152561888313184
E01004176,1526,749,777,0.4908256880733945,0.5091743119266054
E01004076,1628,793,835,0.4871007371007371,0.5128992628992629
E01004077,1626,817,809,0.502460024600246,0.497539975399754
E01004078,1763,855,908,0.48496880317640384,0.5150311968235961
E01004079,1391,697,694,0.501078360891445,0.49892163910855497
E01004080,1394,673,721,0.48278335724533716,0.5172166427546628
E01004081,1643,782,861,0.4759586122945831,0.524041387705417
E01004082,1389,678,711,0.48812095032397407,0.5118790496760259
E01004137,2556,1244,1312,0.486697965571205,0.513302034428795
E01004140,1881,936,945,0.49760765550239233,0.5023923444976076
E01004141,1825,858,967,0.47013698630136985,0.5298630136986301
E01004149,1861,905,956,0.4862976894142934,0.5137023105857066
E01034155,2052,967,1085,0.4712475633528265,0.5287524366471735
E01034156,1406,680,726,0.48364153627311524,0.5163584637268848
E01004101,1409,664,745,0.47125621007806956,0.5287437899219305
E01004103,1776,829,947,0.46677927927927926,0.5332207207207207
E01004138,1808,886,922,0.49004424778761063,0.5099557522123894
E01004139,1543,756,787,0.4899546338302009,0.5100453661697991
E01004168,1611,783,828,0.4860335195530726,0.5139664804469274
E01004143,1533,733,800,0.4781474233529028,0.5218525766470972
E01004148,1820,906,914,0.4978021978021978,0.5021978021978022
E01004159,1652,811,841,0.49092009685230026,0.5090799031476998
E01004160,1650,797,853,0.48303030303030303,0.516969696969697
E01004161,1518,704,814,0.463768115942029,0.5362318840579711
E01004097,1656,800,856,0.4830917874396135,0.5169082125603864
E01004098,1298,636,662,0.4899845916795069,0.5100154083204931
E01004099,1617,748,869,0.46258503401360546,0.5374149659863946
E01004100,1527,755,772,0.49443352979698757,0.5055664702030125
E01004102,1515,737,778,0.4864686468646865,0.5135313531353135
E01004110,2039,981,1058,0.4811181951937224,0.5188818048062775
E01004111,1688,795,893,0.4709715639810427,0.5290284360189573
E01004112,1667,796,871,0.47750449910017995,0.52249550089982
E01004120,1514,742,772,0.4900924702774108,0.5099075297225891
E01004157,1296,625,671,0.48225308641975306,0.5177469135802469
E01004087,1565,787,778,0.5028753993610223,0.4971246006389776
E01004170,2207,1083,1124,0.4907113729043951,0.5092886270956049
E01004174,1573,798,775,0.5073108709472346,0.4926891290527654
E01004178,2368,1160,1208,0.48986486486486486,0.5101351351351351
E01004179,1617,803,814,0.4965986394557823,0.5034013605442177
E01004152,1774,823,951,0.46392333709131905,0.536076662908681
E01004155,1906,904,1002,0.47429171038824763,0.5257082896117523
E01004156,2020,979,1041,0.48465346534653464,0.5153465346534654
E01004158,1605,762,843,0.4747663551401869,0.525233644859813
E01004162,1694,815,879,0.48110979929161746,0.5188902007083825
E01004083,1502,712,790,0.474034620505992,0.525965379494008
E01004086,2015,998,1017,0.49528535980148886,0.5047146401985112
E01004088,1939,912,1027,0.4703455389375967,0.5296544610624033
E01004089,1345,631,714,0.4691449814126394,0.5308550185873606
E01004182,1767,852,915,0.48217317487266553,0.5178268251273345
E01004104,1567,759,808,0.4843650287172942,0.5156349712827059
E01004107,1623,762,861,0.46950092421441775,0.5304990757855823
E01004177,1804,781,1023,0.4329268292682927,0.5670731707317073
E01004180,1761,867,894,0.49233390119250425,0.5076660988074957
E01004181,1732,812,920,0.46882217090069284,0.5311778290993071
E01004090,1344,632,712,0.47023809523809523,0.5297619047619048
E01004096,1561,780,781,0.4996796925048046,0.5003203074951954
E01004150,1986,953,1033,0.4798590130916415,0.5201409869083585
E01004151,1966,977,989,0.4969481180061038,0.5030518819938963
E01004153,1928,967,961,0.5015560165975104,0.49844398340248963
E01004091,1282,629,653,0.4906396255850234,0.5093603744149766
E01004092,1507,747,760,0.49568679495686796,0.504313205043132
E01004105,1874,923,951,0.49252934898612594,0.5074706510138741
E01004106,1626,789,837,0.48523985239852396,0.514760147601476
E01004154,1485,763,722,0.5138047138047138,0.4861952861952862
E01004084,1449,699,750,0.4824016563146998,0.5175983436853002
E01004085,1609,786,823,0.4885021752641392,0.5114978247358608
E01004108,1965,994,971,0.505852417302799,0.494147582697201
E01004109,1714,843,871,0.4918319719953326,0.5081680280046674
E01004093,1718,831,887,0.48370197904540163,0.5162980209545984
E01004094,1865,894,971,0.47935656836461127,0.5206434316353887
E01004095,1562,788,774,0.5044814340588989,0.49551856594110116
E01004114,1780,861,919,0.4837078651685393,0.5162921348314606
E01032623,1798,869,929,0.4833147942157953,0.5166852057842046
E01004222,2730,1293,1437,0.4736263736263736,0.5263736263736264
E01004223,2214,1077,1137,0.48644986449864497,0.513550135501355
E01004226,2407,1196,1211,0.4968840880764437,0.5031159119235563
E01035657,1045,539,506,0.5157894736842106,0.4842105263157895
E01035658,1287,649,638,0.5042735042735043,0.49572649572649574
E01035659,1577,716,861,0.4540266328471782,0.5459733671528219
E01004198,1490,712,778,0.4778523489932886,0.5221476510067115
E01004199,1695,829,866,0.48908554572271384,0.5109144542772861
E01004201,1689,788,901,0.4665482534043813,0.5334517465956187
E01035660,1443,725,718,0.5024255024255024,0.49757449757449757
E01035661,1645,746,899,0.4534954407294833,0.5465045592705167
E01004228,1947,956,991,0.49101181304571134,0.5089881869542886
E01004230,2146,976,1170,0.4547996272134203,0.5452003727865797
E01004232,1788,890,898,0.49776286353467564,0.5022371364653244
E01004233,2203,1116,1087,0.5065819337267363,0.49341806627326373
E01004234,2561,1361,1200,0.5314330339711051,0.46856696602889497
E01004229,1419,690,729,0.48625792811839325,0.5137420718816068
E01004231,1646,807,839,0.49027946537059536,0.5097205346294046
E01032764,2361,1185,1176,0.5019059720457433,0.49809402795425667
E01032765,1754,833,921,0.4749144811858609,0.5250855188141391
E01032784,1706,818,888,0.4794841735052755,0.5205158264947245
E01035662,1112,576,536,0.5179856115107914,0.48201438848920863
E01035663,1330,638,692,0.47969924812030074,0.5203007518796993
E01004200,1502,743,759,0.49467376830892146,0.5053262316910786
E01004202,2018,975,1043,0.48315163528245786,0.5168483647175421
E01004203,1808,896,912,0.49557522123893805,0.504424778761062
E01004204,1868,924,944,0.49464668094218417,0.5053533190578159
E01004311,1845,879,966,0.4764227642276423,0.5235772357723577
E01004315,1580,771,809,0.4879746835443038,0.5120253164556962
E01035664,2506,1258,1248,0.5019952114924182,0.4980047885075818
E01004259,1753,876,877,0.4997147746719909,0.5002852253280091
E01004260,1785,879,906,0.492436974789916,0.507563025210084
E01004263,1381,689,692,0.498913830557567,0.501086169442433
E01004266,1452,697,755,0.4800275482093664,0.5199724517906336
E01004235,1312,688,624,0.524390243902439,0.47560975609756095
E01004236,1560,793,767,0.5083333333333333,0.49166666666666664
E01004237,1530,747,783,0.48823529411764705,0.5117647058823529
E01004239,1773,817,956,0.4608009024252679,0.5391990975747321
E01035665,1429,711,718,0.49755073477956613,0.5024492652204339
E01035666,1916,974,942,0.5083507306889353,0.49164926931106473
E01035667,1994,948,1046,0.4754262788365095,0.5245737211634904
E01004312,1522,740,782,0.48620236530880423,0.5137976346911958
E01004313,2125,1054,1071,0.496,0.504
E01004316,1039,546,493,0.5255052935514918,0.47449470644850816
E01035668,2073,1072,1001,0.5171249397009166,0.48287506029908345
E01035669,1384,700,684,0.5057803468208093,0.49421965317919075
E01004264,1441,730,711,0.5065926439972241,0.49340735600277585
E01032785,2516,1263,1253,0.5019872813990461,0.4980127186009539
E01032786,1614,787,827,0.4876084262701363,0.5123915737298637
E01035670,4279,1971,2308,0.4606216405702267,0.5393783594297733
E01004207,1426,716,710,0.5021037868162693,0.49789621318373073
E01004209,1387,676,711,0.48738284066330206,0.5126171593366979
E01004212,2231,1094,1137,0.49036306588973555,0.5096369341102645
E01032787,2454,1238,1216,0.5044824775876121,0.49551752241238795
E01004240,1684,817,867,0.4851543942992874,0.5148456057007126
E01004241,1672,793,879,0.4742822966507177,0.5257177033492823
E01004267,2199,1121,1078,0.5097771714415643,0.49022282855843563
E01004268,1768,921,847,0.5209276018099548,0.47907239819004527
E01035671,2164,1092,1072,0.5046210720887245,0.4953789279112754
E01035672,2954,1455,1499,0.49255247122545703,0.507447528774543
E01035673,1128,562,566,0.49822695035460995,0.50177304964539
E01004205,2203,1151,1052,0.5224693599636859,0.4775306400363141
E01004206,1464,759,705,0.5184426229508197,0.48155737704918034
E01004208,1978,1100,878,0.5561172901921132,0.44388270980788674
E01004211,1629,820,809,0.5033763044812769,0.49662369551872315
E01004270,2420,1258,1162,0.5198347107438016,0.48016528925619834
E01004271,2463,1271,1192,0.5160373528217621,0.48396264717823795
E01004272,2668,1335,1333,0.5003748125937032,0.49962518740629686
E01035674,1390,698,692,0.5021582733812949,0.497841726618705
E01035675,1782,945,837,0.5303030303030303,0.4696969696969697
E01035676,1569,781,788,0.49776927979604846,0.5022307202039515
E01035677,1517,750,767,0.4943968358602505,0.5056031641397495
E01004306,1842,890,952,0.4831704668838219,0.5168295331161781
E01004307,2336,1227,1109,0.5252568493150684,0.4747431506849315
E01004308,1441,749,692,0.5197779319916724,0.48022206800832756
E01004309,2795,1401,1394,0.501252236135957,0.49874776386404296
E01004310,2021,1100,921,0.5442850074220683,0.45571499257793174
E01004283,2184,1078,1106,0.4935897435897436,0.5064102564102564
E01004287,2250,1142,1108,0.5075555555555555,0.49244444444444446
E01004289,1934,966,968,0.49948293691830403,0.500517063081696
E01004290,1974,1016,958,0.5146909827760892,0.48530901722391084
E01004322,1401,711,690,0.5074946466809421,0.4925053533190578
E01004323,1627,843,784,0.5181315304240934,0.48186846957590657
E01004324,1599,826,773,0.5165728580362726,0.4834271419637273
E01004326,1887,900,987,0.4769475357710652,0.5230524642289348
E01004245,2966,1517,1449,0.5114632501685772,0.4885367498314228
E01004248,1888,870,1018,0.4608050847457627,0.5391949152542372
E01004249,2439,1263,1176,0.5178351783517835,0.4821648216482165
E01035678,1937,945,992,0.48786783686112545,0.5121321631388746
E01035679,1601,818,783,0.5109306683322923,0.48906933166770766
E01004286,2477,1214,1263,0.4901090028259992,0.5098909971740008
E01004288,1852,884,968,0.4773218142548596,0.5226781857451404
E01035680,1853,922,931,0.4975715056664868,0.5024284943335132
E01035681,2005,989,1016,0.49326683291770573,0.5067331670822942
E01035682,1481,737,744,0.49763673193787983,0.5023632680621202
E01035683,1832,837,995,0.4568777292576419,0.5431222707423581
E01004243,1553,801,752,0.5157759175788796,0.4842240824211204
E01004244,2049,1061,988,0.5178135675939483,0.48218643240605175
E01004247,2640,1340,1300,0.5075757575757576,0.49242424242424243
E01035684,1569,782,787,0.4984066284257489,0.5015933715742511
E01035685,1474,696,778,0.47218453188602444,0.5278154681139756
E01004319,2506,1274,1232,0.5083798882681564,0.49162011173184356
E01004321,2146,1076,1070,0.5013979496738118,0.49860205032618826
E01032767,1564,918,646,0.5869565217391305,0.41304347826086957
E01035686,1513,771,742,0.5095836087243887,0.4904163912756114
E01035687,1749,906,843,0.5180102915951973,0.48198970840480276
E01035688,1667,827,840,0.49610077984403117,0.5038992201559688
E01035689,1622,829,793,0.5110974106041923,0.48890258939580766
E01004298,1604,802,802,0.5,0.5
E01004300,1450,710,740,0.4896551724137931,0.5103448275862069
E01004304,2136,1099,1037,0.5145131086142322,0.4854868913857678
E01004305,1864,922,942,0.4946351931330472,0.5053648068669528
E01004251,2578,1330,1248,0.5159038013964313,0.4840961986035687
E01004255,1586,832,754,0.5245901639344263,0.47540983606557374
E01004258,1472,797,675,0.5414402173913043,0.4585597826086957
E01035690,2031,1063,968,0.5233874938453964,0.47661250615460365
E01035691,1924,1126,798,0.5852390852390852,0.41476091476091476
E01004256,1688,868,820,0.514218009478673,0.48578199052132703
E01004257,2234,1112,1122,0.4977618621307073,0.5022381378692927
E01035692,1464,718,746,0.49043715846994534,0.5095628415300546
E01035693,1553,760,793,0.489375402446877,0.510624597553123
E01035694,2213,1134,1079,0.5124265702666064,0.48757342973339357
E01035695,1647,826,821,0.5015179113539769,0.49848208864602306
E01004301,1420,738,682,0.5197183098591549,0.4802816901408451
E01004302,1669,865,804,0.518274415817855,0.481725584182145
E01004303,2871,1468,1403,0.511320097526994,0.4886799024730059
E01032768,1321,683,638,0.5170325510976533,0.4829674489023467
E01032769,1339,684,655,0.5108289768483943,0.48917102315160566
E01004292,1672,873,799,0.5221291866028708,0.47787081339712917
E01004295,2003,1002,1001,0.5002496255616575,0.49975037443834247
E01004296,2430,1291,1139,0.531275720164609,0.46872427983539094
E01035696,1185,638,547,0.5383966244725739,0.46160337552742614
E01035697,1675,855,820,0.5104477611940299,0.48955223880597015
E01004291,1911,1013,898,0.5300889586603872,0.46991104133961276
E01004293,1987,1023,964,0.5148465022647207,0.4851534977352793
E01004297,1917,961,956,0.5013041210224308,0.4986958789775691
E01004214,1620,765,855,0.4722222222222222,0.5277777777777778
E01004216,1788,922,866,0.5156599552572707,0.4843400447427293
E01004217,2077,1003,1074,0.48290804044294655,0.5170919595570534
E01004218,1927,931,996,0.48313440581214323,0.5168655941878568
E01004274,1956,941,1015,0.4810838445807771,0.5189161554192229
E01004275,2513,1223,1290,0.4866693195384003,0.5133306804615997
E01004276,2052,1046,1006,0.5097465886939572,0.4902534113060429
E01004281,1991,978,1013,0.491210447011552,0.508789552988448
E01032775,1187,634,553,0.5341196293176074,0.4658803706823926
E01032783,1308,649,659,0.49617737003058104,0.503822629969419
E01004280,1954,981,973,0.5020470829068577,0.49795291709314227
E01032770,2127,1046,1081,0.4917724494593324,0.5082275505406676
E01032772,2407,1118,1289,0.46447860407145825,0.5355213959285418
E01032774,1803,911,892,0.5052689961175818,0.4947310038824182
E01035698,1002,466,536,0.46506986027944114,0.5349301397205589
E01035699,1722,815,907,0.4732868757259001,0.5267131242740999
E01004277,1591,845,746,0.531112507856694,0.4688874921433061
E01032771,1546,805,741,0.5206985769728332,0.4793014230271669
E01032781,1689,879,810,0.5204262877442274,0.47957371225577267
E01032782,2248,1208,1040,0.5373665480427047,0.4626334519572954
E01032776,2067,1093,974,0.528785679729076,0.471214320270924
E01035700,1153,624,529,0.5411968777103209,0.4588031222896791
E01035701,1176,650,526,0.5527210884353742,0.44727891156462585
E01035702,1497,751,746,0.5016700066800267,0.4983299933199733
E01004219,2721,1350,1371,0.4961411245865491,0.503858875413451
E01032777,1278,640,638,0.5007824726134585,0.49921752738654146
E01032779,1404,748,656,0.5327635327635327,0.4672364672364672
E01032780,2058,1118,940,0.543245869776482,0.45675413022351796
E01004221,1975,1031,944,0.5220253164556962,0.4779746835443038
E01035703,1107,546,561,0.4932249322493225,0.5067750677506775
E01035704,1747,839,908,0.48025186033199774,0.5197481396680023
E01035705,1446,725,721,0.5013831258644537,0.49861687413554634
E01035706,1291,671,620,0.5197521301316809,0.48024786986831913
E01004349,1547,759,788,0.4906270200387847,0.5093729799612152
E01004350,1901,934,967,0.49132035770647026,0.5086796422935297
E01004351,1645,805,840,0.48936170212765956,0.5106382978723404
E01004356,1695,830,865,0.4896755162241888,0.5103244837758112
E01004357,1583,773,810,0.4883133291219204,0.5116866708780796
E01004352,1884,923,961,0.48991507430997877,0.5100849256900213
E01004353,1815,854,961,0.47052341597796143,0.5294765840220386
E01004354,1965,951,1014,0.48396946564885496,0.516030534351145
E01004358,1952,947,1005,0.48514344262295084,0.5148565573770492
E01004359,1712,823,889,0.4807242990654206,0.5192757009345794
E01004384,2002,918,1084,0.45854145854145856,0.5414585414585414
E01004385,1534,680,854,0.44328552803129073,0.5567144719687093
E01004386,1698,835,863,0.4917550058892815,0.5082449941107184
E01004389,1731,822,909,0.4748700173310225,0.5251299826689775
E01004390,1600,760,840,0.475,0.525
E01004355,1690,810,880,0.47928994082840237,0.5207100591715976
E01004360,1334,672,662,0.5037481259370314,0.4962518740629685
E01004413,1545,741,804,0.4796116504854369,0.5203883495145631
E01004415,1617,795,822,0.49165120593692024,0.5083487940630798
E01004416,1828,922,906,0.5043763676148797,0.49562363238512036
E01004361,1383,689,694,0.4981923355025307,0.5018076644974693
E01004414,1814,863,951,0.4757442116868798,0.5242557883131201
E01004417,1886,923,963,0.48939554612937436,0.5106044538706257
E01004451,1841,880,961,0.4780010863661054,0.5219989136338946
E01004452,1887,934,953,0.4949655537890832,0.5050344462109168
E01004450,1708,857,851,0.5017564402810304,0.49824355971896955
E01004453,1816,913,903,0.5027533039647577,0.4972466960352423
E01004454,1970,952,1018,0.483248730964467,0.516751269035533
E01004455,1795,891,904,0.4963788300835655,0.5036211699164346
E01004456,1684,799,885,0.4744655581947744,0.5255344418052257
E01004379,1928,936,992,0.4854771784232365,0.5145228215767634
E01004380,1799,897,902,0.49861033907726515,0.5013896609227348
E01004381,1985,997,988,0.5022670025188917,0.49773299748110833
E01004383,1687,816,871,0.4836988737403675,0.5163011262596325
E01004387,1439,695,744,0.4829742876997915,0.5170257123002084
E01004388,1659,814,845,0.49065702230259195,0.5093429776974081
E01004343,1871,908,963,0.4853019775521112,0.5146980224478889
E01004344,1904,928,976,0.48739495798319327,0.5126050420168067
E01004382,1753,806,947,0.4597832287507131,0.5402167712492869
E01004418,1780,836,944,0.4696629213483146,0.5303370786516854
E01004419,2652,1332,1320,0.502262443438914,0.497737556561086
E01004398,2029,983,1046,0.4844751108920651,0.5155248891079349
E01004399,1890,892,998,0.47195767195767196,0.5280423280423281
E01004400,1898,919,979,0.48419388830347737,0.5158061116965227
E01004402,1870,893,977,0.47754010695187166,0.5224598930481283
E01004403,2588,1236,1352,0.4775888717156105,0.5224111282843895
E01004345,1792,881,911,0.4916294642857143,0.5083705357142857
E01004348,2946,1468,1478,0.4983027834351663,0.5016972165648337
E01004377,1837,903,934,0.49156232988568316,0.5084376701143168
E01004378,1849,907,942,0.4905354245538129,0.5094645754461872
E01004342,2091,1005,1086,0.4806312769010043,0.5193687230989957
E01004346,1796,857,939,0.4771714922048998,0.5228285077951003
E01004347,2184,1065,1119,0.4876373626373626,0.5123626373626373
E01004460,2047,1026,1021,0.5012212994626283,0.4987787005373718
E01004462,2354,1131,1223,0.4804587935429057,0.5195412064570943
E01004396,1995,1000,995,0.5012531328320802,0.49874686716791977
E01004457,1907,927,980,0.48610382800209756,0.5138961719979025
E01004458,2038,991,1047,0.486261040235525,0.5137389597644749
E01004459,1668,768,900,0.460431654676259,0.539568345323741
E01004463,2047,939,1108,0.4587200781631656,0.5412799218368344
E01004407,1633,795,838,0.48683404776484995,0.51316595223515
E01004410,1845,892,953,0.4834688346883469,0.5165311653116531
E01004464,1729,815,914,0.47137073452862926,0.5286292654713707
E01004469,1926,897,1029,0.4657320872274143,0.5342679127725857
E01004470,1671,842,829,0.5038898862956314,0.49611011370436864
E01004471,1776,881,895,0.49605855855855857,0.5039414414414415
E01004391,2324,1024,1300,0.4406196213425129,0.5593803786574871
E01004393,1691,821,870,0.48551153163808397,0.514488468361916
E01004401,2368,1186,1182,0.5008445945945946,0.49915540540540543
E01004404,2854,1351,1503,0.4733707077785564,0.5266292922214436
E01034485,2015,1018,997,0.5052109181141439,0.4947890818858561
E01034486,1652,798,854,0.4830508474576271,0.5169491525423728
E01004412,1787,848,939,0.4745383324006715,0.5254616675993284
E01004465,1607,800,807,0.49782202862476665,0.5021779713752333
E01004466,1719,804,915,0.4677137870855148,0.5322862129144852
E01004467,2355,1120,1235,0.47558386411889597,0.524416135881104
E01004468,1779,878,901,0.49353569421023047,0.5064643057897695
E01004406,1846,942,904,0.5102925243770314,0.48970747562296857
E01004408,1732,832,900,0.48036951501154734,0.5196304849884527
E01004409,1774,825,949,0.4650507328072153,0.5349492671927847
E01004411,1981,977,1004,0.49318525996971224,0.5068147400302877
E01004443,2235,1140,1095,0.5100671140939598,0.4899328859060403
E01004447,1862,930,932,0.49946294307196565,0.5005370569280344
E01004392,2565,1275,1290,0.49707602339181284,0.5029239766081871
E01004394,2003,975,1028,0.4867698452321518,0.5132301547678483
E01004397,2907,1441,1466,0.4957000343997248,0.5042999656002752
E01004444,2820,1394,1426,0.49432624113475176,0.5056737588652482
E01004446,2668,1260,1408,0.47226386806596704,0.527736131934033
E01004395,1700,832,868,0.4894117647058824,0.5105882352941177
E01004421,2132,1102,1030,0.5168855534709194,0.4831144465290807
E01004445,2087,1039,1048,0.49784379492093916,0.5021562050790609
E01004448,1931,953,978,0.4935266701191093,0.5064733298808908
E01004449,1892,897,995,0.4741014799154334,0.5258985200845666
E01004363,1666,834,832,0.5006002400960384,0.49939975990396157
E01004364,1984,972,1012,0.4899193548387097,0.5100806451612904
E01004366,1936,976,960,0.5041322314049587,0.49586776859504134
E01004367,1607,844,763,0.5252022401991289,0.4747977598008712
E01004368,2449,1240,1209,0.5063291139240507,0.4936708860759494
E01004365,2542,1286,1256,0.5059008654602675,0.4940991345397325
E01004405,1716,857,859,0.4994172494172494,0.5005827505827506
E01004420,2260,1186,1074,0.5247787610619469,0.47522123893805307
E01004423,2102,1069,1033,0.5085632730732635,0.49143672692673646
E01034487,1254,579,675,0.46172248803827753,0.5382775119617225
E01034488,1925,931,994,0.48363636363636364,0.5163636363636364
E01004362,1608,798,810,0.4962686567164179,0.503731343283582
E01004436,1531,723,808,0.4722403657740039,0.527759634225996
E01004437,1792,890,902,0.4966517857142857,0.5033482142857143
E01004439,1636,779,857,0.47616136919315405,0.523838630806846
E01004442,1544,778,766,0.5038860103626943,0.4961139896373057
E01004422,2648,1339,1309,0.5056646525679759,0.4943353474320242
E01004424,2120,1055,1065,0.49764150943396224,0.5023584905660378
E01004425,1989,965,1024,0.48516842634489693,0.514831573655103
E01004426,1831,893,938,0.4877116329874386,0.5122883670125614
E01004427,1975,990,985,0.5012658227848101,0.49873417721518987
E01004369,1757,843,914,0.47979510529311326,0.5202048947068867
E01004370,2105,999,1106,0.47458432304038006,0.52541567695962
E01004372,1645,805,840,0.48936170212765956,0.5106382978723404
E01004432,1933,948,985,0.49042938437661665,0.5095706156233833
E01004435,2149,1080,1069,0.5025593299208935,0.4974406700791066
E01004333,1696,850,846,0.5011792452830188,0.4988207547169811
E01004334,1892,1079,813,0.5702959830866807,0.4297040169133192
E01004438,2142,1064,1078,0.49673202614379086,0.5032679738562091
E01004440,2066,1014,1052,0.49080348499515974,0.5091965150048403
E01004441,1527,768,759,0.5029469548133595,0.49705304518664045
E01004371,1647,813,834,0.4936247723132969,0.5063752276867031
E01004373,1800,925,875,0.5138888888888888,0.4861111111111111
E01004374,1967,962,1005,0.48906964921199797,0.5109303507880021
E01004375,1933,930,1003,0.4811174340403518,0.5188825659596482
E01004376,1891,972,919,0.514013749338974,0.4859862506610259
E01004336,1555,821,734,0.5279742765273312,0.4720257234726688
E01004428,2091,961,1130,0.45958871353419417,0.5404112864658058
E01004429,1832,879,953,0.4798034934497817,0.5201965065502183
E01004430,2678,1364,1314,0.5093353248693054,0.49066467513069456
E01004434,2146,1050,1096,0.48928238583411,0.51071761416589
E01004335,1740,802,938,0.46091954022988507,0.539080459770115
E01004337,1741,853,888,0.48994830557151064,0.5100516944284894
E01004338,2020,1073,947,0.5311881188118812,0.4688118811881188
E01004339,1881,954,927,0.507177033492823,0.49282296650717705
E01004340,1880,896,984,0.4765957446808511,0.5234042553191489
E01004341,1935,1004,931,0.5188630490956072,0.4811369509043928
E01004327,1506,686,820,0.4555112881806109,0.5444887118193891
E01004328,1868,948,920,0.5074946466809421,0.4925053533190578
E01004329,1810,902,908,0.4983425414364641,0.5016574585635359
E01004330,1677,806,871,0.4806201550387597,0.5193798449612403
E01004331,1657,821,836,0.49547374773687386,0.5045262522631261
E01004332,1945,1032,913,0.5305912596401028,0.46940874035989716
E01004560,1934,934,1000,0.48293691830403307,0.5170630816959669
E01004566,1681,801,880,0.4765020820939917,0.5234979179060083
E01004582,2203,1077,1126,0.4888788016341353,0.5111211983658648
E01004583,1710,761,949,0.4450292397660819,0.5549707602339181
E01004539,2092,992,1100,0.47418738049713194,0.5258126195028681
E01004540,2234,1070,1164,0.4789615040286482,0.5210384959713519
E01004577,1848,862,986,0.46645021645021645,0.5335497835497836
E01004584,1726,773,953,0.447856315179606,0.552143684820394
E01004579,1871,917,954,0.4901122394441475,0.5098877605558525
E01004580,2114,956,1158,0.4522232734153264,0.5477767265846736
E01004581,1781,795,986,0.446378439079169,0.553621560920831
E01033099,1886,880,1006,0.46659597030752914,0.5334040296924708
E01033133,1194,623,571,0.5217755443886097,0.47822445561139026
E01035488,1465,737,728,0.5030716723549488,0.4969283276450512
E01035489,1329,657,672,0.49435665914221216,0.5056433408577878
E01004565,1663,779,884,0.46843054720384847,0.5315694527961515
E01004590,1850,919,931,0.49675675675675673,0.5032432432432432
E01004591,1901,894,1007,0.4702788006312467,0.5297211993687533
E01004592,1685,780,905,0.4629080118694362,0.5370919881305638
E01004604,1561,747,814,0.478539397821909,0.521460602178091
E01004605,1822,854,968,0.46871569703622395,0.531284302963776
E01004606,1674,810,864,0.4838709677419355,0.5161290322580645
E01004607,1629,748,881,0.45917740945365254,0.5408225905463474
E01004608,1669,788,881,0.4721390053924506,0.5278609946075494
E01004535,1857,838,1019,0.45126548196015076,0.5487345180398492
E01004537,2070,965,1105,0.46618357487922707,0.533816425120773
E01004538,2478,1199,1279,0.4838579499596449,0.5161420500403551
E01004541,1697,772,925,0.45492044784914554,0.5450795521508545
E01004534,1920,869,1051,0.45260416666666664,0.5473958333333333
E01004536,2350,1115,1235,0.474468085106383,0.5255319148936171
E01004552,1972,960,1012,0.486815415821501,0.513184584178499
E01004585,1826,814,1012,0.4457831325301205,0.5542168674698795
E01004588,2014,987,1027,0.4900695134061569,0.5099304865938431
E01004554,1657,830,827,0.5009052504526252,0.49909474954737476
E01004556,1646,802,844,0.48724179829890646,0.5127582017010935
E01004586,1897,905,992,0.47706905640484976,0.5229309435951502
E01004587,1820,898,922,0.49340659340659343,0.5065934065934066
E01004589,1798,891,907,0.4955506117908788,0.5044493882091212
E01004511,1591,742,849,0.4663733500942803,0.5336266499057196
E01004602,1647,802,845,0.4869459623557984,0.5130540376442015
E01004609,2136,992,1144,0.46441947565543074,0.5355805243445693
E01033135,1188,568,620,0.4781144781144781,0.5218855218855218
E01035490,1704,842,862,0.49413145539906106,0.505868544600939
E01035491,1238,597,641,0.48222940226171246,0.5177705977382876
E01035492,1686,848,838,0.5029655990510083,0.4970344009489917
E01035493,1653,781,872,0.4724742891712039,0.5275257108287962
E01004506,2216,1047,1169,0.47247292418772563,0.5275270758122743
E01004638,1375,644,731,0.46836363636363637,0.5316363636363637
E01004639,1707,815,892,0.4774458113649678,0.5225541886350322
E01004640,1680,800,880,0.47619047619047616,0.5238095238095238
E01004641,1888,845,1043,0.4475635593220339,0.5524364406779662
E01004508,2002,989,1013,0.494005994005994,0.505994005994006
E01004510,1843,887,956,0.4812805208898535,0.5187194791101465
E01004514,1822,886,936,0.4862788144895719,0.5137211855104281
E01004515,1684,750,934,0.44536817102137766,0.5546318289786223
E01004551,1567,727,840,0.4639438417358009,0.5360561582641991
E01004568,1763,714,1049,0.40499149177538285,0.5950085082246171
E01004574,2116,916,1200,0.43289224952741023,0.5671077504725898
E01004575,1888,930,958,0.4925847457627119,0.5074152542372882
E01004576,1606,775,831,0.4825653798256538,0.5174346201743462
E01004500,1927,917,1010,0.47586922677737414,0.5241307732226258
E01004501,1534,669,865,0.4361147327249022,0.5638852672750978
E01004503,1702,785,917,0.4612220916568743,0.5387779083431258
E01004505,1618,746,872,0.4610630407911001,0.5389369592088998
E01004507,2585,1220,1365,0.47195357833655704,0.528046421663443
E01004553,1764,838,926,0.47505668934240364,0.5249433106575964
E01004557,1728,816,912,0.4722222222222222,0.5277777777777778
E01004558,1845,895,950,0.48509485094850946,0.5149051490514905
E01004559,1468,670,798,0.4564032697547684,0.5435967302452316
E01004619,1356,645,711,0.4756637168141593,0.5243362831858407
E01004572,1684,809,875,0.4804038004750594,0.5195961995249406
E01004642,2111,989,1122,0.46849834201800095,0.531501657981999
E01004643,2351,1075,1276,0.4572522330923012,0.5427477669076989
E01004644,2506,1168,1338,0.46608140462889064,0.5339185953711093
E01004645,2114,1001,1113,0.4735099337748344,0.5264900662251656
E01004477,1658,821,837,0.4951749095295537,0.5048250904704463
E01004478,1564,767,797,0.4904092071611253,0.5095907928388747
E01004479,1512,745,767,0.49272486772486773,0.5072751322751323
E01004550,1361,633,728,0.4650991917707568,0.5349008082292432
E01004555,1724,850,874,0.49303944315545245,0.5069605568445475
E01004494,1785,865,920,0.484593837535014,0.5154061624649859
E01004513,1931,934,997,0.48368720870015536,0.5163127912998446
E01004601,2464,1192,1272,0.4837662337662338,0.5162337662337663
E01035494,1799,855,944,0.4752640355753196,0.5247359644246804
E01035495,1345,658,687,0.48921933085501856,0.5107806691449814
E01004493,1946,853,1093,0.43833504624871533,0.5616649537512847
E01004512,1454,709,745,0.48762035763411277,0.5123796423658872
E01004620,1696,842,854,0.4964622641509434,0.5035377358490566
E01004621,1719,828,891,0.4816753926701571,0.518324607329843
E01004623,1772,838,934,0.4729119638826185,0.5270880361173815
E01004627,1588,745,843,0.46914357682619645,0.5308564231738035
E01004499,1610,752,858,0.4670807453416149,0.5329192546583851
E01004502,1641,786,855,0.4789762340036563,0.5210237659963437
E01004504,1525,795,730,0.521311475409836,0.4786885245901639
E01004594,1701,783,918,0.4603174603174603,0.5396825396825397
E01004596,1617,778,839,0.4811379097093383,0.5188620902906618
E01004629,1593,763,830,0.47897049591964846,0.5210295040803515
E01004472,1782,855,927,0.4797979797979798,0.5202020202020202
E01004474,2018,946,1072,0.46878097125867196,0.5312190287413281
E01004476,1811,847,964,0.4676974047487576,0.5323025952512425
E01004542,1572,755,817,0.4802798982188295,0.5197201017811705
E01004544,1537,700,837,0.4554326610279766,0.5445673389720235
E01004628,2340,1199,1141,0.5123931623931623,0.4876068376068376
E01004630,1759,782,977,0.4445707788516202,0.5554292211483798
E01004631,1884,879,1005,0.46656050955414013,0.5334394904458599
E01004633,1655,756,899,0.456797583081571,0.543202416918429
E01004569,2382,1106,1276,0.4643157010915197,0.5356842989084802
E01004570,1931,907,1024,0.46970481615743137,0.5302951838425686
E01004571,1845,892,953,0.4834688346883469,0.5165311653116531
E01004573,1685,823,862,0.4884272997032641,0.511572700296736
E01004495,1585,728,857,0.45930599369085173,0.5406940063091482
E01004496,1930,903,1027,0.4678756476683938,0.5321243523316063
E01004497,1498,714,784,0.4766355140186916,0.5233644859813084
E01004622,1848,1272,576,0.6883116883116883,0.3116883116883117
E01004624,1574,752,822,0.4777636594663278,0.5222363405336722
E01004593,1938,912,1026,0.47058823529411764,0.5294117647058824
E01004595,1801,818,983,0.45419211549139366,0.5458078845086063
E01004597,1889,872,1017,0.46161990471148756,0.5383800952885125
E01004598,2146,1037,1109,0.4832246039142591,0.516775396085741
E01004599,1566,741,825,0.4731800766283525,0.5268199233716475
E01004473,1773,846,927,0.47715736040609136,0.5228426395939086
E01004475,1510,750,760,0.4966887417218543,0.5033112582781457
E01004480,1721,805,916,0.46775130737943055,0.5322486926205694
E01004483,2101,963,1138,0.4583531651594479,0.5416468348405521
E01004484,1495,702,793,0.46956521739130436,0.5304347826086957
E01004486,1425,703,722,0.49333333333333335,0.5066666666666667
E01004543,1743,829,914,0.47561675272518644,0.5243832472748136
E01004545,1937,893,1044,0.4610221992772328,0.5389778007227671
E01004546,1500,692,808,0.4613333333333333,0.5386666666666666
E01004549,1660,781,879,0.47048192771084335,0.5295180722891566
E01004625,1314,626,688,0.4764079147640791,0.5235920852359208
E01004626,1846,882,964,0.47778981581798485,0.5222101841820151
E01004632,1515,710,805,0.46864686468646866,0.5313531353135313
E01004634,1480,672,808,0.4540540540540541,0.5459459459459459
E01004635,1662,806,856,0.48495788206979545,0.5150421179302046
E01004636,1463,698,765,0.47710184552289814,0.5228981544771019
E01004637,1465,703,762,0.47986348122866895,0.520136518771331
E01004481,1640,728,912,0.44390243902439025,0.5560975609756098
E01004488,1331,616,715,0.4628099173553719,0.5371900826446281
E01004547,1424,664,760,0.46629213483146065,0.5337078651685393
E01004548,2036,987,1049,0.48477406679764246,0.5152259332023575
E01004482,1557,717,840,0.4605009633911368,0.5394990366088632
E01004485,1733,806,927,0.46508944027697635,0.5349105597230237
E01004487,1492,723,769,0.48458445040214476,0.5154155495978552
E01004489,1366,635,731,0.46486090775988287,0.5351390922401171
E01004490,1569,741,828,0.4722753346080306,0.5277246653919694
E01004491,2509,1064,1445,0.42407333599043445,0.5759266640095656
E01004492,1740,789,951,0.453448275862069,0.5465517241379311
E01004498,1687,798,889,0.4730290456431535,0.5269709543568465
E01004532,1441,647,794,0.4489937543372658,0.5510062456627343
E01004611,1547,709,838,0.45830639948287005,0.5416936005171299
E01004612,1602,769,833,0.48002496878901374,0.5199750312109863
E01004618,1510,700,810,0.46357615894039733,0.5364238410596026
E01004531,1763,793,970,0.4498014747589336,0.5501985252410664
E01004533,1448,658,790,0.4544198895027624,0.5455801104972375
E01004610,1984,960,1024,0.4838709677419355,0.5161290322580645
E01004613,1694,830,864,0.4899645808736718,0.5100354191263282
E01004614,1971,911,1060,0.4622019279553526,0.5377980720446474
E01004615,1645,741,904,0.45045592705167176,0.5495440729483283
E01004616,1896,837,1059,0.44145569620253167,0.5585443037974683
E01004617,1909,887,1022,0.464641173389209,0.535358826610791
E01004525,1926,932,994,0.48390446521287644,0.5160955347871236
E01004526,1775,849,926,0.4783098591549296,0.5216901408450704
E01004527,1659,762,897,0.4593128390596745,0.5406871609403255
E01004528,1653,787,866,0.47610405323653965,0.5238959467634604
E01004529,2103,968,1135,0.4602948169281978,0.5397051830718022
E01004530,1745,892,853,0.5111747851002866,0.4888252148997135
E01004516,1746,841,905,0.4816723940435281,0.518327605956472
E01004518,1734,849,885,0.48961937716262977,0.5103806228373703
E01004519,1756,827,929,0.47095671981776766,0.5290432801822323
E01004520,1403,645,758,0.4597291518175339,0.5402708481824662
E01004523,1637,797,840,0.4868662186927306,0.5131337813072694
E01004517,2262,1129,1133,0.4991158267020336,0.5008841732979664
E01004521,2036,958,1078,0.47053045186640474,0.5294695481335953
E01004522,1729,845,884,0.48872180451127817,0.5112781954887218
E01004524,1838,824,1014,0.44831338411316646,0.5516866158868335
E01033098,1709,838,871,0.4903452311293154,0.5096547688706846
E01033132,2036,1008,1028,0.4950884086444008,0.5049115913555993
E01035496,1255,660,595,0.5258964143426295,0.47410358565737054
E01035497,1492,685,807,0.45911528150134046,0.5408847184986595
E01035498,1216,615,601,0.5057565789473685,0.4942434210526316
E01004563,2179,1049,1130,0.48141349242771914,0.5185865075722809
E01004564,1872,877,995,0.468482905982906,0.531517094017094
E01004567,2365,1110,1255,0.4693446088794926,0.5306553911205074
E01033100,1870,884,986,0.4727272727272727,0.5272727272727272
E01035499,1604,722,882,0.45012468827930174,0.5498753117206983
E01004647,1393,627,766,0.4501076812634602,0.5498923187365399
E01004649,1410,643,767,0.45602836879432623,0.5439716312056737
E01004724,1892,943,949,0.49841437632135305,0.5015856236786469
E01004730,1461,652,809,0.4462696783025325,0.5537303216974675
E01004646,1721,828,893,0.4811156304474143,0.5188843695525857
E01004648,2322,1114,1208,0.4797588285960379,0.5202411714039621
E01004650,1816,858,958,0.4724669603524229,0.5275330396475771
E01004710,1953,964,989,0.4935995903737839,0.5064004096262161
E01004711,2000,931,1069,0.4655,0.5345
E01004651,1775,835,940,0.4704225352112676,0.5295774647887324
E01004725,1295,585,710,0.4517374517374517,0.5482625482625483
E01004726,1689,788,901,0.4665482534043813,0.5334517465956187
E01004728,1454,681,773,0.468363136176066,0.5316368638239339
E01004729,1490,697,793,0.4677852348993289,0.5322147651006711
E01004718,1859,853,1006,0.4588488434642281,0.541151156535772
E01004719,1824,837,987,0.4588815789473684,0.5411184210526315
E01004720,2274,1072,1202,0.4714160070360598,0.5285839929639402
E01004721,1880,877,1003,0.4664893617021277,0.5335106382978724
E01004722,2685,1335,1350,0.4972067039106145,0.5027932960893855
E01004674,1902,897,1005,0.471608832807571,0.5283911671924291
E01004675,2352,1129,1223,0.4800170068027211,0.5199829931972789
E01004677,1717,739,978,0.4304018637157833,0.5695981362842166
E01004678,1963,950,1013,0.48395313295975545,0.5160468670402445
E01004679,1975,907,1068,0.45924050632911395,0.540759493670886
E01004723,2234,1028,1206,0.4601611459265891,0.5398388540734109
E01004676,1498,719,779,0.47997329773030706,0.5200267022696929
E01004706,1475,680,795,0.4610169491525424,0.5389830508474577
E01004707,1841,928,913,0.5040738728951657,0.4959261271048343
E01004708,1539,726,813,0.47173489278752434,0.5282651072124757
E01004756,1523,738,785,0.48456992777413,0.51543007222587
E01004701,1540,738,802,0.4792207792207792,0.5207792207792208
E01004703,1994,934,1060,0.4684052156469408,0.5315947843530592
E01004705,1242,648,594,0.5217391304347826,0.4782608695652174
E01004709,1694,814,880,0.4805194805194805,0.5194805194805194
E01035715,2780,1360,1420,0.4892086330935252,0.5107913669064749
E01004659,1634,794,840,0.48592411260709917,0.5140758873929009
E01004660,1431,663,768,0.46331236897274636,0.5366876310272537
E01004712,1449,727,722,0.5017253278122843,0.49827467218771565
E01004727,1545,726,819,0.46990291262135925,0.5300970873786408
E01004670,2712,1245,1467,0.459070796460177,0.540929203539823
E01004702,2805,1289,1516,0.45953654188948306,0.5404634581105169
E01033598,1366,592,774,0.4333821376281113,0.5666178623718887
E01033601,1980,1024,956,0.5171717171717172,0.48282828282828283
E01033602,1527,677,850,0.44335297969875576,0.5566470203012442
E01033603,1266,619,647,0.48894154818325436,0.5110584518167457
E01033604,1181,626,555,0.5300592718035563,0.46994072819644367
E01033605,1640,795,845,0.4847560975609756,0.5152439024390244
E01004754,1878,858,1020,0.45686900958466453,0.5431309904153354
E01004755,2453,1203,1250,0.49041989400733793,0.509580105992662
E01004757,1657,763,894,0.4604707302353651,0.5395292697646349
E01032512,2386,1105,1281,0.4631181894383906,0.5368818105616094
E01032513,1233,570,663,0.46228710462287104,0.537712895377129
E01004713,1315,675,640,0.5133079847908745,0.4866920152091255
E01004714,1668,820,848,0.49160671462829736,0.5083932853717026
E01004716,1042,500,542,0.4798464491362764,0.5201535508637236
E01004717,1262,575,687,0.45562599049128366,0.5443740095087163
E01004762,1549,802,747,0.5177533892834086,0.48224661071659136
E01004657,1214,661,553,0.5444810543657331,0.45551894563426687
E01004658,1523,811,712,0.5325016414970453,0.4674983585029547
E01004661,1998,973,1025,0.486986986986987,0.513013013013013
E01004662,1320,687,633,0.5204545454545455,0.47954545454545455
E01004663,1418,726,692,0.5119887165021156,0.48801128349788436
E01004715,1805,919,886,0.5091412742382272,0.49085872576177286
E01004763,2016,1039,977,0.5153769841269841,0.48462301587301587
E01004765,1868,937,931,0.5016059957173448,0.49839400428265523
E01035716,2190,1156,1034,0.5278538812785388,0.47214611872146117
E01004653,1958,1051,907,0.5367722165474974,0.46322778345250254
E01004654,2448,1175,1273,0.47998366013071897,0.5200163398692811
E01004656,1967,977,990,0.49669547534316216,0.5033045246568378
E01004760,1686,815,871,0.4833926453143535,0.5166073546856464
E01035717,1895,842,1053,0.44432717678100264,0.5556728232189974
E01004680,1242,594,648,0.4782608695652174,0.5217391304347826
E01004683,1491,746,745,0.500335345405768,0.49966465459423204
E01004684,1341,692,649,0.5160328113348247,0.48396718866517524
E01004686,1399,736,663,0.5260900643316655,0.4739099356683345
E01033593,1732,853,879,0.4924942263279446,0.5075057736720554
E01033594,1500,681,819,0.454,0.546
E01004681,1838,926,912,0.5038084874863983,0.4961915125136017
E01004682,1279,681,598,0.5324472243940579,0.46755277560594216
E01004694,1471,727,744,0.49422161794697483,0.5057783820530252
E01004697,1343,645,698,0.4802680565897245,0.5197319434102755
E01004700,1484,729,755,0.4912398921832884,0.5087601078167115
E01004652,1615,762,853,0.4718266253869969,0.5281733746130031
E01004693,1211,597,614,0.4929810074318745,0.5070189925681255
E01004695,1071,500,571,0.4668534080298786,0.5331465919701214
E01004696,1445,667,778,0.4615916955017301,0.5384083044982699
E01004698,1334,678,656,0.5082458770614693,0.4917541229385307
E01004699,1754,874,880,0.4982896237172178,0.5017103762827823
E01004734,1691,949,742,0.5612063867534004,0.43879361324659966
E01004735,2024,981,1043,0.48468379446640314,0.5153162055335968
E01004736,1465,857,608,0.5849829351535836,0.4150170648464164
E01004761,1207,622,585,0.5153272576636289,0.48467274233637114
E01004687,1319,575,744,0.4359363153904473,0.5640636846095527
E01004690,1065,478,587,0.4488262910798122,0.5511737089201878
E01004691,1151,510,641,0.4430929626411816,0.5569070373588184
E01004692,1025,489,536,0.4770731707317073,0.5229268292682927
E01035718,2566,1305,1261,0.5085736554949337,0.4914263445050662
E01004731,2003,999,1004,0.4987518721917124,0.5012481278082875
E01004732,1311,637,674,0.4858886346300534,0.5141113653699466
E01004733,2102,1074,1028,0.510941960038059,0.489058039961941
E01004744,1455,664,791,0.4563573883161512,0.5436426116838488
E01004748,1218,582,636,0.47783251231527096,0.5221674876847291
E01004740,1304,654,650,0.5015337423312883,0.49846625766871167
E01004743,1500,723,777,0.482,0.518
E01004746,1249,566,683,0.45316253002401924,0.5468374699759808
E01004747,2181,1099,1082,0.5038972948188905,0.4961027051811096
E01035719,1271,626,645,0.4925255704169945,0.5074744295830055
E01035720,1215,578,637,0.4757201646090535,0.5242798353909465
E01004742,1258,633,625,0.5031796502384738,0.4968203497615262
E01004749,2184,1080,1104,0.4945054945054945,0.5054945054945055
E01004751,1712,955,757,0.5578271028037384,0.4421728971962617
E01004752,1362,639,723,0.46916299559471364,0.5308370044052864
E01004753,1755,922,833,0.5253561253561253,0.47464387464387464
E01004668,1421,681,740,0.4792399718508093,0.5207600281491908
E01004750,1583,732,851,0.4624131396083386,0.5375868603916614
E01033597,1006,495,511,0.49204771371769385,0.5079522862823062
E01033599,1301,545,756,0.4189085318985396,0.5810914681014604
E01035721,2327,1032,1295,0.44348947142243234,0.5565105285775677
E01004665,1453,703,750,0.48382656572608396,0.516173434273916
E01004669,1721,810,911,0.4706565950029053,0.5293434049970948
E01004737,1218,567,651,0.46551724137931033,0.5344827586206896
E01004741,1288,651,637,0.5054347826086957,0.4945652173913043
E01035722,2015,932,1083,0.46253101736972707,0.537468982630273
E01016070,1684,831,853,0.49346793349168644,0.5065320665083135
E01016071,1730,841,889,0.4861271676300578,0.5138728323699422
E01016072,1322,627,695,0.4742813918305598,0.5257186081694403
E01016074,2038,980,1058,0.48086359175662413,0.5191364082433758
E01016142,1343,674,669,0.501861504095309,0.498138495904691
E01016144,1475,761,714,0.5159322033898305,0.48406779661016947
E01016145,1379,661,718,0.47933284989122554,0.5206671501087745
E01016149,1526,767,759,0.5026212319790302,0.49737876802096986
E01016073,2242,1108,1134,0.49420160570918825,0.5057983942908117
E01016075,1729,837,892,0.48409485251590517,0.5159051474840949
E01016077,1598,744,854,0.4655819774718398,0.5344180225281602
E01016143,2990,1435,1555,0.479933110367893,0.520066889632107
E01035286,1744,860,884,0.49311926605504586,0.5068807339449541
E01035287,1842,872,970,0.4733984799131379,0.5266015200868621
E01016147,1954,952,1002,0.4872057318321392,0.5127942681678608
E01016148,2185,1074,1111,0.49153318077803204,0.508466819221968
E01035288,1412,658,754,0.4660056657223796,0.5339943342776204
E01035289,1528,754,774,0.49345549738219896,0.506544502617801
E01016133,1390,679,711,0.48848920863309353,0.5115107913669065
E01016134,1405,676,729,0.4811387900355872,0.5188612099644128
E01016138,1494,726,768,0.4859437751004016,0.5140562248995983
E01016139,1679,844,835,0.5026801667659321,0.4973198332340679
E01016135,1609,767,842,0.4766935985083903,0.5233064014916097
E01016136,1716,822,894,0.479020979020979,0.5209790209790209
E01016137,1590,763,827,0.479874213836478,0.520125786163522
E01016140,1521,754,767,0.49572649572649574,0.5042735042735043
E01016141,1799,901,898,0.5008337965536409,0.4991662034463591
E01016035,1961,970,991,0.4946455889852116,0.5053544110147884
E01035290,1841,926,915,0.5029875067897882,0.49701249321021185
E01035291,1832,889,943,0.48526200873362446,0.5147379912663755
E01035292,2125,1302,823,0.6127058823529412,0.38729411764705884
E01035293,1643,826,817,0.5027388922702374,0.4972611077297626
E01016151,1703,830,873,0.4873752201996477,0.5126247798003524
E01016152,1562,770,792,0.49295774647887325,0.5070422535211268
E01016153,1563,731,832,0.4676903390914907,0.5323096609085093
E01016155,1664,792,872,0.47596153846153844,0.5240384615384616
E01016033,1279,636,643,0.49726348709929635,0.5027365129007036
E01016037,1716,879,837,0.5122377622377622,0.48776223776223776
E01016039,1694,838,856,0.4946871310507674,0.5053128689492326
E01035294,1717,917,800,0.5340710541642399,0.46592894583576006
E01035295,1629,816,813,0.5009208103130756,0.4990791896869245
E01016030,1886,880,1006,0.46659597030752914,0.5334040296924708
E01016032,1349,618,731,0.458117123795404,0.541882876204596
E01016034,2541,1259,1282,0.49547422274695,0.50452577725305
E01016038,1609,794,815,0.4934742075823493,0.5065257924176507
E01016150,1804,833,971,0.46175166297117515,0.5382483370288248
E01016154,1732,883,849,0.5098152424942263,0.49018475750577367
E01016156,1706,839,867,0.4917936694021102,0.5082063305978898
E01016157,2419,1198,1221,0.49524596940884663,0.5047540305911534
E01016158,2417,1159,1258,0.4795200661977658,0.5204799338022342
E01016031,1797,862,935,0.4796883695047301,0.5203116304952699
E01016041,1768,870,898,0.4920814479638009,0.5079185520361991
E01016045,1686,831,855,0.4928825622775801,0.5071174377224199
E01016049,2109,1040,1069,0.49312470365101946,0.5068752963489805
E01016040,1821,897,924,0.4925864909390445,0.5074135090609555
E01016042,1469,713,756,0.4853641933287951,0.5146358066712049
E01016043,1455,720,735,0.4948453608247423,0.5051546391752577
E01016177,1538,755,783,0.4908972691807542,0.5091027308192457
E01016178,1481,721,760,0.48683322079675895,0.513166779203241
E01016117,1958,955,1003,0.4877425944841675,0.5122574055158324
E01016129,1977,946,1031,0.47850278199291857,0.5214972180070815
E01016130,1827,921,906,0.5041050903119869,0.49589490968801314
E01016131,1698,803,895,0.47290930506478207,0.5270906949352179
E01016016,1510,726,784,0.48079470198675495,0.519205298013245
E01016017,1697,898,799,0.5291691219799647,0.47083087802003537
E01016019,1868,944,924,0.5053533190578159,0.49464668094218417
E01016111,1763,912,851,0.5173000567214975,0.4826999432785026
E01035296,1584,730,854,0.46085858585858586,0.5391414141414141
E01035297,1497,749,748,0.5003340013360054,0.49966599866399464
E01016044,1775,876,899,0.49352112676056337,0.5064788732394366
E01016046,1612,810,802,0.5024813895781638,0.4975186104218362
E01016047,1772,853,919,0.4813769751693002,0.5186230248306998
E01016048,1719,831,888,0.48342059336823734,0.5165794066317626
E01016113,1492,740,752,0.4959785522788204,0.5040214477211796
E01016114,1554,752,802,0.4839124839124839,0.5160875160875161
E01016115,1984,946,1038,0.47681451612903225,0.5231854838709677
E01016118,1751,865,886,0.49400342661336377,0.5059965733866362
E01016160,1536,723,813,0.470703125,0.529296875
E01016161,1596,745,851,0.4667919799498747,0.5332080200501254
E01016162,1651,810,841,0.49061175045427013,0.5093882495457298
E01016163,1332,672,660,0.5045045045045045,0.4954954954954955
E01016164,1479,694,785,0.46923597025016905,0.530764029749831
E01016165,1266,622,644,0.4913112164296998,0.5086887835703001
E01016159,1510,694,816,0.4596026490066225,0.5403973509933775
E01016174,1487,707,780,0.4754539340954943,0.5245460659045057
E01016175,1959,941,1018,0.48034711587544665,0.5196528841245533
E01016179,1328,654,674,0.4924698795180723,0.5075301204819277
E01016061,1695,824,871,0.4861356932153392,0.5138643067846608
E01016063,1638,814,824,0.49694749694749696,0.503052503052503
E01016064,1709,854,855,0.49970743124634287,0.5002925687536571
E01016069,1762,894,868,0.5073779795686719,0.492622020431328
E01016020,1287,626,661,0.4864024864024864,0.5135975135975136
E01016021,1661,824,837,0.49608669476219147,0.5039133052378085
E01016022,1474,736,738,0.4993215739484396,0.5006784260515604
E01016125,1797,925,872,0.5147468002225932,0.4852531997774068
E01016018,1961,965,996,0.49209586945436,0.50790413054564
E01016023,1799,829,970,0.4608115619788771,0.5391884380211228
E01016024,2053,988,1065,0.4812469556746225,0.5187530443253775
E01016062,1617,792,825,0.4897959183673469,0.5102040816326531
E01016093,1812,881,931,0.48620309050772625,0.5137969094922737
E01016096,1535,748,787,0.48729641693811077,0.5127035830618892
E01016166,1562,760,802,0.48655569782330343,0.5134443021766966
E01016167,1442,706,736,0.4895977808599168,0.5104022191400832
E01016116,1917,909,1008,0.47417840375586856,0.5258215962441315
E01016127,1511,737,774,0.4877564526803441,0.5122435473196558
E01016128,2228,1397,831,0.6270197486535009,0.3729802513464991
E01016132,1763,871,892,0.49404424276800907,0.5059557572319909
E01016094,1578,749,829,0.47465145754119137,0.5253485424588086
E01016095,1340,651,689,0.48582089552238805,0.514179104477612
E01016097,1477,720,757,0.48747461069735953,0.5125253893026405
E01016098,1464,673,791,0.45969945355191255,0.5403005464480874
E01016102,1441,678,763,0.47050659264399725,0.5294934073560028
E01016119,1510,732,778,0.4847682119205298,0.5152317880794702
E01016120,1449,711,738,0.4906832298136646,0.5093167701863354
E01016124,1782,867,915,0.48653198653198654,0.5134680134680135
E01016126,1700,834,866,0.49058823529411766,0.5094117647058823
E01016025,1625,766,859,0.4713846153846154,0.5286153846153846
E01016065,1376,684,692,0.49709302325581395,0.502906976744186
E01016066,1693,831,862,0.4908446544595393,0.5091553455404607
E01016067,1631,801,830,0.49110974862047824,0.5088902513795218
E01016068,1766,844,922,0.47791619479048697,0.522083805209513
E01016026,1307,643,664,0.49196633511859217,0.5080336648814078
E01016027,1505,747,758,0.4963455149501661,0.5036544850498339
E01016028,1533,757,776,0.4938030006523157,0.5061969993476843
E01016029,2257,1091,1166,0.4833850243686309,0.516614975631369
E01016087,1780,903,877,0.5073033707865169,0.4926966292134832
E01016088,1569,752,817,0.4792861695347355,0.5207138304652645
E01016089,1547,768,779,0.4964447317388494,0.5035552682611506
E01016090,1526,743,783,0.48689384010484926,0.5131061598951507
E01016085,1631,796,835,0.4880441446965052,0.5119558553034947
E01016086,1320,636,684,0.4818181818181818,0.5181818181818182
E01016091,1516,754,762,0.4973614775725594,0.5026385224274407
E01016176,1505,750,755,0.4983388704318937,0.5016611295681063
E01016058,1435,700,735,0.4878048780487805,0.5121951219512195
E01016059,1293,626,667,0.48414539829853054,0.5158546017014695
E01016079,1297,637,660,0.49113338473400153,0.5088666152659984
E01016083,1300,633,667,0.4869230769230769,0.5130769230769231
E01016084,1477,707,770,0.4786729857819905,0.5213270142180095
E01016101,1444,671,773,0.4646814404432133,0.5353185595567868
E01016103,1903,913,990,0.4797687861271676,0.5202312138728323
E01016104,1418,690,728,0.48660084626234135,0.5133991537376587
E01016107,1488,727,761,0.4885752688172043,0.5114247311827957
E01016121,1484,722,762,0.4865229110512129,0.5134770889487871
E01016122,2352,1156,1196,0.4914965986394558,0.5085034013605442
E01016123,1533,756,777,0.4931506849315068,0.5068493150684932
E01016173,1718,837,881,0.4871944121071013,0.5128055878928988
E01016078,1493,721,772,0.48292029470864034,0.5170797052913597
E01016080,1446,688,758,0.47579529737206083,0.5242047026279392
E01016081,1631,830,801,0.5088902513795218,0.49110974862047824
E01016082,1527,779,748,0.510150622134905,0.48984937786509497
E01016050,1674,812,862,0.4850657108721625,0.5149342891278376
E01016051,1562,752,810,0.4814340588988476,0.5185659411011524
E01016052,1664,819,845,0.4921875,0.5078125
E01016053,1579,756,823,0.47878404053198226,0.5212159594680177
E01016054,1615,801,814,0.49597523219814244,0.5040247678018576
E01016092,1500,728,772,0.48533333333333334,0.5146666666666667
E01016099,1533,726,807,0.4735812133072407,0.5264187866927593
E01016100,1536,727,809,0.4733072916666667,0.5266927083333334
E01016105,1396,692,704,0.49570200573065903,0.504297994269341
E01016106,1425,691,734,0.4849122807017544,0.5150877192982456
E01016168,1661,803,858,0.48344370860927155,0.5165562913907285
E01016169,1658,819,839,0.4939686369119421,0.5060313630880579
E01016171,1677,808,869,0.48181276088252833,0.5181872391174717
E01016172,1463,728,735,0.49760765550239233,0.5023923444976076
E01016055,1531,749,782,0.4892227302416721,0.5107772697583279
E01016056,1464,704,760,0.4808743169398907,0.5191256830601093
E01016057,1719,836,883,0.48632926119837117,0.5136707388016288
E01016060,1604,765,839,0.4769326683291771,0.523067331670823
E01016170,1599,776,823,0.48530331457160725,0.5146966854283928
E01016252,1492,721,771,0.4832439678284182,0.5167560321715817
E01016253,1406,680,726,0.48364153627311524,0.5163584637268848
E01035234,1062,519,543,0.4887005649717514,0.5112994350282486
E01035235,1814,855,959,0.47133406835722164,0.5286659316427784
E01016185,1442,710,732,0.492371705963939,0.507628294036061
E01016187,1642,799,843,0.4866017052375152,0.5133982947624848
E01016188,1927,932,995,0.4836533471717696,0.5163466528282304
E01035236,1811,881,930,0.4864715626725566,0.5135284373274434
E01035237,1360,676,684,0.4970588235294118,0.5029411764705882
E01035238,1323,667,656,0.5041572184429327,0.4958427815570673
E01035239,1100,555,545,0.5045454545454545,0.4954545454545455
E01035240,1488,760,728,0.510752688172043,0.489247311827957
E01016190,1599,781,818,0.4884302689180738,0.5115697310819262
E01016238,1623,821,802,0.5058533579790512,0.4941466420209489
E01016243,1394,699,695,0.5014347202295553,0.49856527977044474
E01016245,2324,1125,1199,0.48407917383821,0.51592082616179
E01016246,1555,744,811,0.47845659163987136,0.5215434083601286
E01016247,1770,834,936,0.4711864406779661,0.5288135593220339
E01016239,1561,763,798,0.48878923766816146,0.5112107623318386
E01016240,1666,810,856,0.48619447779111646,0.5138055222088835
E01016241,1652,813,839,0.49213075060532685,0.5078692493946732
E01016242,2078,1034,1044,0.49759384023099135,0.5024061597690087
E01016180,1287,615,672,0.47785547785547783,0.5221445221445221
E01016181,1771,761,1010,0.42970073404856013,0.5702992659514399
E01016182,1493,718,775,0.48091091761553917,0.5190890823844608
E01016183,1366,648,718,0.4743777452415813,0.5256222547584187
E01016222,1245,623,622,0.5004016064257029,0.4995983935742972
E01016191,1680,819,861,0.4875,0.5125
E01016223,1255,631,624,0.502788844621514,0.49721115537848604
E01016224,2170,1071,1099,0.4935483870967742,0.5064516129032258
E01016226,1471,720,751,0.4894629503738953,0.5105370496261047
E01032724,1731,850,881,0.49104563835932985,0.5089543616406701
E01032728,1886,956,930,0.5068928950159067,0.4931071049840933
E01016233,2608,1290,1318,0.4946319018404908,0.5053680981595092
E01016248,1536,760,776,0.4947916666666667,0.5052083333333334
E01016250,1782,871,911,0.4887766554433221,0.5112233445566778
E01035241,1287,677,610,0.526029526029526,0.473970473970474
E01035242,1532,788,744,0.5143603133159269,0.4856396866840731
E01035243,1789,865,924,0.4835103409726104,0.5164896590273896
E01035244,1337,662,675,0.4951383694839192,0.5048616305160808
E01016200,1338,661,677,0.4940209267563528,0.5059790732436472
E01016201,1283,639,644,0.49805144193296963,0.5019485580670304
E01016202,1216,621,595,0.5106907894736842,0.48930921052631576
E01016203,1296,625,671,0.48225308641975306,0.5177469135802469
E01016204,1188,566,622,0.4764309764309764,0.5235690235690236
E01016209,1489,745,744,0.5003357958361316,0.49966420416386836
E01016210,1303,647,656,0.4965464313123561,0.5034535686876439
E01016213,1096,552,544,0.5036496350364964,0.49635036496350365
E01016214,1319,677,642,0.513267626990144,0.48673237300985595
E01016215,1230,589,641,0.4788617886178862,0.5211382113821138
E01032726,1746,842,904,0.4822451317296678,0.5177548682703322
E01035245,1613,798,815,0.49473031618102914,0.5052696838189709
E01035246,1830,885,945,0.48360655737704916,0.5163934426229508
E01016205,1287,618,669,0.4801864801864802,0.5198135198135199
E01016217,1380,656,724,0.4753623188405797,0.5246376811594203
E01016218,1388,676,712,0.48703170028818443,0.5129682997118156
E01016231,1953,971,982,0.4971838197644649,0.5028161802355351
E01016232,1432,708,724,0.49441340782122906,0.505586592178771
E01016212,1340,659,681,0.4917910447761194,0.5082089552238805
E01016216,1349,679,670,0.5033358042994811,0.4966641957005189
E01016219,1326,626,700,0.4720965309200603,0.5279034690799397
E01016220,1423,698,725,0.4905130007027407,0.5094869992972593
E01016221,1284,629,655,0.4898753894080997,0.5101246105919003
E01016206,1941,931,1010,0.4796496651210716,0.5203503348789283
E01016208,2110,1021,1089,0.4838862559241706,0.5161137440758294
E01016229,1133,547,586,0.48278905560458957,0.5172109443954104
E01016230,1914,978,936,0.5109717868338558,0.4890282131661442
E01016207,2006,1088,918,0.5423728813559322,0.4576271186440678
E01016234,1106,552,554,0.49909584086799275,0.5009041591320073
E01016235,1238,610,628,0.4927302100161551,0.5072697899838449
E01016236,1522,720,802,0.4730617608409987,0.5269382391590013
E01016237,1143,545,598,0.4768153980752406,0.5231846019247594
E01016192,1381,731,650,0.5293265749456916,0.4706734250543085
E01016194,1243,618,625,0.49718423169750603,0.502815768302494
E01016195,1187,577,610,0.4860994102780118,0.5139005897219882
E01016227,1332,639,693,0.4797297297297297,0.5202702702702703
E01016228,1794,869,925,0.48439241917502784,0.5156075808249722
E01016193,1269,616,653,0.4854215918045705,0.5145784081954294
E01016196,2114,1302,812,0.6158940397350994,0.3841059602649007
E01016197,1417,688,729,0.4855328158080452,0.5144671841919548
E01016198,1165,569,596,0.488412017167382,0.511587982832618
E01016199,1165,566,599,0.4858369098712446,0.5141630901287554
E01016277,1590,817,773,0.5138364779874214,0.4861635220125786
E01016286,1789,863,926,0.4823923979877026,0.5176076020122974
E01016287,1425,712,713,0.49964912280701756,0.5003508771929824
E01016288,1725,827,898,0.47942028985507246,0.5205797101449275
E01016303,1473,731,742,0.49626612355736593,0.5037338764426341
E01016304,1608,782,826,0.486318407960199,0.513681592039801
E01016305,1255,597,658,0.4756972111553785,0.5243027888446216
E01016306,1356,675,681,0.497787610619469,0.5022123893805309
E01016256,1771,895,876,0.5053642010163749,0.4946357989836251
E01016257,1351,668,683,0.4944485566247224,0.5055514433752776
E01016313,1687,808,879,0.47895672791938354,0.5210432720806165
E01016314,1590,833,757,0.5238993710691824,0.4761006289308176
E01016315,1621,785,836,0.4842689697717458,0.5157310302282542
E01016316,2079,1011,1068,0.4862914862914863,0.5137085137085137
E01016317,1543,745,798,0.48282566429034346,0.5171743357096565
E01016318,1488,707,781,0.47513440860215056,0.5248655913978495
E01016258,1553,790,763,0.5086928525434643,0.49130714745653575
E01016261,1628,797,831,0.48955773955773957,0.5104422604422605
E01016349,1270,616,654,0.48503937007874015,0.5149606299212598
E01016350,1495,720,775,0.4816053511705686,0.5183946488294314
E01016259,1534,748,786,0.4876140808344198,0.5123859191655802
E01016260,1683,849,834,0.5044563279857398,0.49554367201426025
E01016262,1367,669,698,0.4893928310168252,0.5106071689831748
E01016272,1537,784,753,0.5100845803513337,0.48991541964866625
E01016273,1729,840,889,0.48582995951417,0.5141700404858299
E01016263,2416,1194,1222,0.49420529801324503,0.5057947019867549
E01016284,1373,676,697,0.4923525127458121,0.507647487254188
E01016285,1601,800,801,0.49968769519050593,0.5003123048094941
E01033851,3265,1439,1826,0.4407350689127106,0.5592649310872895
E01016271,1470,724,746,0.4925170068027211,0.507482993197279
E01016274,1453,702,751,0.4831383344803854,0.5168616655196145
E01016275,1463,722,741,0.4935064935064935,0.5064935064935064
E01016276,1476,749,727,0.5074525745257452,0.49254742547425473
E01016327,1217,596,621,0.4897288414133114,0.5102711585866886
E01016328,1923,929,994,0.4830993239729589,0.516900676027041
E01016344,1572,780,792,0.4961832061068702,0.5038167938931297
E01016345,1481,744,737,0.5023632680621202,0.49763673193787983
E01016296,1551,730,821,0.4706640876853643,0.5293359123146357
E01016297,1636,808,828,0.4938875305623472,0.5061124694376528
E01016298,1186,561,625,0.4730185497470489,0.5269814502529511
E01016299,1489,700,789,0.47011417058428473,0.5298858294157153
E01016254,1484,718,766,0.4838274932614555,0.5161725067385444
E01016255,1475,764,711,0.5179661016949153,0.48203389830508475
E01016264,1717,908,809,0.5288293535235876,0.4711706464764123
E01016265,1553,755,798,0.4861558274307791,0.5138441725692209
E01016266,1328,664,664,0.5,0.5
E01016339,2855,1444,1411,0.5057793345008756,0.49422066549912436
E01016310,1969,980,989,0.4977145759268664,0.5022854240731336
E01016311,1683,823,860,0.489007724301842,0.5109922756981581
E01016323,1390,695,695,0.5,0.5
E01016324,1401,703,698,0.5017844396859387,0.4982155603140614
E01016325,1564,745,819,0.47634271099744246,0.5236572890025576
E01016279,2217,1114,1103,0.5024808299503835,0.4975191700496166
E01016280,1851,891,960,0.4813614262560778,0.5186385737439222
E01016281,1430,715,715,0.5,0.5
E01016282,1480,740,740,0.5,0.5
E01016329,1404,692,712,0.4928774928774929,0.5071225071225072
E01016340,1961,977,984,0.4982151963284039,0.5017848036715962
E01016341,1353,692,661,0.5114560236511456,0.4885439763488544
E01016342,2023,1027,996,0.5076618882847257,0.49233811171527436
E01016343,1407,703,704,0.4996446339729922,0.5003553660270078
E01016267,1484,728,756,0.49056603773584906,0.5094339622641509
E01016268,1731,834,897,0.48180242634315423,0.5181975736568457
E01016269,1430,716,714,0.5006993006993007,0.4993006993006993
E01016270,1467,740,727,0.5044308111792775,0.49556918882072254
E01016330,1393,679,714,0.48743718592964824,0.5125628140703518
E01016331,1534,743,791,0.48435462842242505,0.515645371577575
E01016332,1559,738,821,0.4733803720333547,0.5266196279666453
E01016334,1720,856,864,0.49767441860465117,0.5023255813953489
E01016336,1340,649,691,0.4843283582089552,0.5156716417910447
E01016333,1262,622,640,0.4928684627575277,0.5071315372424723
E01016335,1503,742,761,0.49367930805056554,0.5063206919494344
E01016337,2385,1164,1221,0.4880503144654088,0.5119496855345912
E01016338,1769,880,889,0.497456189937818,0.5025438100621821
E01016300,1455,716,739,0.49209621993127145,0.5079037800687285
E01016301,2042,1013,1029,0.4960822722820764,0.5039177277179236
E01016302,1590,788,802,0.49559748427672956,0.5044025157232704
E01016326,1393,690,703,0.4953338119167265,0.5046661880832735
E01016346,1486,770,716,0.5181695827725438,0.48183041722745623
E01016348,2405,1229,1176,0.511018711018711,0.488981288981289
E01033852,1586,821,765,0.5176544766708702,0.4823455233291299
E01033853,1765,853,912,0.48328611898017,0.5167138810198301
E01033854,1663,834,829,0.5015033072760072,0.4984966927239928
E01033855,1171,587,584,0.5012809564474808,0.4987190435525192
E01033856,1106,566,540,0.5117540687160941,0.488245931283906
E01016294,1519,777,742,0.511520737327189,0.48847926267281105
E01016295,1481,733,748,0.4949358541525996,0.5050641458474004
E01016312,2028,1010,1018,0.4980276134122288,0.5019723865877712
E01016319,1837,888,949,0.4833968426782798,0.5166031573217202
E01016320,1442,718,724,0.49791955617198336,0.5020804438280166
E01016289,1424,705,719,0.49508426966292135,0.5049157303370787
E01016290,1557,736,821,0.472703917790623,0.527296082209377
E01016291,1903,909,994,0.4776668418286915,0.5223331581713084
E01016292,1625,815,810,0.5015384615384615,0.49846153846153846
E01016321,1634,840,794,0.5140758873929009,0.48592411260709917
E01016322,1446,721,725,0.49861687413554634,0.5013831258644537
E01016307,1696,834,862,0.49174528301886794,0.5082547169811321
E01016308,1929,936,993,0.48522550544323484,0.5147744945567652
E01016309,2417,1243,1174,0.5142738932561026,0.4857261067438974
E01016407,1571,754,817,0.47994907702100575,0.5200509229789942
E01016408,1443,714,729,0.49480249480249483,0.5051975051975052
E01016410,1802,879,923,0.4877913429522753,0.5122086570477248
E01016411,1651,828,823,0.5015142337976983,0.4984857662023016
E01016412,1530,769,761,0.5026143790849673,0.4973856209150327
E01016386,1514,753,761,0.49735799207397624,0.5026420079260238
E01016387,1576,777,799,0.4930203045685279,0.506979695431472
E01016425,1754,893,861,0.5091220068415051,0.4908779931584949
E01016426,1454,704,750,0.48418156808803303,0.515818431911967
E01016430,1454,698,756,0.48005502063273725,0.5199449793672627
E01016364,1436,709,727,0.4937325905292479,0.5062674094707521
E01016409,1862,870,992,0.4672395273899033,0.5327604726100966
E01016427,1696,745,951,0.4392688679245283,0.5607311320754716
E01016428,1922,929,993,0.4833506763787721,0.5166493236212278
E01016429,1671,779,892,0.46618791143028127,0.5338120885697187
E01016362,1806,896,910,0.49612403100775193,0.5038759689922481
E01016363,1947,958,989,0.49203903441191577,0.5079609655880842
E01016365,1699,882,817,0.5191288993525603,0.48087110064743965
E01016366,1593,796,797,0.49968612680477087,0.5003138731952291
E01016367,1654,799,855,0.4830713422007255,0.5169286577992744
E01016380,1743,864,879,0.49569707401032703,0.504302925989673
E01016383,1574,732,842,0.4650571791613723,0.5349428208386277
E01016384,1670,847,823,0.5071856287425149,0.492814371257485
E01016431,1682,787,895,0.46789536266349585,0.5321046373365041
E01016432,1492,699,793,0.46849865951742625,0.5315013404825737
E01016381,1539,758,781,0.49252761533463285,0.5074723846653671
E01016382,1936,972,964,0.5020661157024794,0.49793388429752067
E01016385,1700,835,865,0.49117647058823527,0.5088235294117647
E01016396,1685,803,882,0.47655786350148366,0.5234421364985163
E01016397,1797,882,915,0.49081803005008345,0.5091819699499165
E01016355,1897,1005,892,0.5297838692672641,0.4702161307327359
E01016358,1909,971,938,0.5086432687270822,0.49135673127291773
E01016359,2806,1386,1420,0.49394155381325733,0.5060584461867427
E01016360,2548,1297,1251,0.5090266875981162,0.49097331240188385
E01016361,2112,1060,1052,0.5018939393939394,0.4981060606060606
E01016356,1624,817,807,0.5030788177339901,0.49692118226600984
E01016357,1800,962,838,0.5344444444444445,0.46555555555555556
E01016395,1422,696,726,0.48945147679324896,0.510548523206751
E01016398,1774,910,864,0.5129650507328072,0.48703494926719276
E01016399,1510,769,741,0.509271523178808,0.49072847682119203
E01016400,1703,876,827,0.5143863769817968,0.48561362301820316
E01016394,1528,700,828,0.4581151832460733,0.5418848167539267
E01016433,1477,714,763,0.4834123222748815,0.5165876777251185
E01016434,2084,975,1109,0.4678502879078695,0.5321497120921305
E01016435,1538,744,794,0.4837451235370611,0.5162548764629389
E01016436,1597,764,833,0.47839699436443334,0.5216030056355667
E01016402,1888,974,914,0.5158898305084746,0.4841101694915254
E01016404,2195,1078,1117,0.4911161731207289,0.508883826879271
E01016405,2181,1121,1060,0.5139844108207244,0.48601558917927556
E01016406,1604,844,760,0.5261845386533666,0.47381546134663344
E01033417,1213,619,594,0.5103050288540808,0.4896949711459192
E01033421,2450,1240,1210,0.5061224489795918,0.49387755102040815
E01016401,1438,730,708,0.5076495132127955,0.49235048678720444
E01016403,2140,1035,1105,0.48364485981308414,0.5163551401869159
E01016416,2023,1030,993,0.50914483440435,0.49085516559565
E01016417,1762,821,941,0.4659477866061294,0.5340522133938707
E01016418,1608,808,800,0.5024875621890548,0.4975124378109453
E01016388,1473,734,739,0.4983027834351663,0.5016972165648337
E01016389,1856,916,940,0.49353448275862066,0.5064655172413793
E01016390,1611,839,772,0.520794537554314,0.4792054624456859
E01016392,2265,1164,1101,0.5139072847682119,0.4860927152317881
E01016393,1965,962,1003,0.4895674300254453,0.5104325699745547
E01016374,1779,954,825,0.5362563237774031,0.463743676222597
E01016375,1284,626,658,0.48753894080996885,0.5124610591900312
E01016376,1877,982,895,0.5231752797016516,0.47682472029834844
E01016379,2150,1151,999,0.5353488372093024,0.4646511627906977
E01016413,1787,868,919,0.48573027420257414,0.5142697257974258
E01016414,1830,954,876,0.521311475409836,0.4786885245901639
E01016419,2108,996,1112,0.47248576850094876,0.5275142314990512
E01016420,1563,753,810,0.4817658349328215,0.5182341650671785
E01016421,1296,614,682,0.4737654320987654,0.5262345679012346
E01016422,1407,677,730,0.48116560056858565,0.5188343994314144
E01016423,1582,758,824,0.47914032869785084,0.5208596713021492
E01016424,1426,716,710,0.5021037868162693,0.49789621318373073
E01016370,3551,1680,1871,0.4731061672768234,0.5268938327231766
E01016371,1708,844,864,0.49414519906323184,0.5058548009367682
E01016373,1653,806,847,0.48759830611010285,0.5124016938898972
E01016415,1729,885,844,0.5118565644881434,0.48814343551185657
E01016368,1585,782,803,0.4933753943217666,0.5066246056782334
E01016372,1406,701,705,0.49857752489331436,0.5014224751066856
E01016377,1790,912,878,0.5094972067039106,0.49050279329608937
E01016438,1427,708,719,0.49614576033637003,0.50385423966363
E01016443,1636,796,840,0.48655256723716384,0.5134474327628362
E01033857,2138,1066,1072,0.49859681945743684,0.5014031805425632
E01033858,1700,894,806,0.5258823529411765,0.47411764705882353
E01033859,1389,747,642,0.5377969762419006,0.46220302375809935
E01016369,1765,879,886,0.4980169971671388,0.5019830028328612
E01016437,1434,725,709,0.5055788005578801,0.49442119944211993
E01016439,1986,996,990,0.5015105740181269,0.4984894259818731
E01016440,1531,764,767,0.4990202482037884,0.5009797517962117
E01016441,1529,767,762,0.5016350555918901,0.49836494440810986
E01016353,2094,1093,1001,0.5219675262655206,0.4780324737344795
E01033415,2169,1171,998,0.5398801290917473,0.4601198709082526
E01033418,1433,764,669,0.5331472435450104,0.4668527564549895
E01033422,1377,734,643,0.533042846768337,0.46695715323166304
E01016391,2101,1026,1075,0.4883388862446454,0.5116611137553546
E01033420,1284,673,611,0.5241433021806854,0.47585669781931467
E01033423,1805,901,904,0.49916897506925206,0.5008310249307479
E01033838,1360,696,664,0.5117647058823529,0.48823529411764705
E01033839,1690,907,783,0.5366863905325444,0.46331360946745564
E01016450,1618,763,855,0.4715698393077874,0.5284301606922126
E01016451,1857,901,956,0.485191168551427,0.5148088314485729
E01016452,1960,957,1003,0.488265306122449,0.511734693877551
E01016453,1711,824,887,0.48158971361776737,0.5184102863822326
E01016454,1658,810,848,0.48854041013269,0.51145958986731
E01016455,2109,1034,1075,0.4902797534376482,0.5097202465623518
E01016483,2114,1092,1022,0.5165562913907285,0.48344370860927155
E01016484,1831,914,917,0.4991807755324959,0.500819224467504
E01016485,1889,937,952,0.49602964531498145,0.5039703546850185
E01016486,1694,810,884,0.4781582054309327,0.5218417945690673
E01016487,1828,957,871,0.5235229759299781,0.4764770240700219
E01016488,1936,979,957,0.5056818181818182,0.4943181818181818
E01016493,1252,592,660,0.4728434504792332,0.5271565495207667
E01016494,1909,954,955,0.49973808276584597,0.500261917234154
E01016495,1466,740,726,0.504774897680764,0.495225102319236
E01016496,1372,631,741,0.45991253644314867,0.5400874635568513
E01016497,1424,707,717,0.4964887640449438,0.5035112359550562
E01016498,1660,833,827,0.5018072289156627,0.49819277108433735
E01016499,1365,637,728,0.4666666666666667,0.5333333333333333
E01016444,1755,856,899,0.4877492877492878,0.5122507122507123
E01016445,1929,960,969,0.4976671850699845,0.5023328149300156
E01016446,1735,841,894,0.4847262247838617,0.5152737752161384
E01016447,1882,945,937,0.502125398512221,0.49787460148777896
E01016448,2457,1229,1228,0.5002035002035002,0.4997964997964998
E01016449,2483,1219,1264,0.490938380990737,0.509061619009263
E01016516,1963,971,992,0.49465104431991846,0.5053489556800815
E01016517,1728,884,844,0.5115740740740741,0.48842592592592593
E01016518,1928,986,942,0.5114107883817427,0.48858921161825725
E01016519,2983,1415,1568,0.4743546765001676,0.5256453234998324
E01016520,1780,861,919,0.4837078651685393,0.5162921348314606
E01016521,2122,1053,1069,0.49622997172478794,0.5037700282752121
E01016467,1568,757,811,0.48278061224489793,0.517219387755102
E01016468,1996,1005,991,0.5035070140280561,0.4964929859719439
E01016469,1823,916,907,0.5024684585847504,0.4975315414152496
E01016470,1775,895,880,0.504225352112676,0.49577464788732395
E01016471,1472,705,767,0.4789402173913043,0.5210597826086957
E01016472,1775,876,899,0.49352112676056337,0.5064788732394366
E01016473,2722,1332,1390,0.4893460690668626,0.5106539309331374
E01016474,2167,1067,1100,0.49238578680203043,0.5076142131979695
E01016475,2243,1112,1131,0.49576460098082925,0.5042353990191708
E01016476,1806,877,929,0.4856035437430786,0.5143964562569213
E01016477,2844,1410,1434,0.4957805907172996,0.5042194092827004
E01016478,1971,969,1002,0.4916286149162861,0.5083713850837138
E01016462,2573,1346,1227,0.5231247570928876,0.4768752429071123
E01016463,2032,1030,1002,0.5068897637795275,0.49311023622047245
E01016464,2245,1139,1106,0.5073496659242762,0.49265033407572384
E01016465,2908,1456,1452,0.5006877579092159,0.49931224209078406
E01032729,1800,889,911,0.4938888888888889,0.5061111111111111
E01032730,1950,981,969,0.5030769230769231,0.4969230769230769
E01016506,1864,930,934,0.4989270386266094,0.5010729613733905
E01016507,1905,942,963,0.494488188976378,0.5055118110236221
E01016508,2245,1115,1130,0.49665924276169265,0.5033407572383074
E01016509,1662,799,863,0.48074608904933813,0.5192539109506619
E01016510,2138,1057,1081,0.49438727782974745,0.5056127221702525
E01016511,2383,1233,1150,0.5174150230801511,0.4825849769198489
E01016514,2045,981,1064,0.4797066014669927,0.5202933985330074
E01016515,2097,1031,1066,0.491654744873629,0.508345255126371
E01035247,1473,727,746,0.49355057705363203,0.506449422946368
E01035248,1634,805,829,0.49265605875153,0.50734394124847
E01035249,1325,653,672,0.4928301886792453,0.5071698113207547
E01035250,1849,920,929,0.4975662520281233,0.5024337479718767
E01016500,1949,973,976,0.49923037455105185,0.5007696254489482
E01016501,1796,862,934,0.4799554565701559,0.5200445434298441
E01016502,1594,770,824,0.48306148055207027,0.5169385194479298
E01016503,1667,837,830,0.5020995800839833,0.4979004199160168
E01016504,1499,735,764,0.4903268845897265,0.5096731154102735
E01016505,1818,879,939,0.4834983498349835,0.5165016501650165
E01016490,2047,982,1065,0.47972642892037126,0.5202735710796287
E01016491,1820,908,912,0.4989010989010989,0.5010989010989011
E01016492,1804,888,916,0.49223946784922396,0.5077605321507761
E01032731,1542,739,803,0.4792477302204929,0.5207522697795072
E01032732,1770,863,907,0.48757062146892655,0.5124293785310734
E01016479,1690,835,855,0.4940828402366864,0.5059171597633136
E01016480,1478,692,786,0.46820027063599456,0.5317997293640054
E01016481,1514,786,728,0.5191545574636723,0.4808454425363276
E01016482,1736,877,859,0.505184331797235,0.49481566820276496
E01016458,1860,932,928,0.5010752688172043,0.4989247311827957
E01035251,2314,1142,1172,0.49351771823681934,0.5064822817631807
E01035252,1317,646,671,0.4905087319665907,0.5094912680334093
E01035253,1527,771,756,0.5049115913555993,0.4950884086444008
E01016456,2212,1145,1067,0.5176311030741411,0.48236889692585894
E01016457,2088,1056,1032,0.5057471264367817,0.4942528735632184
E01016460,2079,1066,1013,0.5127465127465127,0.48725348725348727
E01035254,1702,875,827,0.5141010575793185,0.48589894242068155
E01016570,1563,732,831,0.46833013435700577,0.5316698656429942
E01016572,1362,659,703,0.48384728340675476,0.5161527165932452
E01016582,1634,785,849,0.4804161566707466,0.5195838433292533
E01016600,1114,531,583,0.47666068222621183,0.5233393177737882
E01016530,1604,753,851,0.4694513715710723,0.5305486284289277
E01016531,1422,708,714,0.4978902953586498,0.5021097046413502
E01016532,1921,936,985,0.4872462259239979,0.5127537740760021
E01016533,1896,929,967,0.4899789029535865,0.5100210970464135
E01016578,1749,867,882,0.4957118353344768,0.5042881646655232
E01016579,1806,879,927,0.4867109634551495,0.5132890365448505
E01016581,1451,731,720,0.503790489317712,0.4962095106822881
E01016571,1820,900,920,0.4945054945054945,0.5054945054945055
E01016573,1502,716,786,0.4766977363515313,0.5233022636484687
E01016574,1593,784,809,0.4921531701192718,0.5078468298807282
E01016599,1671,805,866,0.4817474566128067,0.5182525433871933
E01016583,1903,923,980,0.48502364687335786,0.5149763531266421
E01016585,1693,844,849,0.4985233313644418,0.5014766686355582
E01016586,1339,655,684,0.48917102315160566,0.5108289768483943
E01016591,2327,1155,1172,0.4963472281908036,0.5036527718091964
E01016592,2049,987,1062,0.4816983894582723,0.5183016105417276
E01016525,1794,880,914,0.49052396878483834,0.5094760312151616
E01016528,1699,848,851,0.4991171277221895,0.5008828722778105
E01016529,2160,1052,1108,0.48703703703703705,0.512962962962963
E01016536,1929,982,947,0.5090720580611716,0.4909279419388284
E01016584,2347,1186,1161,0.5053259480187473,0.49467405198125264
E01032733,1335,640,695,0.4794007490636704,0.5205992509363296
E01032734,1802,924,878,0.5127635960044395,0.4872364039955605
E01016526,1821,882,939,0.4843492586490939,0.515650741350906
E01016527,1614,759,855,0.47026022304832715,0.5297397769516728
E01016534,1637,797,840,0.4868662186927306,0.5131337813072694
E01016598,1428,650,778,0.45518207282913165,0.5448179271708683
E01016601,1647,788,859,0.4784456587735276,0.5215543412264724
E01016602,1657,784,873,0.4731442365721183,0.5268557634278818
E01016535,1349,651,698,0.4825796886582654,0.5174203113417346
E01016537,1819,904,915,0.49697636063771305,0.503023639362287
E01016538,1603,817,786,0.5096693699313787,0.4903306300686213
E01016593,1824,912,912,0.5,0.5
E01016594,1588,756,832,0.4760705289672544,0.5239294710327456
E01016559,1490,731,759,0.4906040268456376,0.5093959731543625
E01016560,1560,766,794,0.491025641025641,0.5089743589743589
E01016561,1815,907,908,0.4997245179063361,0.5002754820936639
E01016562,1373,683,690,0.49745083758193737,0.5025491624180627
E01016563,1371,672,699,0.49015317286652077,0.5098468271334792
E01016580,1554,752,802,0.4839124839124839,0.5160875160875161
E01016539,1610,823,787,0.5111801242236025,0.4888198757763975
E01016540,1616,778,838,0.4814356435643564,0.5185643564356436
E01016541,1344,667,677,0.4962797619047619,0.5037202380952381
E01016542,1226,612,614,0.499184339314845,0.5008156606851549
E01016543,1946,948,998,0.48715313463514903,0.512846865364851
E01016544,2004,1118,886,0.5578842315369261,0.4421157684630739
E01016567,3174,2223,951,0.7003780718336484,0.2996219281663516
E01016568,1283,620,663,0.48324240062353857,0.5167575993764614
E01016569,1061,504,557,0.4750235626767201,0.5249764373232799
E01016564,1765,846,919,0.47932011331444757,0.5206798866855524
E01016565,1677,809,868,0.4824090638044126,0.5175909361955874
E01016566,1699,828,871,0.48734549735138316,0.5126545026486168
E01016577,1865,927,938,0.4970509383378016,0.5029490616621984
E01016545,2117,988,1129,0.46669815777042983,0.5333018422295701
E01016547,1753,830,923,0.4734740444951512,0.5265259555048488
E01016550,1484,781,703,0.5262803234501348,0.47371967654986524
E01016552,1742,816,926,0.46842709529276694,0.5315729047072331
E01016551,1581,783,798,0.4952561669829222,0.5047438330170778
E01016553,1500,710,790,0.47333333333333333,0.5266666666666666
E01016557,1942,928,1014,0.47785787847579814,0.5221421215242018
E01016558,1446,703,743,0.48616874135546334,0.5138312586445366
E01016548,1903,961,942,0.5049921177088808,0.4950078822911193
E01016549,2014,948,1066,0.47070506454816285,0.5292949354518371
E01016554,1775,821,954,0.46253521126760566,0.5374647887323943
E01016555,1632,798,834,0.4889705882352941,0.5110294117647058
E01016556,1867,903,964,0.483663631494376,0.516336368505624
E01016546,1622,775,847,0.47780517879161527,0.5221948212083847
E01016595,1834,877,957,0.4781897491821156,0.5218102508178845
E01016596,1964,970,994,0.4938900203665988,0.5061099796334012
E01016597,1722,851,871,0.49419279907084784,0.5058072009291521
E01016575,1902,955,947,0.5021030494216614,0.4978969505783386
E01016576,1813,890,923,0.49089906232763375,0.5091009376723662
E01016587,1757,872,885,0.49630051223676724,0.5036994877632328
E01016588,1827,913,914,0.4997263273125342,0.5002736726874658
E01016589,1740,873,867,0.5017241379310344,0.4982758620689655
E01016522,1872,919,953,0.4909188034188034,0.5090811965811965
E01016523,1569,715,854,0.455704270235819,0.5442957297641811
E01016524,2116,1053,1063,0.4976370510396975,0.5023629489603024
E01016609,1865,890,975,0.4772117962466488,0.5227882037533512
E01016603,1782,832,950,0.4668911335578002,0.5331088664421998
E01016604,2243,1091,1152,0.4864021399910834,0.5135978600089166
E01016605,1613,775,838,0.4804711717296962,0.5195288282703038
E01016606,1670,776,894,0.46467065868263474,0.5353293413173653
E01016607,1972,778,1194,0.3945233265720081,0.6054766734279919
E01016608,1952,935,1017,0.47899590163934425,0.5210040983606558
E01016676,1577,767,810,0.48636651870640457,0.5136334812935954
E01016678,1442,715,727,0.4958391123439667,0.5041608876560333
E01035256,2508,1205,1303,0.48046251993620415,0.5195374800637959
E01016619,1631,831,800,0.5095033721643164,0.49049662783568365
E01016620,1526,773,753,0.5065530799475754,0.49344692005242463
E01016692,1562,753,809,0.4820742637644046,0.5179257362355953
E01016693,1375,668,707,0.4858181818181818,0.5141818181818182
E01016694,1586,778,808,0.4905422446406053,0.5094577553593947
E01016695,1594,797,797,0.5,0.5
E01016621,1547,772,775,0.49903038138332256,0.5009696186166774
E01016623,1525,736,789,0.48262295081967216,0.5173770491803279
E01016624,1398,688,710,0.49213161659513593,0.5078683834048641
E01016684,1585,799,786,0.5041009463722398,0.49589905362776027
E01016685,1616,793,823,0.4907178217821782,0.5092821782178217
E01016622,1164,590,574,0.506872852233677,0.49312714776632305
E01016657,1461,725,736,0.49623545516769335,0.5037645448323066
E01016658,2748,1363,1385,0.4959970887918486,0.5040029112081513
E01016659,1410,657,753,0.46595744680851064,0.5340425531914894
E01016660,1706,825,881,0.4835873388042204,0.5164126611957796
E01016615,1524,744,780,0.4881889763779528,0.5118110236220472
E01016616,1639,825,814,0.5033557046979866,0.4966442953020134
E01016617,2067,1003,1064,0.4852443154329947,0.5147556845670053
E01016662,1757,859,898,0.4889015367103017,0.5110984632896983
E01016613,1527,770,757,0.5042567125081859,0.495743287491814
E01016614,1539,782,757,0.5081221572449642,0.4918778427550357
E01016618,1324,675,649,0.5098187311178247,0.4901812688821752
E01016664,1318,642,676,0.48710166919575115,0.5128983308042488
E01016668,1709,857,852,0.5014628437682855,0.49853715623171446
E01016669,1959,974,985,0.49719244512506383,0.5028075548749362
E01016661,1301,664,637,0.5103766333589547,0.48962336664104533
E01016663,1606,778,828,0.48443337484433374,0.5155666251556662
E01016686,1140,563,577,0.493859649122807,0.506140350877193
E01016687,1231,589,642,0.4784727863525589,0.5215272136474411
E01016688,2120,1064,1056,0.5018867924528302,0.4981132075471698
E01016689,1375,660,715,0.48,0.52
E01016652,1230,638,592,0.5186991869918699,0.4813008130081301
E01016653,1396,704,692,0.504297994269341,0.49570200573065903
E01016665,1575,783,792,0.49714285714285716,0.5028571428571429
E01016666,1408,714,694,0.5071022727272727,0.4928977272727273
E01035257,2763,1205,1558,0.4361201592471951,0.563879840752805
E01035258,1431,714,717,0.4989517819706499,0.5010482180293501
E01016647,1834,887,947,0.4836423118865867,0.5163576881134133
E01016701,2011,991,1020,0.49278965688712084,0.5072103431128792
E01016702,1841,915,926,0.49701249321021185,0.5029875067897882
E01016703,2715,1311,1404,0.48287292817679556,0.5171270718232044
E01016704,2320,1083,1237,0.4668103448275862,0.5331896551724138
E01016627,2073,1021,1052,0.49252291365171247,0.5074770863482875
E01016628,2584,1261,1323,0.48800309597523217,0.5119969040247678
E01016656,1474,735,739,0.49864314789687925,0.5013568521031208
E01016700,1992,978,1014,0.49096385542168675,0.5090361445783133
E01016644,1454,709,745,0.48762035763411277,0.5123796423658872
E01016645,1532,785,747,0.512402088772846,0.48759791122715407
E01016646,1610,809,801,0.5024844720496895,0.49751552795031057
E01016648,1461,732,729,0.5010266940451745,0.4989733059548255
E01016649,1430,717,713,0.5013986013986014,0.4986013986013986
E01016651,1470,763,707,0.5190476190476191,0.48095238095238096
E01016654,1378,668,710,0.4847605224963715,0.5152394775036284
E01016655,1292,665,627,0.5147058823529411,0.4852941176470588
E01016679,2270,1140,1130,0.5022026431718062,0.4977973568281938
E01016680,1362,714,648,0.5242290748898678,0.47577092511013214
E01032759,1993,987,1006,0.49523331660812847,0.5047666833918716
E01035259,1709,831,878,0.48624926857811585,0.5137507314218841
E01035260,1716,829,887,0.4831002331002331,0.5168997668997669
E01016626,2131,1001,1130,0.4697325199436884,0.5302674800563116
E01016671,2106,936,1170,0.4444444444444444,0.5555555555555556
E01016673,1820,866,954,0.4758241758241758,0.5241758241758242
E01016674,1853,874,979,0.4716675661090124,0.5283324338909876
E01016696,1808,863,945,0.47732300884955753,0.5226769911504425
E01016670,2797,1339,1458,0.4787272077225599,0.5212727922774402
E01016672,2739,1333,1406,0.48667396860167944,0.5133260313983206
E01035261,1933,971,962,0.5023279875840663,0.4976720124159338
E01035262,2025,1005,1020,0.4962962962962963,0.5037037037037037
E01016612,2686,1301,1385,0.4843633655994043,0.5156366344005957
E01016629,1383,648,735,0.4685466377440347,0.5314533622559653
E01016630,1495,769,726,0.51438127090301,0.48561872909698994
E01016635,1417,704,713,0.49682427664079043,0.5031757233592096
E01016625,1760,861,899,0.48920454545454545,0.5107954545454545
E01016631,1343,609,734,0.45346239761727475,0.5465376023827252
E01016632,1880,899,981,0.47819148936170214,0.5218085106382979
E01016634,2019,1008,1011,0.49925705794947994,0.5007429420505201
E01016699,1749,846,903,0.483704974271012,0.516295025728988
E01016690,2227,1116,1111,0.5011225864391559,0.4988774135608442
E01016691,1295,624,671,0.48185328185328186,0.5181467181467182
E01035263,1604,792,812,0.4937655860349127,0.5062344139650873
E01035264,1846,900,946,0.4875406283856988,0.5124593716143012
E01035265,2007,985,1022,0.49078226208271053,0.5092177379172895
E01035266,1665,799,866,0.4798798798798799,0.5201201201201201
E01016611,1934,942,992,0.4870734229576008,0.5129265770423992
E01035267,1592,777,815,0.4880653266331658,0.5119346733668342
E01035268,1421,692,729,0.48698099929627026,0.5130190007037297
E01035269,3323,1651,1672,0.4968402046343665,0.5031597953656335
E01016633,1369,670,699,0.48940832724616506,0.5105916727538349
E01016636,1478,733,745,0.4959404600811908,0.5040595399188093
E01016637,1130,579,551,0.5123893805309735,0.48761061946902656
E01016638,1278,625,653,0.4890453834115806,0.5109546165884195
E01016639,1583,775,808,0.4895767530006317,0.5104232469993683
E01016640,1578,770,808,0.4879594423320659,0.5120405576679341
E01016643,1387,685,702,0.4938716654650324,0.5061283345349675
E01016705,1642,935,707,0.5694275274056029,0.43057247259439707
E01016706,1704,830,874,0.48708920187793425,0.5129107981220657
E01016707,1804,901,903,0.49944567627494457,0.5005543237250555
E01016708,1610,812,798,0.5043478260869565,0.4956521739130435
E01016709,1663,824,839,0.4954900781719784,0.5045099218280217
E01016796,1702,814,888,0.4782608695652174,0.5217391304347826
E01016797,1733,823,910,0.4748990190421235,0.5251009809578765
E01016798,1871,916,955,0.48957776590058794,0.5104222340994121
E01016799,1907,931,976,0.48820136339800735,0.5117986366019927
E01016800,1793,889,904,0.49581706636921363,0.5041829336307864
E01016759,1634,797,837,0.48776009791921665,0.5122399020807834
E01016761,1502,727,775,0.4840213049267643,0.5159786950732357
E01016801,1313,656,657,0.49961919268849964,0.5003808073115004
E01016802,1450,696,754,0.48,0.52
E01016803,1361,681,680,0.5003673769287289,0.4996326230712711
E01034446,1556,760,796,0.4884318766066838,0.5115681233933161
E01034447,1278,608,670,0.4757433489827856,0.5242566510172144
E01034448,1581,800,781,0.5060088551549652,0.4939911448450348
E01016786,1448,685,763,0.47306629834254144,0.5269337016574586
E01016787,1684,783,901,0.4649643705463183,0.5350356294536817
E01016788,1561,772,789,0.4945547725816784,0.5054452274183215
E01016789,1341,659,682,0.49142431021625654,0.5085756897837435
E01016790,1447,679,768,0.4692467173462336,0.5307532826537664
E01016791,1456,698,758,0.4793956043956044,0.5206043956043956
E01016792,1238,588,650,0.47495961227786754,0.5250403877221325
E01016793,2143,1057,1086,0.4932337844143724,0.5067662155856276
E01016794,1709,843,866,0.49327091866588646,0.5067290813341135
E01016795,1562,758,804,0.4852752880921895,0.5147247119078106
E01016762,1329,637,692,0.47930775018811134,0.5206922498118887
E01016764,1439,734,705,0.5100764419735928,0.48992355802640725
E01016766,1381,682,699,0.49384503982621286,0.5061549601737871
E01016767,1300,643,657,0.4946153846153846,0.5053846153846154
E01016771,1368,673,695,0.4919590643274854,0.5080409356725146
E01016806,2009,970,1039,0.48282727725236435,0.5171727227476356
E01016807,1805,900,905,0.4986149584487535,0.5013850415512465
E01016809,1405,710,695,0.505338078291815,0.49466192170818507
E01016835,1850,904,946,0.48864864864864865,0.5113513513513513
E01016763,1325,631,694,0.4762264150943396,0.5237735849056604
E01016769,1330,662,668,0.49774436090225566,0.5022556390977444
E01016770,1541,766,775,0.4970798182998053,0.5029201817001947
E01016773,1875,897,978,0.4784,0.5216
E01016836,1708,863,845,0.5052693208430913,0.49473067915690866
E01016837,1950,1001,949,0.5133333333333333,0.4866666666666667
E01016838,1673,816,857,0.4877465630603706,0.5122534369396294
E01016841,2458,1231,1227,0.5008136696501221,0.49918633034987797
E01016721,1726,904,822,0.5237543453070683,0.4762456546929316
E01016765,1632,761,871,0.46629901960784315,0.5337009803921569
E01016772,1366,652,714,0.4773060029282577,0.5226939970717424
E01016804,1864,905,959,0.4855150214592275,0.5144849785407726
E01016812,1562,771,791,0.49359795134443024,0.5064020486555698
E01016817,1544,727,817,0.47085492227979275,0.5291450777202072
E01016818,1789,835,954,0.46674119619899385,0.5332588038010061
E01034449,2049,1005,1044,0.4904831625183016,0.5095168374816984
E01034450,1677,818,859,0.4877757901013715,0.5122242098986285
E01016719,1435,698,737,0.486411149825784,0.5135888501742161
E01016722,1597,792,805,0.49592986850344395,0.504070131496556
E01016805,1279,645,634,0.5043002345582487,0.49569976544175137
E01016808,1417,710,707,0.5010585744530699,0.49894142554693016
E01016810,1532,723,809,0.4719321148825065,0.5280678851174935
E01016811,1562,740,822,0.4737516005121639,0.5262483994878361
E01016819,1252,598,654,0.4776357827476038,0.5223642172523961
E01016839,1848,930,918,0.5032467532467533,0.4967532467532468
E01016717,1668,836,832,0.5011990407673861,0.4988009592326139
E01016720,1582,749,833,0.47345132743362833,0.5265486725663717
E01016723,1584,797,787,0.5031565656565656,0.49684343434343436
E01016724,1792,922,870,0.5145089285714286,0.48549107142857145
E01016718,1904,1030,874,0.5409663865546218,0.45903361344537813
E01016729,2290,1223,1067,0.534061135371179,0.46593886462882095
E01016768,2488,1298,1190,0.5217041800643086,0.4782958199356913
E01033499,2052,1147,905,0.5589668615984406,0.44103313840155944
E01033500,1467,832,635,0.567143830947512,0.4328561690524881
E01016776,1389,711,678,0.5118790496760259,0.48812095032397407
E01016813,1386,716,670,0.5165945165945166,0.4834054834054834
E01016815,1304,670,634,0.5138036809815951,0.48619631901840493
E01016816,1529,767,762,0.5016350555918901,0.49836494440810986
E01016731,1598,823,775,0.5150187734668336,0.48498122653316644
E01016732,1398,698,700,0.49928469241773965,0.5007153075822603
E01016784,1768,911,857,0.5152714932126696,0.4847285067873303
E01033501,2169,1055,1114,0.4863992623328723,0.5136007376671277
E01033506,2081,1053,1028,0.506006727534839,0.493993272465161
E01016726,1825,940,885,0.5150684931506849,0.4849315068493151
E01016733,1795,964,831,0.5370473537604457,0.46295264623955434
E01016845,1859,900,959,0.4841312533620226,0.5158687466379774
E01016846,1656,808,848,0.48792270531400966,0.5120772946859904
E01016848,1647,845,802,0.5130540376442015,0.4869459623557984
E01016774,1773,867,906,0.4890016920473773,0.5109983079526227
E01016775,1708,800,908,0.468384074941452,0.531615925058548
E01016777,1617,806,811,0.49845392702535557,0.5015460729746444
E01016778,1743,838,905,0.48078026391279405,0.519219736087206
E01016725,1644,841,803,0.5115571776155717,0.4884428223844282
E01016727,1759,841,918,0.47811256395679363,0.5218874360432064
E01016728,2109,1085,1024,0.514461830251304,0.48553816974869607
E01016847,2166,1020,1146,0.4709141274238227,0.5290858725761773
E01016822,1559,757,802,0.48556767158434894,0.514432328415651
E01016824,1645,815,830,0.49544072948328266,0.5045592705167173
E01016825,1494,734,760,0.49129852744310576,0.5087014725568942
E01016827,1728,866,862,0.5011574074074074,0.4988425925925926
E01016828,1726,861,865,0.49884125144843566,0.5011587485515643
E01016842,1540,726,814,0.4714285714285714,0.5285714285714286
E01016843,1672,821,851,0.4910287081339713,0.5089712918660287
E01016844,1663,812,851,0.4882742032471437,0.5117257967528562
E01033497,1538,762,776,0.49544863459037713,0.5045513654096229
E01033498,1961,978,983,0.4987251402345742,0.5012748597654259
E01016734,1716,836,880,0.48717948717948717,0.5128205128205128
E01016736,1419,648,771,0.45665961945031713,0.5433403805496829
E01016826,1426,698,728,0.4894810659186536,0.5105189340813464
E01034451,1929,964,965,0.4997407983411094,0.5002592016588906
E01034452,2251,1099,1152,0.48822745446468235,0.5117725455353176
E01016752,1698,814,884,0.4793875147232038,0.5206124852767963
E01016753,2217,1081,1136,0.487595850248083,0.5124041497519171
E01016755,1832,912,920,0.4978165938864629,0.5021834061135371
E01033514,1766,895,871,0.5067950169875425,0.4932049830124575
E01033515,2096,1031,1065,0.49188931297709926,0.5081106870229007
E01033517,1604,792,812,0.4937655860349127,0.5062344139650873
E01016754,1663,802,861,0.48226097414311486,0.5177390258568851
E01016756,2269,1083,1186,0.4773027765535478,0.5226972234464522
E01016757,1528,744,784,0.4869109947643979,0.5130890052356021
E01016758,1693,805,888,0.4754873006497342,0.5245126993502658
E01016737,1719,838,881,0.4874927283304247,0.5125072716695753
E01016738,1969,904,1065,0.4591163026917217,0.5408836973082783
E01016739,1488,717,771,0.48185483870967744,0.5181451612903226
E01016740,1428,705,723,0.49369747899159666,0.5063025210084033
E01016741,1662,801,861,0.48194945848375453,0.5180505415162455
E01016748,2131,1027,1104,0.48193336461755043,0.5180666353824496
E01016750,1620,792,828,0.4888888888888889,0.5111111111111111
E01016751,1632,803,829,0.49203431372549017,0.5079656862745098
E01033519,2954,1438,1516,0.4867975626269465,0.5132024373730535
E01033520,1851,909,942,0.49108589951377635,0.5089141004862237
E01016829,1705,790,915,0.4633431085043988,0.5366568914956011
E01016831,1561,752,809,0.4817424727738629,0.518257527226137
E01016832,1228,609,619,0.495928338762215,0.504071661237785
E01016833,1244,611,633,0.49115755627009644,0.5088424437299035
E01016834,1650,810,840,0.4909090909090909,0.509090909090909
E01016710,1995,936,1059,0.4691729323308271,0.530827067669173
E01016714,2252,1107,1145,0.49156305506216696,0.5084369449378331
E01016716,2562,1312,1250,0.5120999219359875,0.4879000780640125
E01016745,1659,811,848,0.48884870403857744,0.5111512959614225
E01016711,2912,1410,1502,0.4842032967032967,0.5157967032967034
E01016713,1730,856,874,0.49479768786127165,0.5052023121387283
E01016715,1768,845,923,0.47794117647058826,0.5220588235294118
E01016830,1228,597,631,0.48615635179153094,0.5138436482084691
E01016742,2013,964,1049,0.47888723298559366,0.5211127670144063
E01016744,1804,868,936,0.4811529933481153,0.5188470066518847
E01016746,1816,857,959,0.47191629955947134,0.5280837004405287
E01034453,1919,959,960,0.49973944762897343,0.5002605523710266
E01034454,1908,933,975,0.4889937106918239,0.5110062893081762
E01034455,1742,835,907,0.4793340987370838,0.5206659012629162
E01033503,2651,1335,1316,0.5035835533760845,0.4964164466239155
E01033511,1762,897,865,0.5090805902383655,0.4909194097616345
E01034456,1796,913,883,0.5083518930957683,0.4916481069042316
E01034457,2069,1007,1062,0.48670855485741904,0.513291445142581
E01033508,2809,1373,1436,0.48878604485582056,0.5112139551441794
E01034458,1851,931,920,0.5029713668287412,0.4970286331712588
E01034459,1895,963,932,0.508179419525066,0.49182058047493404
E01034460,1772,909,863,0.5129796839729119,0.48702031602708806
E01034461,1782,887,895,0.49775533108866443,0.5022446689113356
E01016783,1911,919,992,0.48090005232862376,0.5190999476713762
E01016820,1973,984,989,0.49873289406994425,0.5012671059300557
E01016821,1550,698,852,0.4503225806451613,0.5496774193548387
E01016823,1689,846,843,0.5008880994671403,0.4991119005328597
E01033522,1897,912,985,0.48075909330521877,0.5192409066947812
E01033523,1490,729,761,0.489261744966443,0.5107382550335571
E01034462,1415,675,740,0.47703180212014135,0.5229681978798587
E01034463,1585,769,816,0.48517350157728706,0.5148264984227129
E01034464,1411,705,706,0.49964564138908574,0.5003543586109143
E01034465,1860,905,955,0.48655913978494625,0.5134408602150538
E01016780,1695,848,847,0.5002949852507375,0.49970501474926254
E01016781,1475,742,733,0.5030508474576271,0.4969491525423729
E01034466,2629,1283,1346,0.4880182578927349,0.5119817421072651
E01034467,2097,1011,1086,0.4821173104434907,0.5178826895565093
E01034468,1318,851,467,0.6456752655538694,0.3543247344461305
E01016924,1443,657,786,0.4553014553014553,0.5446985446985447
E01016926,1585,758,827,0.4782334384858044,0.5217665615141955
E01016927,1586,775,811,0.48865069356872637,0.5113493064312736
E01016929,1548,785,763,0.5071059431524548,0.4928940568475452
E01016931,1628,801,827,0.492014742014742,0.507985257985258
E01016898,2330,1116,1214,0.47896995708154505,0.5210300429184549
E01016899,4165,1954,2211,0.46914765906362543,0.5308523409363746
E01016914,2143,939,1204,0.4381707886140924,0.5618292113859076
E01016915,1477,715,762,0.48408937034529453,0.5159106296547055
E01016923,1592,763,829,0.4792713567839196,0.5207286432160804
E01016928,1652,778,874,0.47094430992736075,0.5290556900726392
E01016998,1514,734,780,0.4848084544253633,0.5151915455746368
E01016999,1491,714,777,0.4788732394366197,0.5211267605633803
E01017000,1812,899,913,0.49613686534216334,0.5038631346578366
E01016925,1554,737,817,0.47425997425997424,0.5257400257400258
E01016930,1916,898,1018,0.46868475991649267,0.5313152400835073
E01017001,1553,761,792,0.4900193174500966,0.5099806825499034
E01017003,1619,793,826,0.4898085237801112,0.5101914762198888
E01016916,1439,684,755,0.47533009034051427,0.5246699096594858
E01016917,1421,692,729,0.48698099929627026,0.5130190007037297
E01016918,1419,666,753,0.4693446088794926,0.5306553911205074
E01016919,1319,596,723,0.4518574677786202,0.5481425322213799
E01016920,1557,732,825,0.4701348747591522,0.5298651252408478
E01016882,1540,715,825,0.4642857142857143,0.5357142857142857
E01016883,1515,734,781,0.4844884488448845,0.5155115511551155
E01016884,1689,835,854,0.49437537004144466,0.5056246299585554
E01016885,1419,666,753,0.4693446088794926,0.5306553911205074
E01016886,1588,800,788,0.5037783375314862,0.49622166246851385
E01016980,1673,822,851,0.4913329348475792,0.5086670651524208
E01016982,1319,647,672,0.49052312357846856,0.5094768764215315
E01016983,1494,734,760,0.49129852744310576,0.5087014725568942
E01016984,1517,752,765,0.4957152274225445,0.5042847725774555
E01016985,1581,788,793,0.49841872232764073,0.5015812776723593
E01016900,1631,788,843,0.48313917841814835,0.5168608215818516
E01016902,1590,773,817,0.4861635220125786,0.5138364779874214
E01016904,1883,895,988,0.4753053637812002,0.5246946362187997
E01016905,1710,855,855,0.5,0.5
E01016909,1734,839,895,0.48385236447520186,0.5161476355247981
E01016906,1651,767,884,0.4645669291338583,0.5354330708661418
E01016907,1770,906,864,0.511864406779661,0.488135593220339
E01016908,1544,770,774,0.49870466321243523,0.5012953367875648
E01016910,1391,671,720,0.4823867721063983,0.5176132278936018
E01016911,1493,741,752,0.49631614199598123,0.5036838580040187
E01016901,1704,823,881,0.482981220657277,0.517018779342723
E01016903,1865,891,974,0.47774798927613943,0.5222520107238606
E01016934,1323,626,697,0.47316704459561604,0.526832955404384
E01016939,1592,764,828,0.4798994974874372,0.5201005025125628
E01016940,1583,767,816,0.4845230574857865,0.5154769425142135
E01016981,1651,803,848,0.4863718958207147,0.5136281041792853
E01017002,1692,850,842,0.5023640661938534,0.49763593380614657
E01017004,1696,822,874,0.4846698113207547,0.5153301886792453
E01017005,1704,830,874,0.48708920187793425,0.5129107981220657
E01017006,1639,817,822,0.4984746796827334,0.5015253203172666
E01016921,1659,774,885,0.4665461121157324,0.5334538878842676
E01016922,1315,636,679,0.48365019011406846,0.5163498098859316
E01016973,1524,737,787,0.4835958005249344,0.5164041994750657
E01016977,1587,759,828,0.4782608695652174,0.5217391304347826
E01016978,1695,871,824,0.5138643067846608,0.4861356932153392
E01016879,1538,726,812,0.4720416124837451,0.5279583875162549
E01016880,1387,665,722,0.4794520547945205,0.5205479452054794
E01016881,1552,786,766,0.5064432989690721,0.49355670103092786
E01016887,1471,699,772,0.4751869476546567,0.5248130523453433
E01016888,1528,708,820,0.46335078534031415,0.5366492146596858
E01016976,1604,780,824,0.486284289276808,0.513715710723192
E01016932,1593,776,817,0.48713119899560575,0.5128688010043942
E01016933,1406,685,721,0.4871977240398293,0.5128022759601707
E01016935,1607,783,824,0.48724331051649034,0.5127566894835096
E01016936,1810,907,903,0.5011049723756906,0.4988950276243094
E01016937,2140,1063,1077,0.49672897196261684,0.5032710280373832
E01016890,1905,927,978,0.48661417322834644,0.5133858267716536
E01016966,1730,843,887,0.48728323699421966,0.5127167630057804
E01016970,1617,764,853,0.47247990105132964,0.5275200989486704
E01016971,1960,959,1001,0.48928571428571427,0.5107142857142857
E01016972,1755,860,895,0.49002849002849,0.50997150997151
E01016979,1837,935,902,0.5089820359281437,0.49101796407185627
E01016990,1689,812,877,0.4807578448786264,0.5192421551213736
E01016991,1739,821,918,0.47211040828062106,0.527889591719379
E01016996,1898,927,971,0.48840885142255,0.5115911485774499
E01017007,1595,779,816,0.4884012539184953,0.5115987460815047
E01017008,1724,812,912,0.4709976798143852,0.5290023201856149
E01017009,1507,720,787,0.47777040477770405,0.522229595222296
E01017010,1782,871,911,0.4887766554433221,0.5112233445566778
E01017011,1375,655,720,0.4763636363636364,0.5236363636363637
E01017012,1790,877,913,0.4899441340782123,0.5100558659217878
E01016892,1680,793,887,0.4720238095238095,0.5279761904761905
E01016893,1845,877,968,0.4753387533875339,0.5246612466124662
E01016912,1937,910,1027,0.4697986577181208,0.5302013422818792
E01016913,1747,880,867,0.5037206639954207,0.4962793360045793
E01016946,1500,731,769,0.48733333333333334,0.5126666666666667
E01016860,1683,825,858,0.49019607843137253,0.5098039215686274
E01016871,1767,908,859,0.5138653084323712,0.48613469156762873
E01016872,1790,835,955,0.4664804469273743,0.5335195530726257
E01016873,1799,857,942,0.4763757643135075,0.5236242356864925
E01016878,1850,898,952,0.4854054054054054,0.5145945945945946
E01016870,1608,771,837,0.47947761194029853,0.5205223880597015
E01016874,1906,940,966,0.4931794333683106,0.5068205666316894
E01016875,1540,763,777,0.4954545454545455,0.5045454545454545
E01016876,1793,868,925,0.4841048522030117,0.5158951477969883
E01016877,1804,874,930,0.4844789356984479,0.5155210643015521
E01016974,1853,880,973,0.4749055585536967,0.5250944414463032
E01016975,1634,783,851,0.4791921664626683,0.5208078335373317
E01016992,1768,847,921,0.47907239819004527,0.5209276018099548
E01016994,1723,813,910,0.4718514219384794,0.5281485780615206
E01016997,1668,789,879,0.47302158273381295,0.5269784172661871
E01016889,1770,815,955,0.4604519774011299,0.53954802259887
E01016891,1880,882,998,0.46914893617021275,0.5308510638297872
E01016894,1915,879,1036,0.4590078328981723,0.5409921671018276
E01016896,1684,805,879,0.47802850356294535,0.5219714964370546
E01016897,1708,808,900,0.47306791569086654,0.5269320843091335
E01016987,1723,789,934,0.4579222286709228,0.5420777713290772
E01016989,1489,713,776,0.4788448623237072,0.5211551376762928
E01016993,1555,706,849,0.45401929260450163,0.5459807073954984
E01016995,1720,838,882,0.4872093023255814,0.5127906976744186
E01016938,1942,974,968,0.5015447991761071,0.4984552008238929
E01016950,1765,900,865,0.509915014164306,0.49008498583569404
E01016951,1562,819,743,0.5243277848911652,0.47567221510883484
E01016967,1782,924,858,0.5185185185185185,0.48148148148148145
E01016968,1415,734,681,0.5187279151943462,0.4812720848056537
E01016864,1491,730,761,0.48960429242119385,0.5103957075788061
E01016865,1513,687,826,0.4540647719762062,0.5459352280237938
E01016866,1500,717,783,0.478,0.522
E01016867,1344,677,667,0.5037202380952381,0.4962797619047619
E01016868,1609,764,845,0.4748290863890615,0.5251709136109385
E01016895,1632,783,849,0.4797794117647059,0.5202205882352942
E01016849,1528,798,730,0.5222513089005235,0.47774869109947643
E01016852,1579,764,815,0.4838505383153895,0.5161494616846105
E01016853,1869,894,975,0.478330658105939,0.521669341894061
E01016855,1576,725,851,0.4600253807106599,0.5399746192893401
E01016856,1628,848,780,0.5208845208845209,0.47911547911547914
E01016952,1783,967,816,0.5423443634324173,0.45765563656758274
E01016953,1545,760,785,0.4919093851132686,0.5080906148867314
E01016964,2423,1279,1144,0.5278580272389599,0.47214197276104003
E01016969,1846,950,896,0.514626218851571,0.48537378114842905
E01033328,1280,648,632,0.50625,0.49375
E01033329,1860,980,880,0.5268817204301075,0.4731182795698925
E01016857,1580,766,814,0.48481012658227846,0.5151898734177215
E01016858,1463,697,766,0.4764183185235817,0.5235816814764184
E01016859,1388,693,695,0.4992795389048991,0.5007204610951008
E01016986,1632,776,856,0.47549019607843135,0.5245098039215687
E01016988,1514,725,789,0.47886393659180976,0.5211360634081902
E01016850,1614,828,786,0.5130111524163569,0.48698884758364314
E01016851,1725,909,816,0.5269565217391304,0.47304347826086957
E01016854,1601,796,805,0.4971892567145534,0.5028107432854466
E01016954,1674,871,803,0.5203106332138591,0.479689366786141
E01016955,1624,886,738,0.5455665024630542,0.4544334975369458
E01016941,1949,1096,853,0.5623396613648025,0.43766033863519754
E01016945,1574,849,725,0.5393900889453621,0.4606099110546379
E01016947,2126,1008,1118,0.47412982126058323,0.5258701787394168
E01016948,1788,883,905,0.49384787472035796,0.506152125279642
E01016949,1734,894,840,0.5155709342560554,0.4844290657439446
E01016861,1555,827,728,0.5318327974276528,0.4681672025723473
E01016862,1547,827,720,0.5345830639948287,0.4654169360051713
E01016942,1893,976,917,0.5155837295298468,0.4844162704701532
E01016943,1469,740,729,0.5037440435670524,0.49625595643294756
E01016944,1614,912,702,0.5650557620817844,0.4349442379182156
E01016863,1743,919,824,0.5272518646012622,0.47274813539873783
E01016869,1928,928,1000,0.48132780082987553,0.5186721991701245
E01016957,2205,1118,1087,0.5070294784580499,0.4929705215419501
E01016963,1930,990,940,0.5129533678756477,0.48704663212435234
E01016956,1545,743,802,0.4809061488673139,0.5190938511326861
E01016958,1811,872,939,0.4815019326339039,0.518498067366096
E01016959,1466,714,752,0.4870395634379263,0.5129604365620737
E01016960,1716,830,886,0.4836829836829837,0.5163170163170163
E01016961,1973,973,1000,0.4931576279776989,0.5068423720223011
E01016962,1647,758,889,0.4602307225258045,0.5397692774741955
E01017112,1857,900,957,0.48465266558966075,0.5153473344103393
E01017115,1384,656,728,0.47398843930635837,0.5260115606936416
E01017117,1527,740,787,0.48461034708578915,0.5153896529142109
E01017119,1681,814,867,0.4842355740630577,0.5157644259369423
E01017120,1666,810,856,0.48619447779111646,0.5138055222088835
E01017051,2157,1016,1141,0.4710245711636532,0.5289754288363467
E01017052,1479,693,786,0.4685598377281947,0.5314401622718052
E01017053,1299,606,693,0.4665127020785219,0.5334872979214781
E01017118,1505,718,787,0.4770764119601329,0.5229235880398672
E01017050,1720,839,881,0.4877906976744186,0.5122093023255814
E01017061,1695,850,845,0.5014749262536873,0.49852507374631266
E01017063,1560,736,824,0.4717948717948718,0.5282051282051282
E01017064,1856,879,977,0.4735991379310345,0.5264008620689655
E01017054,1423,700,723,0.49191848208011246,0.5080815179198875
E01017113,1660,807,853,0.48614457831325303,0.513855421686747
E01017114,1468,757,711,0.5156675749318801,0.4843324250681199
E01017116,1828,880,948,0.4814004376367615,0.5185995623632386
E01017055,1602,742,860,0.4631710362047441,0.5368289637952559
E01017056,1354,670,684,0.4948301329394387,0.5051698670605613
E01017057,1499,739,760,0.49299533022014674,0.5070046697798533
E01017058,1911,904,1007,0.4730507587650445,0.5269492412349556
E01017060,1962,925,1037,0.47145769622833844,0.5285423037716616
E01017086,1341,680,661,0.5070842654735273,0.4929157345264728
E01017089,1602,766,836,0.4781523096129838,0.5218476903870163
E01017090,1777,856,921,0.48171074845244793,0.518289251547552
E01017091,1647,782,865,0.474802671523983,0.525197328476017
E01017092,1498,756,742,0.5046728971962616,0.4953271028037383
E01017014,1544,765,779,0.4954663212435233,0.5045336787564767
E01017046,1615,817,798,0.5058823529411764,0.49411764705882355
E01017047,1657,814,843,0.4912492456246228,0.5087507543753772
E01017048,1501,749,752,0.4990006662225183,0.5009993337774816
E01017085,1403,667,736,0.47540983606557374,0.5245901639344263
E01017084,1433,714,719,0.4982554082344731,0.5017445917655269
E01017087,1415,707,708,0.49964664310954066,0.5003533568904593
E01017088,1813,901,912,0.49696635410921125,0.5030336458907887
E01017105,1576,783,793,0.49682741116751267,0.5031725888324873
E01017107,1636,796,840,0.48655256723716384,0.5134474327628362
E01017104,1222,602,620,0.49263502454991814,0.5073649754500819
E01017106,1519,705,814,0.4641211323238973,0.5358788676761027
E01017108,1591,786,805,0.4940289126335638,0.5059710873664363
E01017109,1453,704,749,0.4845147969717825,0.5154852030282174
E01017041,1425,697,728,0.48912280701754385,0.5108771929824562
E01017043,1341,678,663,0.5055928411633109,0.49440715883668906
E01017044,1489,730,759,0.49026192075218267,0.5097380792478173
E01017049,1534,770,764,0.5019556714471969,0.4980443285528031
E01017110,1476,748,728,0.5067750677506775,0.4932249322493225
E01017111,1630,819,811,0.5024539877300613,0.49754601226993866
E01017013,1793,868,925,0.4841048522030117,0.5158951477969883
E01017042,1473,723,750,0.4908350305498982,0.5091649694501018
E01017045,1266,651,615,0.514218009478673,0.48578199052132703
E01017075,1601,774,827,0.4834478450968145,0.5165521549031855
E01017082,1785,904,881,0.5064425770308123,0.4935574229691877
E01017083,1746,880,866,0.5040091638029782,0.4959908361970218
E01017036,1546,748,798,0.48382923673997413,0.5161707632600259
E01017037,1667,764,903,0.45830833833233353,0.5416916616676665
E01017038,1770,857,913,0.48418079096045197,0.515819209039548
E01017102,1732,838,894,0.4838337182448037,0.5161662817551963
E01017103,1297,595,702,0.45875096376252894,0.5412490362374711
E01017015,1474,727,747,0.4932157394843962,0.5067842605156038
E01017016,1588,774,814,0.48740554156171284,0.5125944584382871
E01017017,1452,734,718,0.5055096418732782,0.49449035812672176
E01017018,1592,772,820,0.4849246231155779,0.5150753768844221
E01017019,1782,880,902,0.49382716049382713,0.5061728395061729
E01017020,2373,1158,1215,0.4879898862199747,0.5120101137800253
E01017076,1733,848,885,0.4893248701673399,0.5106751298326602
E01017077,1789,896,893,0.5008384572386808,0.4991615427613192
E01017078,1569,765,804,0.4875717017208413,0.5124282982791587
E01017079,1564,795,769,0.5083120204603581,0.49168797953964194
E01017080,2052,1098,954,0.5350877192982456,0.4649122807017544
E01017081,1648,826,822,0.5012135922330098,0.4987864077669903
E01017021,1420,644,776,0.4535211267605634,0.5464788732394367
E01017093,1114,525,589,0.47127468581687615,0.5287253141831239
E01017096,1387,666,721,0.4801730353280461,0.5198269646719539
E01017099,2637,1303,1334,0.49412210845657945,0.5058778915434206
E01017100,1369,689,680,0.5032870708546384,0.4967129291453616
E01017101,1507,750,757,0.49767750497677504,0.5023224950232249
E01017035,1753,839,914,0.47860810039931545,0.5213918996006845
E01017128,1715,907,808,0.5288629737609329,0.47113702623906706
E01017129,1909,1030,879,0.5395495023572551,0.46045049764274487
E01017130,2278,1064,1214,0.46707638279192276,0.5329236172080772
E01017132,1622,779,843,0.4802712700369914,0.5197287299630087
E01017133,1661,805,856,0.48464780252859724,0.5153521974714028
E01017023,1636,819,817,0.5006112469437652,0.4993887530562347
E01017025,1983,1033,950,0.5209278870398386,0.4790721129601614
E01017026,1727,881,846,0.5101331789229878,0.4898668210770122
E01017029,1657,813,844,0.49064574532287264,0.5093542546771274
E01017030,1828,950,878,0.5196936542669585,0.4803063457330416
E01017022,1387,724,663,0.5219899062725306,0.47801009372746933
E01017024,1881,994,887,0.5284423179160022,0.4715576820839979
E01017027,1693,878,815,0.5186060248080331,0.4813939751919669
E01017028,2193,1156,1037,0.5271317829457365,0.4728682170542636
E01017124,1629,819,810,0.5027624309392266,0.4972375690607735
E01017094,1481,759,722,0.512491559756921,0.487508440243079
E01017095,1801,846,955,0.4697390338700722,0.5302609661299278
E01017097,1565,750,815,0.4792332268370607,0.5207667731629393
E01017098,1472,706,766,0.4796195652173913,0.5203804347826086
E01017122,1684,876,808,0.5201900237529691,0.47980997624703087
E01017125,1637,827,810,0.5051924251679902,0.49480757483200977
E01017127,1814,980,834,0.5402425578831312,0.4597574421168688
E01017135,1613,813,800,0.5040297582145071,0.49597024178549287
E01017067,1433,703,730,0.49057920446615494,0.5094207955338451
E01017068,1691,834,857,0.4931992903607333,0.5068007096392667
E01017069,1512,722,790,0.4775132275132275,0.5224867724867724
E01017070,1475,740,735,0.5016949152542373,0.49830508474576274
E01017074,1819,912,907,0.5013743815283123,0.49862561847168774
E01017073,1817,914,903,0.5030269675288938,0.49697303247110625
E01017123,1948,1026,922,0.526694045174538,0.473305954825462
E01017131,1839,955,884,0.5193039695486678,0.48069603045133225
E01033380,1144,631,513,0.5515734265734266,0.44842657342657344
E01033384,1341,710,631,0.5294556301267711,0.47054436987322895
E01017071,1421,752,669,0.5292047853624209,0.4707952146375792
E01017072,1413,683,730,0.48336871903750883,0.5166312809624911
E01017121,1627,828,799,0.5089121081745543,0.4910878918254456
E01017126,1704,859,845,0.5041079812206573,0.49589201877934275
E01017059,1597,754,843,0.47213525360050096,0.5278647463994991
E01017062,1667,840,827,0.5038992201559688,0.49610077984403117
E01017066,1874,912,962,0.48665955176093917,0.5133404482390609
E01032604,1520,764,756,0.5026315789473684,0.49736842105263157
E01017032,4913,2607,2306,0.5306330144514553,0.46936698554854467
E01017034,2593,1322,1271,0.5098341689163132,0.49016583108368683
E01033381,1478,793,685,0.5365358592692828,0.4634641407307172
E01033383,1291,634,657,0.49109217660728116,0.5089078233927188
E01017031,1959,990,969,0.5053598774885145,0.4946401225114854
E01017039,1856,910,946,0.49030172413793105,0.509698275862069
E01017040,1497,695,802,0.4642618570474282,0.5357381429525718
E01017144,1073,547,526,0.5097856477166822,0.4902143522833178
E01017145,1531,739,792,0.48269105160026127,0.5173089483997387
E01017146,2723,1396,1327,0.5126698494307749,0.48733015056922513
E01017148,1727,832,895,0.48176027793862186,0.5182397220613781
E01017149,1440,764,676,0.5305555555555556,0.46944444444444444
E01017180,1432,710,722,0.4958100558659218,0.5041899441340782
E01017181,1394,669,725,0.4799139167862267,0.5200860832137734
E01017183,1637,807,830,0.49297495418448384,0.5070250458155162
E01017185,1730,847,883,0.48959537572254336,0.5104046242774567
E01017187,1695,814,881,0.48023598820059,0.51976401179941
E01017264,2423,1380,1043,0.5695418902187371,0.4304581097812629
E01017265,1606,784,822,0.48816936488169366,0.5118306351183064
E01017270,1344,689,655,0.5126488095238095,0.48735119047619047
E01017271,1114,556,558,0.4991023339317774,0.5008976660682226
E01017182,1370,649,721,0.4737226277372263,0.5262773722627737
E01017184,1405,678,727,0.4825622775800712,0.5174377224199288
E01017186,1706,865,841,0.5070339976553341,0.49296600234466587
E01017188,1652,797,855,0.4824455205811138,0.5175544794188862
E01017266,1442,753,689,0.5221914008321775,0.4778085991678225
E01017267,1292,700,592,0.541795665634675,0.4582043343653251
E01017272,1431,699,732,0.48846960167714887,0.5115303983228512
E01035442,1768,959,809,0.542420814479638,0.457579185520362
E01035443,1342,720,622,0.5365126676602087,0.46348733233979134
E01017147,1385,660,725,0.47653429602888087,0.5234657039711191
E01017150,1537,784,753,0.5100845803513337,0.48991541964866625
E01017151,1589,756,833,0.47577092511013214,0.5242290748898678
E01017152,1561,746,815,0.47789878283151827,0.5221012171684818
E01017238,2056,985,1071,0.4790856031128405,0.5209143968871596
E01017241,1462,719,743,0.49179206566347466,0.5082079343365253
E01017242,2007,962,1045,0.47932237169905334,0.5206776283009467
E01017243,1715,883,832,0.5148688046647231,0.485131195335277
E01017244,1463,725,738,0.4955570745044429,0.504442925495557
E01017174,1423,690,733,0.4848910751932537,0.5151089248067463
E01017175,1504,763,741,0.507313829787234,0.49268617021276595
E01017176,1571,795,776,0.5060471037555697,0.4939528962444303
E01017179,1255,598,657,0.47649402390438245,0.5235059760956176
E01017226,1608,795,813,0.4944029850746269,0.5055970149253731
E01017231,1729,905,824,0.523423944476576,0.47657605552342397
E01017232,1252,622,630,0.4968051118210863,0.5031948881789138
E01032753,2210,1134,1076,0.5131221719457013,0.48687782805429863
E01017246,2181,1071,1110,0.49105914718019256,0.5089408528198074
E01017250,1651,777,874,0.47062386432465175,0.5293761356753482
E01017251,1625,774,851,0.4763076923076923,0.5236923076923077
E01017253,1790,900,890,0.5027932960893855,0.4972067039106145
E01017247,1651,789,862,0.4778921865536039,0.5221078134463961
E01017248,1565,762,803,0.48690095846645365,0.5130990415335464
E01017249,1321,651,670,0.4928084784254353,0.5071915215745647
E01017252,1567,764,803,0.48755583918315254,0.5124441608168475
E01017254,1733,861,872,0.49682631275245237,0.5031736872475476
E01017236,1437,707,730,0.4919972164231037,0.5080027835768963
E01017237,1596,785,811,0.4918546365914787,0.5081453634085213
E01017239,1498,727,771,0.48531375166889185,0.5146862483311081
E01017240,1366,680,686,0.4978038067349927,0.5021961932650073
E01017245,1571,745,826,0.47422024188415024,0.5257797581158498
E01017227,1177,607,570,0.5157179269328802,0.4842820730671198
E01017228,1478,761,717,0.5148849797023004,0.4851150202976996
E01017233,1613,807,806,0.5003099814011159,0.49969001859888407
E01017234,2127,1064,1063,0.5002350728725905,0.4997649271274095
E01017235,1528,813,715,0.5320680628272252,0.46793193717277487
E01017171,1862,952,910,0.5112781954887218,0.48872180451127817
E01017172,1851,925,926,0.4997298757428417,0.5002701242571583
E01017173,1519,752,767,0.4950625411454905,0.5049374588545096
E01017177,1582,764,818,0.4829329962073325,0.5170670037926675
E01017178,1504,742,762,0.4933510638297872,0.5066489361702128
E01017207,1678,814,864,0.48510131108462456,0.5148986889153755
E01017209,1407,681,726,0.4840085287846482,0.5159914712153518
E01017211,1685,812,873,0.48189910979228484,0.5181008902077151
E01017212,1453,727,726,0.5003441156228493,0.49965588437715075
E01017213,1795,912,883,0.5080779944289694,0.49192200557103066
E01017200,1846,875,971,0.4739978331527627,0.5260021668472372
E01017201,1268,574,694,0.4526813880126183,0.5473186119873817
E01017202,1737,804,933,0.46286701208981,0.5371329879101899
E01017203,1671,828,843,0.4955116696588869,0.5044883303411131
E01017204,1564,764,800,0.4884910485933504,0.5115089514066496
E01017157,1658,890,768,0.5367913148371531,0.4632086851628468
E01017158,2113,1138,975,0.538570752484619,0.461429247515381
E01017159,1484,824,660,0.555256064690027,0.444743935309973
E01017160,1504,777,727,0.5166223404255319,0.4833776595744681
E01017198,1480,705,775,0.47635135135135137,0.5236486486486487
E01017199,1601,743,858,0.46408494690818236,0.5359150530918176
E01017205,1644,806,838,0.4902676399026764,0.5097323600973236
E01017206,1674,817,857,0.48805256869773,0.51194743130227
E01017208,1507,720,787,0.47777040477770405,0.522229595222296
E01017210,1813,866,947,0.47766133480419193,0.5223386651958081
E01017214,1525,780,745,0.5114754098360655,0.4885245901639344
E01017215,1807,910,897,0.5035971223021583,0.49640287769784175
E01017216,1413,721,692,0.5102618542108988,0.4897381457891012
E01017189,1467,796,671,0.5426039536468984,0.45739604635310155
E01017190,1595,810,785,0.5078369905956113,0.49216300940438873
E01017191,1701,905,796,0.5320399764844209,0.4679600235155791
E01017196,2098,1068,1030,0.5090562440419447,0.4909437559580553
E01017197,1405,722,683,0.5138790035587188,0.48612099644128115
E01017192,2041,1050,991,0.514453699167075,0.48554630083292505
E01017193,1757,909,848,0.5173591348890154,0.48264086511098464
E01017194,2074,1114,960,0.5371263259402121,0.46287367405978785
E01017195,1944,979,965,0.5036008230452675,0.4963991769547325
E01017153,1874,1001,873,0.5341515474919958,0.4658484525080043
E01017154,2560,1347,1213,0.526171875,0.473828125
E01017155,1824,997,827,0.5466008771929824,0.45339912280701755
E01017156,1827,997,830,0.5457033388067871,0.45429666119321294
E01032738,1951,1016,935,0.5207585853408508,0.47924141465914916
E01032750,1573,876,697,0.5568976478067387,0.4431023521932613
E01017136,1962,984,978,0.5015290519877675,0.4984709480122324
E01017137,1479,816,663,0.5517241379310345,0.4482758620689655
E01017138,2165,1145,1020,0.5288683602771362,0.47113163972286376
E01035444,1556,752,804,0.4832904884318766,0.5167095115681234
E01035445,1804,922,882,0.5110864745011087,0.48891352549889133
E01017217,1596,792,804,0.49624060150375937,0.5037593984962406
E01017223,1667,864,803,0.5182963407318536,0.48170365926814634
E01017224,1368,663,705,0.48464912280701755,0.5153508771929824
E01017225,1548,758,790,0.4896640826873385,0.5103359173126615
E01017162,1420,681,739,0.4795774647887324,0.5204225352112676
E01017163,1555,724,831,0.46559485530546624,0.5344051446945337
E01017164,1589,779,810,0.49024543738200127,0.5097545626179988
E01017165,1550,739,811,0.47677419354838707,0.5232258064516129
E01017166,1763,822,941,0.46625070901871807,0.5337492909812819
E01017256,2086,1024,1062,0.49089165867689355,0.5091083413231065
E01017257,1573,823,750,0.5232040686586141,0.47679593134138587
E01017259,1361,677,684,0.49742836149889785,0.5025716385011021
E01017260,1343,667,676,0.49664929262844376,0.5033507073715562
E01017262,1297,638,659,0.4919043947571318,0.5080956052428681
E01017167,1654,811,843,0.49032648125755746,0.5096735187424426
E01017168,1692,808,884,0.47754137115839246,0.5224586288416075
E01017169,1591,735,856,0.4619736015084852,0.5380263984915148
E01017170,1597,782,815,0.48966812773951157,0.5103318722604884
E01017218,1342,673,669,0.5014903129657228,0.49850968703427717
E01017219,1864,904,960,0.48497854077253216,0.5150214592274678
E01017220,1805,885,920,0.4903047091412742,0.5096952908587258
E01017221,1652,807,845,0.48849878934624696,0.511501210653753
E01017222,1463,742,721,0.507177033492823,0.49282296650717705
E01017255,1606,792,814,0.4931506849315068,0.5068493150684932
E01017258,1510,761,749,0.5039735099337749,0.4960264900662252
E01017261,1669,836,833,0.5008987417615338,0.49910125823846613
E01017263,1553,769,784,0.4951706374758532,0.5048293625241468
E01017273,1538,771,767,0.5013003901170351,0.4986996098829649
E01017275,1698,823,875,0.48468786808009423,0.5153121319199058
E01017276,1883,952,931,0.5055762081784386,0.4944237918215613
E01017279,1633,772,861,0.47274954072259645,0.5272504592774035
E01035446,1237,600,637,0.4850444624090542,0.5149555375909458
E01035447,1596,775,821,0.4855889724310777,0.5144110275689223
E01017274,1474,684,790,0.46404341926729986,0.5359565807327001
E01017277,1501,723,778,0.4816788807461692,0.5183211192538307
E01017280,1690,833,857,0.4928994082840237,0.5071005917159763
E01017281,1537,780,757,0.5074821080026025,0.49251789199739754
E01017139,2833,1504,1329,0.5308859865866572,0.46911401341334275
E01032745,2969,1576,1393,0.5308184573930617,0.46918154260693834
E01032751,1797,941,856,0.523650528658876,0.4763494713411241
E01032755,1143,621,522,0.5433070866141733,0.4566929133858268
E01032746,1288,690,598,0.5357142857142857,0.4642857142857143
E01032748,1898,1066,832,0.5616438356164384,0.4383561643835616
E01035448,1036,574,462,0.5540540540540541,0.44594594594594594
E01035449,1079,579,500,0.5366079703429101,0.4633920296570899
E01017300,2151,1046,1105,0.48628544862854484,0.5137145513714552
E01017303,1187,567,620,0.4776748104465038,0.5223251895534962
E01017305,1524,733,791,0.4809711286089239,0.5190288713910761
E01017306,1368,647,721,0.472953216374269,0.527046783625731
E01017309,1571,755,816,0.4805856142584341,0.5194143857415658
E01017301,1073,511,562,0.4762348555452004,0.5237651444547996
E01017302,1755,822,933,0.4683760683760684,0.5316239316239316
E01017304,1388,646,742,0.4654178674351585,0.5345821325648416
E01017316,2088,1030,1058,0.4932950191570881,0.5067049808429118
E01017329,2279,1098,1181,0.4817902588854761,0.5182097411145239
E01017307,2351,1126,1225,0.4789451297320289,0.521054870267971
E01017308,1736,851,885,0.4902073732718894,0.5097926267281107
E01033229,1858,916,942,0.4930032292787944,0.5069967707212056
E01033237,1762,852,910,0.48354143019296253,0.5164585698070374
E01017335,1523,772,751,0.5068942875902823,0.4931057124097177
E01017336,1613,836,777,0.51828890266584,0.48171109733415995
E01017337,1607,787,820,0.4897324206596142,0.5102675793403858
E01017346,1382,686,696,0.4963820549927641,0.5036179450072359
E01017286,1592,792,800,0.49748743718592964,0.5025125628140703
E01017287,1617,748,869,0.46258503401360546,0.5374149659863946
E01017367,1874,879,995,0.46905016008537886,0.5309498399146211
E01017368,1515,710,805,0.46864686468646866,0.5313531353135313
E01017282,1380,668,712,0.48405797101449277,0.5159420289855072
E01017283,1665,807,858,0.4846846846846847,0.5153153153153153
E01017338,1396,663,733,0.47492836676217765,0.5250716332378224
E01017341,1620,761,859,0.4697530864197531,0.5302469135802469
E01017342,1628,748,880,0.4594594594594595,0.5405405405405406
E01017339,1811,865,946,0.47763666482606293,0.5223633351739371
E01017340,1812,834,978,0.4602649006622517,0.5397350993377483
E01017343,1355,674,681,0.4974169741697417,0.5025830258302583
E01017344,1694,820,874,0.48406139315230223,0.5159386068476978
E01017345,1901,916,985,0.4818516570226197,0.5181483429773803
E01017310,1496,718,778,0.4799465240641711,0.5200534759358288
E01017311,1548,759,789,0.4903100775193798,0.5096899224806202
E01017331,2273,1126,1147,0.49538055433348,0.5046194456665201
E01017332,1968,937,1031,0.4761178861788618,0.5238821138211383
E01017334,1981,1375,606,0.6940938919737506,0.30590610802624935
E01017295,1360,625,735,0.45955882352941174,0.5404411764705882
E01017325,1254,601,653,0.47926634768740034,0.5207336523125997
E01017326,1610,807,803,0.5012422360248447,0.49875776397515525
E01017328,1418,704,714,0.49647390691114246,0.5035260930888575
E01017333,1769,889,880,0.5025438100621821,0.497456189937818
E01017284,1580,727,853,0.460126582278481,0.539873417721519
E01017285,1981,943,1038,0.47602221100454317,0.5239777889954569
E01017288,1243,608,635,0.4891391794046661,0.5108608205953339
E01017351,1417,702,715,0.4954128440366973,0.5045871559633027
E01017352,1105,519,586,0.46968325791855203,0.530316742081448
E01017292,1783,859,924,0.4817722938867078,0.5182277061132922
E01017293,1948,953,995,0.48921971252566737,0.5107802874743327
E01017296,1314,632,682,0.4809741248097412,0.5190258751902588
E01017321,1410,671,739,0.47588652482269506,0.524113475177305
E01017322,1433,690,743,0.48150732728541523,0.5184926727145848
E01017327,1528,757,771,0.4954188481675393,0.5045811518324608
E01017312,1799,821,978,0.4563646470261256,0.5436353529738743
E01017315,1526,730,796,0.4783748361730013,0.5216251638269986
E01017354,1091,522,569,0.4784601283226398,0.5215398716773603
E01017361,1448,684,764,0.4723756906077348,0.5276243093922652
E01017362,1512,740,772,0.4894179894179894,0.5105820105820106
E01033239,2313,1103,1210,0.47686986597492437,0.5231301340250757
E01017290,1227,613,614,0.49959250203748984,0.5004074979625102
E01017291,1177,528,649,0.4485981308411215,0.5514018691588785
E01017294,1595,774,821,0.4852664576802508,0.5147335423197492
E01017353,1260,625,635,0.49603174603174605,0.503968253968254
E01017289,2172,1048,1124,0.48250460405156537,0.5174953959484346
E01017347,1770,829,941,0.46836158192090394,0.5316384180790961
E01017348,1418,664,754,0.4682651622002821,0.5317348377997179
E01017349,2105,1044,1061,0.49596199524940615,0.5040380047505938
E01017350,1835,871,964,0.47465940054495914,0.5253405994550409
E01017317,1451,701,750,0.48311509303928324,0.5168849069607168
E01017320,1079,505,574,0.4680259499536608,0.5319740500463392
E01017323,1166,578,588,0.4957118353344768,0.5042881646655232
E01017324,1467,714,753,0.4867075664621677,0.5132924335378323
E01017355,1564,759,805,0.4852941176470588,0.5147058823529411
E01017358,1293,605,688,0.46790409899458624,0.5320959010054138
E01017318,1172,547,625,0.4667235494880546,0.5332764505119454
E01017319,1276,580,696,0.45454545454545453,0.5454545454545454
E01017356,1539,732,807,0.4756335282651072,0.5243664717348928
E01017357,1470,730,740,0.4965986394557823,0.5034013605442177
E01017359,1508,723,785,0.47944297082228116,0.5205570291777188
E01017360,1748,867,881,0.4959954233409611,0.5040045766590389
E01017297,1446,707,739,0.48893499308437066,0.5110650069156293
E01017298,1526,734,792,0.48099606815203144,0.5190039318479686
E01017299,1245,612,633,0.491566265060241,0.5084337349397591
E01017369,1484,719,765,0.48450134770889486,0.5154986522911051
E01017363,1407,683,724,0.48542999289267946,0.5145700071073206
E01017364,1327,642,685,0.48379804069329313,0.5162019593067069
E01017365,1376,678,698,0.49273255813953487,0.5072674418604651
E01017366,1455,693,762,0.4762886597938144,0.5237113402061856
E01017370,1709,812,897,0.4751316559391457,0.5248683440608543
E01017648,1644,817,827,0.49695863746958635,0.5030413625304136
E01017649,2504,1199,1305,0.4788338658146965,0.5211661341853036
E01033951,1599,859,740,0.5372107567229518,0.4627892432770482
E01033952,1413,654,759,0.46284501061571126,0.5371549893842887
E01033953,1681,812,869,0.4830458060678168,0.5169541939321832
E01033954,1713,853,860,0.4979568009340339,0.5020431990659662
E01017644,1464,719,745,0.491120218579235,0.5088797814207651
E01017645,1432,702,730,0.49022346368715086,0.5097765363128491
E01017646,2320,1116,1204,0.4810344827586207,0.5189655172413793
E01017647,1539,731,808,0.47498375568551005,0.5250162443144899
E01017671,1609,791,818,0.4916096954630205,0.5083903045369795
E01017672,1582,785,797,0.49620733249051835,0.5037926675094817
E01017695,1214,576,638,0.4744645799011532,0.5255354200988468
E01017696,1385,675,710,0.48736462093862815,0.5126353790613718
E01017693,1122,582,540,0.5187165775401069,0.48128342245989303
E01017694,2469,1190,1279,0.4819765087079789,0.5180234912920211
E01017713,1423,711,712,0.49964862965565704,0.500351370344343
E01017714,1668,812,856,0.486810551558753,0.513189448441247
E01017717,1775,863,912,0.48619718309859156,0.5138028169014085
E01017718,1905,932,973,0.48923884514435695,0.510761154855643
E01017735,1403,688,715,0.4903777619387028,0.5096222380612973
E01017736,1524,711,813,0.46653543307086615,0.5334645669291339
E01017737,1292,616,676,0.47678018575851394,0.5232198142414861
E01017738,2423,1180,1243,0.48699958728848536,0.5130004127115146
E01017669,2568,1234,1334,0.48052959501557635,0.5194704049844237
E01017670,1825,895,930,0.4904109589041096,0.5095890410958904
E01017715,1206,596,610,0.494195688225539,0.5058043117744611
E01017716,1869,935,934,0.5002675227394329,0.49973247726056713
E01017731,1334,629,705,0.4715142428785607,0.5284857571214393
E01017732,1645,786,859,0.4778115501519757,0.5221884498480243
E01017733,1312,651,661,0.4961890243902439,0.5038109756097561
E01017734,1523,761,762,0.49967170059093896,0.5003282994090611
E01033955,1437,720,717,0.5010438413361169,0.4989561586638831
E01033956,1659,805,854,0.48523206751054854,0.5147679324894515
E01033957,1097,527,570,0.4804010938924339,0.5195989061075661
E01017703,1312,637,675,0.48551829268292684,0.5144817073170732
E01017704,1302,639,663,0.49078341013824883,0.5092165898617511
E01017719,1243,618,625,0.49718423169750603,0.502815768302494
E01017720,1304,633,671,0.4854294478527607,0.5145705521472392
E01032958,1523,756,767,0.4963887065003283,0.5036112934996717
E01033958,1585,773,812,0.48769716088328074,0.5123028391167193
E01033959,1515,691,824,0.4561056105610561,0.5438943894389439
E01017651,1585,770,815,0.48580441640378547,0.5141955835962145
E01017652,1683,837,846,0.49732620320855614,0.5026737967914439
E01017657,1578,781,797,0.49493029150823825,0.5050697084917617
E01017658,1640,828,812,0.5048780487804878,0.4951219512195122
E01017701,2812,1371,1441,0.4875533428165007,0.5124466571834992
E01017702,1507,734,773,0.4870603848706038,0.5129396151293961
E01017642,1287,620,667,0.48174048174048173,0.5182595182595182
E01017643,1425,714,711,0.5010526315789474,0.49894736842105264
E01017673,1382,693,689,0.5014471780028944,0.49855282199710566
E01017674,1796,1123,673,0.6252783964365256,0.3747216035634744
E01017659,1645,821,824,0.4990881458966565,0.5009118541033435
E01017660,1572,770,802,0.48982188295165396,0.510178117048346
E01017661,1603,784,819,0.4890829694323144,0.5109170305676856
E01017664,1395,702,693,0.5032258064516129,0.4967741935483871
E01017706,1466,685,781,0.46725784447476126,0.5327421555252387
E01017707,1352,657,695,0.4859467455621302,0.5140532544378699
E01017708,1602,800,802,0.4993757802746567,0.5006242197253433
E01033960,1742,848,894,0.48679678530424797,0.513203214695752
E01033961,1741,864,877,0.49626651349798967,0.5037334865020103
E01033962,1655,778,877,0.4700906344410876,0.5299093655589124
E01033963,1592,795,797,0.4993718592964824,0.5006281407035176
E01033964,1511,736,775,0.4870946393117141,0.5129053606882858
E01033967,1449,718,731,0.49551414768806074,0.5044858523119393
E01017665,2725,1322,1403,0.4851376146788991,0.514862385321101
E01017666,2344,1152,1192,0.49146757679180886,0.5085324232081911
E01017667,1466,729,737,0.4972714870395634,0.5027285129604365
E01017668,1588,791,797,0.4981108312342569,0.5018891687657431
E01017697,1343,672,671,0.5003723008190618,0.4996276991809382
E01017698,1401,714,687,0.5096359743040685,0.49036402569593146
E01017699,1802,990,812,0.5493895671476138,0.4506104328523862
E01017700,1636,811,825,0.495721271393643,0.5042787286063569
E01017634,1623,809,814,0.4984596426370918,0.5015403573629081
E01017662,1464,727,737,0.49658469945355194,0.5034153005464481
E01017663,1702,878,824,0.5158636897767332,0.48413631022326675
E01032955,1381,677,704,0.49022447501810285,0.5097755249818972
E01032961,1426,721,705,0.5056100981767181,0.4943899018232819
E01017653,1466,737,729,0.5027285129604365,0.4972714870395634
E01017654,1727,897,830,0.5193977996525767,0.4806022003474233
E01017655,1833,874,959,0.4768139661756683,0.5231860338243317
E01032956,1620,799,821,0.49320987654320986,0.5067901234567901
E01032957,1289,625,664,0.4848719937936385,0.5151280062063616
E01032962,1459,712,747,0.4880054832076765,0.5119945167923236
E01017635,1513,739,774,0.488433575677462,0.511566424322538
E01017636,1550,762,788,0.4916129032258065,0.5083870967741936
E01017637,1260,624,636,0.49523809523809526,0.5047619047619047
E01017638,1271,625,646,0.4917387883556255,0.5082612116443745
E01017639,1511,732,779,0.48444738583719393,0.5155526141628061
E01017640,1663,800,863,0.4810583283223091,0.5189416716776909
E01017709,1715,864,851,0.5037900874635568,0.49620991253644314
E01017710,1610,819,791,0.508695652173913,0.49130434782608695
E01017711,1700,868,832,0.5105882352941177,0.4894117647058824
E01017712,2392,1191,1201,0.4979096989966555,0.5020903010033445
E01017687,2620,1272,1348,0.4854961832061069,0.5145038167938931
E01017688,1160,574,586,0.49482758620689654,0.5051724137931034
E01017689,1324,634,690,0.4788519637462236,0.5211480362537765
E01017690,1165,559,606,0.4798283261802575,0.5201716738197425
E01017691,1339,658,681,0.49141150112023896,0.508588498879761
E01017692,1554,783,771,0.5038610038610039,0.49613899613899615
E01017721,1684,812,872,0.4821852731591449,0.517814726840855
E01017722,1453,713,740,0.4907088781830695,0.5092911218169305
E01017723,1341,653,688,0.48695003728560776,0.5130499627143923
E01017724,1487,732,755,0.49226630800269,0.50773369199731
E01017627,1785,860,925,0.48179271708683474,0.5182072829131653
E01017628,1780,871,909,0.4893258426966292,0.5106741573033707
E01017629,1708,826,882,0.48360655737704916,0.5163934426229508
E01017630,1578,774,804,0.49049429657794674,0.5095057034220533
E01017631,2444,1186,1258,0.48527004909983634,0.5147299509001637
E01033965,1520,745,775,0.4901315789473684,0.5098684210526315
E01033966,1645,801,844,0.4869300911854103,0.5130699088145897
E01017675,1778,850,928,0.4780652418447694,0.5219347581552306
E01017676,1458,688,770,0.4718792866941015,0.5281207133058985
E01017677,1965,948,1017,0.48244274809160304,0.517557251908397
E01017678,1431,694,737,0.48497554157931516,0.5150244584206848
E01017679,1598,775,823,0.48498122653316644,0.5150187734668336
E01017680,1219,590,629,0.48400328137817883,0.5159967186218212
E01017681,1363,632,731,0.46368305209097577,0.5363169479090242
E01017682,1261,620,641,0.4916732751784298,0.5083267248215702
E01017683,1798,880,918,0.489432703003337,0.5105672969966629
E01017684,1136,539,597,0.4744718309859155,0.5255281690140845
E01017726,1166,552,614,0.4734133790737564,0.5265866209262435
E01017727,1824,943,881,0.5169956140350878,0.4830043859649123
E01017729,1632,804,828,0.49264705882352944,0.5073529411764706
E01017730,1592,767,825,0.48178391959798994,0.5182160804020101
E01033968,1938,1173,765,0.6052631578947368,0.39473684210526316
E01033969,1501,727,774,0.4843437708194537,0.5156562291805463
E01017750,2256,1114,1142,0.49379432624113473,0.5062056737588653
E01017752,2260,1119,1141,0.49513274336283186,0.5048672566371681
E01017766,2306,1149,1157,0.49826539462272335,0.5017346053772767
E01017778,1323,625,698,0.47241118669690096,0.527588813303099
E01017747,1517,725,792,0.4779169413315755,0.5220830586684245
E01017748,1875,878,997,0.46826666666666666,0.5317333333333333
E01017749,1846,923,923,0.5,0.5
E01017789,1343,647,696,0.48175725986597173,0.5182427401340283
E01017790,1541,756,785,0.49059052563270605,0.509409474367294
E01017795,2285,1143,1142,0.500218818380744,0.499781181619256
E01017769,1626,812,814,0.4993849938499385,0.5006150061500615
E01017771,1483,710,773,0.4787592717464599,0.5212407282535402
E01017780,1443,729,714,0.5051975051975052,0.49480249480249483
E01017781,1267,629,638,0.4964483030781373,0.5035516969218626
E01017770,1693,829,864,0.4896633195510927,0.5103366804489072
E01017791,1509,730,779,0.48376408217362493,0.5162359178263751
E01017792,2232,1063,1169,0.47625448028673834,0.5237455197132617
E01017793,1434,682,752,0.4755927475592748,0.5244072524407253
E01017768,2325,1149,1176,0.4941935483870968,0.5058064516129033
E01017779,1114,556,558,0.4991023339317774,0.5008976660682226
E01017785,1591,791,800,0.497171590194846,0.502828409805154
E01017786,1536,724,812,0.4713541666666667,0.5286458333333334
E01017787,1587,791,796,0.4984247006931317,0.5015752993068683
E01017788,1672,782,890,0.4677033492822967,0.5322966507177034
E01017741,1689,834,855,0.4937833037300178,0.5062166962699822
E01017742,1755,862,893,0.4911680911680912,0.5088319088319089
E01017743,1956,929,1027,0.47494887525562374,0.5250511247443763
E01017763,1784,855,929,0.4792600896860987,0.5207399103139013
E01017764,1674,826,848,0.4934289127837515,0.5065710872162486
E01017765,1706,875,831,0.5128956623681126,0.48710433763188743
E01017739,1271,631,640,0.4964594807238395,0.5035405192761605
E01017740,1479,723,756,0.48884381338742394,0.5111561866125761
E01017744,1512,744,768,0.49206349206349204,0.5079365079365079
E01017745,1711,815,896,0.47632963179427235,0.5236703682057277
E01017746,1598,783,815,0.4899874843554443,0.5100125156445557
E01017762,1405,696,709,0.49537366548042705,0.504626334519573
E01017775,1683,785,898,0.46642899584076053,0.5335710041592394
E01017776,2273,1069,1204,0.4703035635723713,0.5296964364276286
E01017777,1803,863,940,0.4786466999445369,0.5213533000554631
E01017759,1843,869,974,0.4715138361367336,0.5284861638632664
E01017760,1704,832,872,0.48826291079812206,0.5117370892018779
E01017761,2139,1029,1110,0.48106591865357645,0.5189340813464236
E01017794,2325,1126,1199,0.4843010752688172,0.5156989247311828
E01017754,1531,741,790,0.4839973873285434,0.5160026126714565
E01017755,1990,921,1069,0.4628140703517588,0.5371859296482412
E01017756,1497,730,767,0.4876419505678023,0.5123580494321978
E01017757,1184,572,612,0.4831081081081081,0.5168918918918919
E01017758,1359,655,704,0.481972038263429,0.5180279617365711
E01017751,2140,1031,1109,0.48177570093457944,0.5182242990654206
E01017753,1300,614,686,0.4723076923076923,0.5276923076923077
E01017767,2379,1123,1256,0.47204707860445566,0.5279529213955444
E01017796,1828,870,958,0.4759299781181619,0.524070021881838
E01017797,1376,658,718,0.47819767441860467,0.5218023255813954
E01017798,1819,868,951,0.4771852666300165,0.5228147333699835
E01017799,2177,1028,1149,0.4722094625631603,0.5277905374368397
E01017800,1710,833,877,0.4871345029239766,0.5128654970760234
E01017801,1679,805,874,0.4794520547945205,0.5205479452054794
E01017802,1642,798,844,0.48599269183922045,0.5140073081607796
E01017818,2086,1016,1070,0.48705656759348037,0.5129434324065196
E01017819,1670,841,829,0.5035928143712575,0.49640718562874253
E01017820,1782,833,949,0.4674523007856341,0.5325476992143658
E01017821,1612,788,824,0.48883374689826303,0.511166253101737
E01017822,2111,1024,1087,0.48507816200852677,0.5149218379914733
E01017810,2317,1055,1262,0.4553301683211049,0.5446698316788952
E01017811,1226,560,666,0.4567699836867863,0.5432300163132137
E01017812,1917,931,986,0.4856546687532603,0.5143453312467396
E01017813,2014,1011,1003,0.5019860973187686,0.49801390268123136
E01017815,1923,914,1009,0.4752990119604784,0.5247009880395216
E01017816,1747,813,934,0.4653692043503148,0.5346307956496852
E01017817,2167,1112,1055,0.5131518227964929,0.48684817720350715
E01017823,1454,686,768,0.4718019257221458,0.5281980742778541
E01017830,1982,935,1047,0.4717457114026236,0.5282542885973764
E01017831,1721,829,892,0.48169668797210924,0.5183033120278907
E01017832,1871,891,980,0.47621592731159806,0.5237840726884019
E01017834,1658,839,819,0.5060313630880579,0.4939686369119421
E01017835,1658,770,888,0.4644149577804584,0.5355850422195416
E01017803,1391,680,711,0.4888569374550683,0.5111430625449317
E01017806,1743,842,901,0.48307515777395293,0.5169248422260471
E01017814,1695,826,869,0.4873156342182891,0.512684365781711
E01017833,2390,1167,1223,0.48828451882845186,0.5117154811715481
E01017804,1636,775,861,0.4737163814180929,0.5262836185819071
E01017805,1932,892,1040,0.4616977225672878,0.5383022774327122
E01017807,1586,777,809,0.48991172761664564,0.5100882723833543
E01017808,1647,784,863,0.47601700060716456,0.5239829993928354
E01017809,1643,799,844,0.48630553864881315,0.5136944613511869
E01017824,1705,843,862,0.49442815249266864,0.5055718475073314
E01017825,1722,865,857,0.5023228803716608,0.49767711962833916
E01017826,1596,760,836,0.47619047619047616,0.5238095238095238
E01017827,2050,1005,1045,0.4902439024390244,0.5097560975609756
E01017828,1541,736,805,0.47761194029850745,0.5223880597014925
E01017829,2193,1111,1082,0.5066119471044231,0.49338805289557686
E01017929,1727,797,930,0.4614939200926462,0.5385060799073538
E01017930,1856,906,950,0.48814655172413796,0.5118534482758621
E01017931,1482,724,758,0.4885290148448043,0.5114709851551957
E01017932,1605,766,839,0.47725856697819313,0.5227414330218069
E01017933,1877,849,1028,0.45231752797016517,0.5476824720298349
E01017885,2144,1036,1108,0.4832089552238806,0.5167910447761194
E01017886,1496,728,768,0.48663101604278075,0.5133689839572193
E01017887,1135,565,570,0.4977973568281938,0.5022026431718062
E01017888,1536,749,787,0.4876302083333333,0.5123697916666666
E01017869,1298,667,631,0.5138674884437596,0.4861325115562404
E01017870,1171,581,590,0.4961571306575576,0.5038428693424424
E01017871,1505,736,769,0.48903654485049836,0.5109634551495017
E01017872,1557,764,793,0.49068721901091844,0.5093127809890816
E01017873,1366,660,706,0.48316251830161056,0.5168374816983895
E01017874,1373,697,676,0.507647487254188,0.4923525127458121
E01017915,1443,718,725,0.49757449757449757,0.5024255024255024
E01017916,1181,587,594,0.4970364098221846,0.5029635901778154
E01017917,1682,825,857,0.49048751486325803,0.509512485136742
E01017918,1546,738,808,0.47736093143596375,0.5226390685640362
E01017857,1486,750,736,0.5047106325706595,0.4952893674293405
E01017858,2474,1189,1285,0.48059822150363785,0.5194017784963622
E01017859,1716,848,868,0.49417249417249415,0.5058275058275058
E01017860,1461,745,716,0.5099247091033539,0.49007529089664614
E01017861,1565,758,807,0.48434504792332267,0.5156549520766773
E01017862,1846,898,948,0.48645720476706394,0.5135427952329361
E01017863,1754,872,882,0.49714937286202965,0.5028506271379704
E01017853,1351,662,689,0.4900074019245004,0.5099925980754997
E01017854,1176,592,584,0.5034013605442177,0.4965986394557823
E01017878,2409,1173,1236,0.48692403486924035,0.5130759651307597
E01033970,1542,752,790,0.4876783398184176,0.5123216601815823
E01033971,1714,923,791,0.5385064177362894,0.4614935822637106
E01017920,1513,767,746,0.5069398545935228,0.4930601454064772
E01017921,1759,895,864,0.5088118249005117,0.49118817509948837
E01017922,2403,1202,1201,0.5002080732417811,0.4997919267582189
E01017923,1681,874,807,0.5199286139202856,0.48007138607971445
E01017924,1611,768,843,0.4767225325884544,0.5232774674115456
E01017937,1442,708,734,0.4909847434119279,0.5090152565880721
E01017938,1292,643,649,0.49767801857585137,0.5023219814241486
E01017940,1604,810,794,0.5049875311720698,0.49501246882793015
E01017942,1473,712,761,0.48336727766463,0.5166327223353699
E01017850,1441,701,740,0.4864677307425399,0.5135322692574601
E01017851,1727,863,864,0.49971048060220036,0.5002895193977996
E01017852,2581,1321,1260,0.5118171251452925,0.48818287485470746
E01017919,1358,671,687,0.49410898379970547,0.5058910162002945
E01017925,2099,1019,1080,0.48546927108146737,0.5145307289185327
E01017926,1453,691,762,0.4755677907777013,0.5244322092222987
E01017927,1738,853,885,0.4907940161104718,0.5092059838895282
E01017928,1478,740,738,0.5006765899864682,0.4993234100135318
E01017911,1706,841,865,0.49296600234466587,0.5070339976553341
E01017912,1507,739,768,0.49037823490378235,0.5096217650962177
E01017913,2137,1074,1063,0.5025737014506317,0.49742629854936826
E01017914,1400,694,706,0.4957142857142857,0.5042857142857143
E01017903,1749,897,852,0.5128644939965694,0.48713550600343053
E01017904,1972,1010,962,0.5121703853955375,0.48782961460446245
E01017905,2300,1183,1117,0.5143478260869565,0.4856521739130435
E01017906,1939,976,963,0.5033522434244456,0.49664775657555443
E01017907,1815,916,899,0.5046831955922865,0.4953168044077135
E01017899,1738,826,912,0.475258918296893,0.5247410817031071
E01017900,1188,604,584,0.5084175084175084,0.49158249158249157
E01017901,1217,594,623,0.48808545603944126,0.5119145439605588
E01017902,1618,771,847,0.4765142150803461,0.5234857849196539
E01017836,1728,863,865,0.4994212962962963,0.5005787037037037
E01017837,2555,1278,1277,0.5001956947162427,0.49980430528375736
E01017838,1651,849,802,0.5142337976983646,0.48576620230163536
E01017839,2359,936,1423,0.39677829588808816,0.6032217041119118
E01017840,2008,1012,996,0.5039840637450199,0.4960159362549801
E01017841,2619,1240,1379,0.473463153875525,0.526536846124475
E01017910,2550,1278,1272,0.5011764705882353,0.4988235294117647
E01017941,1410,690,720,0.48936170212765956,0.5106382978723404
E01033972,1781,849,932,0.47669848399775405,0.523301516002246
E01033973,1246,613,633,0.49197431781701445,0.5080256821829856
E01033974,1378,678,700,0.49201741654571846,0.5079825834542816
E01033975,1381,691,690,0.500362056480811,0.499637943519189
E01017843,1576,759,817,0.4815989847715736,0.5184010152284264
E01017844,1767,842,925,0.47651386530843237,0.5234861346915677
E01017845,1640,800,840,0.4878048780487805,0.5121951219512195
E01017855,1621,756,865,0.4663787785317705,0.5336212214682294
E01017856,1530,742,788,0.4849673202614379,0.515032679738562
E01017864,1286,627,659,0.48755832037325036,0.5124416796267496
E01017865,1508,725,783,0.4807692307692308,0.5192307692307693
E01017867,1537,760,777,0.494469746258946,0.505530253741054
E01017868,1571,725,846,0.4614894971355824,0.5385105028644176
E01017934,1845,918,927,0.4975609756097561,0.5024390243902439
E01017935,2021,950,1071,0.47006432459178626,0.5299356754082137
E01017936,1478,720,758,0.4871447902571042,0.5128552097428958
E01017939,1407,696,711,0.4946695095948827,0.5053304904051172
E01017866,1462,721,741,0.49316005471956226,0.5068399452804377
E01017875,1482,748,734,0.50472334682861,0.49527665317139
E01017876,2049,1014,1035,0.49487554904831627,0.5051244509516838
E01017877,1576,762,814,0.48350253807106597,0.516497461928934
E01017846,1531,734,797,0.47942521227955587,0.5205747877204442
E01017847,1664,787,877,0.4729567307692308,0.5270432692307693
E01017848,1264,628,636,0.49683544303797467,0.5031645569620253
E01017849,1472,718,754,0.48777173913043476,0.5122282608695652
E01017889,1478,702,776,0.4749661705006766,0.5250338294993234
E01017890,1317,656,661,0.49810174639331817,0.5018982536066818
E01017891,1431,677,754,0.47309573724668064,0.5269042627533194
E01017892,1534,745,789,0.48565840938722293,0.5143415906127771
E01017893,1758,806,952,0.45847554038680316,0.5415244596131968
E01017894,1593,727,866,0.4563716258631513,0.5436283741368487
E01017895,1317,634,683,0.48139711465451784,0.5186028853454822
E01017896,1407,685,722,0.48685145700071075,0.5131485429992892
E01017897,1703,815,888,0.47856723429242515,0.5214327657075749
E01017898,1235,586,649,0.4744939271255061,0.5255060728744939
E01017773,1526,757,769,0.49606815203145477,0.5039318479685452
E01017774,1313,645,668,0.49124143183549124,0.5087585681645087
E01017782,1540,728,812,0.4727272727272727,0.5272727272727272
E01017783,1559,760,799,0.48749198203976907,0.5125080179602309
E01017784,1671,786,885,0.4703770197486535,0.5296229802513465
E01032609,1326,626,700,0.4720965309200603,0.5279034690799397
E01017880,1397,673,724,0.4817465998568361,0.5182534001431639
E01017881,1928,934,994,0.48443983402489627,0.5155601659751037
E01017882,1601,766,835,0.47845096814490945,0.5215490318550906
E01017883,1628,804,824,0.49385749385749383,0.5061425061425061
E01017884,1391,645,746,0.46369518332135157,0.5363048166786485
E01032610,1589,782,807,0.4921334172435494,0.5078665827564506
E01020924,1385,689,696,0.49747292418772565,0.5025270758122744
E01020925,1566,769,797,0.49106002554278416,0.5089399744572158
E01020927,1412,652,760,0.46175637393767704,0.5382436260623229
E01020928,1633,780,853,0.47764849969381507,0.5223515003061849
E01020930,1396,687,709,0.49212034383954156,0.5078796561604585
E01020917,1455,686,769,0.47147766323024054,0.5285223367697595
E01020918,1659,814,845,0.49065702230259195,0.5093429776974081
E01020919,1583,758,825,0.47883765003158557,0.5211623499684144
E01020923,1402,665,737,0.4743223965763195,0.5256776034236804
E01020949,1587,750,837,0.4725897920604915,0.5274102079395085
E01020926,1473,687,786,0.4663951120162933,0.5336048879837068
E01020929,1764,826,938,0.46825396825396826,0.5317460317460317
E01020955,1626,772,854,0.4747847478474785,0.5252152521525215
E01020956,1604,758,846,0.47256857855361595,0.527431421446384
E01020957,1574,717,857,0.45552731893265563,0.5444726810673444
E01020920,1509,700,809,0.4638833664678595,0.5361166335321405
E01020921,1449,679,770,0.46859903381642515,0.5314009661835749
E01020922,1431,661,770,0.46191474493361284,0.5380852550663872
E01020945,1826,868,958,0.47535596933187296,0.524644030668127
E01020950,1536,727,809,0.4733072916666667,0.5266927083333334
E01020940,1624,775,849,0.4772167487684729,0.5227832512315271
E01020941,1759,836,923,0.4752700397953383,0.5247299602046618
E01020942,1537,721,816,0.4690956408588159,0.5309043591411842
E01020946,1694,815,879,0.48110979929161746,0.5188902007083825
E01020947,1577,723,854,0.4584654407102093,0.5415345592897908
E01020914,1955,913,1042,0.4670076726342711,0.5329923273657289
E01020915,1702,805,897,0.47297297297297297,0.527027027027027
E01020952,1887,894,993,0.4737678855325914,0.5262321144674086
E01020953,1525,745,780,0.4885245901639344,0.5114754098360655
E01020954,1756,829,927,0.47209567198177677,0.5279043280182233
E01020948,1431,666,765,0.46540880503144655,0.5345911949685535
E01020963,1994,978,1016,0.49047141424272817,0.5095285857572718
E01020965,1814,896,918,0.49393605292171994,0.5060639470782801
E01020966,1722,869,853,0.5046457607433217,0.49535423925667826
E01020938,1602,721,881,0.4500624219725343,0.5499375780274657
E01020939,1572,728,844,0.4631043256997455,0.5368956743002544
E01020943,1570,731,839,0.4656050955414013,0.5343949044585987
E01020964,1597,750,847,0.469630557294928,0.530369442705072
E01020967,1860,876,984,0.47096774193548385,0.5290322580645161
E01020910,2022,996,1026,0.49258160237388726,0.5074183976261127
E01020911,2337,1192,1145,0.5100556268720582,0.4899443731279418
E01020912,2219,1184,1035,0.533573681838666,0.46642631816133395
E01020916,1848,870,978,0.4707792207792208,0.5292207792207793
E01020935,2088,1039,1049,0.4976053639846743,0.5023946360153256
E01020936,1614,742,872,0.459727385377943,0.540272614622057
E01020937,1991,975,1016,0.4897036664992466,0.5102963335007534
E01020968,1948,929,1019,0.4768993839835729,0.5231006160164271
E01020931,1696,788,908,0.46462264150943394,0.535377358490566
E01020932,1299,574,725,0.44187836797536567,0.5581216320246344
E01020944,1503,707,796,0.4703925482368596,0.5296074517631404
E01034298,2251,1048,1203,0.46557085739671256,0.5344291426032874
E01020913,2360,1081,1279,0.45805084745762714,0.5419491525423729
E01020951,1587,762,825,0.48015122873345933,0.5198487712665406
E01020959,1504,705,799,0.46875,0.53125
E01020961,1464,696,768,0.47540983606557374,0.5245901639344263
E01020962,2079,1022,1057,0.49158249158249157,0.5084175084175084
E01020960,2450,1189,1261,0.4853061224489796,0.5146938775510204
E01032831,1591,781,810,0.4908862350722816,0.5091137649277184
E01032832,1493,699,794,0.4681848626925653,0.5318151373074347
E01032833,1298,639,659,0.49229583975346686,0.5077041602465331
E01020969,1525,756,769,0.49573770491803276,0.5042622950819672
E01020970,2733,1328,1405,0.48591291620929383,0.5140870837907062
E01020971,2158,1085,1073,0.5027803521779426,0.49721964782205746
E01020987,1877,907,970,0.4832179009057006,0.5167820990942994
E01020974,1722,819,903,0.47560975609756095,0.524390243902439
E01020986,1573,751,822,0.47743165924984104,0.5225683407501589
E01020988,1632,777,855,0.47610294117647056,0.5238970588235294
E01021007,1606,754,852,0.46948941469489414,0.5305105853051059
E01021008,1566,724,842,0.4623243933588761,0.5376756066411239
E01021009,1953,929,1024,0.4756784434203789,0.5243215565796211
E01020993,1452,685,767,0.47176308539944906,0.528236914600551
E01020994,1616,784,832,0.48514851485148514,0.5148514851485149
E01020995,1417,684,733,0.4827099505998589,0.5172900494001411
E01020996,1952,936,1016,0.47950819672131145,0.5204918032786885
E01021019,1669,804,865,0.481725584182145,0.518274415817855
E01021004,1847,886,961,0.47969680563075257,0.5203031943692474
E01021005,1736,778,958,0.44815668202764974,0.5518433179723502
E01021006,1735,815,920,0.4697406340057637,0.5302593659942363
E01021013,1819,864,955,0.4749862561847169,0.5250137438152831
E01020972,1892,882,1010,0.46617336152219874,0.5338266384778013
E01020973,1882,896,986,0.4760892667375133,0.5239107332624867
E01020977,1576,788,788,0.5,0.5
E01021015,1799,814,985,0.45247359644246804,0.547526403557532
E01021010,1534,741,793,0.4830508474576271,0.5169491525423728
E01021011,1623,808,815,0.49784349969192854,0.5021565003080715
E01021012,1731,871,860,0.5031773541305604,0.49682264586943964
E01021020,2014,969,1045,0.4811320754716981,0.5188679245283019
E01021021,1896,938,958,0.4947257383966245,0.5052742616033755
E01021000,1444,682,762,0.47229916897506924,0.5277008310249307
E01021001,1211,570,641,0.47068538398018167,0.5293146160198183
E01021002,1403,670,733,0.4775481111903065,0.5224518888096935
E01021003,1433,729,704,0.5087229588276343,0.49127704117236565
E01021014,1802,840,962,0.46614872364039955,0.5338512763596004
E01020975,1656,781,875,0.4716183574879227,0.5283816425120773
E01020976,1866,925,941,0.4957127545551983,0.5042872454448017
E01020990,1647,807,840,0.4899817850637523,0.5100182149362478
E01020991,1339,684,655,0.5108289768483943,0.48917102315160566
E01020992,1856,943,913,0.5080818965517241,0.49191810344827586
E01020978,1981,974,1007,0.491670873296315,0.508329126703685
E01020979,1922,1035,887,0.5385015608740895,0.4614984391259105
E01020980,1523,729,794,0.47866053841103084,0.5213394615889692
E01020981,1451,728,723,0.5017229496898691,0.4982770503101309
E01020997,1635,791,844,0.4837920489296636,0.5162079510703363
E01020998,1879,912,967,0.48536455561468866,0.5146354443853113
E01020999,1882,878,1004,0.4665249734325186,0.5334750265674814
E01021016,1833,880,953,0.4800872885979269,0.5199127114020731
E01021017,1581,786,795,0.4971537001897533,0.5028462998102466
E01021018,1900,929,971,0.48894736842105263,0.5110526315789473
E01020982,1671,867,804,0.518850987432675,0.48114901256732495
E01020983,1493,731,762,0.4896182183523108,0.5103817816476892
E01020984,1859,932,927,0.5013448090371168,0.49865519096288324
E01020985,1589,796,793,0.500943989930774,0.49905601006922595
E01020989,1607,775,832,0.48226509023024267,0.5177349097697573
E01021022,2230,1103,1127,0.4946188340807175,0.5053811659192825
E01021024,1106,543,563,0.4909584086799277,0.5090415913200723
E01021025,1866,957,909,0.5128617363344051,0.4871382636655949
E01021052,1218,578,640,0.4745484400656814,0.5254515599343186
E01021053,1228,583,645,0.4747557003257329,0.5252442996742671
E01021023,2964,1468,1496,0.49527665317139,0.50472334682861
E01021026,2554,1118,1436,0.437744714173845,0.562255285826155
E01021032,1904,921,983,0.483718487394958,0.5162815126050421
E01021067,1059,504,555,0.47592067988668557,0.5240793201133145
E01021068,1163,581,582,0.4995700773860705,0.5004299226139295
E01021033,1806,869,937,0.48117386489479513,0.5188261351052049
E01021034,1258,614,644,0.48807631160572335,0.5119236883942766
E01021035,1770,830,940,0.4689265536723164,0.5310734463276836
E01021036,1413,697,716,0.49327671620665253,0.5067232837933475
E01021037,1511,729,782,0.4824619457313038,0.5175380542686963
E01021038,1616,749,867,0.463490099009901,0.536509900990099
E01021054,1462,705,757,0.48221614227086185,0.5177838577291382
E01021055,1747,829,918,0.4745277618775043,0.5254722381224957
E01021056,1752,828,924,0.4726027397260274,0.5273972602739726
E01021057,1552,742,810,0.47809278350515466,0.5219072164948454
E01021039,1330,604,726,0.45413533834586467,0.5458646616541354
E01021040,1756,1001,755,0.5700455580865603,0.4299544419134396
E01021041,1500,706,794,0.4706666666666667,0.5293333333333333
E01021042,1233,583,650,0.47283049472830496,0.527169505271695
E01021043,1520,715,805,0.47039473684210525,0.5296052631578947
E01021027,1497,725,772,0.48430193720774883,0.5156980627922512
E01021028,1517,740,777,0.4878048780487805,0.5121951219512195
E01021029,1566,765,801,0.4885057471264368,0.5114942528735632
E01021030,1254,586,668,0.46730462519936206,0.532695374800638
E01021031,1558,765,793,0.4910141206675225,0.5089858793324775
E01021061,1518,757,761,0.4986824769433465,0.5013175230566534
E01021063,1680,809,871,0.48154761904761906,0.518452380952381
E01021064,1772,838,934,0.4729119638826185,0.5270880361173815
E01021065,1164,540,624,0.4639175257731959,0.5360824742268041
E01021066,1525,719,806,0.47147540983606556,0.5285245901639344
E01021045,1929,954,975,0.49455676516329705,0.505443234836703
E01021046,1505,731,774,0.4857142857142857,0.5142857142857142
E01021047,1507,753,754,0.4996682149966821,0.5003317850033179
E01021048,1681,822,859,0.48899464604402143,0.5110053539559786
E01021044,2128,1012,1116,0.4755639097744361,0.5244360902255639
E01021049,1462,714,748,0.4883720930232558,0.5116279069767442
E01021050,1324,679,645,0.5128398791540786,0.4871601208459215
E01021051,1156,557,599,0.4818339100346021,0.5181660899653979
E01021058,1980,944,1036,0.4767676767676768,0.5232323232323233
E01021059,1753,857,896,0.48887621220764405,0.511123787792356
E01021060,2326,1140,1186,0.4901117798796217,0.5098882201203784
E01021062,1719,852,867,0.4956369982547993,0.5043630017452007
E01021069,1544,740,804,0.4792746113989637,0.5207253886010362
E01021075,1834,853,981,0.46510359869138496,0.534896401308615
E01021077,1493,734,759,0.4916275954454119,0.5083724045545881
E01021081,1572,759,813,0.48282442748091603,0.517175572519084
E01021082,1609,766,843,0.47607209446861404,0.5239279055313859
E01021083,1290,622,668,0.4821705426356589,0.517829457364341
E01021072,1570,723,847,0.4605095541401274,0.5394904458598726
E01021073,1449,701,748,0.48378191856452724,0.5162180814354728
E01021074,1757,825,932,0.4695503699487763,0.5304496300512237
E01021076,1879,889,990,0.4731240021287919,0.5268759978712081
E01021078,1379,641,738,0.4648295866569978,0.5351704133430022
E01021070,1621,768,853,0.47378161628624305,0.526218383713757
E01021071,1859,876,983,0.471221086605702,0.5287789133942981
E01021079,1505,696,809,0.46245847176079735,0.5375415282392026
E01021080,1503,699,804,0.46506986027944114,0.5349301397205589
E01021132,1517,750,767,0.4943968358602505,0.5056031641397495
E01021133,1606,787,819,0.4900373599003736,0.5099626400996264
E01021134,1497,750,747,0.501002004008016,0.49899799599198397
E01021139,1427,682,745,0.47792571829011915,0.5220742817098809
E01021140,1748,827,921,0.4731121281464531,0.5268878718535469
E01021141,1490,760,730,0.5100671140939598,0.4899328859060403
E01021103,1438,699,739,0.4860917941585535,0.5139082058414465
E01021114,1757,851,906,0.48434832100170744,0.5156516789982926
E01021115,1598,784,814,0.490613266583229,0.509386733416771
E01021116,1557,732,825,0.4701348747591522,0.5298651252408478
E01021098,1764,847,917,0.4801587301587302,0.5198412698412699
E01021099,1706,866,840,0.5076201641266119,0.492379835873388
E01021100,1690,837,853,0.4952662721893491,0.5047337278106508
E01021104,1499,744,755,0.4963308872581721,0.5036691127418279
E01021105,1250,608,642,0.4864,0.5136
E01021101,1667,807,860,0.48410317936412717,0.5158968206358728
E01021102,1473,718,755,0.4874405974202308,0.5125594025797692
E01021117,1545,724,821,0.4686084142394822,0.5313915857605178
E01021118,1815,881,934,0.48539944903581267,0.5146005509641873
E01021119,1124,512,612,0.4555160142348754,0.5444839857651246
E01021087,1920,903,1017,0.4703125,0.5296875
E01021088,1613,797,816,0.4941103533787973,0.5058896466212027
E01021089,1583,753,830,0.4756790903348073,0.5243209096651926
E01021109,1824,904,920,0.4956140350877193,0.5043859649122807
E01021110,2298,1108,1190,0.4821583986074848,0.5178416013925152
E01021084,1911,874,1037,0.45735217163788594,0.5426478283621141
E01021085,1690,813,877,0.48106508875739645,0.5189349112426036
E01021086,1813,823,990,0.45394373965802537,0.5460562603419746
E01021096,1301,621,680,0.47732513451191394,0.5226748654880861
E01021097,1421,696,725,0.4897959183673469,0.5102040816326531
E01021111,1082,465,617,0.4297597042513863,0.5702402957486137
E01021113,1705,799,906,0.4686217008797654,0.5313782991202346
E01021131,1561,745,816,0.47725816784112746,0.5227418321588725
E01021135,1947,914,1033,0.4694401643554186,0.5305598356445814
E01021136,1356,618,738,0.4557522123893805,0.5442477876106194
E01021137,1670,765,905,0.45808383233532934,0.5419161676646707
E01021112,1389,631,758,0.45428365730741543,0.5457163426925846
E01021120,1545,688,857,0.4453074433656958,0.5546925566343042
E01021126,1581,741,840,0.4686907020872865,0.5313092979127134
E01021127,1600,717,883,0.448125,0.551875
E01021128,1932,927,1005,0.4798136645962733,0.5201863354037267
E01021093,1433,692,741,0.4829030006978367,0.5170969993021632
E01021095,1264,589,675,0.46598101265822783,0.5340189873417721
E01021123,1537,731,806,0.47560182173064414,0.5243981782693559
E01021124,2146,1014,1132,0.4725069897483691,0.527493010251631
E01021125,1284,594,690,0.46261682242990654,0.5373831775700935
E01021129,1723,805,918,0.4672083575159605,0.5327916424840394
E01021138,1145,559,586,0.4882096069868996,0.5117903930131005
E01021094,1484,664,820,0.4474393530997305,0.5525606469002695
E01021106,1712,796,916,0.4649532710280374,0.5350467289719626
E01021107,1531,742,789,0.4846505551926845,0.5153494448073155
E01021108,1492,680,812,0.45576407506702415,0.5442359249329759
E01021130,1492,720,772,0.48257372654155495,0.517426273458445
E01021090,1688,816,872,0.4834123222748815,0.5165876777251185
E01021091,2055,998,1057,0.4856447688564477,0.5143552311435523
E01021092,2135,963,1172,0.45105386416861826,0.5489461358313817
E01021121,1580,698,882,0.4417721518987342,0.5582278481012658
E01021122,1505,695,810,0.46179401993355484,0.5382059800664452
E01021167,2298,1040,1258,0.4525674499564839,0.5474325500435161
E01021168,1656,793,863,0.4788647342995169,0.5211352657004831
E01021169,1243,598,645,0.48109412711182625,0.5189058728881738
E01021186,1237,601,636,0.4858528698464026,0.5141471301535974
E01021171,2026,1000,1026,0.49358341559723595,0.506416584402764
E01021172,1733,844,889,0.4870167339873053,0.5129832660126947
E01021173,1472,720,752,0.4891304347826087,0.5108695652173914
E01021218,1175,576,599,0.4902127659574468,0.5097872340425532
E01021156,1922,897,1025,0.4667013527575442,0.5332986472424558
E01021157,1797,873,924,0.48580968280467446,0.5141903171953256
E01021158,2311,1146,1165,0.4958892254435309,0.504110774556469
E01021159,2339,1149,1190,0.49123557075673363,0.5087644292432664
E01021160,1698,798,900,0.46996466431095407,0.5300353356890459
E01021161,1640,799,841,0.4871951219512195,0.5128048780487805
E01021162,1609,776,833,0.48228713486637664,0.5177128651336234
E01021202,1226,517,709,0.42169657422512236,0.5783034257748777
E01021203,1574,775,799,0.4923761118170267,0.5076238881829733
E01021229,1835,886,949,0.4828337874659401,0.5171662125340599
E01021230,1737,831,906,0.4784110535405872,0.5215889464594128
E01021231,1731,841,890,0.4858463316002311,0.514153668399769
E01021151,1857,935,922,0.5035002692514808,0.4964997307485191
E01021152,1831,909,922,0.4964500273074823,0.5035499726925178
E01021153,1999,993,1006,0.49674837418709356,0.5032516258129065
E01021154,1464,715,749,0.4883879781420765,0.5116120218579235
E01021155,1223,592,631,0.48405560098119377,0.5159443990188062
E01021163,2093,1005,1088,0.48017200191113235,0.5198279980888677
E01021164,1833,892,941,0.4866339334424441,0.5133660665575559
E01021187,1396,696,700,0.498567335243553,0.501432664756447
E01021144,1713,858,855,0.500875656742557,0.4991243432574431
E01021145,2229,1107,1122,0.49663526244952894,0.5033647375504711
E01021170,2764,1350,1414,0.48842257597684513,0.5115774240231549
E01021217,1283,622,661,0.4848012470771629,0.5151987529228371
E01021219,1314,629,685,0.4786910197869102,0.5213089802130898
E01021220,1611,736,875,0.45685909373060213,0.5431409062693979
E01021223,1091,520,571,0.4766269477543538,0.5233730522456462
E01021224,1533,722,811,0.4709719504240052,0.5290280495759948
E01021225,1629,768,861,0.4714548802946593,0.5285451197053407
E01021226,1334,652,682,0.48875562218890556,0.5112443778110944
E01021150,1445,690,755,0.47750865051903113,0.5224913494809689
E01021191,1617,773,844,0.4780457637600495,0.5219542362399505
E01021192,1522,738,784,0.48488830486202367,0.5151116951379764
E01021193,1787,867,920,0.485170677112479,0.514829322887521
E01021194,1709,824,885,0.4821533060269163,0.5178466939730837
E01021149,1406,675,731,0.4800853485064011,0.5199146514935988
E01021189,1343,669,674,0.498138495904691,0.501861504095309
E01021190,1450,727,723,0.5013793103448276,0.4986206896551724
E01021200,1429,696,733,0.48705388383484954,0.5129461161651504
E01021201,1692,803,889,0.47458628841607564,0.5254137115839244
E01021221,1293,635,658,0.4911059551430781,0.5088940448569219
E01021222,1496,725,771,0.48462566844919786,0.5153743315508021
E01021227,2047,990,1057,0.4836345872007816,0.5163654127992183
E01021228,1690,816,874,0.48284023668639053,0.5171597633136095
E01021146,2256,1053,1203,0.46675531914893614,0.5332446808510638
E01021147,1656,845,811,0.5102657004830918,0.4897342995169082
E01021148,1506,754,752,0.50066401062417,0.49933598937583
E01021165,1281,644,637,0.5027322404371585,0.4972677595628415
E01021188,1129,557,572,0.4933569530558016,0.5066430469441984
E01021198,1611,775,836,0.48106765983860955,0.5189323401613904
E01021199,1316,657,659,0.4992401215805471,0.5007598784194529
E01021204,1203,583,620,0.484621778886118,0.515378221113882
E01021205,1220,602,618,0.4934426229508197,0.5065573770491804
E01021174,2092,1017,1075,0.4861376673040153,0.5138623326959847
E01021175,1439,707,732,0.49131341209173035,0.5086865879082696
E01021176,1519,674,845,0.4437129690585912,0.5562870309414089
E01021177,1467,683,784,0.4655760054533061,0.534423994546694
E01021180,1455,682,773,0.46872852233676976,0.5312714776632302
E01021181,1466,700,766,0.47748976807639837,0.5225102319236017
E01021182,1570,759,811,0.4834394904458599,0.5165605095541401
E01021183,1302,607,695,0.4662058371735791,0.5337941628264209
E01021178,1637,765,872,0.46731826511912034,0.5326817348808797
E01021179,1681,793,888,0.47174301011302794,0.528256989886972
E01021184,1547,741,806,0.4789915966386555,0.5210084033613446
E01021185,1467,709,758,0.4832992501704158,0.5167007498295841
E01021142,1118,522,596,0.4669051878354204,0.5330948121645797
E01021143,1184,537,647,0.4535472972972973,0.5464527027027027
E01021166,2214,1051,1163,0.47470641373080397,0.525293586269196
E01021196,2077,976,1101,0.46990852190659604,0.530091478093404
E01034299,1451,705,746,0.48587181254307377,0.5141281874569262
E01034300,1600,747,853,0.466875,0.533125
E01034301,1181,568,613,0.4809483488569009,0.519051651143099
E01034302,1834,901,933,0.49127589967284624,0.5087241003271538
E01034303,1287,665,622,0.5167055167055167,0.48329448329448327
E01021213,1847,887,960,0.48023822414726586,0.5197617758527342
E01021214,1755,830,925,0.47293447293447294,0.5270655270655271
E01021215,1337,632,705,0.47270007479431564,0.5272999252056844
E01021216,1135,536,599,0.4722466960352423,0.5277533039647577
E01034304,1354,652,702,0.4815361890694239,0.518463810930576
E01034305,1911,943,968,0.4934589220303506,0.5065410779696494
E01021206,1532,717,815,0.4680156657963446,0.5319843342036553
E01021207,1388,670,718,0.4827089337175792,0.5172910662824207
E01021208,2661,1283,1378,0.48214956783164226,0.5178504321683578
E01021209,2382,1148,1234,0.4819479429051218,0.5180520570948782
E01021210,1641,820,821,0.4996953077391834,0.5003046922608165
E01021211,1502,714,788,0.47536617842876167,0.5246338215712384
E01021232,1700,782,918,0.46,0.54
E01021233,1516,712,804,0.46965699208443273,0.5303430079155673
E01021234,1438,661,777,0.45966620305980527,0.5403337969401947
E01021235,1335,635,700,0.4756554307116105,0.5243445692883895
E01021236,1569,748,821,0.4767367750159337,0.5232632249840663
E01022553,1424,678,746,0.476123595505618,0.523876404494382
E01022554,1789,889,900,0.49692565679150363,0.5030743432084964
E01022555,1446,722,724,0.49930843706777317,0.5006915629322268
E01022556,1892,943,949,0.49841437632135305,0.5015856236786469
E01022560,1174,581,593,0.4948892674616695,0.5051107325383305
E01022493,1365,653,712,0.4783882783882784,0.5216117216117216
E01022536,1354,664,690,0.49039881831610044,0.5096011816838996
E01022537,1272,610,662,0.47955974842767296,0.5204402515723271
E01022557,1505,775,730,0.5149501661129569,0.4850498338870432
E01022558,1244,616,628,0.49517684887459806,0.5048231511254019
E01022559,1248,616,632,0.4935897435897436,0.5064102564102564
E01022488,1414,716,698,0.5063649222065064,0.49363507779349364
E01022489,1528,779,749,0.5098167539267016,0.49018324607329844
E01022499,1622,796,826,0.4907521578298397,0.5092478421701603
E01022500,1370,645,725,0.4708029197080292,0.5291970802919708
E01022513,1631,806,825,0.4941753525444513,0.5058246474555488
E01022472,1248,619,629,0.49599358974358976,0.5040064102564102
E01022473,1216,608,608,0.5,0.5
E01022520,1757,851,906,0.48434832100170744,0.5156516789982926
E01022521,1571,761,810,0.48440483768300446,0.5155951623169955
E01022522,1786,900,886,0.503919372900336,0.49608062709966405
E01022490,1828,870,958,0.4759299781181619,0.524070021881838
E01022491,2050,1025,1025,0.5,0.5
E01022492,1494,754,740,0.5046854082998661,0.49531459170013387
E01022547,1767,866,901,0.490096208262592,0.5099037917374081
E01034708,1320,662,658,0.5015151515151515,0.4984848484848485
E01034709,1275,610,665,0.47843137254901963,0.5215686274509804
E01034710,1377,654,723,0.4749455337690632,0.5250544662309368
E01022495,1442,724,718,0.5020804438280166,0.49791955617198336
E01022497,1333,684,649,0.5131282820705176,0.48687171792948236
E01022498,1509,751,758,0.49768058316766073,0.5023194168323393
E01034711,1643,793,850,0.48265368228849664,0.5173463177115033
E01034712,1921,956,965,0.4976574700676731,0.5023425299323269
E01022539,1252,607,645,0.48482428115015974,0.5151757188498403
E01022540,2539,1244,1295,0.4899566758566365,0.5100433241433635
E01022542,1236,606,630,0.49029126213592233,0.5097087378640777
E01022543,1639,826,813,0.5039658328248933,0.4960341671751068
E01032843,1963,950,1013,0.48395313295975545,0.5160468670402445
E01032844,2944,1463,1481,0.4969429347826087,0.5030570652173914
E01034713,1506,749,757,0.49734395750332006,0.50265604249668
E01034714,1851,869,982,0.46947595894111294,0.5305240410588871
E01022470,1842,918,924,0.498371335504886,0.501628664495114
E01022471,1468,739,729,0.5034059945504087,0.49659400544959126
E01022494,2459,1226,1233,0.49857665717771454,0.5014233428222855
E01022523,2569,1282,1287,0.4990268586998832,0.5009731413001168
E01022524,1912,959,953,0.5015690376569037,0.49843096234309625
E01022525,1654,813,841,0.4915356711003628,0.5084643288996372
E01022527,1611,778,833,0.4829298572315332,0.5170701427684667
E01034715,1680,859,821,0.5113095238095238,0.4886904761904762
E01034716,1302,680,622,0.522273425499232,0.47772657450076805
E01022566,1255,615,640,0.4900398406374502,0.5099601593625498
E01022567,1322,640,682,0.48411497730711045,0.5158850226928896
E01022568,1363,666,697,0.4886280264123258,0.5113719735876743
E01022570,1519,741,778,0.4878209348255431,0.5121790651744569
E01032841,2655,1327,1328,0.49981167608286253,0.5001883239171375
E01034717,1063,492,571,0.4628410159924741,0.5371589840075258
E01034718,2196,1092,1104,0.4972677595628415,0.5027322404371585
E01022502,1587,790,797,0.49779458097038437,0.5022054190296156
E01022506,1317,671,646,0.5094912680334093,0.4905087319665907
E01022507,1539,800,739,0.5198180636777128,0.4801819363222872
E01032842,1382,771,611,0.5578871201157742,0.44211287988422576
E01032847,2059,1087,972,0.5279261777561923,0.4720738222438077
E01022481,1981,993,988,0.5012619888944977,0.49873801110550225
E01022482,1650,789,861,0.4781818181818182,0.5218181818181818
E01022503,1738,899,839,0.5172612197928653,0.4827387802071346
E01032845,1775,878,897,0.49464788732394366,0.5053521126760563
E01032846,1689,881,808,0.5216104203670812,0.4783895796329189
E01022484,1433,695,738,0.48499651081646894,0.515003489183531
E01022485,1204,580,624,0.48172757475083056,0.5182724252491694
E01022486,2220,1087,1133,0.48963963963963963,0.5103603603603604
E01022487,1337,676,661,0.5056095736724009,0.4943904263275991
E01022569,1497,746,751,0.4983299933199733,0.5016700066800267
E01022548,1395,688,707,0.4931899641577061,0.5068100358422939
E01022549,1642,803,839,0.4890377588306943,0.5109622411693058
E01022550,1733,845,888,0.4875937680323139,0.5124062319676861
E01022551,1495,755,740,0.5050167224080268,0.49498327759197325
E01022552,1581,783,798,0.4952561669829222,0.5047438330170778
E01022528,1267,619,648,0.48855564325177586,0.5114443567482242
E01022529,1568,743,825,0.47385204081632654,0.5261479591836735
E01022530,1440,688,752,0.4777777777777778,0.5222222222222223
E01022531,1415,701,714,0.49540636042402825,0.5045936395759717
E01022475,1645,834,811,0.5069908814589665,0.4930091185410334
E01022476,1724,860,864,0.4988399071925754,0.5011600928074246
E01022480,1336,642,694,0.4805389221556886,0.5194610778443114
E01022504,1666,818,848,0.4909963985594238,0.5090036014405762
E01022505,1752,884,868,0.5045662100456622,0.4954337899543379
E01022467,1613,793,820,0.4916305021698698,0.5083694978301302
E01022468,1871,896,975,0.47888829502939606,0.521111704970604
E01022469,1551,752,799,0.48484848484848486,0.5151515151515151
E01022561,1482,720,762,0.48582995951417,0.5141700404858299
E01022562,1432,707,725,0.4937150837988827,0.5062849162011173
E01022515,1304,627,677,0.4808282208588957,0.5191717791411042
E01022516,1502,739,763,0.49201065246338216,0.5079893475366178
E01022517,1240,612,628,0.4935483870967742,0.5064516129032258
E01022518,1923,962,961,0.500260010400416,0.499739989599584
E01022519,1263,621,642,0.4916864608076009,0.5083135391923991
E01022474,1746,839,907,0.4805269186712486,0.5194730813287515
E01022477,1376,717,659,0.5210755813953488,0.4789244186046512
E01022478,1458,712,746,0.4883401920438957,0.5116598079561042
E01022479,1470,717,753,0.48775510204081635,0.5122448979591837
E01022509,1396,699,697,0.5007163323782235,0.4992836676217765
E01022514,1638,806,832,0.49206349206349204,0.5079365079365079
E01022563,1845,911,934,0.4937669376693767,0.5062330623306233
E01022564,2149,1063,1086,0.49464867380176825,0.5053513261982318
E01022565,1907,949,958,0.4976402726796015,0.5023597273203986
E01022510,1593,799,794,0.5015693659761457,0.49843063402385435
E01022511,1213,615,598,0.5070074196207749,0.49299258037922505
E01022512,1326,667,659,0.5030165912518854,0.49698340874811464
E01032848,1690,821,869,0.48579881656804735,0.5142011834319526
E01032849,1533,767,766,0.5003261578604045,0.49967384213959554
E01032850,1398,698,700,0.49928469241773965,0.5007153075822603
E01022532,2296,1159,1137,0.5047909407665505,0.4952090592334495
E01022533,1712,852,860,0.4976635514018692,0.5023364485981309
E01022534,1926,941,985,0.4885773624091381,0.5114226375908619
E01022535,1610,785,825,0.48757763975155277,0.5124223602484472
E01022581,1839,879,960,0.47797716150081565,0.5220228384991843
E01022582,1491,716,775,0.4802146210596915,0.5197853789403085
E01022604,1394,652,742,0.46771879483500717,0.5322812051649928
E01022605,2112,1026,1086,0.48579545454545453,0.5142045454545454
E01022574,1562,747,815,0.47823303457106275,0.5217669654289373
E01022575,1568,766,802,0.4885204081632653,0.5114795918367347
E01022576,1547,747,800,0.48287007110536523,0.5171299288946348
E01022579,1928,933,995,0.48392116182572614,0.5160788381742739
E01022571,1104,541,563,0.490036231884058,0.509963768115942
E01022572,1161,563,598,0.48492678725236865,0.5150732127476314
E01022573,2359,1189,1170,0.5040271301398898,0.49597286986011024
E01022577,1445,653,792,0.4519031141868512,0.5480968858131487
E01022580,1209,600,609,0.49627791563275436,0.5037220843672456
E01034719,1740,875,865,0.5028735632183908,0.49712643678160917
E01034720,1691,790,901,0.4671791839148433,0.5328208160851567
E01022603,1410,695,715,0.4929078014184397,0.5070921985815603
E01022634,1128,562,566,0.49822695035460995,0.50177304964539
E01022639,1642,819,823,0.4987819732034105,0.5012180267965896
E01022640,2725,1350,1375,0.4954128440366973,0.5045871559633027
E01022615,2739,1349,1390,0.4925155166119021,0.5074844833880978
E01022633,1267,626,641,0.4940805051302289,0.5059194948697711
E01022635,1442,708,734,0.4909847434119279,0.5090152565880721
E01022636,1316,669,647,0.5083586626139818,0.49164133738601823
E01022641,1255,620,635,0.4940239043824701,0.5059760956175299
E01022591,2559,1272,1287,0.4970691676436108,0.5029308323563892
E01022593,1423,700,723,0.49191848208011246,0.5080815179198875
E01022594,1953,913,1040,0.4674859190988223,0.5325140809011777
E01022595,2482,1197,1285,0.4822723609991942,0.5177276390008058
E01022596,1884,928,956,0.49256900212314225,0.5074309978768577
E01022627,2311,1135,1176,0.49112938122025096,0.508870618779749
E01022630,2229,1103,1126,0.4948407357559444,0.5051592642440557
E01022642,1035,491,544,0.47439613526570046,0.5256038647342995
E01034721,1158,567,591,0.4896373056994819,0.5103626943005182
E01034722,1782,911,871,0.5112233445566778,0.4887766554433221
E01022583,1834,879,955,0.4792802617230098,0.5207197382769901
E01022584,1833,871,962,0.475177304964539,0.524822695035461
E01022585,1903,908,995,0.4771413557540725,0.5228586442459274
E01022586,2094,1026,1068,0.4899713467048711,0.5100286532951289
E01022587,2107,973,1134,0.46179401993355484,0.5382059800664452
E01022616,1688,795,893,0.4709715639810427,0.5290284360189573
E01022617,1723,829,894,0.4811375507835171,0.5188624492164828
E01022618,1802,868,934,0.4816870144284129,0.5183129855715871
E01022631,1266,627,639,0.495260663507109,0.504739336492891
E01022632,1137,556,581,0.4890061565523307,0.5109938434476693
E01022592,2263,1098,1165,0.48519664162615994,0.5148033583738401
E01022597,2899,1416,1483,0.4884442911348741,0.5115557088651259
E01022619,1209,589,620,0.48717948717948717,0.5128205128205128
E01022624,2221,1092,1129,0.49167041873030165,0.5083295812696983
E01022625,2615,1246,1369,0.47648183556405355,0.5235181644359465
E01022620,1196,567,629,0.47408026755852845,0.5259197324414716
E01022621,1438,663,775,0.4610570236439499,0.53894297635605
E01022622,2300,1097,1203,0.47695652173913045,0.5230434782608696
E01022623,2257,1043,1214,0.4621178555604785,0.5378821444395215
E01032664,1108,525,583,0.47382671480144406,0.526173285198556
E01032665,1323,632,691,0.47770219198790626,0.5222978080120937
E01022588,2657,1302,1355,0.4900263455024464,0.5099736544975536
E01022589,2054,995,1059,0.4844206426484908,0.5155793573515093
E01022590,1524,741,783,0.4862204724409449,0.5137795275590551
E01022607,1179,562,617,0.4766751484308736,0.5233248515691263
E01022608,1329,640,689,0.4815650865312265,0.5184349134687735
E01022606,2465,1224,1241,0.496551724137931,0.503448275862069
E01022611,1519,743,776,0.489137590520079,0.510862409479921
E01022613,1454,710,744,0.48830811554332876,0.5116918844566712
E01022614,1116,533,583,0.4775985663082437,0.5224014336917563
E01022610,1856,900,956,0.4849137931034483,0.5150862068965517
E01022628,1441,697,744,0.48369188063844554,0.5163081193615545
E01022629,1529,723,806,0.4728580771746239,0.5271419228253761
E01032615,1050,514,536,0.4895238095238095,0.5104761904761905
E01032616,1521,748,773,0.4917817225509533,0.5082182774490467
E01022599,1356,655,701,0.4830383480825959,0.5169616519174042
E01022600,1475,718,757,0.48677966101694914,0.5132203389830509
E01022601,1361,661,700,0.4856722997795738,0.5143277002204262
E01022602,1331,654,677,0.49135987978963186,0.5086401202103682
E01032625,1417,697,720,0.4918842625264644,0.5081157374735357
E01022705,1636,778,858,0.47555012224938875,0.5244498777506112
E01022706,1691,821,870,0.48551153163808397,0.514488468361916
E01022707,1939,980,959,0.5054151624548736,0.49458483754512633
E01022708,1773,849,924,0.47884940778341795,0.5211505922165821
E01022709,1731,857,874,0.4950895436164067,0.5049104563835933
E01022659,1526,753,773,0.49344692005242463,0.5065530799475754
E01022660,1471,709,762,0.48198504418762744,0.5180149558123726
E01022675,1333,660,673,0.4951237809452363,0.5048762190547637
E01022676,1856,902,954,0.4859913793103448,0.5140086206896551
E01022704,1848,899,949,0.48647186147186144,0.5135281385281385
E01022661,1684,785,899,0.4661520190023753,0.5338479809976246
E01022662,1355,661,694,0.4878228782287823,0.5121771217712177
E01022663,1593,798,795,0.5009416195856874,0.4990583804143126
E01022664,1520,733,787,0.48223684210526313,0.5177631578947368
E01022665,1364,637,727,0.4670087976539589,0.532991202346041
E01022648,1662,798,864,0.48014440433212996,0.51985559566787
E01022667,2118,1063,1055,0.5018885741265344,0.4981114258734655
E01022672,1492,756,736,0.5067024128686327,0.4932975871313673
E01022673,2273,1166,1107,0.5129784425868896,0.48702155741311043
E01022674,1500,717,783,0.478,0.522
E01022643,1532,750,782,0.489556135770235,0.5104438642297651
E01022644,1219,591,628,0.48482362592288764,0.5151763740771124
E01022646,1485,721,764,0.4855218855218855,0.5144781144781144
E01022647,1776,891,885,0.5016891891891891,0.4983108108108108
E01022649,1533,742,791,0.4840182648401826,0.5159817351598174
E01022650,1202,623,579,0.5183028286189684,0.48169717138103163
E01022678,2000,993,1007,0.4965,0.5035
E01022680,1723,849,874,0.4927452118398143,0.5072547881601858
E01022681,1811,893,918,0.49309773605742685,0.5069022639425732
E01035433,1395,677,718,0.4853046594982079,0.5146953405017921
E01035434,1925,954,971,0.49558441558441557,0.5044155844155844
E01035435,1158,566,592,0.48877374784110533,0.5112262521588946
E01035436,1271,628,643,0.4940991345397325,0.5059008654602675
E01035437,1705,793,912,0.46510263929618767,0.5348973607038123
E01022666,2046,1009,1037,0.49315738025415445,0.5068426197458455
E01022669,1776,877,899,0.4938063063063063,0.5061936936936937
E01022670,1479,722,757,0.48816768086544965,0.5118323191345504
E01022671,1448,743,705,0.513121546961326,0.48687845303867405
E01022679,1943,967,976,0.49768399382398354,0.5023160061760165
E01022645,1112,535,577,0.48111510791366907,0.5188848920863309
E01022682,1893,917,976,0.4844162704701532,0.5155837295298468
E01022683,2299,1113,1186,0.4841235319704219,0.5158764680295781
E01022684,1400,711,689,0.5078571428571429,0.49214285714285716
E01022685,1122,546,576,0.48663101604278075,0.5133689839572193
E01022686,2029,1006,1023,0.4958107442089699,0.50418925579103
E01022687,1676,858,818,0.5119331742243437,0.4880668257756563
E01022713,2049,972,1077,0.4743777452415813,0.5256222547584187
E01022714,1606,788,818,0.49066002490660027,0.5093399750933998
E01022715,1949,922,1027,0.4730631092868138,0.5269368907131863
E01022716,1452,694,758,0.47796143250688705,0.522038567493113
E01022717,1165,578,587,0.496137339055794,0.503862660944206
E01022718,1539,767,772,0.4983755685510071,0.5016244314489928
E01022719,1563,765,798,0.4894433781190019,0.510556621880998
E01022691,1502,715,787,0.4760319573901465,0.5239680426098535
E01022693,1454,708,746,0.48693259972489683,0.5130674002751031
E01022694,1744,847,897,0.4856651376146789,0.5143348623853211
E01035438,2133,1018,1115,0.4772620721987811,0.522737927801219
E01035439,1984,978,1006,0.49294354838709675,0.5070564516129032
E01035440,1487,735,752,0.49428379287155344,0.5057162071284466
E01035441,1480,716,764,0.4837837837837838,0.5162162162162162
E01022652,1760,864,896,0.4909090909090909,0.509090909090909
E01022695,1243,594,649,0.4778761061946903,0.5221238938053098
E01022700,1532,713,819,0.4654046997389034,0.5345953002610966
E01022701,1058,506,552,0.4782608695652174,0.5217391304347826
E01022703,1416,701,715,0.4950564971751412,0.5049435028248588
E01022651,1763,858,905,0.48667044809982984,0.5133295519001702
E01022696,1500,726,774,0.484,0.516
E01022697,1585,748,837,0.47192429022082016,0.5280757097791798
E01022698,1981,980,1001,0.49469964664310956,0.5053003533568905
E01022699,1742,830,912,0.4764638346727899,0.5235361653272101
E01022702,1284,612,672,0.4766355140186916,0.5233644859813084
E01022654,1313,665,648,0.5064737242955065,0.49352627570449353
E01022655,1473,726,747,0.49287169042769857,0.5071283095723014
E01022656,2442,1218,1224,0.4987714987714988,0.5012285012285013
E01022657,2742,1341,1401,0.4890590809628009,0.5109409190371991
E01022658,1700,843,857,0.4958823529411765,0.5041176470588236
E01022710,2071,1004,1067,0.484789956542733,0.5152100434572671
E01022711,1777,864,913,0.48621271806415306,0.5137872819358469
E01022712,1595,773,822,0.4846394984326019,0.5153605015673981
E01022688,2207,1085,1122,0.4916175804259175,0.5083824195740825
E01022689,1945,921,1024,0.4735218508997429,0.526478149100257
E01022690,1884,921,963,0.4888535031847134,0.5111464968152867
E01022758,2217,1079,1138,0.4866937302661254,0.5133062697338746
E01022771,1698,839,859,0.49411071849234395,0.5058892815076561
E01022772,2532,1275,1257,0.5035545023696683,0.49644549763033174
E01022773,1712,831,881,0.48539719626168226,0.5146028037383178
E01022774,2098,1021,1077,0.48665395614871304,0.5133460438512869
E01022749,1311,633,678,0.482837528604119,0.517162471395881
E01022753,1144,532,612,0.46503496503496505,0.534965034965035
E01022754,2287,1098,1189,0.480104940970704,0.519895059029296
E01022780,1741,860,881,0.4939689833429064,0.5060310166570936
E01022787,1366,672,694,0.49194729136163984,0.5080527086383602
E01022788,1249,607,642,0.4859887910328263,0.5140112089671738
E01022730,1493,717,776,0.48024112525117213,0.5197588747488279
E01022731,1261,610,651,0.4837430610626487,0.5162569389373514
E01022732,1454,700,754,0.4814305364511692,0.5185694635488308
E01022733,1643,800,843,0.48691418137553255,0.5130858186244674
E01022734,1395,684,711,0.49032258064516127,0.5096774193548387
E01022720,1492,744,748,0.49865951742627346,0.5013404825737265
E01022725,1292,638,654,0.4938080495356037,0.5061919504643962
E01022726,1428,684,744,0.4789915966386555,0.5210084033613446
E01022727,1511,721,790,0.4771674387822634,0.5228325612177366
E01022729,1153,564,589,0.4891587163920208,0.5108412836079792
E01022743,1795,880,915,0.49025069637883006,0.5097493036211699
E01022750,1408,670,738,0.4758522727272727,0.5241477272727273
E01022751,1536,733,803,0.4772135416666667,0.5227864583333334
E01022752,1364,679,685,0.49780058651026393,0.5021994134897361
E01022757,1591,778,813,0.48900062853551224,0.5109993714644877
E01022790,1680,843,837,0.5017857142857143,0.4982142857142857
E01022755,1670,791,879,0.47365269461077847,0.5263473053892216
E01022756,1775,861,914,0.48507042253521127,0.5149295774647887
E01022791,1861,876,985,0.4707146695325094,0.5292853304674906
E01022792,1597,800,797,0.5009392611145899,0.49906073888541014
E01022793,1937,919,1018,0.47444501806917916,0.5255549819308208
E01022781,1365,669,696,0.4901098901098901,0.5098901098901099
E01022782,1573,745,828,0.47361729179911,0.5263827082008901
E01022785,1420,704,716,0.49577464788732395,0.504225352112676
E01022786,2160,1039,1121,0.4810185185185185,0.5189814814814815
E01022789,1500,745,755,0.49666666666666665,0.5033333333333333
E01022721,1551,737,814,0.475177304964539,0.524822695035461
E01022722,1616,755,861,0.46720297029702973,0.5327970297029703
E01022723,1509,734,775,0.48641484426772696,0.513585155732273
E01022724,1377,673,704,0.4887436456063907,0.5112563543936093
E01022737,1540,765,775,0.4967532467532468,0.5032467532467533
E01022766,1233,612,621,0.49635036496350365,0.5036496350364964
E01022769,1284,640,644,0.4984423676012461,0.5015576323987538
E01022740,1569,769,800,0.49012109623964306,0.5098789037603569
E01022741,1480,711,769,0.4804054054054054,0.5195945945945946
E01022742,1660,808,852,0.4867469879518072,0.5132530120481927
E01022783,1418,670,748,0.47249647390691113,0.5275035260930888
E01022784,1354,665,689,0.4911373707533235,0.5088626292466765
E01022759,1565,777,788,0.4964856230031949,0.5035143769968051
E01022763,1511,737,774,0.4877564526803441,0.5122435473196558
E01022765,1752,857,895,0.4891552511415525,0.5108447488584474
E01022768,1345,669,676,0.49739776951672865,0.5026022304832714
E01022770,1936,947,989,0.48915289256198347,0.5108471074380165
E01022728,1643,787,856,0.47900182592818014,0.5209981740718198
E01022735,1771,895,876,0.5053642010163749,0.4946357989836251
E01022736,1571,791,780,0.5035009548058561,0.49649904519414384
E01022738,1018,485,533,0.4764243614931238,0.5235756385068763
E01022739,1569,742,827,0.47291268323773106,0.5270873167622689
E01022760,1529,755,774,0.49378678875081755,0.5062132112491825
E01022761,1423,678,745,0.4764581869290232,0.5235418130709768
E01022762,1455,687,768,0.47216494845360824,0.5278350515463918
E01022764,1520,738,782,0.4855263157894737,0.5144736842105263
E01022767,1281,638,643,0.49804839968774395,0.501951600312256
E01022776,1494,720,774,0.4819277108433735,0.5180722891566265
E01022777,1571,718,853,0.4570337364735837,0.5429662635264163
E01022778,1399,639,760,0.45675482487491065,0.5432451751250893
E01032877,2760,1551,1209,0.5619565217391305,0.4380434782608696
E01022744,1290,631,659,0.48914728682170544,0.5108527131782946
E01022745,1540,761,779,0.4941558441558442,0.5058441558441559
E01022746,1698,822,876,0.4840989399293286,0.5159010600706714
E01022747,1191,544,647,0.45675902602854745,0.5432409739714525
E01022748,1375,637,738,0.4632727272727273,0.5367272727272727
E01022800,1555,774,781,0.4977491961414791,0.5022508038585209
E01022801,1453,688,765,0.47350309704060567,0.5264969029593943
E01022802,1506,748,758,0.49667994687915007,0.5033200531208499
E01022803,1579,802,777,0.5079164027865738,0.4920835972134262
E01022836,1404,655,749,0.46652421652421655,0.5334757834757835
E01022804,1568,763,805,0.48660714285714285,0.5133928571428571
E01022805,1406,655,751,0.46586059743954483,0.5341394025604552
E01022834,1246,597,649,0.47913322632423755,0.5208667736757624
E01022835,1345,650,695,0.483271375464684,0.516728624535316
E01022840,1489,752,737,0.5050369375419744,0.4949630624580255
E01022813,1356,679,677,0.5007374631268436,0.49926253687315636
E01022814,1639,787,852,0.4801708358755339,0.5198291641244661
E01022815,1505,737,768,0.48970099667774086,0.5102990033222591
E01022823,1495,746,749,0.49899665551839467,0.5010033444816053
E01022825,1321,638,683,0.4829674489023467,0.5170325510976533
E01022819,1603,762,841,0.47535870243293826,0.5246412975670618
E01022820,1701,829,872,0.48736037624926515,0.5126396237507349
E01022841,1517,750,767,0.4943968358602505,0.5056031641397495
E01022842,1644,848,796,0.5158150851581509,0.48418491484184917
E01034060,2190,1077,1113,0.4917808219178082,0.5082191780821917
E01034061,1163,548,615,0.471195184866724,0.528804815133276
E01022807,1396,671,725,0.4806590257879656,0.5193409742120344
E01022816,1353,681,672,0.5033259423503326,0.49667405764966743
E01022817,1738,881,857,0.5069044879171462,0.49309551208285385
E01022818,1454,708,746,0.48693259972489683,0.5130674002751031
E01034062,1398,715,683,0.5114449213161659,0.488555078683834
E01034063,1172,579,593,0.49402730375426623,0.5059726962457338
E01022826,1476,714,762,0.483739837398374,0.516260162601626
E01022828,1262,588,674,0.4659270998415214,0.5340729001584786
E01022829,2590,1257,1333,0.48532818532818534,0.5146718146718147
E01022830,1343,646,697,0.4810126582278481,0.5189873417721519
E01032880,1398,692,706,0.4949928469241774,0.5050071530758226
E01032881,1703,833,870,0.4891368173810922,0.5108631826189078
E01032883,1339,629,710,0.4697535474234503,0.5302464525765497
E01022806,1344,661,683,0.49181547619047616,0.5081845238095238
E01022832,1621,818,803,0.5046267735965454,0.49537322640345466
E01022839,1269,640,629,0.5043341213553979,0.49566587864460204
E01032884,2013,970,1043,0.48186785891703926,0.5181321410829608
E01022810,1471,709,762,0.48198504418762744,0.5180149558123726
E01022833,1729,843,886,0.4875650665124349,0.5124349334875651
E01022843,1505,713,792,0.47375415282392025,0.5262458471760797
E01032878,1038,553,485,0.5327552986512524,0.46724470134874757
E01032879,1210,595,615,0.49173553719008267,0.5082644628099173
E01034064,1379,674,705,0.4887599709934735,0.5112400290065264
E01034065,1063,524,539,0.4929444967074318,0.5070555032925682
E01022794,1490,709,781,0.47583892617449663,0.5241610738255034
E01022795,1567,772,795,0.49266113592852584,0.5073388640714741
E01022796,1320,620,700,0.4696969696969697,0.5303030303030303
E01022837,1529,731,798,0.4780902550686723,0.5219097449313277
E01022838,1268,589,679,0.4645110410094637,0.5354889589905363
E01022797,1114,556,558,0.4991023339317774,0.5008976660682226
E01022798,1460,833,627,0.5705479452054795,0.42945205479452053
E01022799,1402,670,732,0.47788873038516405,0.5221112696148359
E01022812,1192,584,608,0.4899328859060403,0.5100671140939598
E01022831,1316,634,682,0.4817629179331307,0.5182370820668692
E01022845,1352,635,717,0.46967455621301774,0.5303254437869822
E01022890,1467,731,736,0.49829584185412407,0.501704158145876
E01022891,1851,868,983,0.4689357104267963,0.5310642895732036
E01022892,1882,923,959,0.4904357066950053,0.5095642933049946
E01022893,1819,870,949,0.4782847718526663,0.5217152281473337
E01022894,1417,667,750,0.47071277346506707,0.529287226534933
E01022859,1705,857,848,0.5026392961876833,0.49736070381231673
E01022895,1663,795,868,0.47805171377029465,0.5219482862297053
E01022896,1506,756,750,0.50199203187251,0.49800796812749004
E01022897,1609,798,811,0.4959602237414543,0.5040397762585457
E01022898,1470,748,722,0.508843537414966,0.49115646258503404
E01022846,2555,1605,950,0.6281800391389433,0.37181996086105673
E01022847,1789,899,890,0.5025153717160424,0.4974846282839575
E01022848,1522,767,755,0.5039421813403416,0.49605781865965837
E01022874,1305,637,668,0.48812260536398466,0.5118773946360153
E01022875,1409,686,723,0.4868701206529453,0.5131298793470547
E01022876,1513,744,769,0.4917382683410443,0.5082617316589557
E01022877,1423,725,698,0.5094869992972593,0.4905130007027407
E01022858,1242,633,609,0.5096618357487923,0.49033816425120774
E01022878,1659,773,886,0.46594333936106086,0.5340566606389391
E01022879,2130,988,1142,0.463849765258216,0.536150234741784
E01022880,2133,1001,1132,0.4692920768870136,0.5307079231129864
E01022860,2010,915,1095,0.4552238805970149,0.5447761194029851
E01022862,2238,1144,1094,0.5111706881143878,0.48882931188561213
E01022867,1599,807,792,0.5046904315196998,0.49530956848030017
E01032852,1725,849,876,0.49217391304347824,0.5078260869565218
E01032853,1859,918,941,0.49381387842926305,0.506186121570737
E01032854,1674,804,870,0.48028673835125446,0.5197132616487455
E01032857,1060,549,511,0.5179245283018868,0.4820754716981132
E01022881,2745,1360,1385,0.49544626593806923,0.5045537340619308
E01022882,2528,1263,1265,0.49960443037974683,0.5003955696202531
E01022883,1395,697,698,0.4996415770609319,0.5003584229390681
E01022884,1570,772,798,0.49171974522292994,0.5082802547770701
E01022885,1421,719,702,0.505981703026038,0.494018296973962
E01022861,1630,813,817,0.49877300613496933,0.5012269938650307
E01022863,1566,761,805,0.4859514687100894,0.5140485312899106
E01022865,1634,815,819,0.49877600979192166,0.5012239902080783
E01022868,1676,846,830,0.5047732696897375,0.49522673031026254
E01022870,1386,669,717,0.48268398268398266,0.5173160173160173
E01022864,1441,708,733,0.4913254684247051,0.508674531575295
E01022871,1348,651,697,0.48293768545994065,0.5170623145400594
E01022872,1776,877,899,0.4938063063063063,0.5061936936936937
E01022887,1536,784,752,0.5104166666666666,0.4895833333333333
E01034723,1357,650,707,0.47899778924097275,0.5210022107590273
E01034724,1695,826,869,0.4873156342182891,0.512684365781711
E01022849,1701,825,876,0.48500881834215165,0.5149911816578483
E01022850,1488,724,764,0.48655913978494625,0.5134408602150538
E01022851,1647,787,860,0.47783849423193686,0.5221615057680632
E01022853,1861,907,954,0.4873723804406233,0.5126276195593766
E01022869,1531,746,785,0.48726322664924887,0.5127367733507512
E01022852,1798,887,911,0.4933259176863181,0.5066740823136818
E01022854,1604,792,812,0.4937655860349127,0.5062344139650873
E01022855,1221,586,635,0.4799344799344799,0.5200655200655201
E01022856,1658,792,866,0.4776839565741858,0.5223160434258143
E01034725,2140,1054,1086,0.49252336448598133,0.5074766355140187
E01034726,2305,1079,1226,0.4681127982646421,0.531887201735358
E01022888,2147,1005,1142,0.4680950163018165,0.5319049836981835
E01022889,1527,728,799,0.4767518009168304,0.5232481990831697
E01032855,1196,574,622,0.479933110367893,0.520066889632107
E01032856,1649,992,657,0.6015767131594906,0.39842328684050937
E01022930,1711,820,891,0.4792518994739918,0.5207481005260082
E01022931,1589,779,810,0.49024543738200127,0.5097545626179988
E01022935,1472,729,743,0.4952445652173913,0.5047554347826086
E01022975,1984,963,1021,0.48538306451612906,0.514616935483871
E01022976,1418,687,731,0.4844851904090268,0.5155148095909732
E01022922,1450,707,743,0.48758620689655174,0.5124137931034483
E01022971,1439,727,712,0.5052119527449618,0.4947880472550382
E01022972,1823,877,946,0.4810751508502468,0.5189248491497531
E01022974,1333,644,689,0.4831207801950488,0.5168792198049512
E01022959,1448,670,778,0.462707182320442,0.537292817679558
E01022962,2146,1038,1108,0.483690587138863,0.516309412861137
E01022965,1393,670,723,0.4809763101220388,0.5190236898779612
E01022973,2128,1038,1090,0.48778195488721804,0.5122180451127819
E01022901,1818,884,934,0.48624862486248627,0.5137513751375138
E01022902,1510,744,766,0.49271523178807947,0.5072847682119205
E01022966,1354,617,737,0.45568685376661744,0.5443131462333826
E01022967,1136,547,589,0.48151408450704225,0.5184859154929577
E01022960,1306,635,671,0.48621745788667686,0.5137825421133231
E01022961,1287,611,676,0.47474747474747475,0.5252525252525253
E01022963,1421,690,731,0.48557353976073186,0.5144264602392681
E01022964,1362,646,716,0.47430249632892807,0.5256975036710719
E01022903,1741,845,896,0.48535324526134405,0.514646754738656
E01022906,1437,682,755,0.4745998608211552,0.5254001391788448
E01022968,1385,667,718,0.4815884476534296,0.5184115523465704
E01022969,1819,864,955,0.4749862561847169,0.5250137438152831
E01022913,1294,603,691,0.4659969088098918,0.5340030911901081
E01022914,1287,635,652,0.4933954933954934,0.5066045066045066
E01022915,1507,743,764,0.4930325149303251,0.5069674850696748
E01022916,1600,776,824,0.485,0.515
E01022917,1162,564,598,0.4853700516351119,0.5146299483648882
E01022900,1763,847,916,0.48043108338060125,0.5195689166193987
E01022904,2101,1028,1073,0.4892908138981437,0.5107091861018562
E01022905,1738,824,914,0.47410817031070196,0.525891829689298
E01022908,1479,709,770,0.4793779580797836,0.5206220419202163
E01022970,1886,887,999,0.47030752916224816,0.5296924708377518
E01022947,1640,821,819,0.500609756097561,0.499390243902439
E01022948,1646,825,821,0.5012150668286756,0.49878493317132444
E01022949,1481,723,758,0.48818365968939903,0.511816340310601
E01022950,1768,866,902,0.48981900452488686,0.5101809954751131
E01022951,1374,647,727,0.4708879184861718,0.5291120815138283
E01022952,1432,692,740,0.48324022346368717,0.5167597765363129
E01022924,1520,737,783,0.48486842105263156,0.5151315789473684
E01022925,2187,1053,1134,0.48148148148148145,0.5185185185185185
E01022926,1774,862,912,0.4859075535512965,0.5140924464487034
E01022927,1631,763,868,0.4678111587982833,0.5321888412017167
E01022928,1701,803,898,0.4720752498530276,0.5279247501469724
E01022929,1457,671,786,0.4605353466026081,0.5394646533973919
E01022954,1555,755,800,0.4855305466237942,0.5144694533762058
E01022955,1592,744,848,0.46733668341708545,0.5326633165829145
E01022956,1146,559,587,0.48778359511343805,0.512216404886562
E01022957,1306,627,679,0.48009188361408883,0.5199081163859112
E01022958,2304,1131,1173,0.4908854166666667,0.5091145833333334
E01034066,1011,477,534,0.47181008902077154,0.5281899109792285
E01034067,1399,665,734,0.4753395282344532,0.5246604717655469
E01022937,1302,630,672,0.4838709677419355,0.5161290322580645
E01022943,1367,650,717,0.4754937820043892,0.5245062179956108
E01022944,1269,629,640,0.49566587864460204,0.5043341213553979
E01022946,2010,955,1055,0.47512437810945274,0.5248756218905473
E01022940,1546,732,814,0.47347994825355755,0.5265200517464425
E01022942,1467,696,771,0.47443762781186094,0.5255623721881391
E01022945,2243,1062,1181,0.47347302719572004,0.52652697280428
E01022936,1475,735,740,0.49830508474576274,0.5016949152542373
E01022938,1727,796,931,0.4609148812970469,0.5390851187029531
E01022939,1532,738,794,0.48172323759791125,0.5182767624020888
E01022941,1450,697,753,0.4806896551724138,0.5193103448275862
E01022899,1374,695,679,0.5058224163027657,0.49417758369723436
E01022907,1529,741,788,0.48463047743623283,0.5153695225637671
E01022909,1763,858,905,0.48667044809982984,0.5133295519001702
E01022910,1468,719,749,0.48978201634877383,0.5102179836512262
E01022911,1510,760,750,0.5033112582781457,0.4966887417218543
E01032605,1664,818,846,0.49158653846153844,0.5084134615384616
E01022919,1566,789,777,0.5038314176245211,0.49616858237547895
E01022933,1556,742,814,0.4768637532133676,0.5231362467866324
E01022934,1830,864,966,0.4721311475409836,0.5278688524590164
E01032618,1718,843,875,0.49068684516880096,0.5093131548311991
E01022918,1499,716,783,0.47765176784523017,0.5223482321547699
E01022920,1603,786,817,0.4903306300686213,0.5096693699313787
E01022921,1493,720,773,0.4822505023442733,0.5177494976557268
E01032617,1590,782,808,0.4918238993710692,0.5081761006289308
E01023011,1499,727,772,0.4849899933288859,0.5150100066711141
E01023012,1337,651,686,0.4869109947643979,0.5130890052356021
E01023021,1546,757,789,0.4896507115135834,0.5103492884864166
E01023022,1827,854,973,0.4674329501915709,0.5325670498084292
E01023023,1681,822,859,0.48899464604402143,0.5110053539559786
E01023024,1729,839,890,0.4852515905147484,0.5147484094852516
E01023025,1306,623,683,0.4770290964777948,0.5229709035222052
E01023076,1416,680,736,0.480225988700565,0.519774011299435
E01023082,1401,674,727,0.48108493932905066,0.5189150606709493
E01023083,1476,705,771,0.47764227642276424,0.5223577235772358
E01023088,1582,758,824,0.47914032869785084,0.5208596713021492
E01023073,1262,621,641,0.4920760697305864,0.5079239302694136
E01023080,1441,702,739,0.4871616932685635,0.5128383067314365
E01023081,2026,985,1041,0.4861796643632774,0.5138203356367226
E01023089,1476,696,780,0.4715447154471545,0.5284552845528455
E01023090,1802,892,910,0.49500554938956715,0.5049944506104328
E01023074,1347,620,727,0.4602821083890126,0.5397178916109874
E01023077,1734,863,871,0.49769319492502884,0.5023068050749712
E01023078,1442,708,734,0.4909847434119279,0.5090152565880721
E01023079,1745,871,874,0.4991404011461318,0.5008595988538682
E01023085,1466,703,763,0.4795361527967258,0.5204638472032742
E01023072,1256,610,646,0.4856687898089172,0.5143312101910829
E01023075,1353,662,691,0.4892830746489283,0.5107169253510717
E01023084,1478,720,758,0.4871447902571042,0.5128552097428958
E01023086,1542,757,785,0.4909208819714656,0.5090791180285343
E01023087,1406,699,707,0.4971550497866287,0.5028449502133713
E01022977,1460,709,751,0.48561643835616436,0.5143835616438356
E01022978,1584,770,814,0.4861111111111111,0.5138888888888888
E01022979,1126,552,574,0.49023090586145646,0.5097690941385435
E01022980,1475,755,720,0.511864406779661,0.488135593220339
E01022992,1156,575,581,0.49740484429065746,0.5025951557093425
E01022993,1316,661,655,0.5022796352583586,0.49772036474164133
E01023045,1559,739,820,0.4740218088518281,0.5259781911481719
E01023046,1460,701,759,0.48013698630136986,0.5198630136986301
E01023007,1088,529,559,0.48621323529411764,0.5137867647058824
E01023010,1384,653,731,0.4718208092485549,0.528179190751445
E01023047,1255,633,622,0.5043824701195219,0.4956175298804781
E01023048,1306,617,689,0.4724349157733537,0.5275650842266463
E01023049,1465,711,754,0.4853242320819113,0.5146757679180888
E01023050,1749,872,877,0.4985706117781589,0.501429388221841
E01023008,1577,731,846,0.4635383639822448,0.5364616360177552
E01023009,1444,704,740,0.48753462603878117,0.5124653739612188
E01023038,1395,652,743,0.46738351254480287,0.5326164874551972
E01023039,1412,679,733,0.48087818696883855,0.5191218130311614
E01023040,1448,720,728,0.4972375690607735,0.5027624309392266
E01023026,1167,570,597,0.4884318766066838,0.5115681233933161
E01023062,1487,751,736,0.5050437121721587,0.4949562878278413
E01023064,1358,650,708,0.4786450662739323,0.5213549337260678
E01023066,1710,876,834,0.512280701754386,0.48771929824561405
E01023067,1504,723,781,0.480718085106383,0.519281914893617
E01023003,1719,825,894,0.4799301919720768,0.5200698080279232
E01023004,1818,891,927,0.4900990099009901,0.5099009900990099
E01023005,1465,711,754,0.4853242320819113,0.5146757679180888
E01023006,1371,653,718,0.4762946754194019,0.5237053245805982
E01023028,2065,999,1066,0.4837772397094431,0.5162227602905569
E01023037,1997,928,1069,0.4646970455683525,0.5353029544316474
E01023065,1613,796,817,0.4934903905765654,0.5065096094234346
E01023068,1275,611,664,0.4792156862745098,0.5207843137254902
E01023069,1918,902,1016,0.470281543274244,0.529718456725756
E01023070,1823,794,1029,0.4355458036204059,0.564454196379594
E01023071,1478,704,774,0.476319350473613,0.523680649526387
E01023029,1682,805,877,0.47859690844233055,0.5214030915576694
E01023030,1265,627,638,0.4956521739130435,0.5043478260869565
E01023032,1317,639,678,0.48519362186788156,0.5148063781321185
E01023033,1293,644,649,0.4980665119876257,0.5019334880123744
E01023013,1408,685,723,0.4865056818181818,0.5134943181818182
E01023014,1657,813,844,0.49064574532287264,0.5093542546771274
E01023015,1421,709,712,0.4989444053483462,0.5010555946516537
E01023016,1355,679,676,0.5011070110701107,0.4988929889298893
E01023027,1421,692,729,0.48698099929627026,0.5130190007037297
E01023031,1193,605,588,0.5071248952221291,0.4928751047778709
E01022989,1793,835,958,0.46569994422755157,0.5343000557724484
E01022991,2114,1034,1080,0.489120151371807,0.510879848628193
E01022998,1736,844,892,0.4861751152073733,0.5138248847926268
E01023000,1748,826,922,0.47254004576659037,0.5274599542334096
E01022994,1511,728,783,0.4818001323626737,0.5181998676373263
E01022995,1411,673,738,0.47696669029057404,0.523033309709426
E01022996,1188,594,594,0.5,0.5
E01022997,1299,604,695,0.4649730561970747,0.5350269438029254
E01023063,1483,711,772,0.4794335805799056,0.5205664194200944
E01022990,1548,767,781,0.49547803617571057,0.5045219638242894
E01022999,2081,1046,1035,0.5026429601153292,0.49735703988467084
E01023041,1593,788,805,0.49466415568110483,0.5053358443188951
E01023042,1629,715,914,0.4389195825659914,0.5610804174340086
E01023043,1663,763,900,0.4588093806374023,0.5411906193625977
E01022984,1458,694,764,0.47599451303155005,0.52400548696845
E01022985,1180,564,616,0.47796610169491527,0.5220338983050847
E01023020,1416,687,729,0.4851694915254237,0.5148305084745762
E01023034,1801,844,957,0.46862853970016655,0.5313714602998334
E01023035,1776,848,928,0.4774774774774775,0.5225225225225225
E01023036,1999,956,1043,0.4782391195597799,0.5217608804402201
E01023001,2031,963,1068,0.4741506646971935,0.5258493353028065
E01023002,1677,801,876,0.4776386404293381,0.5223613595706619
E01023058,1436,691,745,0.48119777158774374,0.5188022284122563
E01023060,1543,753,790,0.4880103694102398,0.5119896305897602
E01023061,1435,694,741,0.48362369337979094,0.5163763066202091
E01023017,1949,932,1017,0.47819394561313494,0.521806054386865
E01023018,1477,713,764,0.4827352742044685,0.5172647257955315
E01023019,1394,671,723,0.4813486370157819,0.5186513629842181
E01023055,1329,643,686,0.48382242287434163,0.5161775771256584
E01022986,1443,684,759,0.47401247401247404,0.525987525987526
E01022988,1453,708,745,0.48726772195457674,0.5127322780454233
E01023054,1801,875,926,0.4858411993337035,0.5141588006662965
E01023056,1505,642,863,0.42657807308970097,0.573421926910299
E01023057,1741,787,954,0.45203905801263644,0.5479609419873636
E01022981,1883,890,993,0.4726500265533723,0.5273499734466277
E01022982,1900,880,1020,0.4631578947368421,0.5368421052631579
E01022983,1605,741,864,0.4616822429906542,0.5383177570093458
E01022987,2016,900,1116,0.44642857142857145,0.5535714285714286
E01023044,1098,518,580,0.47176684881602915,0.5282331511839709
E01023051,1490,703,787,0.47181208053691276,0.5281879194630873
E01023052,1721,782,939,0.4543869843114468,0.5456130156885531
E01023053,1693,805,888,0.4754873006497342,0.5245126993502658
E01023059,1731,805,926,0.4650491045638359,0.534950895436164
E01023099,1641,794,847,0.4838513101767215,0.5161486898232784
E01023104,1651,801,850,0.485160508782556,0.514839491217444
E01023106,1478,721,757,0.4878213802435724,0.5121786197564276
E01023121,1981,955,1026,0.48207975769813227,0.5179202423018677
E01023105,1614,766,848,0.4745972738537794,0.5254027261462205
E01023119,1268,606,662,0.47791798107255523,0.5220820189274448
E01023120,1745,872,873,0.4997134670487106,0.5002865329512894
E01023122,1489,735,754,0.49361987911349897,0.506380120886501
E01023146,1377,673,704,0.4887436456063907,0.5112563543936093
E01023100,1210,626,584,0.5173553719008265,0.4826446280991736
E01023101,1243,624,619,0.50201126307321,0.49798873692679
E01023102,1427,698,729,0.48913805185704273,0.5108619481429573
E01023134,1735,866,869,0.49913544668587895,0.500864553314121
E01023147,1540,764,776,0.4961038961038961,0.5038961038961038
E01023096,2342,1192,1150,0.5089666951323655,0.4910333048676345
E01023097,1532,761,771,0.49673629242819844,0.5032637075718016
E01023103,1568,771,797,0.4917091836734694,0.5082908163265306
E01023111,1837,902,935,0.49101796407185627,0.5089820359281437
E01023112,1290,652,638,0.5054263565891473,0.4945736434108527
E01023092,1408,715,693,0.5078125,0.4921875
E01023093,1295,653,642,0.5042471042471043,0.4957528957528958
E01023132,1552,757,795,0.4877577319587629,0.5122422680412371
E01023133,1302,671,631,0.5153609831029186,0.4846390168970814
E01023135,2477,1199,1278,0.4840532902704885,0.5159467097295115
E01023091,1823,852,971,0.4673614920460779,0.5326385079539221
E01023094,1326,651,675,0.49095022624434387,0.5090497737556561
E01023095,1920,932,988,0.48541666666666666,0.5145833333333333
E01023098,1710,825,885,0.4824561403508772,0.5175438596491229
E01023148,1320,673,647,0.5098484848484849,0.49015151515151517
E01023149,1362,692,670,0.5080763582966226,0.4919236417033774
E01023113,1885,955,930,0.506631299734748,0.493368700265252
E01023114,1454,735,719,0.5055020632737276,0.49449793672627235
E01023136,2777,1483,1294,0.534029528267915,0.465970471732085
E01023137,1374,679,695,0.49417758369723436,0.5058224163027657
E01023138,1440,726,714,0.5041666666666667,0.49583333333333335
E01023139,1237,609,628,0.49232012934519,0.50767987065481
E01023140,1954,1198,756,0.6131013306038895,0.38689866939611056
E01023141,2171,1280,891,0.5895900506678949,0.410409949332105
E01023144,1910,941,969,0.49267015706806283,0.5073298429319372
E01034727,2218,1107,1111,0.49909828674481516,0.5009017132551848
E01034728,1699,853,846,0.5020600353148911,0.49793996468510887
E01034729,1448,706,742,0.48756906077348067,0.5124309392265194
E01034730,1468,718,750,0.4891008174386921,0.510899182561308
E01023118,1885,962,923,0.5103448275862069,0.4896551724137931
E01023124,1315,654,661,0.4973384030418251,0.5026615969581749
E01023125,2392,1200,1192,0.5016722408026756,0.4983277591973244
E01032858,2492,1187,1305,0.4763242375601926,0.5236757624398074
E01023128,1391,659,732,0.47375988497483823,0.5262401150251618
E01023129,1428,755,673,0.5287114845938375,0.47128851540616246
E01023130,1402,710,692,0.5064194008559201,0.49358059914407987
E01023131,1478,729,749,0.493234100135318,0.506765899864682
E01023145,2273,1138,1135,0.5006599208095028,0.49934007919049717
E01023109,1576,789,787,0.5006345177664975,0.4993654822335025
E01023115,1455,738,717,0.5072164948453608,0.4927835051546392
E01023116,1943,986,957,0.5074626865671642,0.4925373134328358
E01023117,1769,879,890,0.4968908988128886,0.5031091011871114
E01023107,1488,703,785,0.4724462365591398,0.5275537634408602
E01023108,1540,722,818,0.4688311688311688,0.5311688311688312
E01023110,1850,894,956,0.48324324324324325,0.5167567567567568
E01023123,1586,796,790,0.501891551071879,0.49810844892812106
E01023165,2103,1035,1068,0.4921540656205421,0.5078459343794579
E01023169,2121,1016,1105,0.47901933050447904,0.520980669495521
E01023181,1314,643,671,0.4893455098934551,0.510654490106545
E01023182,1504,753,751,0.5006648936170213,0.49933510638297873
E01023153,1731,870,861,0.5025996533795494,0.49740034662045063
E01023154,1609,751,858,0.46674953387197016,0.5332504661280298
E01023156,1397,681,716,0.4874731567644954,0.5125268432355047
E01023157,1339,660,679,0.49290515309932786,0.5070948469006722
E01023205,1297,640,657,0.49344641480339246,0.5065535851966075
E01023179,1849,916,933,0.49540292049756623,0.5045970795024337
E01023183,1411,668,743,0.47342310418143163,0.5265768958185684
E01023190,1208,591,617,0.48923841059602646,0.5107615894039735
E01023203,1421,677,744,0.47642505277973257,0.5235749472202674
E01023204,1601,792,809,0.4946908182386009,0.5053091817613992
E01023180,1648,787,861,0.47754854368932037,0.5224514563106796
E01023186,1652,826,826,0.5,0.5
E01023189,1921,1083,838,0.5637688703800104,0.4362311296199896
E01023196,1662,824,838,0.49578820697954273,0.5042117930204573
E01032870,1876,914,962,0.48720682302771856,0.5127931769722814
E01032871,1483,734,749,0.4949426837491571,0.5050573162508429
E01023187,1549,783,766,0.5054874112330536,0.4945125887669464
E01023188,1259,623,636,0.4948371723590151,0.5051628276409849
E01023216,1901,939,962,0.4939505523408732,0.5060494476591267
E01023217,1585,770,815,0.48580441640378547,0.5141955835962145
E01023218,1502,752,750,0.5006657789613849,0.4993342210386152
E01023159,2339,1147,1192,0.4903805044890979,0.5096194955109021
E01023195,2065,1075,990,0.5205811138014528,0.4794188861985472
E01023197,1442,711,731,0.4930651872399445,0.5069348127600555
E01023198,1441,709,732,0.49201943095072864,0.5079805690492714
E01023160,1509,736,773,0.487740225314778,0.512259774685222
E01023168,1426,683,743,0.4789621318373071,0.5210378681626928
E01023178,2291,1151,1140,0.5024006983849847,0.49759930161501525
E01023166,1583,789,794,0.4984207201516109,0.5015792798483891
E01023167,1556,747,809,0.4800771208226221,0.5199228791773779
E01023177,2256,1117,1139,0.4951241134751773,0.5048758865248227
E01023184,1423,710,713,0.4989458889669712,0.5010541110330288
E01023185,1207,595,612,0.49295774647887325,0.5070422535211268
E01023174,1658,823,835,0.49638118214716526,0.5036188178528347
E01023175,1524,712,812,0.4671916010498688,0.5328083989501312
E01023176,1545,716,829,0.4634304207119741,0.5365695792880258
E01023207,1566,752,814,0.48020434227330777,0.5197956577266922
E01023208,1090,520,570,0.47706422018348627,0.5229357798165137
E01023209,1275,616,659,0.4831372549019608,0.5168627450980392
E01023150,1683,758,925,0.4503862150920974,0.5496137849079026
E01023151,1382,633,749,0.45803183791606367,0.5419681620839363
E01023152,1654,734,920,0.4437726723095526,0.5562273276904474
E01023206,1138,543,595,0.4771528998242531,0.5228471001757469
E01023158,2392,1189,1203,0.4970735785953177,0.5029264214046822
E01023191,1827,877,950,0.48002189381499727,0.5199781061850027
E01023192,1889,926,963,0.490206458443621,0.509793541556379
E01023193,1855,910,945,0.49056603773584906,0.5094339622641509
E01023194,1429,699,730,0.48915325402379284,0.5108467459762072
E01023200,1511,726,785,0.4804765056254136,0.5195234943745863
E01023162,1854,900,954,0.4854368932038835,0.5145631067961165
E01023163,1624,820,804,0.5049261083743842,0.49507389162561577
E01023164,1557,747,810,0.4797687861271676,0.5202312138728323
E01035450,1610,773,837,0.48012422360248447,0.5198757763975155
E01035451,1588,742,846,0.4672544080604534,0.5327455919395466
E01035452,1531,746,785,0.48726322664924887,0.5127367733507512
E01023210,1487,737,750,0.49562878278412914,0.5043712172158709
E01023211,1900,942,958,0.4957894736842105,0.5042105263157894
E01023212,1406,669,737,0.47581792318634425,0.5241820768136558
E01023213,1284,615,669,0.47897196261682246,0.5210280373831776
E01023214,1282,635,647,0.4953198127925117,0.5046801872074883
E01023170,2541,1216,1325,0.478551751279024,0.521448248720976
E01023171,1819,894,925,0.491478834524464,0.508521165475536
E01023172,1474,740,734,0.5020352781546812,0.49796472184531887
E01023173,1416,689,727,0.4865819209039548,0.5134180790960452
E01035453,1420,725,695,0.5105633802816901,0.4894366197183099
E01035454,1417,729,688,0.5144671841919548,0.4855328158080452
E01035455,1709,841,868,0.49210064365125805,0.507899356348742
E01035456,1659,828,831,0.49909584086799275,0.5009041591320073
E01035457,1463,707,756,0.48325358851674644,0.5167464114832536
E01035458,1652,800,852,0.48426150121065376,0.5157384987893463
E01035459,1644,810,834,0.4927007299270073,0.5072992700729927
E01035460,1343,670,673,0.49888309754281457,0.5011169024571854
E01035461,1262,627,635,0.4968304278922345,0.5031695721077655
E01035462,1576,748,828,0.4746192893401015,0.5253807106598984
E01023202,1965,992,973,0.5048346055979643,0.4951653944020356
E01023215,1712,831,881,0.48539719626168226,0.5146028037383178
E01023219,1398,680,718,0.4864091559370529,0.5135908440629471
E01023286,1513,733,780,0.48446794448116326,0.5155320555188367
E01023287,2962,1463,1499,0.4939230249831195,0.5060769750168805
E01023288,1443,720,723,0.498960498960499,0.501039501039501
E01023236,2019,1015,1004,0.5027241208519069,0.4972758791480931
E01023237,1469,688,781,0.46834581347855686,0.5316541865214431
E01023238,1792,929,863,0.5184151785714286,0.48158482142857145
E01023239,1664,804,860,0.4831730769230769,0.5168269230769231
E01023240,2200,1031,1169,0.46863636363636363,0.5313636363636364
E01023241,1851,1106,745,0.5975148568341437,0.4024851431658563
E01023248,1735,832,903,0.4795389048991354,0.5204610951008646
E01023253,2038,956,1082,0.4690873405299313,0.5309126594700687
E01023274,2665,1271,1394,0.47692307692307695,0.5230769230769231
E01023225,2223,1076,1147,0.4840305892937472,0.5159694107062528
E01023278,1521,720,801,0.47337278106508873,0.5266272189349113
E01023279,1436,703,733,0.4895543175487465,0.5104456824512534
E01023280,1557,758,799,0.48683365446371224,0.5131663455362877
E01023281,1741,761,980,0.43710511200459506,0.562894887995405
E01023247,1588,760,828,0.47858942065491183,0.5214105793450882
E01023249,1349,646,703,0.4788732394366197,0.5211267605633803
E01023250,1893,900,993,0.4754358161648177,0.5245641838351822
E01023268,1222,601,621,0.4918166939443535,0.5081833060556464
E01023269,2503,1119,1384,0.44706352377147424,0.5529364762285258
E01023270,1527,891,636,0.5834970530451866,0.4165029469548134
E01023251,1221,529,692,0.4332514332514332,0.5667485667485668
E01023255,1692,748,944,0.44208037825059104,0.557919621749409
E01023256,1550,755,795,0.4870967741935484,0.5129032258064516
E01023257,1609,794,815,0.4934742075823493,0.5065257924176507
E01023258,1571,703,868,0.4474856779121579,0.5525143220878421
E01023252,1821,880,941,0.48325096101043385,0.5167490389895661
E01023254,1812,901,911,0.49724061810154524,0.5027593818984547
E01023263,2047,1013,1034,0.4948705422569614,0.5051294577430386
E01023264,1773,1105,668,0.6232374506486181,0.3767625493513818
E01023265,1840,896,944,0.48695652173913045,0.5130434782608696
E01023267,1407,659,748,0.4683724235963042,0.5316275764036958
E01023260,1307,587,720,0.44912012241775057,0.5508798775822494
E01023261,1633,735,898,0.45009185548071035,0.5499081445192896
E01023262,1562,725,837,0.4641485275288092,0.5358514724711908
E01023266,2262,1019,1243,0.4504862953138815,0.5495137046861185
E01023229,2091,1035,1056,0.4949784791965567,0.5050215208034433
E01023242,1218,594,624,0.4876847290640394,0.5123152709359606
E01023243,1243,569,674,0.4577634754625905,0.5422365245374094
E01023244,1591,789,802,0.49591451917033313,0.5040854808296669
E01023259,2089,994,1095,0.475825753949258,0.524174246050742
E01023226,1689,798,891,0.4724689165186501,0.5275310834813499
E01023227,2022,996,1026,0.49258160237388726,0.5074183976261127
E01023228,2282,1099,1183,0.4815950920245399,0.5184049079754601
E01023230,2129,1013,1116,0.4758102395490841,0.5241897604509159
E01023246,1628,842,786,0.5171990171990172,0.4828009828009828
E01023235,2105,1028,1077,0.4883610451306413,0.5116389548693586
E01023275,1694,823,871,0.4858323494687131,0.5141676505312869
E01023276,1760,842,918,0.4784090909090909,0.5215909090909091
E01023277,1257,618,639,0.4916467780429594,0.5083532219570406
E01023282,2146,1067,1079,0.4972041006523765,0.5027958993476235
E01023220,1991,982,1009,0.4932194876946258,0.5067805123053741
E01023221,1861,854,1007,0.4588930682428802,0.5411069317571199
E01023222,1562,713,849,0.4564660691421255,0.5435339308578745
E01023223,1543,745,798,0.48282566429034346,0.5171743357096565
E01023272,1596,776,820,0.48621553884711777,0.5137844611528822
E01023273,1652,815,837,0.4933414043583535,0.5066585956416465
E01023245,2718,1359,1359,0.5,0.5
E01023271,1271,619,652,0.48701809598741147,0.5129819040125885
E01023285,1607,764,843,0.47542003733665217,0.5245799626633478
E01032859,1749,873,876,0.49914236706689535,0.5008576329331046
E01032860,1570,809,761,0.5152866242038217,0.48471337579617835
E01034731,1487,762,725,0.5124411566913248,0.48755884330867516
E01034732,1345,658,687,0.48921933085501856,0.5107806691449814
E01023231,1851,893,958,0.48244192328471097,0.5175580767152891
E01023232,2860,1442,1418,0.5041958041958042,0.4958041958041958
E01023233,1819,866,953,0.4760857614073667,0.5239142385926333
E01023234,1550,750,800,0.4838709677419355,0.5161290322580645
E01034733,1834,970,864,0.5288985823336968,0.47110141766630315
E01034734,1621,779,842,0.4805675508945096,0.5194324491054905
E01023987,1007,477,530,0.47368421052631576,0.5263157894736842
E01023988,1574,763,811,0.48475222363405335,0.5152477763659467
E01024040,1315,612,703,0.46539923954372625,0.5346007604562738
E01024041,1166,548,618,0.4699828473413379,0.5300171526586621
E01032810,1587,738,849,0.46502835538752363,0.5349716446124764
E01032812,1778,886,892,0.4983127109111361,0.5016872890888638
E01023985,1165,554,611,0.4755364806866953,0.5244635193133047
E01023986,1547,731,816,0.4725274725274725,0.5274725274725275
E01023989,1333,662,671,0.4966241560390098,0.5033758439609902
E01023990,1277,626,651,0.490211433046202,0.5097885669537979
E01024033,1821,887,934,0.4870950027457441,0.5129049972542559
E01024035,1048,492,556,0.46946564885496184,0.5305343511450382
E01023983,1482,706,776,0.47638326585695007,0.5236167341430499
E01023999,2275,1107,1168,0.4865934065934066,0.5134065934065934
E01032811,1595,789,806,0.4946708463949843,0.5053291536050156
E01032822,1448,686,762,0.47375690607734805,0.5262430939226519
E01023973,2802,1328,1474,0.4739471805852962,0.5260528194147038
E01024002,1467,765,702,0.5214723926380368,0.4785276073619632
E01024023,2635,1280,1355,0.4857685009487666,0.5142314990512334
E01024029,2516,1260,1256,0.5007949125596184,0.49920508744038156
E01034985,1385,720,665,0.51985559566787,0.48014440433212996
E01034986,1299,687,612,0.5288683602771362,0.47113163972286376
E01023972,1434,686,748,0.4783821478382148,0.5216178521617852
E01023995,1178,601,577,0.5101867572156197,0.4898132427843803
E01023996,1270,629,641,0.4952755905511811,0.5047244094488189
E01024003,1842,885,957,0.4804560260586319,0.5195439739413681
E01024004,2253,1086,1167,0.48202396804260983,0.5179760319573902
E01024005,1585,772,813,0.48706624605678234,0.5129337539432177
E01023974,1472,742,730,0.5040760869565217,0.49592391304347827
E01023975,2177,1070,1107,0.491502067064768,0.5084979329352319
E01023977,1430,675,755,0.47202797202797203,0.527972027972028
E01024016,1347,656,691,0.48700816629547145,0.5129918337045286
E01024017,1903,934,969,0.4908039936941671,0.509196006305833
E01024028,1709,793,916,0.46401404330017554,0.5359859566998244
E01023976,1821,900,921,0.4942339373970346,0.5057660626029654
E01024019,1730,859,871,0.49653179190751445,0.5034682080924856
E01024020,2044,962,1082,0.4706457925636008,0.5293542074363993
E01032816,2026,993,1033,0.4901283316880553,0.5098716683119447
E01032823,1627,790,837,0.4855562384757222,0.5144437615242778
E01024001,1595,765,830,0.47962382445141066,0.5203761755485894
E01024006,1266,624,642,0.4928909952606635,0.5071090047393365
E01024008,2012,970,1042,0.4821073558648111,0.5178926441351889
E01032815,1036,506,530,0.48841698841698844,0.5115830115830116
E01032817,1178,609,569,0.5169779286926995,0.4830220713073005
E01032818,1524,768,756,0.5039370078740157,0.49606299212598426
E01032819,1753,852,901,0.4860239589275528,0.5139760410724472
E01032824,1437,730,707,0.5080027835768963,0.4919972164231037
E01024013,1913,927,986,0.48457919498170415,0.5154208050182959
E01024014,1900,952,948,0.5010526315789474,0.49894736842105264
E01024015,1610,794,816,0.493167701863354,0.506832298136646
E01034987,1605,786,819,0.4897196261682243,0.5102803738317757
E01034988,1666,838,828,0.503001200480192,0.4969987995198079
E01034989,1699,866,833,0.5097115950559152,0.49028840494408477
E01023978,1313,661,652,0.5034272658035034,0.49657273419649656
E01023979,1346,634,712,0.4710252600297177,0.5289747399702823
E01024032,2094,1000,1094,0.4775549188156638,0.5224450811843362
E01024036,1455,713,742,0.49003436426116836,0.5099656357388316
E01024031,1669,831,838,0.4979029358897543,0.5020970641102457
E01024038,2061,983,1078,0.4769529354682193,0.5230470645317807
E01024039,1631,809,822,0.4960147148988351,0.5039852851011649
E01032813,1904,920,984,0.4831932773109244,0.5168067226890757
E01032814,2100,1063,1037,0.5061904761904762,0.4938095238095238
E01024009,1385,656,729,0.4736462093862816,0.5263537906137185
E01024010,1417,674,743,0.4756527875793931,0.5243472124206069
E01024011,1288,638,650,0.4953416149068323,0.5046583850931677
E01024012,1099,518,581,0.4713375796178344,0.5286624203821656
E01024024,2218,1018,1200,0.45897204688908927,0.5410279531109107
E01024025,1361,579,782,0.4254224834680382,0.5745775165319618
E01023997,1554,767,787,0.49356499356499356,0.5064350064350064
E01023998,1174,567,607,0.4829642248722317,0.5170357751277683
E01024026,1246,577,669,0.46308186195826645,0.5369181380417335
E01024037,1987,964,1023,0.4851534977352793,0.5148465022647207
E01023980,1118,528,590,0.47227191413237923,0.5277280858676208
E01023981,1580,747,833,0.4727848101265823,0.5272151898734178
E01023984,1288,604,684,0.468944099378882,0.531055900621118
E01024021,1480,769,711,0.5195945945945946,0.4804054054054054
E01024022,1563,763,800,0.48816378758797185,0.5118362124120281
E01023992,1842,871,971,0.4728555917480999,0.5271444082519001
E01023993,1467,702,765,0.4785276073619632,0.5214723926380368
E01032820,2533,1213,1320,0.4788787998420845,0.5211212001579155
E01032821,3002,1495,1507,0.49800133244503664,0.5019986675549634
E01024078,1807,866,941,0.47924737133370227,0.5207526286662977
E01024080,1344,626,718,0.46577380952380953,0.5342261904761905
E01024081,1542,724,818,0.4695201037613489,0.5304798962386511
E01024082,1422,674,748,0.4739803094233474,0.5260196905766527
E01024095,1479,733,746,0.495605138607167,0.504394861392833
E01024094,2659,1284,1375,0.4828883038736367,0.5171116961263633
E01024096,1709,796,913,0.4657694558221182,0.5342305441778818
E01024097,1581,706,875,0.4465528146742568,0.5534471853257432
E01024098,1535,735,800,0.4788273615635179,0.5211726384364821
E01024064,2605,1271,1334,0.48790786948176584,0.5120921305182342
E01024066,1585,778,807,0.4908517350157729,0.5091482649842272
E01024079,1578,735,843,0.46577946768060835,0.5342205323193916
E01024083,1403,668,735,0.47612259444048466,0.5238774055595153
E01024118,1789,867,922,0.48462828395751817,0.5153717160424819
E01024059,1451,703,748,0.4844934527911785,0.5155065472088215
E01024065,2029,975,1054,0.48053228191227204,0.519467718087728
E01024117,1518,729,789,0.48023715415019763,0.5197628458498024
E01024119,1575,765,810,0.4857142857142857,0.5142857142857142
E01024120,1640,790,850,0.4817073170731707,0.5182926829268293
E01024056,1907,918,989,0.48138437336130047,0.5186156266386995
E01024057,1775,864,911,0.4867605633802817,0.5132394366197183
E01024058,1606,763,843,0.475093399750934,0.524906600249066
E01024114,1736,813,923,0.4683179723502304,0.5316820276497696
E01024115,1414,644,770,0.45544554455445546,0.5445544554455446
E01024073,2580,1230,1350,0.47674418604651164,0.5232558139534884
E01024074,1454,715,739,0.49174690508940855,0.5082530949105915
E01024075,1593,770,823,0.48336472065285624,0.5166352793471437
E01024076,1825,892,933,0.48876712328767125,0.5112328767123288
E01024077,2196,1100,1096,0.5009107468123861,0.4990892531876138
E01024055,1582,770,812,0.48672566371681414,0.5132743362831859
E01024061,1480,685,795,0.46283783783783783,0.5371621621621622
E01024063,1592,765,827,0.4805276381909548,0.5194723618090452
E01024071,1669,786,883,0.47094068304373876,0.5290593169562612
E01024116,1485,717,768,0.48282828282828283,0.5171717171717172
E01024060,1499,716,783,0.47765176784523017,0.5223482321547699
E01024069,1226,580,646,0.4730831973898858,0.5269168026101142
E01024070,1249,585,664,0.46837469975980783,0.5316253002401922
E01024072,1093,534,559,0.4885635864592864,0.5114364135407137
E01024106,1570,736,834,0.46878980891719746,0.5312101910828025
E01024062,2189,1060,1129,0.4842393787117405,0.5157606212882595
E01024105,1526,726,800,0.47575360419397117,0.5242463958060288
E01024107,1457,703,754,0.48249828414550444,0.5175017158544956
E01024108,1198,571,627,0.4766277128547579,0.5233722871452421
E01024109,2362,1182,1180,0.5004233700254022,0.4995766299745978
E01024084,1290,595,695,0.46124031007751937,0.5387596899224806
E01024085,1641,777,864,0.473491773308958,0.526508226691042
E01024086,2245,1117,1128,0.49755011135857463,0.5024498886414254
E01024087,1349,664,685,0.4922164566345441,0.507783543365456
E01024091,1402,670,732,0.47788873038516405,0.5221112696148359
E01024110,1533,771,762,0.50293542074364,0.49706457925636005
E01024111,1556,725,831,0.46593830334190234,0.5340616966580977
E01024112,1592,748,844,0.46984924623115576,0.5301507537688442
E01024113,1438,678,760,0.4714881780250348,0.5285118219749653
E01024067,1216,593,623,0.4876644736842105,0.5123355263157895
E01024068,1599,769,830,0.4809255784865541,0.5190744215134458
E01024123,1603,768,835,0.479101684341859,0.5208983156581409
E01035308,1167,550,617,0.4712939160239931,0.5287060839760068
E01035309,5447,2663,2784,0.48889296860657244,0.5111070313934276
E01024099,1445,701,744,0.485121107266436,0.514878892733564
E01024100,1506,740,766,0.4913678618857902,0.5086321381142098
E01024101,1749,905,844,0.5174385363064609,0.48256146369353914
E01024102,1771,904,867,0.510446075663467,0.48955392433653305
E01024103,1592,738,854,0.4635678391959799,0.5364321608040201
E01024047,2085,988,1097,0.47386091127098323,0.5261390887290168
E01024049,1373,671,702,0.48871085214857973,0.5112891478514202
E01024090,2868,1378,1490,0.4804741980474198,0.5195258019525802
E01024092,1549,742,807,0.4790187217559716,0.5209812782440284
E01024093,1851,869,982,0.46947595894111294,0.5305240410588871
E01024044,2499,1174,1325,0.46978791516606644,0.5302120848339336
E01024045,1629,788,841,0.48373235113566604,0.516267648864334
E01024046,1893,902,991,0.47649234020073955,0.5235076597992604
E01024048,1481,604,877,0.40783254557731263,0.5921674544226874
E01024131,2392,1022,1370,0.42725752508361203,0.572742474916388
E01024052,2436,1145,1291,0.4700328407224959,0.5299671592775042
E01024053,2112,1033,1079,0.4891098484848485,0.5108901515151515
E01024054,1810,871,939,0.48121546961325967,0.5187845303867403
E01024127,1724,842,882,0.48839907192575405,0.511600928074246
E01024042,1446,714,732,0.49377593360995853,0.5062240663900415
E01024043,1345,636,709,0.4728624535315985,0.5271375464684015
E01024088,1583,716,867,0.45230574857864814,0.5476942514213519
E01024089,1143,543,600,0.47506561679790027,0.5249343832020997
E01024128,1725,860,865,0.4985507246376812,0.5014492753623189
E01024129,1751,884,867,0.5048543689320388,0.49514563106796117
E01035310,1569,759,810,0.4837476099426386,0.5162523900573613
E01035311,1372,665,707,0.4846938775510204,0.5153061224489796
E01024104,2097,1034,1063,0.49308536003814973,0.5069146399618503
E01024121,1689,778,911,0.46062759029011247,0.5393724097098875
E01024122,1471,705,766,0.47926580557443915,0.5207341944255608
E01024124,1294,676,618,0.5224111282843895,0.4775888717156105
E01024126,1474,729,745,0.494572591587517,0.505427408412483
E01032807,1453,695,758,0.4783207157604955,0.5216792842395045
E01032808,1664,833,831,0.5006009615384616,0.49939903846153844
E01024154,1347,653,694,0.48478099480326653,0.5152190051967335
E01024155,2522,1202,1320,0.4766058683584457,0.5233941316415543
E01035270,1618,789,829,0.48763906056860323,0.5123609394313968
E01035271,1690,851,839,0.5035502958579882,0.49644970414201184
E01035272,1579,798,781,0.5053831538948702,0.49461684610512985
E01035273,1240,579,661,0.4669354838709677,0.5330645161290323
E01035274,1268,618,650,0.48738170347003157,0.5126182965299685
E01035275,1482,749,733,0.5053981106612686,0.49460188933873145
E01035276,1622,776,846,0.4784217016029593,0.5215782983970407
E01024143,2648,1299,1349,0.49055891238670696,0.5094410876132931
E01024179,2853,1433,1420,0.5022783035401331,0.4977216964598668
E01035277,1749,886,863,0.5065751858204688,0.49342481417953116
E01035278,1727,842,885,0.48755066589461493,0.5124493341053851
E01035279,2041,991,1050,0.48554630083292505,0.514453699167075
E01035280,1993,988,1005,0.49573507275464124,0.5042649272453588
E01035281,1913,933,980,0.48771562990067957,0.5122843700993205
E01024180,2417,1182,1235,0.48903599503516754,0.5109640049648324
E01024181,2076,1044,1032,0.5028901734104047,0.49710982658959535
E01024182,1812,913,899,0.5038631346578366,0.49613686534216334
E01024183,1438,696,742,0.48400556328233657,0.5159944367176634
E01024184,2152,1058,1094,0.491635687732342,0.508364312267658
E01024185,2308,1088,1220,0.4714038128249567,0.5285961871750433
E01024176,1849,906,943,0.4899945916711736,0.5100054083288263
E01024177,1514,706,808,0.4663143989431968,0.5336856010568032
E01024178,1668,840,828,0.5035971223021583,0.49640287769784175
E01035282,1569,778,791,0.4958572339069471,0.5041427660930529
E01035283,1540,781,759,0.5071428571428571,0.4928571428571429
E01024156,1678,852,826,0.5077473182359953,0.4922526817640048
E01024161,2059,1015,1044,0.49295774647887325,0.5070422535211268
E01024162,2106,1079,1027,0.5123456790123457,0.4876543209876543
E01024163,1907,951,956,0.49868904037755635,0.5013109596224437
E01024164,1977,996,981,0.503793626707132,0.496206373292868
E01024169,2289,1078,1211,0.4709480122324159,0.5290519877675841
E01024170,1576,765,811,0.4854060913705584,0.5145939086294417
E01024171,1548,775,773,0.5006459948320413,0.49935400516795864
E01024172,2190,1069,1121,0.48812785388127855,0.5118721461187214
E01024144,1497,748,749,0.49966599866399464,0.5003340013360054
E01024145,1655,823,832,0.4972809667673716,0.5027190332326285
E01024146,1440,708,732,0.49166666666666664,0.5083333333333333
E01024147,1770,870,900,0.4915254237288136,0.5084745762711864
E01024186,1365,672,693,0.49230769230769234,0.5076923076923077
E01024133,1367,665,702,0.4864667154352597,0.5135332845647403
E01024136,1524,763,761,0.5006561679790026,0.49934383202099736
E01024137,1915,949,966,0.4955613577023499,0.5044386422976501
E01024138,1911,890,1021,0.46572475143903713,0.5342752485609629
E01024139,1822,882,940,0.4840834248079034,0.5159165751920965
E01024165,1693,813,880,0.4802126402835204,0.5197873597164796
E01024166,1715,810,905,0.47230320699708456,0.5276967930029155
E01024167,2076,1010,1066,0.4865125240847784,0.5134874759152216
E01024168,1249,616,633,0.4931945556445156,0.5068054443554844
E01024150,1504,729,775,0.48470744680851063,0.5152925531914894
E01024151,1455,699,756,0.48041237113402063,0.5195876288659794
E01024152,2728,1310,1418,0.4802052785923754,0.5197947214076246
E01024153,1400,684,716,0.48857142857142855,0.5114285714285715
E01024173,1810,877,933,0.4845303867403315,0.5154696132596686
E01024187,1178,560,618,0.47538200339558573,0.5246179966044142
E01024188,1469,707,762,0.48127978216473793,0.5187202178352621
E01024189,1541,742,799,0.48150551589876706,0.518494484101233
E01024132,1319,649,670,0.4920394238059136,0.5079605761940864
E01024134,1638,797,841,0.48656898656898656,0.5134310134310134
E01024135,1465,706,759,0.48191126279863483,0.5180887372013652
E01024174,1157,581,576,0.5021607605877269,0.4978392394122731
E01024175,1297,634,663,0.48882035466461066,0.5111796453353894
E01024157,1802,852,950,0.4728079911209767,0.5271920088790233
E01024158,2034,970,1064,0.4768928220255654,0.5231071779744346
E01024159,1578,786,792,0.49809885931558934,0.5019011406844106
E01024160,1416,699,717,0.4936440677966102,0.5063559322033898
E01024206,2002,991,1011,0.495004995004995,0.504995004995005
E01024207,1847,903,944,0.4889009204114781,0.511099079588522
E01024208,1641,783,858,0.47714808043875684,0.5228519195612431
E01024209,1755,891,864,0.5076923076923077,0.49230769230769234
E01024202,1825,882,943,0.4832876712328767,0.5167123287671233
E01024242,1741,866,875,0.4974152785755313,0.5025847214244687
E01024243,1719,811,908,0.47178592204770214,0.5282140779522978
E01024244,1692,833,859,0.4923167848699764,0.5076832151300237
E01024245,1947,949,998,0.4874165382639959,0.5125834617360041
E01024219,1314,624,690,0.4748858447488584,0.5251141552511416
E01024220,1558,707,851,0.45378690629011553,0.5462130937098845
E01024221,1483,693,790,0.4672960215778827,0.5327039784221174
E01024227,1393,662,731,0.4752333094041637,0.5247666905958364
E01024229,1379,641,738,0.4648295866569978,0.5351704133430022
E01024228,1213,629,584,0.5185490519373455,0.4814509480626546
E01024230,1264,596,668,0.47151898734177217,0.5284810126582279
E01024231,1296,635,661,0.48996913580246915,0.5100308641975309
E01024252,2281,1105,1176,0.4844366505918457,0.5155633494081543
E01024201,1462,716,746,0.4897400820793434,0.5102599179206566
E01024223,1553,757,796,0.4874436574372183,0.5125563425627817
E01024225,1652,820,832,0.4963680387409201,0.5036319612590799
E01024226,1531,735,796,0.4800783801436969,0.519921619856303
E01035312,1746,864,882,0.4948453608247423,0.5051546391752577
E01035313,1404,662,742,0.47150997150997154,0.5284900284900285
E01024190,1527,737,790,0.48264571054354943,0.5173542894564506
E01024192,1927,905,1022,0.4696419304618578,0.5303580695381422
E01024204,1634,772,862,0.4724602203182375,0.5275397796817626
E01035314,2111,1021,1090,0.4836570345807674,0.5163429654192326
E01035315,1766,865,901,0.4898074745186863,0.5101925254813137
E01024218,1372,636,736,0.46355685131195334,0.5364431486880467
E01024222,1599,760,839,0.47529706066291433,0.5247029393370857
E01024224,1531,717,814,0.4683213585891574,0.5316786414108425
E01024250,1645,773,872,0.46990881458966566,0.5300911854103344
E01024251,1570,718,852,0.4573248407643312,0.5426751592356688
E01024200,1676,837,839,0.49940334128878283,0.5005966587112172
E01024203,1601,795,806,0.49656464709556525,0.5034353529044348
E01024205,1545,745,800,0.48220064724919093,0.517799352750809
E01024255,1772,857,915,0.48363431151241537,0.5163656884875847
E01024232,1963,944,1019,0.48089658685685177,0.5191034131431482
E01024236,1735,863,872,0.4974063400576369,0.5025936599423632
E01024237,1569,777,792,0.49521988527724664,0.5047801147227533
E01024253,1665,779,886,0.4678678678678679,0.5321321321321322
E01024233,1572,771,801,0.4904580152671756,0.5095419847328244
E01024235,1556,757,799,0.4865038560411311,0.5134961439588689
E01024254,2362,1179,1183,0.49915325994919557,0.5008467400508044
E01024256,1764,840,924,0.47619047619047616,0.5238095238095238
E01033210,2451,1213,1238,0.4949000407996736,0.5050999592003264
E01024193,1547,753,794,0.486748545572075,0.513251454427925
E01024194,1489,746,743,0.5010073875083949,0.4989926124916051
E01024195,1454,723,731,0.4972489683631362,0.5027510316368639
E01024196,1499,689,810,0.45963975983989325,0.5403602401601068
E01024197,1569,753,816,0.47992351816443596,0.5200764818355641
E01024240,1822,899,923,0.4934138309549945,0.5065861690450055
E01024241,2170,1063,1107,0.48986175115207375,0.5101382488479262
E01024248,2056,1004,1052,0.4883268482490272,0.5116731517509727
E01024238,1972,1024,948,0.5192697768762677,0.48073022312373226
E01024239,1815,862,953,0.474931129476584,0.525068870523416
E01024247,2069,1088,981,0.5258579023682939,0.4741420976317061
E01033209,1131,603,528,0.53315649867374,0.46684350132625996
E01033211,1365,685,680,0.5018315018315018,0.4981684981684982
E01024214,1737,877,860,0.5048934945308002,0.49510650546919976
E01024215,1643,832,811,0.5063907486305539,0.4936092513694461
E01024216,1539,762,777,0.4951267056530214,0.5048732943469786
E01024246,2201,1102,1099,0.5006815084052704,0.4993184915947297
E01024249,2037,1005,1032,0.49337260677466865,0.5066273932253313
E01024198,2459,1219,1240,0.4957299715331436,0.5042700284668564
E01024212,1444,720,724,0.4986149584487535,0.5013850415512465
E01024213,1385,685,700,0.49458483754512633,0.5054151624548736
E01024234,1398,692,706,0.4949928469241774,0.5050071530758226
E01024276,2657,1319,1338,0.4964245389537072,0.5035754610462928
E01024277,2032,984,1048,0.484251968503937,0.515748031496063
E01024278,2057,966,1091,0.46961594555177444,0.5303840544482256
E01024279,1649,800,849,0.4851425106124924,0.5148574893875075
E01024257,1920,998,922,0.5197916666666667,0.48020833333333335
E01024290,1717,850,867,0.49504950495049505,0.504950495049505
E01024291,1830,927,903,0.5065573770491804,0.4934426229508197
E01024295,2038,1047,991,0.5137389597644749,0.486261040235525
E01032799,1442,750,692,0.5201109570041609,0.4798890429958391
E01032800,1216,632,584,0.5197368421052632,0.48026315789473684
E01024258,1647,843,804,0.51183970856102,0.48816029143898
E01024261,2208,1075,1133,0.48686594202898553,0.5131340579710145
E01024293,1826,906,920,0.49616648411829134,0.5038335158817087
E01024294,2953,1427,1526,0.483237385709448,0.516762614290552
E01024296,2952,1437,1515,0.4867886178861789,0.5132113821138211
E01024262,1778,835,943,0.46962879640044997,0.53037120359955
E01024263,1616,744,872,0.4603960396039604,0.5396039603960396
E01024282,1667,838,829,0.5026994601079784,0.4973005398920216
E01024283,1304,641,663,0.4915644171779141,0.5084355828220859
E01024284,1642,804,838,0.48964677222898906,0.510353227771011
E01024259,1550,789,761,0.5090322580645161,0.49096774193548387
E01024260,1737,854,883,0.4916522740356937,0.5083477259643063
E01024292,1589,807,782,0.5078665827564506,0.4921334172435494
E01024313,1563,749,814,0.47920665387076133,0.5207933461292387
E01024317,1642,816,826,0.49695493300852617,0.5030450669914738
E01024318,1564,757,807,0.4840153452685422,0.5159846547314578
E01024281,1449,695,754,0.47964113181504486,0.5203588681849551
E01024285,1363,668,695,0.4900953778429934,0.5099046221570066
E01024287,1466,699,767,0.4768076398362892,0.5231923601637107
E01024288,1334,628,706,0.4707646176911544,0.5292353823088456
E01035284,1458,725,733,0.49725651577503427,0.5027434842249657
E01035285,1575,747,828,0.4742857142857143,0.5257142857142857
E01024308,1525,725,800,0.47540983606557374,0.5245901639344263
E01024310,1581,758,823,0.4794433902593295,0.5205566097406704
E01024311,1418,669,749,0.4717912552891396,0.5282087447108603
E01024314,1286,653,633,0.5077760497667185,0.49222395023328147
E01024315,1686,841,845,0.4988137603795967,0.5011862396204033
E01024297,1536,765,771,0.498046875,0.501953125
E01024298,1386,685,701,0.49422799422799424,0.5057720057720058
E01024299,1410,697,713,0.49432624113475176,0.5056737588652482
E01024309,1381,656,725,0.47501810282404056,0.5249818971759594
E01024312,1373,669,704,0.48725418790968683,0.5127458120903132
E01024264,1706,817,889,0.47889800703399765,0.5211019929660023
E01024286,1518,750,768,0.49407114624505927,0.5059288537549407
E01024316,2498,1236,1262,0.49479583666933546,0.5052041633306645
E01024319,1604,758,846,0.47256857855361595,0.527431421446384
E01024265,1296,642,654,0.49537037037037035,0.5046296296296297
E01024266,1142,538,604,0.4711033274956217,0.5288966725043783
E01024267,1494,738,756,0.4939759036144578,0.5060240963855421
E01024300,1402,684,718,0.48787446504992865,0.5121255349500713
E01024301,1229,570,659,0.46379170056956875,0.5362082994304312
E01024303,1543,698,845,0.4523655217109527,0.5476344782890473
E01024304,1675,776,899,0.4632835820895522,0.5367164179104478
E01024305,1716,842,874,0.49067599067599066,0.5093240093240093
E01024306,1821,860,961,0.47226798462383307,0.527732015376167
E01024307,1556,766,790,0.4922879177377892,0.5077120822622108
E01024268,1550,763,787,0.492258064516129,0.5077419354838709
E01024269,1847,919,928,0.4975636166756903,0.5024363833243097
E01024270,1458,702,756,0.48148148148148145,0.5185185185185185
E01024271,1423,675,748,0.47434996486296555,0.5256500351370345
E01024272,1469,694,775,0.472430224642614,0.527569775357386
E01024273,1619,827,792,0.5108091414453366,0.4891908585546634
E01024274,1425,692,733,0.4856140350877193,0.5143859649122807
E01024275,1405,688,717,0.4896797153024911,0.5103202846975089
E01024302,1483,722,761,0.4868509777478085,0.5131490222521915
E01024333,1315,654,661,0.4973384030418251,0.5026615969581749
E01024335,1693,848,845,0.5008860011813349,0.4991139988186651
E01024347,1851,943,908,0.5094543490005402,0.49054565099945974
E01034990,2313,1149,1164,0.496757457846952,0.503242542153048
E01024353,2058,1023,1035,0.4970845481049563,0.5029154518950437
E01024354,1437,683,754,0.47529575504523314,0.5247042449547669
E01024355,2004,1011,993,0.5044910179640718,0.49550898203592814
E01024385,1675,837,838,0.49970149253731344,0.5002985074626866
E01024386,1912,953,959,0.49843096234309625,0.5015690376569037
E01024320,1749,842,907,0.48141795311606633,0.5185820468839337
E01024321,1695,801,894,0.4725663716814159,0.5274336283185841
E01024322,1202,585,617,0.48668885191347755,0.5133111480865225
E01024323,1836,903,933,0.4918300653594771,0.5081699346405228
E01024324,1420,689,731,0.4852112676056338,0.5147887323943662
E01024341,1852,873,979,0.4713822894168467,0.5286177105831533
E01024352,1873,929,944,0.49599572877736253,0.5040042712226375
E01024382,1994,1286,708,0.6449348044132397,0.3550651955867603
E01024383,2768,1643,1125,0.5935693641618497,0.4064306358381503
E01024384,1937,973,964,0.5023231801755291,0.4976768198244708
E01033092,1489,792,697,0.5319006044325051,0.46809939556749497
E01034991,1153,611,542,0.5299219427580225,0.47007805724197743
E01034992,1079,493,586,0.4569045412418906,0.5430954587581094
E01024330,1635,798,837,0.48807339449541287,0.5119266055045871
E01024336,1950,952,998,0.4882051282051282,0.5117948717948718
E01024337,1458,704,754,0.4828532235939643,0.5171467764060357
E01024348,1396,693,703,0.49641833810888253,0.5035816618911175
E01024351,1600,771,829,0.481875,0.518125
E01024339,2276,1193,1083,0.5241652021089631,0.4758347978910369
E01024340,2586,1320,1266,0.5104408352668214,0.4895591647331787
E01024356,1791,925,866,0.5164712451144612,0.4835287548855388
E01024373,2282,1153,1129,0.5052585451358458,0.4947414548641543
E01033087,1751,904,847,0.5162764134780126,0.48372358652198744
E01033091,1678,858,820,0.5113230035756854,0.48867699642431467
E01024326,1853,891,962,0.4808418780356179,0.519158121964382
E01024327,1625,771,854,0.47446153846153843,0.5255384615384615
E01024328,1684,779,905,0.46258907363420426,0.5374109263657957
E01024329,1555,771,784,0.4958199356913183,0.5041800643086817
E01024349,1315,662,653,0.5034220532319391,0.49657794676806083
E01024357,1707,847,860,0.4961921499707089,0.5038078500292912
E01024358,1912,918,994,0.4801255230125523,0.5198744769874477
E01024367,1739,875,864,0.5031627372052904,0.4968372627947096
E01024369,1549,769,780,0.4964493221433183,0.5035506778566817
E01033088,2331,1126,1205,0.48305448305448306,0.5169455169455169
E01033089,1823,874,949,0.4794295117937466,0.5205704882062534
E01024360,1557,746,811,0.47912652536929995,0.5208734746307001
E01024372,2216,1155,1061,0.5212093862815884,0.47879061371841153
E01024374,1916,914,1002,0.477035490605428,0.5229645093945721
E01024401,1966,943,1023,0.47965412004069174,0.5203458799593083
E01024403,2355,1167,1188,0.49554140127388535,0.5044585987261146
E01024371,1780,925,855,0.5196629213483146,0.4803370786516854
E01024392,1690,802,888,0.47455621301775147,0.5254437869822485
E01024393,1642,769,873,0.46833130328867234,0.5316686967113277
E01024395,1414,731,683,0.516973125884017,0.48302687411598305
E01024396,1573,759,814,0.4825174825174825,0.5174825174825175
E01024361,1744,847,897,0.4856651376146789,0.5143348623853211
E01024362,1899,916,983,0.4823591363875724,0.5176408636124276
E01024387,2677,1350,1327,0.5042958535674262,0.49570414643257377
E01034993,1568,781,787,0.49808673469387754,0.5019132653061225
E01034994,1876,914,962,0.48720682302771856,0.5127931769722814
E01024331,1647,804,843,0.48816029143898,0.51183970856102
E01024394,1466,728,738,0.4965893587994543,0.5034106412005457
E01024402,1537,750,787,0.48796356538711777,0.5120364346128823
E01024404,1661,827,834,0.49789283564118003,0.50210716435882
E01024405,2740,1330,1410,0.4854014598540146,0.5145985401459854
E01024390,1831,850,981,0.4642271982523211,0.5357728017476788
E01024391,1442,703,739,0.48751733703190014,0.5124826629680999
E01024397,1419,688,731,0.48484848484848486,0.5151515151515151
E01024398,1724,847,877,0.49129930394431554,0.5087006960556845
E01024399,1332,624,708,0.46846846846846846,0.5315315315315315
E01024400,1424,696,728,0.4887640449438202,0.5112359550561798
E01034995,1530,736,794,0.48104575163398694,0.5189542483660131
E01034996,1481,662,819,0.44699527346387574,0.5530047265361242
E01024325,2388,1146,1242,0.4798994974874372,0.5201005025125628
E01024346,1329,655,674,0.4928517682468021,0.5071482317531979
E01024377,1704,834,870,0.4894366197183099,0.5105633802816901
E01024378,1549,774,775,0.49967721110393803,0.500322788896062
E01024332,1264,646,618,0.5110759493670886,0.4889240506329114
E01024350,2049,1031,1018,0.5031722791605662,0.4968277208394339
E01024375,2419,1177,1242,0.4865646961554361,0.5134353038445638
E01024410,1678,836,842,0.49821215733015495,0.5017878426698451
E01034997,1506,739,767,0.4907038512616202,0.5092961487383798
E01034998,1441,694,747,0.4816099930603747,0.5183900069396252
E01034999,1612,781,831,0.4844913151364764,0.5155086848635235
E01024342,2239,1090,1149,0.4868244752121483,0.5131755247878517
E01024343,1358,674,684,0.4963181148748159,0.5036818851251841
E01024344,1678,834,844,0.4970202622169249,0.5029797377830751
E01024376,2575,1256,1319,0.48776699029126214,0.5122330097087379
E01024364,1733,823,910,0.4748990190421235,0.5251009809578765
E01024365,2544,1206,1338,0.4740566037735849,0.5259433962264151
E01024366,1795,880,915,0.49025069637883006,0.5097493036211699
E01024411,1433,708,725,0.49406838799720865,0.5059316120027914
E01024345,1639,821,818,0.50091519219036,0.49908480780964004
E01024379,1835,914,921,0.49809264305177114,0.5019073569482289
E01024380,2338,1140,1198,0.4875962360992301,0.5124037639007699
E01024381,2068,1022,1046,0.4941972920696325,0.5058027079303675
E01024406,1826,898,928,0.49178532311062434,0.5082146768893757
E01024407,1831,893,938,0.4877116329874386,0.5122883670125614
E01024408,1566,743,823,0.47445721583652617,0.5255427841634738
E01024409,1470,708,762,0.4816326530612245,0.5183673469387755
E01024445,1350,628,722,0.4651851851851852,0.5348148148148149
E01024446,1426,674,752,0.4726507713884993,0.5273492286115007
E01024447,1323,628,695,0.47467876039304613,0.5253212396069539
E01024472,1489,739,750,0.49630624580255206,0.503693754197448
E01024479,1553,734,819,0.4726336123631681,0.527366387636832
E01024476,1756,852,904,0.48519362186788156,0.5148063781321185
E01024477,1557,751,806,0.48233782915863843,0.5176621708413616
E01024478,1543,748,795,0.4847699287103046,0.5152300712896954
E01024480,1840,852,988,0.46304347826086956,0.5369565217391304
E01024481,1631,749,882,0.4592274678111588,0.5407725321888412
E01024482,1586,743,843,0.46847414880201765,0.5315258511979823
E01024421,1990,955,1035,0.4798994974874372,0.5201005025125628
E01024473,1601,776,825,0.48469706433479076,0.5153029356652092
E01024474,1660,810,850,0.4879518072289157,0.5120481927710844
E01024475,1605,768,837,0.4785046728971963,0.5214953271028038
E01024441,1557,785,772,0.50417469492614,0.49582530507385997
E01024442,1549,774,775,0.49967721110393803,0.500322788896062
E01024443,1522,672,850,0.44152431011826543,0.5584756898817346
E01024444,1301,593,708,0.4558032282859339,0.5441967717140661
E01024431,1863,895,968,0.48040794417606014,0.5195920558239399
E01024432,1507,730,777,0.48440610484406105,0.5155938951559389
E01024433,1458,712,746,0.4883401920438957,0.5116598079561042
E01024434,1942,931,1011,0.47940267765190525,0.5205973223480947
E01024435,1631,815,816,0.4996934396076027,0.5003065603923973
E01024436,1484,707,777,0.47641509433962265,0.5235849056603774
E01024437,1472,735,737,0.499320652173913,0.5006793478260869
E01024438,1437,697,740,0.4850382741823243,0.5149617258176757
E01024423,1708,830,878,0.4859484777517564,0.5140515222482436
E01024439,1663,803,860,0.48286229705351774,0.5171377029464823
E01024440,1933,952,981,0.49249870667356443,0.5075012933264356
E01024452,1482,726,756,0.4898785425101215,0.5101214574898786
E01035000,1585,775,810,0.4889589905362776,0.5110410094637224
E01035001,1357,649,708,0.4782608695652174,0.5217391304347826
E01024448,1312,628,684,0.47865853658536583,0.5213414634146342
E01024449,1461,696,765,0.47638603696098564,0.5236139630390144
E01024450,1554,744,810,0.47876447876447875,0.5212355212355212
E01024453,1674,844,830,0.5041816009557945,0.4958183990442055
E01024454,1564,755,809,0.4827365728900256,0.5172634271099744
E01024457,1299,590,709,0.4541955350269438,0.5458044649730562
E01024460,1722,837,885,0.48606271777003485,0.5139372822299652
E01024461,2440,1203,1237,0.4930327868852459,0.5069672131147541
E01024465,1421,704,717,0.4954257565095003,0.5045742434904996
E01024466,1391,669,722,0.4809489575844716,0.5190510424155284
E01024468,1580,777,803,0.4917721518987342,0.5082278481012659
E01024416,1714,846,868,0.4935822637106184,0.5064177362893816
E01024418,1445,727,718,0.5031141868512111,0.49688581314878894
E01024424,1403,691,712,0.4925160370634355,0.5074839629365645
E01024463,1609,783,826,0.48663766314481044,0.5133623368551895
E01024464,1691,823,868,0.4866942637492608,0.5133057362507392
E01024467,1777,862,915,0.4850872256612268,0.5149127743387732
E01024458,1417,695,722,0.49047282992237123,0.5095271700776288
E01024459,1571,766,805,0.4875875238701464,0.5124124761298536
E01024462,1659,821,838,0.4948764315852923,0.5051235684147076
E01024469,1781,896,885,0.5030881527231892,0.49691184727681076
E01024470,1668,793,875,0.4754196642685851,0.5245803357314148
E01024471,2012,897,1115,0.44582504970178927,0.5541749502982107
E01024417,1634,798,836,0.4883720930232558,0.5116279069767442
E01024419,1830,887,943,0.4846994535519126,0.5153005464480874
E01024483,1551,781,770,0.5035460992907801,0.49645390070921985
E01024484,1212,592,620,0.4884488448844885,0.5115511551155115
E01024485,1738,801,937,0.4608745684695052,0.5391254315304949
E01024425,2143,1028,1115,0.47970135324311713,0.5202986467568829
E01024426,2028,978,1050,0.4822485207100592,0.5177514792899408
E01024427,1374,657,717,0.4781659388646288,0.5218340611353712
E01024428,1328,638,690,0.48042168674698793,0.5195783132530121
E01024429,1667,764,903,0.45830833833233353,0.5416916616676665
E01024430,1342,667,675,0.4970193740685544,0.5029806259314457
E01024420,2097,1039,1058,0.4954697186456843,0.5045302813543157
E01024451,2502,1208,1294,0.4828137490007994,0.5171862509992007
E01024455,1198,588,610,0.49081803005008345,0.5091819699499165
E01024456,1275,636,639,0.4988235294117647,0.5011764705882353
E01024413,1608,761,847,0.4732587064676617,0.5267412935323383
E01024414,1602,765,837,0.47752808988764045,0.5224719101123596
E01024415,1306,639,667,0.4892802450229709,0.5107197549770292
E01032619,1554,742,812,0.4774774774774775,0.5225225225225225
E01024490,1976,973,1003,0.4924089068825911,0.5075910931174089
E01024544,1368,659,709,0.4817251461988304,0.5182748538011696
E01024545,1425,694,731,0.4870175438596491,0.5129824561403509
E01024547,1322,609,713,0.4606656580937973,0.5393343419062028
E01024492,1585,759,826,0.4788643533123028,0.5211356466876972
E01024541,2533,1266,1267,0.4998026056060008,0.5001973943939992
E01024542,1932,928,1004,0.4803312629399586,0.5196687370600414
E01033213,1982,953,1029,0.4808274470232089,0.5191725529767911
E01033214,2053,1001,1052,0.4875791524598149,0.5124208475401851
E01024496,1476,703,773,0.47628726287262874,0.5237127371273713
E01024497,1598,753,845,0.4712140175219024,0.5287859824780976
E01024498,1616,771,845,0.4771039603960396,0.5228960396039604
E01024503,1676,803,873,0.47911694510739855,0.5208830548926014
E01024518,1632,798,834,0.4889705882352941,0.5110294117647058
E01024499,1647,807,840,0.4899817850637523,0.5100182149362478
E01024500,1253,594,659,0.47406225059856344,0.5259377494014366
E01024501,1477,718,759,0.4861205145565335,0.5138794854434665
E01024502,1432,700,732,0.4888268156424581,0.5111731843575419
E01024505,1847,905,942,0.4899837574445046,0.5100162425554954
E01024491,1476,705,771,0.47764227642276424,0.5223577235772358
E01024493,1530,723,807,0.4725490196078431,0.5274509803921569
E01024494,1956,933,1023,0.47699386503067487,0.5230061349693251
E01024495,2287,1137,1150,0.49715784871010055,0.5028421512898994
E01024520,1506,725,781,0.4814077025232404,0.5185922974767596
E01024528,1253,596,657,0.475658419792498,0.524341580207502
E01024511,1803,871,932,0.48308374930671105,0.516916250693289
E01024512,1728,829,899,0.47974537037037035,0.5202546296296297
E01024513,1640,793,847,0.48353658536585364,0.5164634146341464
E01024514,1317,645,672,0.489749430523918,0.510250569476082
E01024515,1819,865,954,0.4755360087960418,0.5244639912039583
E01024516,1371,668,703,0.48723559445660103,0.512764405543399
E01024519,1804,1107,697,0.6136363636363636,0.38636363636363635
E01024521,1618,767,851,0.47404202719406674,0.5259579728059333
E01024523,1559,741,818,0.47530468248877483,0.5246953175112251
E01024526,1464,678,786,0.46311475409836067,0.5368852459016393
E01024527,1631,737,894,0.45187001839362356,0.5481299816063765
E01024550,2038,996,1042,0.4887144259077527,0.5112855740922473
E01024489,1581,743,838,0.46995572422517395,0.530044275774826
E01024530,1888,939,949,0.4973516949152542,0.5026483050847458
E01024536,1889,956,933,0.5060878771836951,0.4939121228163049
E01024546,1749,859,890,0.4911377930245855,0.5088622069754145
E01024522,1367,626,741,0.4579370885149963,0.5420629114850036
E01024524,1440,684,756,0.475,0.525
E01024525,1539,698,841,0.4535412605588044,0.5464587394411956
E01024529,1432,696,736,0.4860335195530726,0.5139664804469274
E01024531,1404,677,727,0.4821937321937322,0.5178062678062678
E01024486,1955,950,1005,0.4859335038363171,0.5140664961636828
E01024487,1285,608,677,0.47315175097276263,0.5268482490272374
E01024488,1244,586,658,0.47106109324758844,0.5289389067524116
E01024548,1299,657,642,0.5057736720554272,0.4942263279445728
E01024549,1271,639,632,0.5027537372147916,0.4972462627852085
E01024537,1630,827,803,0.507361963190184,0.49263803680981594
E01024538,1753,843,910,0.48088990302338847,0.5191100969766115
E01024539,2077,962,1115,0.4631680308136736,0.5368319691863265
E01024540,1791,875,916,0.4885538805136795,0.5114461194863205
E01024532,1291,640,651,0.4957397366382649,0.5042602633617351
E01024533,1137,576,561,0.5065963060686016,0.49340369393139843
E01024534,1499,737,762,0.4916611074049366,0.5083388925950634
E01024535,2413,1227,1186,0.5084956485702445,0.4915043514297555
E01024504,1891,976,915,0.5161290322580645,0.4838709677419355
E01024507,1914,1016,898,0.5308254963427377,0.46917450365726227
E01033212,1499,761,738,0.5076717811874583,0.4923282188125417
E01033215,1240,604,636,0.4870967741935484,0.5129032258064516
E01024508,1983,981,1002,0.4947049924357035,0.5052950075642966
E01024509,1457,669,788,0.4591626630061771,0.540837336993823
E01024510,1521,754,767,0.49572649572649574,0.5042735042735043
E01024517,1686,897,789,0.5320284697508897,0.4679715302491103
E01024609,1433,715,718,0.4989532449406839,0.5010467550593162
E01024610,1823,899,924,0.4931431705979155,0.5068568294020844
E01024611,1761,869,892,0.4934696195343555,0.5065303804656445
E01024612,1690,842,848,0.4982248520710059,0.5017751479289941
E01024613,1650,802,848,0.4860606060606061,0.5139393939393939
E01024614,1616,744,872,0.4603960396039604,0.5396039603960396
E01024615,1494,736,758,0.4926372155287818,0.5073627844712182
E01024616,1783,854,929,0.47896803140773975,0.5210319685922602
E01024585,1401,695,706,0.49607423269093504,0.5039257673090649
E01024587,1876,936,940,0.4989339019189765,0.5010660980810234
E01024588,1675,829,846,0.4949253731343284,0.5050746268656716
E01024589,1632,805,827,0.49325980392156865,0.5067401960784313
E01024595,1588,757,831,0.47670025188916876,0.5232997481108312
E01024598,1686,832,854,0.49347568208778175,0.5065243179122183
E01024619,1428,711,717,0.49789915966386555,0.5021008403361344
E01024621,1399,667,732,0.4767691208005718,0.5232308791994281
E01032653,1529,734,795,0.48005232177894047,0.5199476782210595
E01035298,1495,737,758,0.49297658862876254,0.5070234113712374
E01035299,1730,845,885,0.4884393063583815,0.5115606936416185
E01024594,1448,733,715,0.5062154696132597,0.4937845303867403
E01024596,1694,825,869,0.487012987012987,0.512987012987013
E01024597,1844,889,955,0.4821041214750542,0.5178958785249458
E01024620,1588,784,804,0.49370277078085645,0.5062972292191436
E01024580,2012,993,1019,0.49353876739562624,0.5064612326043738
E01024581,1408,722,686,0.5127840909090909,0.4872159090909091
E01024586,1639,805,834,0.49115314215985356,0.5088468578401464
E01035300,2432,1915,517,0.7874177631578947,0.21258223684210525
E01035301,2141,1489,652,0.6954694068192433,0.30453059318075665
E01024576,1644,800,844,0.48661800486618007,0.51338199513382
E01024577,1355,672,683,0.4959409594095941,0.5040590405904058
E01024578,1649,814,835,0.49363250454821106,0.5063674954517889
E01024583,1767,835,932,0.4725523486134692,0.5274476513865308
E01032655,1938,956,982,0.4932920536635707,0.5067079463364293
E01032656,2594,1306,1288,0.5034695451040864,0.49653045489591363
E01035302,1578,801,777,0.5076045627376425,0.4923954372623574
E01035303,1512,764,748,0.5052910052910053,0.4947089947089947
E01024570,1872,891,981,0.47596153846153844,0.5240384615384616
E01024571,2050,972,1078,0.4741463414634146,0.5258536585365854
E01024572,1360,675,685,0.4963235294117647,0.5036764705882353
E01024573,1318,634,684,0.48103186646433993,0.5189681335356601
E01024575,1211,605,606,0.4995871180842279,0.500412881915772
E01024554,2599,1275,1324,0.49057329742208544,0.5094267025779146
E01024561,1846,953,893,0.5162513542795233,0.4837486457204767
E01024582,1554,759,795,0.48841698841698844,0.5115830115830116
E01035304,1853,917,936,0.49487317862924984,0.5051268213707502
E01035305,1761,874,887,0.49630891538898353,0.5036910846110164
E01035306,1724,822,902,0.4767981438515081,0.5232018561484919
E01035307,1420,680,740,0.4788732394366197,0.5211267605633803
E01024559,1411,682,729,0.4833451452870305,0.5166548547129696
E01024584,1753,846,907,0.48260125499144324,0.5173987450085568
E01024590,1558,763,795,0.48973042362002567,0.5102695763799743
E01024599,2033,952,1081,0.4682734874569602,0.5317265125430398
E01024608,2066,1008,1058,0.4878993223620523,0.5121006776379478
E01024591,2717,1350,1367,0.49687154950312845,0.5031284504968716
E01024592,1275,645,630,0.5058823529411764,0.49411764705882355
E01024593,1393,672,721,0.4824120603015075,0.5175879396984925
E01024600,1463,720,743,0.49213943950786054,0.5078605604921395
E01024601,1701,832,869,0.48912404467960025,0.5108759553203998
E01024560,1416,698,718,0.4929378531073446,0.5070621468926554
E01024562,1704,841,863,0.4935446009389671,0.5064553990610329
E01024569,1861,910,951,0.48898441698011824,0.5110155830198818
E01024630,1681,812,869,0.4830458060678168,0.5169541939321832
E01024632,1502,721,781,0.4800266311584554,0.5199733688415447
E01024606,1356,648,708,0.4778761061946903,0.5221238938053098
E01024628,1539,769,770,0.4996751137102014,0.5003248862897985
E01024629,1154,588,566,0.5095320623916811,0.4904679376083189
E01024631,1669,809,860,0.4847213900539245,0.5152786099460755
E01032735,1633,768,865,0.47030006123698714,0.5296999387630129
E01032737,1539,751,788,0.48797920727745286,0.5120207927225471
E01024564,1228,597,631,0.48615635179153094,0.5138436482084691
E01024603,1242,608,634,0.4895330112721417,0.5104669887278583
E01024604,1214,571,643,0.47034596375617793,0.5296540362438221
E01024605,1283,611,672,0.47622759158222916,0.5237724084177708
E01024626,2052,963,1089,0.4692982456140351,0.5307017543859649
E01024627,1957,949,1008,0.48492590700051097,0.515074092999489
E01024551,2193,1035,1158,0.4719562243502052,0.5280437756497948
E01024552,2307,1090,1217,0.47247507585609017,0.5275249241439098
E01024553,1976,928,1048,0.46963562753036436,0.5303643724696356
E01024563,1674,836,838,0.4994026284348865,0.5005973715651135
E01024602,1411,669,742,0.4741318214032601,0.52586817859674
E01024625,1902,926,976,0.4868559411146162,0.5131440588853838
E01024565,1248,637,611,0.5104166666666666,0.4895833333333333
E01024566,1513,763,750,0.5042961004626569,0.495703899537343
E01024622,1752,876,876,0.5,0.5
E01024623,2106,1026,1080,0.48717948717948717,0.5128205128205128
E01024624,2901,1454,1447,0.5012064805239572,0.4987935194760427
E01024555,1347,654,693,0.48552338530066813,0.5144766146993318
E01024556,1222,611,611,0.5,0.5
E01024557,1496,690,806,0.4612299465240642,0.5387700534759359
E01024558,1733,868,865,0.500865551067513,0.49913444893248704
E01024657,2510,1239,1271,0.4936254980079681,0.5063745019920318
E01024658,2274,1083,1191,0.4762532981530343,0.5237467018469657
E01024659,1717,843,874,0.49097262667443214,0.5090273733255678
E01024660,1864,895,969,0.4801502145922747,0.5198497854077253
E01035316,1109,545,564,0.4914337240757439,0.5085662759242561
E01035317,1158,557,601,0.48100172711571676,0.5189982728842832
E01024653,1671,809,862,0.4841412327947337,0.5158587672052664
E01024654,1584,752,832,0.47474747474747475,0.5252525252525253
E01024655,1513,690,823,0.4560475875743556,0.5439524124256444
E01024656,1671,796,875,0.476361460203471,0.5236385397965291
E01024675,2196,1032,1164,0.46994535519125685,0.5300546448087432
E01024676,2153,1124,1029,0.5220622387366466,0.47793776126335347
E01024677,1811,832,979,0.45941468801766977,0.5405853119823302
E01024695,1325,637,688,0.4807547169811321,0.519245283018868
E01024697,1204,568,636,0.4717607973421927,0.5282392026578073
E01024710,1501,758,743,0.5049966688874084,0.4950033311125916
E01024661,1561,762,799,0.48814862267777065,0.5118513773222293
E01024664,1592,770,822,0.4836683417085427,0.5163316582914573
E01024665,1541,726,815,0.47112264763140815,0.5288773523685918
E01024694,1649,810,839,0.49120679199514855,0.5087932080048514
E01024696,1539,743,796,0.48278102664067574,0.5172189733593242
E01024672,1483,696,787,0.46931894807821983,0.5306810519217802
E01024673,1868,898,970,0.480728051391863,0.5192719486081371
E01024674,1636,818,818,0.5,0.5
E01024711,1443,701,742,0.4857934857934858,0.5142065142065142
E01024712,1617,773,844,0.4780457637600495,0.5219542362399505
E01024633,1636,791,845,0.4834963325183374,0.5165036674816625
E01024634,1372,655,717,0.4774052478134111,0.5225947521865889
E01024662,1536,706,830,0.4596354166666667,0.5403645833333334
E01024663,1570,710,860,0.45222929936305734,0.5477707006369427
E01024666,1606,777,829,0.4838107098381071,0.5161892901618929
E01024641,1530,718,812,0.469281045751634,0.530718954248366
E01024713,1844,868,976,0.47071583514099785,0.5292841648590022
E01024714,1683,795,888,0.47237076648841353,0.5276292335115864
E01024715,1898,924,974,0.4868282402528978,0.5131717597471022
E01024716,2095,987,1108,0.4711217183770883,0.5288782816229117
E01024636,2118,988,1130,0.4664778092540132,0.5335221907459868
E01024637,1765,842,923,0.47705382436260624,0.5229461756373938
E01024638,1681,779,902,0.4634146341463415,0.5365853658536586
E01024639,1642,773,869,0.4707673568818514,0.5292326431181485
E01024640,1658,784,874,0.47285886610373945,0.5271411338962606
E01024635,1677,817,860,0.48717948717948717,0.5128205128205128
E01024642,1415,681,734,0.4812720848056537,0.5187279151943462
E01024644,1359,653,706,0.48050036791758644,0.5194996320824136
E01024692,1722,777,945,0.45121951219512196,0.5487804878048781
E01024693,1384,657,727,0.47471098265895956,0.5252890173410405
E01024643,1175,580,595,0.49361702127659574,0.5063829787234042
E01024705,1084,547,537,0.5046125461254612,0.49538745387453875
E01024706,1422,673,749,0.4732770745428973,0.5267229254571026
E01024707,1386,671,715,0.48412698412698413,0.5158730158730159
E01024708,1998,983,1015,0.491991991991992,0.508008008008008
E01024686,1659,819,840,0.4936708860759494,0.5063291139240507
E01024688,1720,834,886,0.4848837209302326,0.5151162790697674
E01024689,1228,578,650,0.47068403908794787,0.5293159609120521
E01024690,1435,677,758,0.47177700348432056,0.5282229965156794
E01024691,1253,629,624,0.5019952114924182,0.4980047885075818
E01024669,1744,803,941,0.46043577981651373,0.5395642201834863
E01024698,1435,697,738,0.4857142857142857,0.5142857142857142
E01024699,1868,906,962,0.48501070663811563,0.5149892933618844
E01024700,1779,841,938,0.47273749297358064,0.5272625070264193
E01024709,1380,655,725,0.4746376811594203,0.5253623188405797
E01024682,2253,1065,1188,0.47270306258322237,0.5272969374167776
E01024683,1706,823,883,0.4824150058616647,0.5175849941383353
E01024684,1746,849,897,0.48625429553264604,0.5137457044673539
E01024685,1784,871,913,0.4882286995515695,0.5117713004484304
E01024687,1436,723,713,0.5034818941504178,0.49651810584958217
E01024702,1359,640,719,0.47093451066961,0.52906548933039
E01024703,1853,910,943,0.4910955207771182,0.5089044792228818
E01024704,1793,881,912,0.4913552704963748,0.5086447295036252
E01035318,1527,771,756,0.5049115913555993,0.4950884086444008
E01035319,1522,743,779,0.48817345597897505,0.511826544021025
E01024645,1584,770,814,0.4861111111111111,0.5138888888888888
E01024647,1558,757,801,0.4858793324775353,0.5141206675224647
E01024668,1368,658,710,0.48099415204678364,0.5190058479532164
E01024670,1727,815,912,0.4719166184134337,0.5280833815865663
E01024681,1903,911,992,0.47871781397792956,0.5212821860220704
E01024646,1937,977,960,0.504388229220444,0.49561177077955604
E01024648,1509,748,761,0.49569251159708416,0.5043074884029158
E01024649,1813,919,894,0.5068946497517927,0.4931053502482074
E01024667,1791,857,934,0.4785036292573981,0.5214963707426019
E01024671,1656,785,871,0.47403381642512077,0.5259661835748792
E01024650,1498,723,775,0.4826435246995995,0.5173564753004005
E01024651,1498,729,769,0.48664886515353806,0.513351134846462
E01024652,1889,901,988,0.47697194282689254,0.5230280571731075
E01024679,1263,601,662,0.4758511480601742,0.5241488519398259
E01024680,1669,804,865,0.481725584182145,0.518274415817855
E01024719,2280,1140,1140,0.5,0.5
E01024720,1333,639,694,0.47936984246061515,0.5206301575393848
E01024721,1344,693,651,0.515625,0.484375
E01024722,1372,647,725,0.4715743440233236,0.5284256559766763
E01024728,1757,854,903,0.4860557768924303,0.5139442231075697
E01035002,1416,672,744,0.4745762711864407,0.5254237288135594
E01035003,1359,645,714,0.4746136865342163,0.5253863134657837
E01035004,1244,599,645,0.4815112540192926,0.5184887459807074
E01024771,1941,955,986,0.49201442555383823,0.5079855744461618
E01024772,1657,805,852,0.4858177429088715,0.5141822570911285
E01024773,1717,827,890,0.481654047757717,0.5183459522422831
E01032830,2461,1198,1263,0.48679398618447783,0.5132060138155221
E01035005,1245,615,630,0.4939759036144578,0.5060240963855421
E01035006,1329,653,676,0.49134687735139204,0.508653122648608
E01035007,1479,714,765,0.4827586206896552,0.5172413793103449
E01024741,1598,761,837,0.4762202753441802,0.5237797246558198
E01024761,2132,1036,1096,0.48592870544090055,0.5140712945590994
E01024762,2236,1096,1140,0.49016100178890876,0.5098389982110912
E01024763,1363,670,693,0.491562729273661,0.5084372707263389
E01024764,1329,646,683,0.4860797592174567,0.5139202407825433
E01024765,1316,658,658,0.5,0.5
E01024782,1222,596,626,0.4877250409165303,0.5122749590834698
E01024785,1520,719,801,0.4730263157894737,0.5269736842105263
E01024717,2292,1085,1207,0.4733856893542757,0.5266143106457243
E01024718,1346,678,668,0.5037147102526003,0.4962852897473997
E01024735,1518,763,755,0.502635046113307,0.497364953886693
E01024736,1806,889,917,0.49224806201550386,0.5077519379844961
E01024737,2480,1163,1317,0.4689516129032258,0.5310483870967742
E01024723,1621,828,793,0.5107958050586058,0.4892041949413942
E01024724,2096,1023,1073,0.4880725190839695,0.5119274809160306
E01024725,2149,1034,1115,0.4811540251279665,0.5188459748720335
E01024726,1886,877,1009,0.4650053022269353,0.5349946977730647
E01024755,2038,988,1050,0.4847890088321884,0.5152109911678115
E01024786,1961,945,1016,0.4818969913309536,0.5181030086690463
E01024746,1068,531,537,0.49719101123595505,0.5028089887640449
E01024760,1491,753,738,0.5050301810865191,0.4949698189134809
E01024781,1976,966,1010,0.4888663967611336,0.5111336032388664
E01032825,2983,1463,1520,0.49044585987261147,0.5095541401273885
E01032826,1732,885,847,0.5109699769053118,0.48903002309468824
E01032827,2135,1030,1105,0.48243559718969553,0.5175644028103045
E01032828,1174,561,613,0.4778534923339012,0.5221465076660988
E01024743,1869,925,944,0.49491706795077584,0.5050829320492242
E01024744,1961,982,979,0.5007649158592555,0.4992350841407445
E01024745,1842,883,959,0.4793702497285559,0.5206297502714441
E01024747,1541,751,790,0.4873458792991564,0.5126541207008436
E01024730,1365,662,703,0.484981684981685,0.515018315018315
E01024731,1136,530,606,0.4665492957746479,0.5334507042253521
E01024775,1679,789,890,0.4699225729600953,0.5300774270399047
E01024776,1386,666,720,0.4805194805194805,0.5194805194805194
E01024777,1164,570,594,0.4896907216494845,0.5103092783505154
E01024734,1637,778,859,0.4752596212583995,0.5247403787416005
E01024752,1662,811,851,0.4879663056558363,0.5120336943441637
E01024753,1578,807,771,0.5114068441064639,0.48859315589353614
E01024754,1737,848,889,0.4881980426021877,0.5118019573978123
E01024729,1703,788,915,0.46271285965942455,0.5372871403405755
E01024748,1368,671,697,0.4904970760233918,0.5095029239766082
E01024749,1625,780,845,0.48,0.52
E01024750,1526,701,825,0.45937090432503275,0.5406290956749672
E01024751,1507,735,772,0.4877239548772396,0.5122760451227605
E01024732,2071,1208,863,0.5832930951231289,0.41670690487687106
E01024733,1789,851,938,0.475684740078256,0.524315259921744
E01024756,1532,733,799,0.47845953002610964,0.5215404699738904
E01024767,2084,965,1119,0.4630518234165067,0.5369481765834933
E01024768,1819,909,910,0.4997251236943375,0.5002748763056625
E01035008,1521,749,772,0.49243918474687703,0.5075608152531229
E01035009,1693,830,863,0.490253987005316,0.509746012994684
E01024757,1648,800,848,0.4854368932038835,0.5145631067961165
E01024758,1695,844,851,0.49793510324483775,0.5020648967551622
E01024778,1847,893,954,0.48348673524634544,0.5165132647536546
E01024779,1841,896,945,0.4866920152091255,0.5133079847908745
E01024780,1572,751,821,0.477735368956743,0.522264631043257
E01024740,1986,995,991,0.501007049345418,0.4989929506545821
E01024742,1839,852,987,0.4632952691680261,0.5367047308319739
E01024783,1586,718,868,0.4527112232030265,0.5472887767969735
E01032620,2323,1122,1201,0.4829961256995265,0.5170038743004736
E01032829,1748,882,866,0.5045766590389016,0.4954233409610984
E01035010,1448,696,752,0.48066298342541436,0.5193370165745856
E01035011,1474,685,789,0.46472184531886024,0.5352781546811397
E01024798,2350,1165,1185,0.4957446808510638,0.5042553191489362
E01024811,1191,589,602,0.4945424013434089,0.5054575986565911
E01024812,1389,670,719,0.48236141108711306,0.5176385889128869
E01024813,1608,778,830,0.48383084577114427,0.5161691542288557
E01024814,1264,632,632,0.5,0.5
E01024815,1198,553,645,0.46160267111853087,0.5383973288814691
E01024816,1509,748,761,0.49569251159708416,0.5043074884029158
E01024837,1858,936,922,0.503767491926803,0.49623250807319697
E01024844,1585,774,811,0.48832807570977915,0.5116719242902208
E01024846,1657,815,842,0.49185274592637296,0.508147254073627
E01024849,1621,788,833,0.486119679210364,0.5138803207896361
E01024850,1359,629,730,0.4628403237674761,0.5371596762325239
E01024836,1737,869,868,0.5002878526194589,0.49971214738054115
E01024839,2889,1422,1467,0.49221183800623053,0.5077881619937694
E01024845,1359,689,670,0.506990434142752,0.493009565857248
E01024847,1586,752,834,0.47414880201765447,0.5258511979823455
E01024848,1356,644,712,0.4749262536873156,0.5250737463126843
E01024793,1733,835,898,0.48182342758222735,0.5181765724177726
E01024825,1336,629,707,0.4708083832335329,0.5291916167664671
E01024826,1381,675,706,0.4887762490948588,0.5112237509051412
E01024827,1501,716,785,0.4770153231179214,0.5229846768820786
E01024828,1566,742,824,0.47381864623243936,0.5261813537675607
E01024840,1858,910,948,0.4897739504843918,0.5102260495156081
E01024841,1981,973,1008,0.4911660777385159,0.508833922261484
E01024842,1631,778,853,0.47700797057020233,0.5229920294297977
E01024843,1444,697,747,0.4826869806094183,0.5173130193905817
E01024829,1624,801,823,0.4932266009852217,0.5067733990147784
E01024851,1679,813,866,0.48421679571173315,0.5157832042882668
E01024852,1373,683,690,0.49745083758193737,0.5025491624180627
E01024853,1359,649,710,0.4775570272259014,0.5224429727740986
E01024854,1625,800,825,0.49230769230769234,0.5076923076923077
E01024799,2124,1010,1114,0.4755178907721281,0.524482109227872
E01024800,1621,795,826,0.4904380012338063,0.5095619987661937
E01024835,2062,1012,1050,0.49078564500484967,0.5092143549951503
E01024838,1765,856,909,0.484985835694051,0.515014164305949
E01024802,1824,938,886,0.5142543859649122,0.4857456140350877
E01024823,1856,928,928,0.5,0.5
E01024833,2562,1243,1319,0.485167837626854,0.514832162373146
E01035012,1205,638,567,0.5294605809128631,0.4705394190871369
E01035013,1650,831,819,0.5036363636363637,0.49636363636363634
E01024821,2072,972,1100,0.4691119691119691,0.5308880308880309
E01024822,2227,1074,1153,0.4822631342613381,0.5177368657386618
E01024824,1696,808,888,0.47641509433962265,0.5235849056603774
E01024832,1634,777,857,0.4755201958384333,0.5244798041615667
E01024834,2218,1076,1142,0.48512173128944996,0.5148782687105501
E01024795,1569,759,810,0.4837476099426386,0.5162523900573613
E01024796,1382,703,679,0.5086830680173662,0.4913169319826339
E01024830,1896,865,1031,0.45622362869198313,0.5437763713080169
E01024831,1353,622,731,0.4597191426459719,0.5402808573540281
E01024792,1856,910,946,0.49030172413793105,0.509698275862069
E01024794,1698,842,856,0.4958775029446408,0.5041224970553593
E01024804,1406,697,709,0.4957325746799431,0.5042674253200569
E01024805,1636,820,816,0.5012224938875306,0.49877750611246946
E01024806,1666,839,827,0.5036014405762305,0.4963985594237695
E01024797,1658,825,833,0.49758745476477684,0.5024125452352232
E01024817,1703,845,858,0.4961832061068702,0.5038167938931297
E01024818,1792,851,941,0.47488839285714285,0.5251116071428571
E01024819,1523,746,777,0.489822718319107,0.5101772816808929
E01024820,1754,845,909,0.48175598631698974,0.5182440136830102
E01024787,1239,596,643,0.48103309120258275,0.5189669087974172
E01024788,1438,718,720,0.4993045897079277,0.5006954102920723
E01024790,1202,578,624,0.480865224625624,0.519134775374376
E01024791,1370,643,727,0.46934306569343065,0.5306569343065694
E01024803,2327,1115,1212,0.4791577137945853,0.5208422862054147
E01024789,2309,941,1368,0.4075357297531399,0.5924642702468601
E01024807,1607,762,845,0.4741754822650902,0.5258245177349098
E01024808,1747,840,907,0.48082427017744706,0.519175729822553
E01024809,1414,685,729,0.48444130127298446,0.5155586987270155
E01024810,1641,792,849,0.4826325411334552,0.5173674588665448
E01028479,1325,649,676,0.489811320754717,0.510188679245283
E01028480,1545,751,794,0.486084142394822,0.513915857605178
E01028508,1082,545,537,0.5036968576709797,0.49630314232902034
E01035723,1221,604,617,0.49467649467649466,0.5053235053235053
E01035724,1727,855,872,0.4950781702374059,0.5049218297625941
E01028441,2453,1254,1199,0.5112107623318386,0.48878923766816146
E01028443,1446,722,724,0.49930843706777317,0.5006915629322268
E01028444,1414,685,729,0.48444130127298446,0.5155586987270155
E01032943,2194,1079,1115,0.49179580674567,0.50820419325433
E01032944,1333,678,655,0.5086271567891973,0.4913728432108027
E01028445,1478,757,721,0.5121786197564276,0.4878213802435724
E01028446,1583,787,796,0.49715729627289956,0.5028427037271005
E01028447,1270,674,596,0.5307086614173229,0.4692913385826772
E01028448,1683,802,881,0.47653000594177064,0.5234699940582294
E01028435,2073,1103,970,0.5320791123974915,0.46792088760250844
E01028437,1629,835,794,0.512584407612032,0.48741559238796806
E01028439,1397,730,667,0.5225483178239084,0.47745168217609163
E01028440,1637,874,763,0.5339034819792303,0.4660965180207697
E01032941,1480,729,751,0.4925675675675676,0.5074324324324324
E01032942,1512,768,744,0.5079365079365079,0.49206349206349204
E01035725,1210,582,628,0.4809917355371901,0.5190082644628099
E01035726,1664,870,794,0.5228365384615384,0.47716346153846156
E01028449,1469,720,749,0.4901293396868618,0.5098706603131382
E01028450,1522,728,794,0.4783180026281209,0.5216819973718791
E01028451,1291,647,644,0.5011618900077459,0.4988381099922541
E01028452,1474,720,754,0.48846675712347354,0.5115332428765265
E01028453,1406,679,727,0.4829302987197724,0.5170697012802276
E01028454,1722,842,880,0.4889663182346109,0.5110336817653891
E01028430,1872,935,937,0.49946581196581197,0.500534188034188
E01028431,1619,800,819,0.49413218035824585,0.5058678196417542
E01028432,1982,957,1025,0.4828456104944501,0.5171543895055499
E01028433,1610,782,828,0.4857142857142857,0.5142857142857142
E01028434,1941,844,1097,0.4348274085522926,0.5651725914477074
E01028426,1765,878,887,0.49745042492917846,0.5025495750708215
E01028427,1460,759,701,0.5198630136986301,0.48013698630136986
E01028428,1347,675,672,0.5011135857461024,0.49888641425389757
E01028429,1076,524,552,0.48698884758364314,0.5130111524163569
E01028422,1859,895,964,0.48144163528778916,0.5185583647122108
E01028423,1631,792,839,0.4855916615573268,0.5144083384426732
E01028476,2863,1413,1450,0.4935382465944813,0.5064617534055187
E01035727,1871,909,962,0.48583645109567075,0.5141635489043292
E01035728,1376,673,703,0.4890988372093023,0.5109011627906976
E01035729,1505,740,765,0.49169435215946844,0.5083056478405316
E01028474,1923,940,983,0.4888195527821113,0.5111804472178887
E01028485,1591,741,850,0.4657448145820239,0.5342551854179761
E01028486,1242,612,630,0.4927536231884058,0.5072463768115942
E01028503,1146,545,601,0.4755671902268761,0.5244328097731239
E01028504,1441,725,716,0.5031228313671062,0.49687716863289383
E01028481,1463,714,749,0.4880382775119617,0.5119617224880383
E01028482,1392,696,696,0.5,0.5
E01028506,1913,940,973,0.4913748039728176,0.5086251960271825
E01028507,1453,688,765,0.47350309704060567,0.5264969029593943
E01035730,1761,889,872,0.5048268029528676,0.4951731970471323
E01035731,1482,744,738,0.5020242914979757,0.4979757085020243
E01028477,2488,1222,1266,0.49115755627009644,0.5088424437299035
E01028478,1381,654,727,0.47356987690079655,0.5264301230992035
E01028483,1299,631,668,0.4857582755966128,0.5142417244033872
E01028484,1100,564,536,0.5127272727272727,0.48727272727272725
E01028499,1979,950,1029,0.48004042445679634,0.5199595755432036
E01035733,1686,842,844,0.49940688018979834,0.5005931198102017
E01035734,1322,660,662,0.49924357034795763,0.5007564296520424
E01028459,1442,726,716,0.5034674063800277,0.49653259361997226
E01028460,2047,1026,1021,0.5012212994626283,0.4987787005373718
E01028461,1660,834,826,0.5024096385542168,0.4975903614457831
E01028462,1577,805,772,0.5104629042485732,0.4895370957514268
E01028455,1493,753,740,0.5043536503683858,0.4956463496316142
E01028456,1457,706,751,0.48455730954015097,0.515442690459849
E01028457,1369,689,680,0.5032870708546384,0.4967129291453616
E01028458,1567,779,788,0.4971282705807275,0.5028717294192725
E01028467,1829,887,942,0.48496446145434663,0.5150355385456533
E01028466,1758,849,909,0.48293515358361777,0.5170648464163823
E01028469,1426,692,734,0.485273492286115,0.514726507713885
E01028470,1646,819,827,0.4975698663426488,0.5024301336573511
E01028471,1346,652,694,0.48439821693907875,0.5156017830609212
E01028472,1205,584,621,0.4846473029045643,0.5153526970954356
E01028473,1466,739,727,0.5040927694406548,0.49590723055934516
E01028463,2592,1286,1306,0.49614197530864196,0.503858024691358
E01028464,1645,822,823,0.49969604863221884,0.5003039513677812
E01028465,1376,682,694,0.4956395348837209,0.5043604651162791
E01035735,1740,846,894,0.4862068965517241,0.5137931034482759
E01035736,1227,599,628,0.48818255908720454,0.5118174409127955
E01028497,1435,677,758,0.47177700348432056,0.5282229965156794
E01028498,1664,852,812,0.5120192307692307,0.4879807692307692
E01028500,2018,1296,722,0.6422200198216056,0.35777998017839446
E01028501,1222,612,610,0.5008183306055647,0.49918166939443537
E01028502,1227,597,630,0.48655256723716384,0.5134474327628362
E01035737,1912,928,984,0.48535564853556484,0.5146443514644351
E01035738,1702,851,851,0.5,0.5
E01035739,1883,966,917,0.5130111524163569,0.48698884758364314
E01028487,1203,611,592,0.5078969243557773,0.4921030756442228
E01028489,1366,641,725,0.46925329428989754,0.5307467057101025
E01028490,1287,619,668,0.48096348096348096,0.519036519036519
E01028491,1584,783,801,0.4943181818181818,0.5056818181818182
E01028494,1101,535,566,0.485921889191644,0.5140781108083561
E01028492,1562,774,788,0.49551856594110116,0.5044814340588989
E01028493,1406,706,700,0.5021337126600285,0.49786628733997157
E01028495,1313,647,666,0.49276466108149275,0.5072353389185073
E01028496,1402,704,698,0.5021398002853067,0.4978601997146933
E01028488,1372,698,674,0.5087463556851312,0.4912536443148688
E01028510,1627,797,830,0.48985863552550707,0.510141364474493
E01028511,1886,907,979,0.4809119830328738,0.5190880169671261
E01028512,1897,926,971,0.4881391671059568,0.5118608328940433
E01028594,1566,751,815,0.47956577266922096,0.520434227330779
E01028595,1616,768,848,0.4752475247524752,0.5247524752475248
E01028596,1447,708,739,0.4892881824464409,0.5107118175535591
E01028597,1525,762,763,0.499672131147541,0.5003278688524591
E01028591,1270,683,587,0.5377952755905512,0.4622047244094488
E01028592,1669,823,846,0.49310964649490713,0.5068903535050928
E01032554,2181,995,1186,0.45621274644658416,0.5437872535534158
E01032555,1964,924,1040,0.47046843177189407,0.5295315682281059
E01028565,1285,622,663,0.4840466926070039,0.5159533073929962
E01028584,2444,1198,1246,0.49018003273322425,0.5098199672667758
E01035740,2521,1124,1397,0.44585481951606504,0.5541451804839349
E01028560,1821,897,924,0.4925864909390445,0.5074135090609555
E01028561,1984,946,1038,0.47681451612903225,0.5231854838709677
E01028562,1957,889,1068,0.45426673479816043,0.5457332652018395
E01028563,1570,768,802,0.489171974522293,0.510828025477707
E01028513,2600,1385,1215,0.5326923076923077,0.4673076923076923
E01028514,1584,785,799,0.49558080808080807,0.5044191919191919
E01028516,2416,1170,1246,0.48427152317880795,0.515728476821192
E01028538,1793,851,942,0.4746235359732292,0.5253764640267707
E01028534,1239,566,673,0.45682001614205003,0.54317998385795
E01028535,2171,1041,1130,0.47950253339474896,0.5204974666052511
E01028536,1441,647,794,0.4489937543372658,0.5510062456627343
E01028537,1836,793,1043,0.43191721132897604,0.568082788671024
E01028539,2114,1032,1082,0.4881740775780511,0.5118259224219489
E01028540,2314,1125,1189,0.48617113223854796,0.513828867761452
E01028515,1741,873,868,0.5014359563469271,0.49856404365307294
E01028571,1655,798,857,0.48217522658610273,0.5178247734138973
E01028572,1869,915,954,0.4895666131621188,0.5104333868378812
E01028573,1769,848,921,0.47936687394007915,0.5206331260599208
E01028574,1436,697,739,0.4853760445682451,0.5146239554317549
E01028521,9898,4991,4907,0.5042432814710043,0.4957567185289958
E01028522,4099,2232,1867,0.544523054403513,0.45547694559648694
E01035741,2246,1090,1156,0.4853072128227961,0.5146927871772039
E01035742,2229,1021,1208,0.45805293853746076,0.5419470614625392
E01028548,1960,962,998,0.49081632653061225,0.5091836734693878
E01028549,1533,806,727,0.5257664709719504,0.47423352902804955
E01028550,1433,716,717,0.49965108164689465,0.5003489183531054
E01028551,1692,818,874,0.483451536643026,0.516548463356974
E01028523,1605,708,897,0.4411214953271028,0.5588785046728972
E01028524,1744,851,893,0.48795871559633025,0.5120412844036697
E01028525,2036,938,1098,0.46070726915520627,0.5392927308447937
E01028526,2236,1066,1170,0.47674418604651164,0.5232558139534884
E01028579,1689,868,821,0.5139135583185317,0.4860864416814683
E01028580,1351,640,711,0.47372316802368614,0.5262768319763138
E01028581,1499,720,779,0.48032021347565046,0.5196797865243495
E01028582,1222,600,622,0.4909983633387889,0.5090016366612111
E01028586,1717,912,805,0.5311589982527665,0.46884100174723353
E01028587,1884,918,966,0.4872611464968153,0.5127388535031847
E01028588,1775,876,899,0.49352112676056337,0.5064788732394366
E01028541,1416,695,721,0.490819209039548,0.509180790960452
E01028542,1811,909,902,0.5019326339039205,0.4980673660960795
E01028543,1203,594,609,0.4937655860349127,0.5062344139650873
E01028544,1148,553,595,0.4817073170731707,0.5182926829268293
E01028545,1870,883,987,0.47219251336898393,0.5278074866310161
E01028546,1872,909,963,0.4855769230769231,0.5144230769230769
E01028547,2272,1143,1129,0.503080985915493,0.49691901408450706
E01028527,1801,878,923,0.4875069405885619,0.5124930594114381
E01028528,1680,845,835,0.5029761904761905,0.49702380952380953
E01028529,1778,860,918,0.48368953880764903,0.5163104611923509
E01028530,2144,1155,989,0.5387126865671642,0.4612873134328358
E01028575,1544,752,792,0.48704663212435234,0.5129533678756477
E01028578,1535,781,754,0.5087947882736157,0.49120521172638437
E01028552,2195,1031,1164,0.4697038724373576,0.5302961275626423
E01028553,1835,923,912,0.5029972752043597,0.49700272479564034
E01028554,1556,804,752,0.5167095115681234,0.4832904884318766
E01028555,1643,830,813,0.505173463177115,0.49482653682288497
E01028576,1734,839,895,0.48385236447520186,0.5161476355247981
E01028577,2270,1101,1169,0.48502202643171805,0.5149779735682819
E01028517,1352,660,692,0.4881656804733728,0.5118343195266272
E01028518,1598,788,810,0.493116395494368,0.5068836045056321
E01028519,1742,903,839,0.518369690011481,0.48163030998851897
E01028567,1867,877,990,0.46973754686663094,0.5302624531333691
E01028520,1696,825,871,0.486438679245283,0.5135613207547169
E01028568,1498,700,798,0.4672897196261682,0.5327102803738317
E01028569,1606,746,860,0.46450809464508097,0.5354919053549191
E01028570,2109,1086,1023,0.5149359886201992,0.4850640113798009
E01028556,2722,1256,1466,0.461425422483468,0.5385745775165319
E01028557,2095,1033,1062,0.4930787589498807,0.5069212410501194
E01028558,1727,912,815,0.5280833815865663,0.4719166184134337
E01028559,1897,1007,890,0.5308381655245124,0.4691618344754876
E01028531,2069,1021,1048,0.4934751087481875,0.5065248912518124
E01028532,2957,1499,1458,0.5069327020629016,0.4930672979370984
E01035743,1666,881,785,0.5288115246098439,0.47118847539015607
E01035744,1486,826,660,0.5558546433378196,0.44414535666218036
E01028666,1467,711,756,0.48466257668711654,0.5153374233128835
E01028667,1310,655,655,0.5,0.5
E01028668,1278,613,665,0.47965571205007823,0.5203442879499217
E01028669,1325,640,685,0.4830188679245283,0.5169811320754717
E01028638,1527,740,787,0.48461034708578915,0.5153896529142109
E01028639,1493,748,745,0.5010046885465506,0.49899531145344944
E01028640,1410,692,718,0.4907801418439716,0.5092198581560283
E01028683,1466,743,723,0.5068212824010914,0.4931787175989086
E01028670,1481,722,759,0.487508440243079,0.512491559756921
E01028671,1631,781,850,0.47884733292458614,0.5211526670754139
E01028672,2765,1354,1411,0.48969258589511755,0.5103074141048825
E01028673,2010,997,1013,0.49601990049751243,0.5039800995024876
E01028646,1195,588,607,0.4920502092050209,0.507949790794979
E01028647,1598,768,830,0.4806007509386733,0.5193992490613266
E01028681,1301,642,659,0.49346656418139895,0.5065334358186011
E01028682,1247,615,632,0.49318364073777066,0.5068163592622293
E01028684,1398,657,741,0.4699570815450644,0.5300429184549357
E01028598,2524,1291,1233,0.5114896988906498,0.48851030110935023
E01028613,1399,699,700,0.4996426018584703,0.5003573981415297
E01028614,2583,1261,1322,0.48819202477739065,0.5118079752226093
E01028615,1856,868,988,0.4676724137931034,0.5323275862068966
E01028616,1805,904,901,0.5008310249307479,0.49916897506925206
E01028604,1531,763,768,0.4983670803396473,0.5016329196603527
E01028605,1505,746,759,0.4956810631229236,0.5043189368770764
E01028607,1315,646,669,0.49125475285171105,0.508745247148289
E01028641,1153,582,571,0.5047701647875108,0.49522983521248914
E01028657,1204,618,586,0.5132890365448505,0.4867109634551495
E01028658,1326,632,694,0.4766214177978884,0.5233785822021116
E01028600,1444,694,750,0.4806094182825485,0.5193905817174516
E01028603,1369,668,701,0.48794740686632576,0.5120525931336742
E01028606,1679,815,864,0.4854079809410363,0.5145920190589637
E01028609,1350,674,676,0.49925925925925924,0.5007407407407407
E01028610,1458,720,738,0.49382716049382713,0.5061728395061729
E01028678,1625,787,838,0.48430769230769233,0.5156923076923077
E01028679,2199,1067,1132,0.48522055479763526,0.5147794452023647
E01028680,1695,815,880,0.4808259587020649,0.5191740412979351
E01028625,1939,979,960,0.5048994326972667,0.4951005673027334
E01028626,1591,778,813,0.48900062853551224,0.5109993714644877
E01028627,1426,709,717,0.49719495091164095,0.5028050490883591
E01028628,1742,907,835,0.5206659012629162,0.4793340987370838
E01028629,1417,721,696,0.5088214537755822,0.4911785462244178
E01028622,2024,978,1046,0.48320158102766797,0.516798418972332
E01028623,1599,821,778,0.5134459036898061,0.48655409631019386
E01028624,2260,1126,1134,0.4982300884955752,0.5017699115044247
E01035745,1804,936,868,0.5188470066518847,0.4811529933481153
E01035746,1849,889,960,0.4808004326663061,0.5191995673336939
E01028599,1997,952,1045,0.4767150726089134,0.5232849273910867
E01028601,1622,964,658,0.594327990135635,0.40567200986436497
E01028602,1297,668,629,0.5150346954510409,0.48496530454895914
E01035747,1026,480,546,0.4678362573099415,0.5321637426900585
E01035748,2069,1229,840,0.5940067665538907,0.4059932334461092
E01028608,1246,584,662,0.46869983948635635,0.5313001605136437
E01028617,2088,1000,1088,0.4789272030651341,0.5210727969348659
E01028674,1339,643,696,0.48020911127707244,0.5197908887229276
E01028675,1353,658,695,0.48632668144863267,0.5136733185513673
E01028676,2262,1072,1190,0.4739168877099912,0.5260831122900088
E01028677,1414,688,726,0.48656294200848654,0.5134370579915134
E01028630,1429,758,671,0.5304408677396781,0.4695591322603219
E01028631,1145,573,572,0.5004366812227075,0.4995633187772926
E01028632,1474,728,746,0.49389416553595655,0.5061058344640434
E01028633,1466,762,704,0.519781718963165,0.48021828103683495
E01028634,1308,648,660,0.4954128440366973,0.5045871559633027
E01028635,1557,784,773,0.5035324341682723,0.4964675658317277
E01028636,1321,637,684,0.4822104466313399,0.5177895533686601
E01028637,2171,1094,1077,0.5039152464302165,0.4960847535697835
E01028619,1815,878,937,0.4837465564738292,0.5162534435261708
E01028644,1665,825,840,0.4954954954954955,0.5045045045045045
E01028649,1523,733,790,0.4812869336835194,0.5187130663164806
E01035749,2664,1307,1357,0.4906156156156156,0.5093843843843844
E01035750,1186,588,598,0.4957841483979764,0.5042158516020236
E01035751,1596,790,806,0.4949874686716792,0.5050125313283208
E01035752,1563,769,794,0.49200255918106206,0.5079974408189379
E01028650,2162,1042,1120,0.48196114708603144,0.5180388529139686
E01028651,1632,759,873,0.4650735294117647,0.5349264705882353
E01028652,2119,967,1152,0.45634733364794716,0.5436526663520529
E01028653,1596,757,839,0.4743107769423559,0.5256892230576441
E01028654,1595,782,813,0.490282131661442,0.509717868338558
E01028655,1725,803,922,0.46550724637681157,0.5344927536231884
E01028656,1355,662,693,0.4885608856088561,0.5114391143911439
E01028611,1225,604,621,0.4930612244897959,0.506938775510204
E01028642,1473,711,762,0.48268839103869654,0.5173116089613035
E01028643,1417,683,734,0.4820042342978123,0.5179957657021877
E01028645,1499,716,783,0.47765176784523017,0.5223482321547699
E01028685,1242,629,613,0.5064412238325282,0.49355877616747185
E01028686,1378,728,650,0.5283018867924528,0.4716981132075472
E01028612,1279,630,649,0.49257232212666147,0.5074276778733385
E01028660,1969,971,998,0.4931437277805993,0.5068562722194007
E01028661,1706,869,837,0.5093786635404455,0.4906213364595545
E01028662,1386,675,711,0.487012987012987,0.512987012987013
E01028659,1677,849,828,0.5062611806797853,0.4937388193202147
E01028663,1611,757,854,0.46989447548106766,0.5301055245189323
E01028664,1502,718,784,0.4780292942743009,0.521970705725699
E01028665,1370,672,698,0.4905109489051095,0.5094890510948905
E01028708,1890,932,958,0.4931216931216931,0.5068783068783069
E01028709,1923,941,982,0.48933957358294333,0.5106604264170567
E01028710,2100,1035,1065,0.4928571428571429,0.5071428571428571
E01028711,1687,820,867,0.4860699466508595,0.5139300533491404
E01028733,1340,640,700,0.47761194029850745,0.5223880597014925
E01028734,1568,768,800,0.4897959183673469,0.5102040816326531
E01028735,1646,855,791,0.5194410692588093,0.48055893074119077
E01028740,1635,849,786,0.5192660550458715,0.48073394495412847
E01028741,2017,1022,995,0.5066931085770947,0.4933068914229053
E01028742,2069,1019,1050,0.49250845819236344,0.5074915418076366
E01028738,1894,1127,767,0.5950369588173179,0.40496304118268217
E01028739,2473,1277,1196,0.5163768701981399,0.48362312980186006
E01028743,1654,1156,498,0.6989117291414753,0.3010882708585248
E01028744,1279,655,624,0.5121188428459734,0.4878811571540266
E01028750,1379,665,714,0.48223350253807107,0.5177664974619289
E01028751,1424,701,723,0.4922752808988764,0.5077247191011236
E01028752,1662,820,842,0.49338146811071,0.50661853188929
E01028693,1517,762,755,0.5023071852340145,0.4976928147659855
E01028694,1411,694,717,0.49184975194897235,0.5081502480510276
E01028701,1548,777,771,0.501937984496124,0.49806201550387597
E01028705,1238,596,642,0.481421647819063,0.518578352180937
E01028706,1395,689,706,0.4939068100358423,0.5060931899641578
E01028707,1443,718,725,0.49757449757449757,0.5024255024255024
E01028688,1127,563,564,0.49955634427684115,0.5004436557231589
E01028689,1404,684,720,0.48717948717948717,0.5128205128205128
E01028695,1607,789,818,0.4909769757311761,0.5090230242688238
E01028699,1601,784,817,0.4896939412866958,0.5103060587133041
E01028696,1438,736,702,0.5118219749652295,0.48817802503477054
E01028697,1606,791,815,0.4925280199252802,0.5074719800747198
E01028698,1425,690,735,0.4842105263157895,0.5157894736842106
E01028700,1654,835,819,0.5048367593712213,0.4951632406287787
E01028703,1705,832,873,0.4879765395894428,0.5120234604105571
E01033305,1310,636,674,0.4854961832061069,0.5145038167938931
E01033306,1842,925,917,0.502171552660152,0.497828447339848
E01028726,2865,1425,1440,0.4973821989528796,0.5026178010471204
E01028737,2382,1161,1221,0.48740554156171284,0.5125944584382871
E01035753,2051,997,1054,0.48610433934666014,0.5138956606533398
E01035754,1854,932,922,0.5026968716289104,0.49730312837108953
E01028690,1584,794,790,0.5012626262626263,0.49873737373737376
E01028691,1783,877,906,0.4918676388109927,0.5081323611890073
E01028692,1444,701,743,0.48545706371191133,0.5145429362880887
E01028702,1227,625,602,0.5093724531377343,0.4906275468622657
E01028704,1866,900,966,0.48231511254019294,0.5176848874598071
E01028716,2423,1183,1240,0.48823772183243913,0.5117622781675609
E01028717,1553,755,798,0.4861558274307791,0.5138441725692209
E01028718,1469,709,760,0.48264125255275697,0.517358747447243
E01028719,1608,794,814,0.4937810945273632,0.5062189054726368
E01028749,2635,1272,1363,0.4827324478178368,0.5172675521821631
E01028731,2117,1017,1100,0.48039678790741613,0.5196032120925839
E01028732,1665,818,847,0.4912912912912913,0.5087087087087087
E01028753,1766,872,894,0.49377123442808607,0.5062287655719139
E01028754,1641,799,842,0.48689823278488725,0.5131017672151127
E01035755,1573,803,770,0.5104895104895105,0.48951048951048953
E01035756,1537,751,786,0.4886141834743006,0.5113858165256994
E01028721,1243,617,626,0.49637972646822204,0.503620273531778
E01028722,1551,788,763,0.5080593165699548,0.49194068343004516
E01028723,2233,1106,1127,0.4952978056426332,0.5047021943573667
E01028724,1190,594,596,0.4991596638655462,0.5008403361344538
E01028725,2909,1434,1475,0.4929529047782743,0.5070470952217256
E01028755,1814,901,913,0.4966923925027563,0.5033076074972437
E01028758,1712,828,884,0.48364485981308414,0.5163551401869159
E01028759,1762,877,885,0.4977298524404086,0.5022701475595914
E01028760,1237,592,645,0.4785772029102668,0.5214227970897333
E01028761,1237,595,642,0.48100242522231207,0.5189975747776879
E01035757,1139,555,584,0.4872695346795435,0.5127304653204565
E01035758,1166,534,632,0.45797598627787306,0.5420240137221269
E01028712,2133,1001,1132,0.4692920768870136,0.5307079231129864
E01028728,1306,646,660,0.4946401225114854,0.5053598774885145
E01028729,1888,940,948,0.4978813559322034,0.5021186440677966
E01028730,1603,800,803,0.4990642545227698,0.5009357454772302
E01028757,2244,1061,1183,0.47281639928698754,0.5271836007130125
E01035759,1518,753,765,0.49604743083003955,0.5039525691699605
E01035760,1613,794,819,0.4922504649721017,0.5077495350278983
E01035761,1609,778,831,0.48353014294592916,0.5164698570540709
E01028713,2557,1241,1316,0.4853343762221353,0.5146656237778647
E01028715,2353,1106,1247,0.4700382490437739,0.5299617509562261
E01028720,2616,1260,1356,0.481651376146789,0.518348623853211
E01028745,1785,925,860,0.5182072829131653,0.48179271708683474
E01028746,1640,820,820,0.5,0.5
E01028747,1511,752,759,0.49768365320979485,0.5023163467902052
E01028748,1393,686,707,0.49246231155778897,0.507537688442211
E01028780,2280,1119,1161,0.49078947368421055,0.5092105263157894
E01028781,1867,892,975,0.4777718264595608,0.5222281735404392
E01028782,1518,727,791,0.47891963109354413,0.5210803689064558
E01028783,1585,735,850,0.4637223974763407,0.5362776025236593
E01028795,1624,793,831,0.4883004926108374,0.5116995073891626
E01028796,1435,720,715,0.5017421602787456,0.49825783972125437
E01028797,1242,592,650,0.47665056360708535,0.5233494363929146
E01028806,1971,950,1021,0.4819888381532217,0.5180111618467783
E01028763,2174,1029,1145,0.4733210671573137,0.5266789328426863
E01028776,1951,978,973,0.5012813941568427,0.49871860584315736
E01028798,2247,1095,1152,0.48731642189586116,0.5126835781041389
E01028804,1435,706,729,0.49198606271777,0.50801393728223
E01028823,1306,613,693,0.46937212863705974,0.5306278713629403
E01028824,1889,886,1003,0.4690312334568555,0.5309687665431445
E01028825,1304,635,669,0.4869631901840491,0.5130368098159509
E01034751,1532,762,770,0.49738903394255873,0.5026109660574413
E01035762,1468,715,753,0.48705722070844687,0.5129427792915532
E01028777,1176,560,616,0.47619047619047616,0.5238095238095238
E01028778,1499,724,775,0.4829886591060707,0.5170113408939293
E01028779,1153,567,586,0.49176062445793584,0.5082393755420642
E01028799,2127,1032,1095,0.48519040902679833,0.5148095909732017
E01028788,2007,951,1056,0.47384155455904337,0.5261584454409567
E01028789,1883,901,982,0.47849176845459374,0.5215082315454063
E01028790,1618,779,839,0.4814585908529048,0.5185414091470952
E01028791,1521,755,766,0.49638395792241946,0.5036160420775806
E01028784,2420,1197,1223,0.4946280991735537,0.5053719008264462
E01028792,1108,557,551,0.5027075812274369,0.4972924187725632
E01028793,1580,741,839,0.4689873417721519,0.5310126582278482
E01028794,1436,707,729,0.4923398328690808,0.5076601671309192
E01028810,1287,643,644,0.4996114996114996,0.5003885003885004
E01028811,1376,641,735,0.46584302325581395,0.534156976744186
E01028813,1301,652,649,0.5011529592621061,0.49884704073789393
E01028814,1442,713,729,0.4944521497919556,0.5055478502080444
E01028815,1208,595,613,0.4925496688741722,0.5074503311258278
E01032947,1858,933,925,0.5021528525296017,0.49784714747039827
E01032948,1942,943,999,0.48558187435633365,0.5144181256436663
E01032952,1359,628,731,0.46210448859455483,0.5378955114054452
E01028809,1466,684,782,0.4665757162346521,0.5334242837653479
E01028820,2788,1359,1429,0.48744619799139166,0.5125538020086083
E01028821,1387,678,709,0.48882480173035325,0.5111751982696467
E01028822,1445,702,743,0.48581314878892734,0.5141868512110727
E01028807,2159,1061,1098,0.49143121815655394,0.508568781843446
E01028808,2327,1133,1194,0.48689299527288354,0.5131070047271165
E01028816,1287,651,636,0.5058275058275058,0.49417249417249415
E01028817,1434,750,684,0.5230125523012552,0.4769874476987448
E01028818,1653,766,887,0.4633998790078645,0.5366001209921355
E01028819,1912,907,1005,0.4743723849372385,0.5256276150627615
E01028785,1574,772,802,0.49047013977128334,0.5095298602287166
E01028786,1444,712,732,0.4930747922437673,0.5069252077562327
E01028787,1431,695,736,0.4856743535988819,0.5143256464011181
E01028800,1481,735,746,0.4962862930452397,0.5037137069547603
E01028762,1823,904,919,0.4958859023587493,0.5041140976412507
E01028767,1977,952,1025,0.4815376833586242,0.5184623166413759
E01035255,1131,526,605,0.4650751547303271,0.5349248452696729
E01035565,2405,1623,782,0.6748440748440748,0.3251559251559252
E01028772,2440,1177,1263,0.48237704918032787,0.5176229508196721
E01032949,1365,675,690,0.4945054945054945,0.5054945054945055
E01032950,1729,863,866,0.4991324465008676,0.5008675534991325
E01032951,2035,1014,1021,0.4982800982800983,0.5017199017199018
E01032953,2463,1210,1253,0.49127080795777506,0.5087291920422249
E01028771,1478,727,751,0.4918809201623816,0.5081190798376184
E01028773,1352,672,680,0.4970414201183432,0.5029585798816568
E01028774,1573,785,788,0.4990464081373172,0.5009535918626827
E01028775,1247,657,590,0.5268644747393745,0.4731355252606255
E01028764,1732,819,913,0.47286374133949194,0.5271362586605081
E01028765,2470,1198,1272,0.48502024291497975,0.5149797570850202
E01028801,1497,747,750,0.49899799599198397,0.501002004008016
E01028802,1608,812,796,0.5049751243781094,0.49502487562189057
E01030330,1651,786,865,0.4760751059963658,0.5239248940036342
E01030331,1640,769,871,0.4689024390243902,0.5310975609756098
E01030332,1619,773,846,0.47745521927115503,0.5225447807288449
E01030333,1443,705,738,0.4885654885654886,0.5114345114345115
E01030326,1722,845,877,0.4907084785133566,0.5092915214866435
E01030327,1974,954,1020,0.48328267477203646,0.5167173252279635
E01030328,1679,822,857,0.48957712924359736,0.5104228707564026
E01030329,1589,737,852,0.4638137193203272,0.5361862806796728
E01030334,1542,767,775,0.4974059662775616,0.5025940337224384
E01030335,1860,886,974,0.47634408602150535,0.5236559139784946
E01030336,2008,972,1036,0.48406374501992033,0.5159362549800797
E01030337,1805,865,940,0.4792243767313019,0.5207756232686981
E01030361,2290,1118,1172,0.4882096069868996,0.5117903930131005
E01030362,1457,684,773,0.46945778997940973,0.5305422100205902
E01030363,1874,912,962,0.48665955176093917,0.5133404482390609
E01030364,1630,787,843,0.48282208588957054,0.5171779141104295
E01030350,1797,868,929,0.4830272676683361,0.5169727323316639
E01030351,1598,768,830,0.4806007509386733,0.5193992490613266
E01030352,1629,771,858,0.4732965009208103,0.5267034990791897
E01030353,1585,757,828,0.477602523659306,0.522397476340694
E01030322,1841,919,922,0.4991852254209669,0.5008147745790331
E01030323,1378,658,720,0.47750362844702465,0.5224963715529753
E01030324,1643,785,858,0.47778454047474134,0.5222154595252587
E01030325,1627,788,839,0.4843269821757836,0.5156730178242164
E01030357,1635,786,849,0.48073394495412847,0.5192660550458715
E01030358,1597,764,833,0.47839699436443334,0.5216030056355667
E01030360,1707,832,875,0.4874048037492677,0.5125951962507322
E01034285,1003,490,513,0.4885343968095713,0.5114656031904287
E01034286,1587,806,781,0.5078764965343415,0.4921235034656585
E01030354,1828,862,966,0.47155361050328226,0.5284463894967177
E01030355,1447,710,737,0.4906703524533518,0.5093296475466482
E01030356,1445,674,771,0.46643598615916954,0.5335640138408304
E01030365,1533,754,779,0.4918460534898891,0.5081539465101109
E01030368,1662,805,857,0.4843561973525872,0.5156438026474127
E01030319,1981,976,1005,0.49268046441191315,0.5073195355880868
E01030320,1768,831,937,0.47002262443438914,0.5299773755656109
E01030321,1590,761,829,0.47861635220125787,0.5213836477987421
E01030369,2162,1098,1064,0.5078630897317299,0.4921369102682701
E01030370,1671,826,845,0.4943147815679234,0.5056852184320766
E01030313,2174,1064,1110,0.48942042318307266,0.5105795768169273
E01030314,1762,845,917,0.47956867196367764,0.5204313280363224
E01030366,1956,949,1007,0.48517382413087934,0.5148261758691206
E01030367,1640,822,818,0.501219512195122,0.49878048780487805
E01030338,1669,814,855,0.487717195925704,0.5122828040742959
E01030339,1504,685,819,0.4554521276595745,0.5445478723404256
E01030340,1590,761,829,0.47861635220125787,0.5213836477987421
E01030341,1937,955,982,0.4930304594734125,0.5069695405265875
E01030371,1598,752,846,0.47058823529411764,0.5294117647058824
E01030372,1442,689,753,0.4778085991678225,0.5221914008321775
E01030373,1623,781,842,0.48120764017252005,0.51879235982748
E01030374,1756,842,914,0.479498861047836,0.520501138952164
E01030375,1860,887,973,0.4768817204301075,0.5231182795698924
E01030376,1316,672,644,0.5106382978723404,0.48936170212765956
E01030307,1825,889,936,0.48712328767123286,0.5128767123287671
E01030308,1736,824,912,0.47465437788018433,0.5253456221198156
E01030309,1661,786,875,0.473208910295003,0.526791089704997
E01030310,1875,923,952,0.4922666666666667,0.5077333333333334
E01030311,1566,773,793,0.49361430395913153,0.5063856960408685
E01030312,1508,753,755,0.4993368700265252,0.5006631299734748
E01030315,1718,824,894,0.479627473806752,0.5203725261932479
E01030316,1671,827,844,0.49491322561340517,0.5050867743865949
E01030317,1965,940,1025,0.47837150127226463,0.5216284987277354
E01030318,1500,651,849,0.434,0.566
E01030296,1814,876,938,0.4829106945975744,0.5170893054024256
E01030297,2127,1032,1095,0.48519040902679833,0.5148095909732017
E01030298,1634,791,843,0.48408812729498163,0.5159118727050184
E01030299,1688,811,877,0.48045023696682465,0.5195497630331753
E01030346,1512,703,809,0.46494708994708994,0.53505291005291
E01030347,1775,866,909,0.48788732394366197,0.512112676056338
E01030348,1644,823,821,0.5006082725060828,0.49939172749391725
E01030349,1720,826,894,0.48023255813953486,0.5197674418604651
E01030300,1639,765,874,0.46674801708358754,0.5332519829164124
E01030301,1592,777,815,0.4880653266331658,0.5119346733668342
E01030302,1787,817,970,0.4571908226077224,0.5428091773922775
E01030304,1691,782,909,0.462448255470136,0.537551744529864
E01030305,1653,864,789,0.5226860254083484,0.47731397459165154
E01030306,1582,790,792,0.4993678887484197,0.5006321112515802
E01030303,1726,833,893,0.48261877172653533,0.5173812282734647
E01030342,1804,842,962,0.46674057649667405,0.5332594235033259
E01030343,1821,869,952,0.4772103239978034,0.5227896760021966
E01030344,1517,751,766,0.4950560316413975,0.5049439683586026
E01030345,1681,814,867,0.4842355740630577,0.5157644259369423
E01030386,1479,745,734,0.5037187288708587,0.49628127112914133
E01030387,1558,748,810,0.48010269576379977,0.5198973042362003
E01030388,1342,656,686,0.488822652757079,0.511177347242921
E01030389,1545,760,785,0.4919093851132686,0.5080906148867314
E01030393,1989,949,1040,0.477124183006536,0.5228758169934641
E01030394,1818,896,922,0.49284928492849284,0.5071507150715071
E01030399,2398,1141,1257,0.47581317764804004,0.52418682235196
E01030400,1625,749,876,0.46092307692307694,0.5390769230769231
E01030414,1326,624,702,0.47058823529411764,0.5294117647058824
E01030377,2424,1203,1221,0.4962871287128713,0.5037128712871287
E01030378,1692,838,854,0.49527186761229314,0.5047281323877069
E01030406,1555,769,786,0.4945337620578778,0.5054662379421222
E01030407,1407,700,707,0.4975124378109453,0.5024875621890548
E01030408,1793,874,919,0.48745119910764084,0.5125488008923592
E01030395,1728,816,912,0.4722222222222222,0.5277777777777778
E01030413,2010,986,1024,0.490547263681592,0.5094527363184079
E01030415,1666,802,864,0.48139255702280914,0.5186074429771909
E01030416,1384,659,725,0.4761560693641618,0.5238439306358381
E01030384,2739,1371,1368,0.5005476451259584,0.4994523548740416
E01030401,2525,1222,1303,0.48396039603960395,0.516039603960396
E01030402,2465,1191,1274,0.48316430020283974,0.5168356997971603
E01034287,1698,849,849,0.5,0.5
E01034288,1484,745,739,0.5020215633423181,0.49797843665768193
E01030385,1765,823,942,0.46628895184135977,0.5337110481586402
E01030391,1909,942,967,0.4934520691461498,0.5065479308538502
E01030403,1626,783,843,0.48154981549815495,0.518450184501845
E01030404,1595,784,811,0.4915360501567398,0.5084639498432602
E01030409,1594,757,837,0.4749058971141782,0.5250941028858218
E01030410,1761,871,890,0.4946053378762067,0.5053946621237932
E01030381,1465,707,758,0.4825938566552901,0.5174061433447099
E01030412,2084,967,1117,0.46401151631477927,0.5359884836852208
E01030419,1794,840,954,0.4682274247491639,0.5317725752508361
E01034289,1455,672,783,0.4618556701030928,0.5381443298969072
E01034290,1398,620,778,0.4434907010014306,0.5565092989985694
E01030379,1561,828,733,0.5304292120435619,0.4695707879564382
E01030380,1449,692,757,0.4775707384403037,0.5224292615596964
E01030405,1840,846,994,0.4597826086956522,0.5402173913043479
E01030417,1329,621,708,0.4672686230248307,0.5327313769751693
E01030418,1516,741,775,0.4887862796833773,0.5112137203166227
E01030420,1361,623,738,0.4577516531961793,0.5422483468038207
E01030382,1540,782,758,0.5077922077922078,0.4922077922077922
E01030390,2035,953,1082,0.4683046683046683,0.5316953316953317
E01030392,2041,1001,1040,0.49044585987261147,0.5095541401273885
E01030396,2489,1249,1240,0.5018079550020088,0.49819204499799113
E01030398,1706,833,873,0.48827667057444313,0.5117233294255569
E01032624,1972,974,998,0.49391480730223125,0.5060851926977687
E01030440,1663,822,841,0.49428743235117256,0.5057125676488274
E01030458,1207,604,603,0.5004142502071252,0.4995857497928749
E01030459,1407,612,795,0.4349680170575693,0.5650319829424307
E01030475,1397,673,724,0.4817465998568361,0.5182534001431639
E01030476,1151,561,590,0.48740225890529976,0.5125977410947002
E01030477,1695,824,871,0.4861356932153392,0.5138643067846608
E01030465,1495,759,736,0.5076923076923077,0.49230769230769234
E01030466,1618,793,825,0.4901112484548826,0.5098887515451175
E01030473,1697,840,857,0.4949911608721273,0.5050088391278728
E01030474,2865,2021,844,0.7054101221640489,0.29458987783595114
E01030441,1377,665,712,0.4829339143064633,0.5170660856935366
E01030442,1457,710,747,0.48730267673301303,0.5126973232669869
E01030443,1369,677,692,0.49452154857560265,0.5054784514243974
E01030444,1554,764,790,0.49163449163449163,0.5083655083655083
E01030445,1446,690,756,0.47717842323651455,0.5228215767634855
E01030446,1376,635,741,0.46148255813953487,0.5385174418604651
E01030447,1346,661,685,0.49108469539375926,0.5089153046062407
E01030426,1532,750,782,0.489556135770235,0.5104438642297651
E01030427,1404,705,699,0.5021367521367521,0.49786324786324787
E01030428,1280,629,651,0.49140625,0.50859375
E01030429,1478,745,733,0.5040595399188093,0.4959404600811908
E01030430,1433,690,743,0.48150732728541523,0.5184926727145848
E01030499,1498,714,784,0.4766355140186916,0.5233644859813084
E01030500,1563,776,787,0.4964811260396673,0.5035188739603327
E01030501,1669,787,882,0.4715398442180947,0.5284601557819053
E01030502,1233,591,642,0.4793187347931874,0.5206812652068127
E01030503,1375,663,712,0.48218181818181816,0.5178181818181818
E01030504,1125,521,604,0.4631111111111111,0.5368888888888889
E01030485,1780,880,900,0.4943820224719101,0.5056179775280899
E01030487,1590,814,776,0.5119496855345912,0.4880503144654088
E01030488,2154,1078,1076,0.500464252553389,0.49953574744661094
E01030489,2484,1209,1275,0.4867149758454106,0.5132850241545893
E01030481,1773,918,855,0.5177664974619289,0.48223350253807107
E01030482,1413,702,711,0.4968152866242038,0.5031847133757962
E01030483,1478,745,733,0.5040595399188093,0.4959404600811908
E01030484,1713,866,847,0.5055458260361938,0.4944541739638062
E01030434,1587,791,796,0.4984247006931317,0.5015752993068683
E01030435,1986,972,1014,0.48942598187311176,0.5105740181268882
E01030462,1613,780,833,0.48357098574085555,0.5164290142591444
E01030463,1448,673,775,0.4647790055248619,0.5352209944751382
E01030464,1737,855,882,0.49222797927461137,0.5077720207253886
E01030486,1572,782,790,0.49745547073791346,0.5025445292620865
E01030493,1291,665,626,0.5151045701006971,0.48489542989930284
E01030495,1894,988,906,0.5216473072861668,0.4783526927138332
E01030498,1388,695,693,0.5007204610951008,0.4992795389048991
E01030424,1498,718,780,0.47930574098798395,0.520694259012016
E01030431,1435,724,711,0.5045296167247387,0.49547038327526133
E01030432,1527,742,785,0.4859201047806156,0.5140798952193845
E01030433,1655,809,846,0.48882175226586105,0.511178247734139
E01030436,2266,1101,1165,0.4858781994704325,0.5141218005295676
E01030437,2357,1129,1228,0.4789987271955876,0.5210012728044124
E01030439,1731,835,896,0.4823801270941652,0.5176198729058348
E01030460,1609,798,811,0.4959602237414543,0.5040397762585457
E01030461,1656,795,861,0.48007246376811596,0.519927536231884
E01030470,4674,2074,2600,0.44373127941805734,0.5562687205819427
E01030494,1784,881,903,0.4938340807174888,0.5061659192825112
E01030496,1707,798,909,0.46748681898066785,0.5325131810193322
E01030497,1589,756,833,0.47577092511013214,0.5242290748898678
E01030438,1823,874,949,0.4794295117937466,0.5205704882062534
E01030450,2599,1335,1264,0.5136590996537129,0.486340900346287
E01030451,2008,1061,947,0.5283864541832669,0.4716135458167331
E01030453,1492,730,762,0.48927613941018766,0.5107238605898123
E01030455,1853,920,933,0.496492174851592,0.503507825148408
E01030457,1678,827,851,0.4928486293206198,0.5071513706793802
E01030421,1746,831,915,0.47594501718213056,0.5240549828178694
E01030422,1805,859,946,0.4759002770083102,0.5240997229916897
E01030423,1726,823,903,0.4768250289687138,0.5231749710312862
E01030425,1934,930,1004,0.4808686659772492,0.5191313340227508
E01030452,2584,1286,1298,0.49767801857585137,0.5023219814241486
E01030467,1725,813,912,0.47130434782608693,0.528695652173913
E01030468,3206,1660,1546,0.5177791640673737,0.4822208359326263
E01030469,1459,692,767,0.4742974640164496,0.5257025359835503
E01030448,1566,773,793,0.49361430395913153,0.5063856960408685
E01030449,1354,673,681,0.49704579025110784,0.5029542097488922
E01030454,1694,830,864,0.4899645808736718,0.5100354191263282
E01030456,1516,754,762,0.4973614775725594,0.5026385224274407
E01030471,1257,627,630,0.4988066825775656,0.5011933174224343
E01030472,1300,630,670,0.4846153846153846,0.5153846153846153
E01030478,1858,857,1001,0.461248654467169,0.538751345532831
E01030479,1857,898,959,0.48357565966612814,0.5164243403338719
E01030480,1854,876,978,0.47249190938511326,0.5275080906148867
E01030490,1659,788,871,0.47498493068113323,0.5250150693188668
E01030491,2003,958,1045,0.4782825761357963,0.5217174238642037
E01030492,1997,961,1036,0.48122183274912367,0.5187781672508763
E01030506,1324,632,692,0.4773413897280967,0.5226586102719033
E01030508,1444,697,747,0.4826869806094183,0.5173130193905817
E01030509,1208,555,653,0.4594370860927152,0.5405629139072847
E01030513,1434,668,766,0.46582984658298465,0.5341701534170153
E01030514,1493,712,781,0.4768921634293369,0.5231078365706631
E01030505,1572,796,776,0.5063613231552163,0.49363867684478374
E01030507,1277,615,662,0.4815974941268598,0.5184025058731402
E01030511,1598,753,845,0.4712140175219024,0.5287859824780976
E01030512,1607,790,817,0.4915992532669571,0.5084007467330429
E01030548,2277,1099,1178,0.4826526130873957,0.5173473869126043
E01030549,1883,915,968,0.485926712692512,0.514073287307488
E01030550,1815,918,897,0.5057851239669422,0.49421487603305786
E01030551,1728,844,884,0.48842592592592593,0.5115740740740741
E01030510,1875,873,1002,0.4656,0.5344
E01030552,1538,761,777,0.49479843953185954,0.5052015604681405
E01030553,1695,828,867,0.48849557522123893,0.511504424778761
E01030554,1152,578,574,0.5017361111111112,0.4982638888888889
E01030539,1712,841,871,0.4912383177570093,0.5087616822429907
E01030540,2147,1066,1081,0.49650675360968793,0.503493246390312
E01030541,1266,619,647,0.48894154818325436,0.5110584518167457
E01030542,1257,622,635,0.49482895783611774,0.5051710421638823
E01030543,1639,819,820,0.4996949359365467,0.5003050640634533
E01030516,1323,644,679,0.48677248677248675,0.5132275132275133
E01030517,1656,808,848,0.48792270531400966,0.5120772946859904
E01030518,1388,671,717,0.4834293948126801,0.5165706051873199
E01030519,1602,763,839,0.4762796504369538,0.5237203495630461
E01030520,1384,635,749,0.4588150289017341,0.5411849710982659
E01030521,1652,776,876,0.46973365617433416,0.5302663438256658
E01030522,1420,701,719,0.4936619718309859,0.5063380281690141
E01030523,1225,592,633,0.483265306122449,0.516734693877551
E01030524,1847,924,923,0.5002707092582567,0.4997292907417434
E01030525,1489,728,761,0.4889187374076561,0.5110812625923439
E01030526,1286,615,671,0.4782270606531882,0.5217729393468118
E01030527,1636,775,861,0.4737163814180929,0.5262836185819071
E01030532,1621,799,822,0.49290561381863046,0.5070943861813695
E01030533,1424,719,705,0.5049157303370787,0.49508426966292135
E01030534,1405,666,739,0.4740213523131673,0.5259786476868328
E01030556,1891,898,993,0.4748810153358012,0.5251189846641988
E01030535,1845,910,935,0.4932249322493225,0.5067750677506775
E01030536,1833,848,985,0.46262956901254776,0.5373704309874523
E01030537,1719,848,871,0.49331006399069227,0.5066899360093078
E01030538,1926,950,976,0.4932502596053998,0.5067497403946002
E01030544,1651,803,848,0.4863718958207147,0.5136281041792853
E01030545,1498,714,784,0.4766355140186916,0.5233644859813084
E01030546,1552,740,812,0.47680412371134023,0.5231958762886598
E01030547,1710,821,889,0.4801169590643275,0.5198830409356725
E01030529,1631,802,829,0.4917228694052728,0.5082771305947271
E01030555,1643,806,837,0.49056603773584906,0.5094339622641509
E01030557,1963,1002,961,0.5104431991849211,0.48955680081507896
E01030558,2275,1051,1224,0.46197802197802196,0.538021978021978
E01030515,1940,963,977,0.4963917525773196,0.5036082474226804
E01030528,1410,708,702,0.502127659574468,0.4978723404255319
E01030530,1203,593,610,0.4929343308395677,0.5070656691604323
E01030531,2398,1228,1170,0.51209341117598,0.48790658882402
E01030603,1512,715,797,0.4728835978835979,0.5271164021164021
E01030604,1609,782,827,0.4860161591050342,0.5139838408949658
E01030605,1678,847,831,0.5047675804529201,0.49523241954707986
E01030607,1971,948,1023,0.4809741248097412,0.5190258751902588
E01030559,1239,571,668,0.4608555286521388,0.5391444713478611
E01030560,1589,684,905,0.4304594084329767,0.5695405915670233
E01030561,1365,602,763,0.441025641025641,0.558974358974359
E01030562,1308,610,698,0.46636085626911317,0.5336391437308868
E01030563,2330,1565,765,0.6716738197424893,0.3283261802575107
E01030564,1396,689,707,0.49355300859598855,0.5064469914040115
E01030606,1654,795,859,0.48065296251511486,0.5193470374848851
E01030641,1552,753,799,0.485180412371134,0.5148195876288659
E01030642,1713,801,912,0.46760070052539404,0.532399299474606
E01030644,1249,597,652,0.477982385908727,0.522017614091273
E01030565,1492,735,757,0.492627345844504,0.5073726541554959
E01030566,1467,712,755,0.48534423994546694,0.5146557600545331
E01030567,1660,829,831,0.49939759036144576,0.5006024096385542
E01030568,1482,725,757,0.4892037786774629,0.5107962213225371
E01030569,2748,1338,1410,0.4868995633187773,0.5131004366812227
E01030608,1557,715,842,0.4592164418754014,0.5407835581245986
E01030609,2400,1125,1275,0.46875,0.53125
E01030640,1554,741,813,0.4768339768339768,0.5231660231660231
E01030643,1458,682,776,0.46776406035665297,0.532235939643347
E01030635,1659,778,881,0.4689572031344183,0.5310427968655816
E01030636,1169,585,584,0.5004277159965783,0.49957228400342174
E01030637,1223,611,612,0.49959116925592806,0.5004088307440719
E01030638,1516,741,775,0.4887862796833773,0.5112137203166227
E01030639,1528,710,818,0.46465968586387435,0.5353403141361257
E01030589,1793,895,898,0.4991634132738427,0.5008365867261573
E01030590,1890,922,968,0.48783068783068784,0.5121693121693122
E01030591,1716,846,870,0.493006993006993,0.506993006993007
E01030592,1856,933,923,0.5026939655172413,0.4973060344827586
E01030599,1687,822,865,0.4872554831061055,0.5127445168938944
E01030600,1657,803,854,0.48461074230537116,0.5153892576946288
E01030601,1681,820,861,0.4878048780487805,0.5121951219512195
E01030602,1839,926,913,0.5035345296356716,0.4964654703643284
E01030598,1680,819,861,0.4875,0.5125
E01030623,2303,1072,1231,0.4654798089448545,0.5345201910551455
E01030624,1459,692,767,0.4742974640164496,0.5257025359835503
E01030625,1694,842,852,0.4970484061393152,0.5029515938606848
E01030626,1072,519,553,0.4841417910447761,0.5158582089552238
E01030627,1910,920,990,0.4816753926701571,0.518324607329843
E01030615,2059,1001,1058,0.4861583292860612,0.5138416707139388
E01030616,1702,818,884,0.4806110458284371,0.5193889541715628
E01030617,1730,858,872,0.4959537572254335,0.5040462427745664
E01030618,1958,954,1004,0.48723186925434114,0.5127681307456589
E01030619,1492,710,782,0.47587131367292224,0.5241286863270778
E01030622,1978,1004,974,0.5075834175935288,0.4924165824064712
E01030610,1492,757,735,0.5073726541554959,0.492627345844504
E01030613,2008,1043,965,0.5194223107569721,0.4805776892430279
E01030614,1729,847,882,0.4898785425101215,0.5101214574898786
E01035355,1601,767,834,0.4790755777638976,0.5209244222361025
E01035356,1560,792,768,0.5076923076923077,0.49230769230769234
E01035357,1587,788,799,0.49653434152488973,0.5034656584751103
E01035358,1345,644,701,0.4788104089219331,0.521189591078067
E01030593,1517,742,775,0.4891232696110745,0.5108767303889256
E01030596,1557,776,781,0.4983943481053308,0.5016056518946692
E01030597,1710,817,893,0.4777777777777778,0.5222222222222223
E01030620,1941,948,993,0.4884080370942813,0.5115919629057187
E01030621,1653,775,878,0.4688445251058681,0.5311554748941318
E01030594,1912,931,981,0.4869246861924686,0.5130753138075314
E01030595,1640,823,817,0.5018292682926829,0.49817073170731707
E01030630,1595,761,834,0.47711598746081507,0.5228840125391849
E01030631,1641,798,843,0.48628884826325414,0.5137111517367459
E01030570,1722,839,883,0.48722415795586527,0.5127758420441347
E01030571,1585,771,814,0.48643533123028393,0.5135646687697161
E01030572,2197,1039,1158,0.4729176149294492,0.5270823850705507
E01030573,1865,896,969,0.4804289544235925,0.5195710455764075
E01030574,1958,1017,941,0.5194075587334014,0.48059244126659856
E01030628,1567,776,791,0.4952137843012125,0.5047862156987875
E01030629,1397,708,689,0.5068002863278454,0.4931997136721546
E01030632,1353,665,688,0.49150036954915005,0.50849963045085
E01030633,1489,729,760,0.4895903290799194,0.5104096709200806
E01030634,1564,739,825,0.4725063938618926,0.5274936061381074
E01030585,1530,721,809,0.47124183006535947,0.5287581699346405
E01030586,1924,950,974,0.49376299376299376,0.5062370062370062
E01030587,1627,783,844,0.4812538414259373,0.5187461585740627
E01030588,1515,739,776,0.4877887788778878,0.5122112211221123
E01035359,1995,988,1007,0.49523809523809526,0.5047619047619047
E01035360,1917,926,991,0.48304642670839854,0.5169535732916014
E01030580,2237,1106,1131,0.49441215914170766,0.5055878408582923
E01030581,2414,1192,1222,0.49378624689312345,0.5062137531068766
E01030582,1429,704,725,0.4926522043386984,0.5073477956613016
E01030583,1669,820,849,0.49131216297183944,0.5086878370281606
E01030576,1723,888,835,0.5153801508995938,0.4846198491004063
E01030577,1639,820,819,0.5003050640634533,0.4996949359365467
E01030578,1490,752,738,0.5046979865771812,0.49530201342281877
E01030579,1619,773,846,0.47745521927115503,0.5225447807288449
E01035361,1422,688,734,0.4838255977496484,0.5161744022503516
E01035362,1279,627,652,0.490226739640344,0.509773260359656
E01030667,1538,754,784,0.49024707412223667,0.5097529258777633
E01030668,1989,962,1027,0.48366013071895425,0.5163398692810458
E01030669,1870,872,998,0.4663101604278075,0.5336898395721925
E01030670,1544,736,808,0.47668393782383417,0.5233160621761658
E01030671,1409,658,751,0.46699787083037614,0.5330021291696239
E01030672,4541,2106,2435,0.46377449900902884,0.5362255009909711
E01030673,1452,683,769,0.4703856749311295,0.5296143250688705
E01030674,1432,695,737,0.48533519553072624,0.5146648044692738
E01030675,1533,744,789,0.48532289628180036,0.5146771037181996
E01030676,1457,699,758,0.47975291695264244,0.5202470830473576
E01030663,1766,843,923,0.4773499433748584,0.5226500566251415
E01030664,1774,852,922,0.48027057497181513,0.5197294250281849
E01030665,1607,762,845,0.4741754822650902,0.5258245177349098
E01030666,1759,858,901,0.4877771461057419,0.5122228538942581
E01030687,1256,615,641,0.4896496815286624,0.5103503184713376
E01030688,1591,799,792,0.5021998742928976,0.49780012570710247
E01030656,1573,771,802,0.4901462174189447,0.5098537825810553
E01030658,1433,694,739,0.4842986741102582,0.5157013258897418
E01030685,1498,715,783,0.4773030707610147,0.5226969292389854
E01030686,1459,726,733,0.4976010966415353,0.5023989033584647
E01030689,1497,722,775,0.48229792919171677,0.5177020708082832
E01030690,1795,863,932,0.4807799442896936,0.5192200557103064
E01030691,1576,774,802,0.49111675126903553,0.5088832487309645
E01030692,1466,712,754,0.48567530695770805,0.514324693042292
E01030652,1895,928,967,0.48970976253298154,0.5102902374670185
E01030653,1835,850,985,0.46321525885558584,0.5367847411444142
E01030654,1495,749,746,0.5010033444816053,0.49899665551839467
E01030657,1535,741,794,0.4827361563517915,0.5172638436482084
E01030659,1895,904,991,0.47704485488126647,0.5229551451187335
E01030647,1624,804,820,0.49507389162561577,0.5049261083743842
E01030648,1728,821,907,0.47511574074074076,0.5248842592592593
E01030649,2588,1243,1345,0.4802936630602782,0.5197063369397218
E01030650,1331,674,657,0.5063861758076634,0.49361382419233657
E01030651,1385,665,720,0.48014440433212996,0.51985559566787
E01030655,1861,895,966,0.48092423428264375,0.5190757657173563
E01030662,1754,871,883,0.4965792474344356,0.5034207525655644
E01030677,1474,711,763,0.48236092265943015,0.5176390773405699
E01030678,1426,672,754,0.47124824684431976,0.5287517531556802
E01030679,1275,635,640,0.4980392156862745,0.5019607843137255
E01030680,1512,743,769,0.4914021164021164,0.5085978835978836
E01030645,2196,1037,1159,0.4722222222222222,0.5277777777777778
E01030646,2268,1113,1155,0.49074074074074076,0.5092592592592593
E01030660,2725,1307,1418,0.4796330275229358,0.5203669724770642
E01030661,2020,970,1050,0.4801980198019802,0.5198019801980198
E01030684,1502,729,773,0.48535286284953394,0.5146471371504661
E01030681,1712,840,872,0.49065420560747663,0.5093457943925234
E01030682,1373,681,692,0.4959941733430444,0.5040058266569556
E01030683,1429,685,744,0.4793561931420574,0.5206438068579426
E01030693,1293,610,683,0.4717710750193349,0.5282289249806651
E01030694,1355,678,677,0.5003690036900369,0.4996309963099631
E01030695,1214,586,628,0.4827018121911038,0.5172981878088962
E01030696,1562,776,786,0.4967989756722151,0.5032010243277849
E01030743,1680,843,837,0.5017857142857143,0.4982142857142857
E01030744,1774,931,843,0.5248027057497181,0.47519729425028184
E01030745,1853,897,956,0.4840798704803022,0.5159201295196978
E01030747,1431,741,690,0.5178197064989518,0.48218029350104824
E01030709,1813,911,902,0.5024820739106454,0.49751792608935463
E01030710,2104,1046,1058,0.49714828897338403,0.502851711026616
E01030711,1978,1004,974,0.5075834175935288,0.4924165824064712
E01030746,1863,927,936,0.4975845410628019,0.5024154589371981
E01030707,2085,1038,1047,0.497841726618705,0.5021582733812949
E01030708,1689,850,839,0.5032563647128478,0.49674363528715215
E01030712,1806,914,892,0.5060908084163898,0.4939091915836102
E01030713,1331,676,655,0.5078888054094666,0.49211119459053343
E01030714,1498,597,901,0.3985313751668892,0.6014686248331108
E01030715,1555,763,792,0.4906752411575563,0.5093247588424438
E01030716,1466,732,734,0.49931787175989084,0.5006821282401092
E01030734,1528,732,796,0.4790575916230366,0.5209424083769634
E01030735,1651,814,837,0.49303452453058755,0.5069654754694125
E01030737,1511,755,756,0.499669093315685,0.500330906684315
E01030738,1539,762,777,0.4951267056530214,0.5048732943469786
E01034291,1512,790,722,0.5224867724867724,0.4775132275132275
E01034292,1213,645,568,0.5317394888705689,0.4682605111294312
E01030701,1614,779,835,0.4826517967781908,0.5173482032218092
E01030702,1310,615,695,0.46946564885496184,0.5305343511450382
E01030703,1624,805,819,0.4956896551724138,0.5043103448275862
E01030704,1604,805,799,0.5018703241895262,0.4981296758104738
E01030705,1654,808,846,0.48851269649334944,0.5114873035066505
E01030706,1503,765,738,0.5089820359281437,0.49101796407185627
E01030697,1723,860,863,0.4991294254207777,0.5008705745792222
E01030698,1732,851,881,0.4913394919168591,0.5086605080831409
E01030699,1505,746,759,0.4956810631229236,0.5043189368770764
E01030700,1780,875,905,0.49157303370786515,0.5084269662921348
E01030725,2110,1071,1039,0.5075829383886256,0.4924170616113744
E01030729,1521,705,816,0.4635108481262327,0.5364891518737672
E01030739,1728,834,894,0.4826388888888889,0.5173611111111112
E01030740,1851,906,945,0.48946515397082657,0.5105348460291734
E01030741,1678,835,843,0.49761620977353993,0.5023837902264601
E01030748,1779,878,901,0.49353569421023047,0.5064643057897695
E01030749,1576,743,833,0.4714467005076142,0.5285532994923858
E01030750,1549,749,800,0.4835377663008393,0.5164622336991608
E01030751,1819,907,912,0.49862561847168774,0.5013743815283123
E01030752,1791,883,908,0.49302065884980456,0.5069793411501954
E01030726,1747,873,874,0.4997137950772753,0.5002862049227247
E01030727,1854,890,964,0.48004314994606256,0.5199568500539374
E01030728,1683,847,836,0.5032679738562091,0.49673202614379086
E01030742,1907,922,985,0.48348190875721025,0.5165180912427897
E01030753,1811,875,936,0.48315847598012146,0.5168415240198785
E01030754,2203,1075,1128,0.4879709487063096,0.5120290512936905
E01030755,2073,994,1079,0.4794983116256633,0.5205016883743367
E01030756,1654,805,849,0.4866989117291415,0.5133010882708585
E01030717,1660,778,882,0.4686746987951807,0.5313253012048192
E01030718,1363,662,701,0.4856933235509905,0.5143066764490095
E01030719,1611,789,822,0.4897579143389199,0.5102420856610801
E01030720,1835,879,956,0.4790190735694823,0.5209809264305177
E01030721,1503,713,790,0.4743845642049235,0.5256154357950765
E01030722,1645,817,828,0.4966565349544073,0.5033434650455927
E01030723,1587,777,810,0.4896030245746692,0.5103969754253308
E01030724,1500,733,767,0.4886666666666667,0.5113333333333333
E01030730,1818,892,926,0.49064906490649063,0.5093509350935094
E01030731,1863,933,930,0.500805152979066,0.499194847020934
E01030732,1629,776,853,0.476365868631062,0.523634131368938
E01030733,1676,800,876,0.477326968973747,0.522673031026253
E01030763,1235,609,626,0.4931174089068826,0.5068825910931174
E01030764,1314,650,664,0.4946727549467275,0.5053272450532724
E01030765,1571,743,828,0.47294716740929343,0.5270528325907066
E01030809,1481,743,738,0.5016880486158002,0.49831195138419987
E01030810,1299,643,656,0.49499615088529636,0.5050038491147036
E01030811,1485,725,760,0.4882154882154882,0.5117845117845118
E01030757,1688,836,852,0.495260663507109,0.504739336492891
E01030758,1190,576,614,0.48403361344537815,0.5159663865546219
E01030759,1564,778,786,0.49744245524296676,0.5025575447570333
E01030760,1641,814,827,0.4960390006093845,0.5039609993906154
E01030778,1681,829,852,0.49315883402736466,0.5068411659726353
E01030779,1713,795,918,0.46409807355516636,0.5359019264448336
E01030780,1564,744,820,0.47570332480818417,0.5242966751918159
E01030781,1578,760,818,0.4816223067173637,0.5183776932826363
E01030786,1820,890,930,0.489010989010989,0.510989010989011
E01030787,1473,692,781,0.4697895451459606,0.5302104548540394
E01030788,1366,647,719,0.47364568081991215,0.5263543191800878
E01030801,1742,840,902,0.48220436280137774,0.5177956371986223
E01030802,1847,888,959,0.4807796426637791,0.5192203573362209
E01030796,1397,684,713,0.4896206156048676,0.5103793843951324
E01030797,1407,688,719,0.48898365316275766,0.5110163468372424
E01030798,1563,773,790,0.4945617402431222,0.5054382597568778
E01030799,1364,673,691,0.4934017595307918,0.5065982404692082
E01030800,2010,963,1047,0.4791044776119403,0.5208955223880597
E01030761,2557,1471,1086,0.5752835353930387,0.4247164646069613
E01030762,1828,902,926,0.4934354485776805,0.5065645514223195
E01030806,1504,731,773,0.48603723404255317,0.5139627659574468
E01030807,2788,1337,1451,0.4795552367288379,0.5204447632711621
E01030808,1658,803,855,0.48431845597104944,0.5156815440289505
E01030774,1533,771,762,0.50293542074364,0.49706457925636005
E01030775,1489,729,760,0.4895903290799194,0.5104096709200806
E01030776,1606,767,839,0.4775840597758406,0.5224159402241594
E01030777,1578,752,826,0.47655259822560203,0.523447401774398
E01030793,2162,1071,1091,0.49537465309898243,0.5046253469010176
E01030794,1574,775,799,0.4923761118170267,0.5076238881829733
E01030795,2262,1068,1194,0.47214854111405835,0.5278514588859416
E01030803,1779,881,898,0.4952220348510399,0.5047779651489601
E01030804,1714,844,870,0.49241540256709454,0.5075845974329055
E01030805,1715,846,869,0.4932944606413994,0.5067055393586006
E01030789,1644,813,831,0.49452554744525545,0.5054744525547445
E01030790,1809,890,919,0.4919845218352681,0.5080154781647319
E01030791,1737,868,869,0.49971214738054115,0.5002878526194589
E01030792,1305,660,645,0.5057471264367817,0.4942528735632184
E01030766,1815,895,920,0.4931129476584022,0.5068870523415978
E01030767,1775,864,911,0.4867605633802817,0.5132394366197183
E01030768,1348,643,705,0.47700296735905046,0.5229970326409495
E01030769,1504,733,771,0.48736702127659576,0.5126329787234043
E01030770,1477,714,763,0.4834123222748815,0.5165876777251185
E01030771,1232,602,630,0.48863636363636365,0.5113636363636364
E01030772,1502,765,737,0.5093209054593875,0.49067909454061254
E01030773,1331,659,672,0.49511645379413977,0.5048835462058603
E01030782,1608,802,806,0.4987562189054726,0.5012437810945274
E01030783,1660,815,845,0.49096385542168675,0.5090361445783133
E01030784,2494,1260,1234,0.5052125100240578,0.49478748997594224
E01030785,1466,738,728,0.5034106412005457,0.4965893587994543
E01030855,2040,1007,1033,0.4936274509803922,0.5063725490196078
E01030856,1551,779,772,0.5022566086395873,0.4977433913604126
E01030859,2080,1037,1043,0.4985576923076923,0.5014423076923077
E01035363,1315,626,689,0.47604562737642586,0.5239543726235741
E01035364,1227,615,612,0.5012224938875306,0.49877750611246946
E01030844,1840,907,933,0.49293478260869567,0.5070652173913044
E01030845,1271,591,680,0.46498819826907944,0.5350118017309206
E01030846,1576,760,816,0.48223350253807107,0.5177664974619289
E01030857,2201,1049,1152,0.47660154475238525,0.5233984552476147
E01030858,2633,1267,1366,0.4812001519179643,0.5187998480820357
E01030828,1439,735,704,0.5107713690062543,0.48922863099374564
E01030829,1720,866,854,0.5034883720930232,0.4965116279069767
E01030830,1349,663,686,0.49147516679021497,0.508524833209785
E01030850,2462,1156,1306,0.4695369618196588,0.5304630381803412
E01030851,2059,998,1061,0.4847013113161729,0.5152986886838271
E01030861,2542,984,1558,0.3870967741935484,0.6129032258064516
E01030820,1824,883,941,0.48410087719298245,0.5158991228070176
E01030847,1593,776,817,0.48713119899560575,0.5128688010043942
E01030848,2255,1123,1132,0.4980044345898004,0.5019955654101995
E01030831,2241,1118,1123,0.49888442659527,0.50111557340473
E01030832,1371,669,702,0.487964989059081,0.5120350109409191
E01030836,1608,776,832,0.48258706467661694,0.5174129353233831
E01030837,1498,679,819,0.4532710280373832,0.5467289719626168
E01030838,1343,639,704,0.4758004467609829,0.5241995532390171
E01030839,1430,696,734,0.48671328671328673,0.5132867132867133
E01030840,1430,671,759,0.46923076923076923,0.5307692307692308
E01030841,1368,658,710,0.48099415204678364,0.5190058479532164
E01030842,2318,1093,1225,0.4715271786022433,0.5284728213977566
E01030843,1513,729,784,0.48182419035029744,0.5181758096497026
E01030812,1692,824,868,0.48699763593380613,0.5130023640661938
E01030813,1527,745,782,0.48788474132285525,0.5121152586771447
E01030814,1321,654,667,0.49507948523845574,0.5049205147615443
E01030815,1574,744,830,0.4726810673443456,0.5273189326556544
E01030824,1575,729,846,0.46285714285714286,0.5371428571428571
E01030825,1360,643,717,0.4727941176470588,0.5272058823529412
E01030826,1524,728,796,0.4776902887139108,0.5223097112860893
E01030827,1755,851,904,0.4849002849002849,0.5150997150997151
E01030821,1983,986,997,0.497226424609178,0.502773575390822
E01030822,2005,983,1022,0.4902743142144638,0.5097256857855361
E01030833,1437,669,768,0.46555323590814196,0.534446764091858
E01030834,1479,724,755,0.48951994590939824,0.5104800540906017
E01030835,1484,714,770,0.4811320754716981,0.5188679245283019
E01030816,1655,807,848,0.48761329305135953,0.5123867069486405
E01030817,1419,703,716,0.49541930937279777,0.5045806906272022
E01030818,1236,598,638,0.48381877022653724,0.5161812297734628
E01030819,1723,887,836,0.5147997678467788,0.4852002321532211
E01030823,2323,1149,1174,0.4946190271201033,0.5053809728798967
E01030852,1945,911,1034,0.4683804627249357,0.5316195372750643
E01030853,1808,836,972,0.46238938053097345,0.5376106194690266
E01030854,1986,933,1053,0.4697885196374622,0.5302114803625377
E01032571,1978,966,1012,0.4883720930232558,0.5116279069767442
E01030890,1533,746,787,0.4866275277234181,0.5133724722765819
E01030902,1292,629,663,0.4868421052631579,0.5131578947368421
E01030903,1905,926,979,0.4860892388451444,0.5139107611548557
E01030904,1506,741,765,0.49203187250996017,0.5079681274900398
E01030891,1660,830,830,0.5,0.5
E01030892,1299,653,646,0.5026943802925328,0.4973056197074673
E01030899,1572,790,782,0.5025445292620865,0.49745547073791346
E01030900,1283,631,652,0.49181605611847234,0.5081839438815277
E01030901,1381,679,702,0.49167270094134685,0.5083272990586531
E01030884,1595,757,838,0.4746081504702194,0.5253918495297806
E01030885,1753,764,989,0.43582430119794635,0.5641756988020536
E01030886,1407,671,736,0.47690120824449184,0.5230987917555082
E01030893,2062,994,1068,0.48205625606207564,0.5179437439379243
E01030895,1611,778,833,0.4829298572315332,0.5170701427684667
E01030881,1542,779,763,0.5051880674448768,0.49481193255512324
E01030883,1487,737,750,0.49562878278412914,0.5043712172158709
E01030888,1664,817,847,0.4909855769230769,0.5090144230769231
E01030894,1721,838,883,0.48692620569436373,0.5130737943056363
E01030911,1514,729,785,0.4815059445178336,0.5184940554821664
E01030912,1336,642,694,0.4805389221556886,0.5194610778443114
E01030913,1351,660,691,0.48852701702442636,0.5114729829755736
E01030920,1600,777,823,0.485625,0.514375
E01030921,1700,802,898,0.4717647058823529,0.528235294117647
E01030882,1463,760,703,0.5194805194805194,0.4805194805194805
E01030887,1452,698,754,0.4807162534435262,0.5192837465564738
E01030889,1576,739,837,0.46890862944162437,0.5310913705583756
E01030896,1313,647,666,0.49276466108149275,0.5072353389185073
E01030897,1374,680,694,0.4949053857350801,0.50509461426492
E01030916,2268,1127,1141,0.49691358024691357,0.5030864197530864
E01030917,1174,598,576,0.5093696763202725,0.4906303236797274
E01030918,1176,550,626,0.467687074829932,0.532312925170068
E01030919,1992,1154,838,0.5793172690763052,0.4206827309236948
E01030922,1824,900,924,0.4934210526315789,0.506578947368421
E01030863,1872,876,996,0.46794871794871795,0.532051282051282
E01030865,1600,716,884,0.4475,0.5525
E01030866,1567,737,830,0.47032546266751757,0.5296745373324825
E01030940,1940,928,1012,0.47835051546391755,0.5216494845360825
E01030898,1623,828,795,0.5101663585951941,0.4898336414048059
E01030905,1747,822,925,0.4705208929593589,0.529479107040641
E01030906,1949,944,1005,0.4843509492047204,0.5156490507952797
E01030907,1425,720,705,0.5052631578947369,0.49473684210526314
E01030914,1420,667,753,0.4697183098591549,0.530281690140845
E01030915,1492,721,771,0.4832439678284182,0.5167560321715817
E01030923,1579,796,783,0.5041165294490184,0.49588347055098164
E01030924,1204,595,609,0.4941860465116279,0.5058139534883721
E01030925,1692,806,886,0.47635933806146574,0.5236406619385343
E01030877,1152,539,613,0.4678819444444444,0.5321180555555556
E01030878,1690,822,868,0.4863905325443787,0.5136094674556213
E01030937,1670,803,867,0.4808383233532934,0.5191616766467065
E01030938,1282,582,700,0.4539781591263651,0.5460218408736349
E01030939,1163,574,589,0.4935511607910576,0.5064488392089423
E01030864,1826,890,936,0.4874041621029573,0.5125958378970427
E01030879,1126,559,567,0.49644760213143874,0.5035523978685613
E01030941,1497,696,801,0.4649298597194389,0.5350701402805611
E01030942,1366,655,711,0.479502196193265,0.5204978038067349
E01030943,1346,637,709,0.47325408618127784,0.5267459138187222
E01030870,1600,775,825,0.484375,0.515625
E01030871,1918,913,1005,0.4760166840458811,0.5239833159541188
E01030872,1827,891,936,0.4876847290640394,0.5123152709359606
E01030873,1418,679,739,0.4788434414668547,0.5211565585331452
E01030874,1729,867,862,0.5014459224985541,0.4985540775014459
E01030875,1733,832,901,0.4800923254472014,0.5199076745527986
E01030876,1571,764,807,0.4863144493952896,0.5136855506047103
E01030862,1968,901,1067,0.4578252032520325,0.5421747967479674
E01030867,1550,765,785,0.4935483870967742,0.5064516129032258
E01030868,1317,651,666,0.49430523917995445,0.5056947608200456
E01030869,1192,581,611,0.4874161073825503,0.5125838926174496
E01030880,2361,1053,1308,0.44599745870393903,0.554002541296061
E01030930,1538,751,787,0.488296488946684,0.511703511053316
E01030931,1755,847,908,0.4826210826210826,0.5173789173789174
E01030932,1651,769,882,0.465778316172017,0.5342216838279831
E01030933,1823,899,924,0.4931431705979155,0.5068568294020844
E01030926,1555,736,819,0.4733118971061093,0.5266881028938907
E01030927,1298,643,655,0.4953775038520801,0.5046224961479199
E01030928,1751,823,928,0.47001713306681897,0.5299828669331811
E01030929,1539,799,740,0.5191682910981157,0.4808317089018843
E01030908,1677,825,852,0.4919499105545617,0.5080500894454383
E01030909,1310,629,681,0.4801526717557252,0.5198473282442748
E01030910,1157,565,592,0.48833189282627487,0.5116681071737251
E01030934,1434,694,740,0.4839609483960948,0.5160390516039052
E01030935,1288,631,657,0.48990683229813664,0.5100931677018633
E01032626,1653,773,880,0.4676346037507562,0.5323653962492438
E01030946,1446,711,735,0.491701244813278,0.508298755186722
E01030947,1476,717,759,0.48577235772357724,0.5142276422764228
E01030948,1637,814,823,0.4972510690287111,0.5027489309712889
E01030949,1895,932,963,0.49182058047493404,0.508179419525066
E01030950,1567,727,840,0.4639438417358009,0.5360561582641991
E01030996,1523,739,784,0.4852265265922521,0.5147734734077478
E01030998,1869,923,946,0.4938469769930444,0.5061530230069556
E01031002,1756,857,899,0.4880410022779043,0.5119589977220956
E01031003,1925,940,985,0.4883116883116883,0.5116883116883116
E01031004,2259,1118,1141,0.4949092518813634,0.5050907481186365
E01030963,1507,743,764,0.4930325149303251,0.5069674850696748
E01030964,1764,895,869,0.5073696145124716,0.49263038548752835
E01030965,1517,734,783,0.4838497033618985,0.5161502966381015
E01030966,1431,708,723,0.4947589098532495,0.5052410901467506
E01030967,1647,799,848,0.4851244687310261,0.5148755312689739
E01030968,1356,663,693,0.4889380530973451,0.5110619469026548
E01030980,1749,912,837,0.5214408233276158,0.47855917667238423
E01030981,1773,913,860,0.514946418499718,0.485053581500282
E01030983,1974,1037,937,0.5253292806484295,0.4746707193515704
E01030984,2242,1117,1125,0.4982158786797502,0.5017841213202497
E01034293,2919,1469,1450,0.5032545392257622,0.49674546077423776
E01030951,1280,626,654,0.4890625,0.5109375
E01030952,1621,809,812,0.49907464528069095,0.5009253547193091
E01030953,1431,711,720,0.4968553459119497,0.5031446540880503
E01030956,1274,634,640,0.4976452119309262,0.5023547880690737
E01030957,1257,622,635,0.49482895783611774,0.5051710421638823
E01030958,1436,704,732,0.49025069637883006,0.5097493036211699
E01030959,1020,472,548,0.4627450980392157,0.5372549019607843
E01030988,2031,1049,982,0.5164943377646479,0.483505662235352
E01030989,1850,916,934,0.49513513513513513,0.5048648648648648
E01030990,1434,722,712,0.5034867503486751,0.496513249651325
E01030997,1472,708,764,0.48097826086956524,0.5190217391304348
E01030974,1544,797,747,0.5161917098445595,0.4838082901554404
E01030975,1437,699,738,0.48643006263048016,0.5135699373695198
E01030976,1502,727,775,0.4840213049267643,0.5159786950732357
E01030977,1776,900,876,0.5067567567567568,0.49324324324324326
E01030979,2085,1012,1073,0.4853717026378897,0.5146282973621104
E01030954,2423,1269,1154,0.5237309120924474,0.4762690879075526
E01030969,1488,729,759,0.4899193548387097,0.5100806451612904
E01030970,1453,728,725,0.5010323468685478,0.4989676531314522
E01030991,2046,1035,1011,0.5058651026392962,0.4941348973607038
E01034294,1596,856,740,0.5363408521303258,0.46365914786967416
E01034295,1655,845,810,0.5105740181268882,0.48942598187311176
E01030960,1748,837,911,0.4788329519450801,0.5211670480549199
E01030961,1936,972,964,0.5020661157024794,0.49793388429752067
E01030962,1633,802,831,0.4911206368646663,0.5088793631353338
E01031000,1494,735,759,0.4919678714859438,0.5080321285140562
E01030955,1371,679,692,0.49525893508388036,0.5047410649161196
E01030992,1744,872,872,0.5,0.5
E01030999,1361,665,696,0.4886113152094049,0.5113886847905952
E01031001,1739,858,881,0.4933870040253019,0.5066129959746981
E01030971,2464,1183,1281,0.48011363636363635,0.5198863636363636
E01030972,2036,1012,1024,0.49705304518664045,0.5029469548133595
E01030994,1974,969,1005,0.4908814589665654,0.5091185410334347
E01030995,1769,918,851,0.5189372526851328,0.48106274731486715
E01034296,1215,595,620,0.4897119341563786,0.5102880658436214
E01034297,1846,890,956,0.48212351029252437,0.5178764897074756
E01030944,1349,694,655,0.514455151964418,0.4855448480355819
E01030945,1241,615,626,0.49556809024979853,0.5044319097502015
E01030978,2296,1146,1150,0.4991289198606272,0.5008710801393729
E01030986,1040,500,540,0.4807692307692308,0.5192307692307693
E01030987,1339,659,680,0.4921583271097834,0.5078416728902165
E01031349,1399,676,723,0.4832022873481058,0.5167977126518942
E01031350,1319,620,699,0.4700530705079606,0.5299469294920395
E01031351,1622,795,827,0.49013563501849566,0.5098643649815043
E01031352,1540,711,829,0.4616883116883117,0.5383116883116883
E01031370,1522,730,792,0.47963206307490147,0.5203679369250985
E01031374,1694,836,858,0.4935064935064935,0.5064935064935064
E01031338,1295,636,659,0.4911196911196911,0.5088803088803089
E01031339,1194,571,623,0.47822445561139026,0.5217755443886097
E01031340,1535,770,765,0.501628664495114,0.498371335504886
E01031365,1944,894,1050,0.45987654320987653,0.5401234567901234
E01031367,1394,691,703,0.49569583931133426,0.5043041606886657
E01031345,1593,778,815,0.4883866917765223,0.5116133082234777
E01031353,1384,701,683,0.5065028901734104,0.4934971098265896
E01031354,1305,664,641,0.5088122605363985,0.49118773946360156
E01031355,1816,880,936,0.4845814977973568,0.5154185022026432
E01031359,1402,701,701,0.5,0.5
E01031347,1688,828,860,0.490521327014218,0.509478672985782
E01031348,1756,869,887,0.494874715261959,0.505125284738041
E01031366,1420,670,750,0.47183098591549294,0.528169014084507
E01031371,1274,610,664,0.478806907378336,0.521193092621664
E01031372,1470,685,785,0.46598639455782315,0.5340136054421769
E01031373,1438,668,770,0.46453407510431155,0.5354659248956884
E01031375,1486,706,780,0.47510094212651416,0.5248990578734859
E01031356,2423,1207,1216,0.4981427981840693,0.5018572018159306
E01031357,2239,1113,1126,0.4970969182670835,0.5029030817329165
E01031364,1871,902,969,0.4820951362907536,0.5179048637092464
E01031368,1477,728,749,0.4928909952606635,0.5071090047393365
E01031369,1251,557,694,0.44524380495603516,0.5547561950439648
E01031344,1442,737,705,0.5110957004160888,0.48890429958391124
E01031346,1456,696,760,0.47802197802197804,0.521978021978022
E01031361,1513,731,782,0.48314606741573035,0.5168539325842697
E01031362,1344,655,689,0.48735119047619047,0.5126488095238095
E01031363,1538,702,836,0.4564369310793238,0.5435630689206762
E01031358,1511,734,777,0.485771012574454,0.514228987425546
E01031360,1552,741,811,0.47744845360824745,0.5225515463917526
E01031376,1272,615,657,0.4834905660377358,0.5165094339622641
E01031378,1390,677,713,0.4870503597122302,0.5129496402877698
E01031341,1471,721,750,0.49014276002719237,0.5098572399728076
E01031342,1601,759,842,0.4740787008119925,0.5259212991880075
E01031343,1375,662,713,0.48145454545454547,0.5185454545454545
E01031377,1702,828,874,0.4864864864864865,0.5135135135135135
E01031379,1625,760,865,0.4676923076923077,0.5323076923076923
E01031390,1348,645,703,0.478486646884273,0.521513353115727
E01031391,1488,685,803,0.4603494623655914,0.5396505376344086
E01031392,1538,723,815,0.47009102730819247,0.5299089726918076
E01031465,1365,696,669,0.5098901098901099,0.4901098901098901
E01031386,1507,741,766,0.49170537491705374,0.5082946250829462
E01031387,1566,763,803,0.4872286079182631,0.5127713920817369
E01031425,1336,629,707,0.4708083832335329,0.5291916167664671
E01031426,1189,579,610,0.48696383515559294,0.5130361648444071
E01031393,2478,1197,1281,0.4830508474576271,0.5169491525423728
E01031394,1643,804,839,0.4893487522824102,0.5106512477175897
E01031395,1664,828,836,0.49759615384615385,0.5024038461538461
E01031396,2434,1195,1239,0.49096138044371407,0.5090386195562859
E01031397,1841,853,988,0.46333514394350894,0.5366648560564911
E01031466,1555,760,795,0.4887459807073955,0.5112540192926045
E01031427,1699,813,886,0.4785167745732784,0.5214832254267217
E01031429,1573,764,809,0.48569612205975843,0.5143038779402416
E01031430,1433,704,729,0.49127704117236565,0.5087229588276343
E01034816,2142,1019,1123,0.4757236227824463,0.5242763772175537
E01034817,2045,1021,1024,0.49926650366748165,0.5007334963325183
E01034818,1562,752,810,0.4814340588988476,0.5185659411011524
E01034819,1710,829,881,0.4847953216374269,0.5152046783625731
E01031389,2157,1019,1138,0.47241539174779784,0.5275846082522021
E01031414,1502,704,798,0.46870838881491345,0.5312916111850865
E01031415,1588,724,864,0.45591939546599497,0.5440806045340051
E01031459,1877,884,993,0.47096430474160894,0.529035695258391
E01034820,2176,1041,1135,0.47840073529411764,0.5215992647058824
E01034821,1668,819,849,0.4910071942446043,0.5089928057553957
E01031470,1818,1059,759,0.5825082508250825,0.4174917491749175
E01031471,2260,1100,1160,0.48672566371681414,0.5132743362831859
E01031472,1595,781,814,0.4896551724137931,0.5103448275862069
E01031473,1241,599,642,0.48267526188557613,0.5173247381144238
E01031407,1502,723,779,0.481358189081225,0.5186418109187749
E01031408,2100,1012,1088,0.4819047619047619,0.518095238095238
E01031410,1289,608,681,0.4716834755624515,0.5283165244375485
E01031462,1532,710,822,0.46344647519582244,0.5365535248041775
E01031463,1641,768,873,0.4680073126142596,0.5319926873857403
E01031464,1692,767,925,0.4533096926713948,0.5466903073286052
E01031412,1395,673,722,0.4824372759856631,0.5175627240143369
E01031422,1553,720,833,0.463618802318094,0.536381197681906
E01031423,1870,871,999,0.4657754010695187,0.5342245989304812
E01031424,1430,657,773,0.45944055944055945,0.5405594405594406
E01031398,1465,731,734,0.49897610921501706,0.5010238907849829
E01031399,1647,777,870,0.47176684881602915,0.5282331511839709
E01031409,1439,699,740,0.4857539958304378,0.5142460041695622
E01031455,1656,763,893,0.4607487922705314,0.5392512077294686
E01031461,1753,809,944,0.4614945807187678,0.5385054192812322
E01031469,1649,781,868,0.4736203759854457,0.5263796240145543
E01031411,1348,604,744,0.44807121661721067,0.5519287833827893
E01031413,1396,619,777,0.44340974212034384,0.5565902578796562
E01031457,1689,774,915,0.458259325044405,0.5417406749555951
E01031458,1798,815,983,0.4532814238042269,0.5467185761957731
E01031460,1724,768,956,0.44547563805104406,0.5545243619489559
E01031400,1587,796,791,0.5015752993068683,0.4984247006931317
E01031428,1538,767,771,0.4986996098829649,0.5013003901170351
E01031454,2507,1295,1212,0.5165536497806142,0.4834463502193857
E01031456,1748,903,845,0.5165903890160183,0.4834096109839817
E01031402,1689,823,866,0.4872705743043221,0.5127294256956779
E01031403,1487,712,775,0.47881640887693344,0.5211835911230666
E01031405,1390,663,727,0.47697841726618706,0.5230215827338129
E01031406,1347,655,692,0.4862657757980698,0.5137342242019303
E01034822,1974,958,1016,0.48530901722391084,0.5146909827760892
E01034823,1778,857,921,0.48200224971878514,0.5179977502812149
E01031417,1702,820,882,0.481786133960047,0.518213866039953
E01031438,1522,704,818,0.46254927726675427,0.5374507227332457
E01031439,1879,905,974,0.4816391697711549,0.5183608302288452
E01031440,1515,734,781,0.4844884488448845,0.5155115511551155
E01031404,1168,561,607,0.4803082191780822,0.5196917808219178
E01031433,1413,661,752,0.4677990092002831,0.5322009907997169
E01031434,1656,800,856,0.4830917874396135,0.5169082125603864
E01031441,1710,828,882,0.4842105263157895,0.5157894736842106
E01031442,1748,848,900,0.4851258581235698,0.5148741418764302
E01031416,1518,723,795,0.4762845849802372,0.5237154150197628
E01031418,2060,1005,1055,0.4878640776699029,0.5121359223300971
E01031419,1575,720,855,0.45714285714285713,0.5428571428571428
E01031420,1752,804,948,0.4589041095890411,0.541095890410959
E01034824,1924,924,1000,0.4802494802494803,0.5197505197505198
E01034825,1765,838,927,0.47478753541076485,0.5252124645892351
E01031443,1397,684,713,0.4896206156048676,0.5103793843951324
E01031444,1688,812,876,0.48104265402843605,0.518957345971564
E01031450,1460,708,752,0.4849315068493151,0.5150684931506849
E01031451,1756,827,929,0.47095671981776766,0.5290432801822323
E01031452,1467,741,726,0.5051124744376279,0.4948875255623722
E01031431,1095,528,567,0.4821917808219178,0.5178082191780822
E01031432,1947,980,967,0.5033384694401644,0.49666153055983564
E01031435,1884,988,896,0.524416135881104,0.47558386411889597
E01031436,1985,1040,945,0.5239294710327456,0.4760705289672544
E01031437,2109,1050,1059,0.49786628733997157,0.5021337126600285
E01031453,1705,837,868,0.4909090909090909,0.509090909090909
E01031380,1558,729,829,0.46790757381258025,0.5320924261874198
E01031381,1652,803,849,0.4860774818401937,0.5139225181598063
E01031382,1712,829,883,0.4842289719626168,0.5157710280373832
E01031383,1561,746,815,0.47789878283151827,0.5221012171684818
E01031384,1698,798,900,0.46996466431095407,0.5300353356890459
E01031385,1557,736,821,0.472703917790623,0.527296082209377
E01031445,1910,995,915,0.5209424083769634,0.4790575916230366
E01031446,1334,615,719,0.46101949025487254,0.5389805097451275
E01031447,1646,803,843,0.48784933171324424,0.5121506682867558
E01031448,1544,721,823,0.46696891191709844,0.5330310880829016
E01031449,1713,809,904,0.47227086981903094,0.527729130180969
E01031502,1589,773,816,0.48646947765890497,0.513530522341095
E01031503,1598,794,804,0.49687108886107634,0.5031289111389237
E01031504,2117,1012,1105,0.47803495512517713,0.5219650448748229
E01031519,1401,710,691,0.5067808708065668,0.49321912919343325
E01031517,1974,959,1015,0.4858156028368794,0.5141843971631206
E01031518,1656,805,851,0.4861111111111111,0.5138888888888888
E01031544,1263,624,639,0.49406175771971494,0.505938242280285
E01031545,1270,615,655,0.484251968503937,0.515748031496063
E01031508,2053,994,1059,0.48416950803701897,0.515830491962981
E01031520,1337,658,679,0.49214659685863876,0.5078534031413613
E01031521,1127,561,566,0.49778172138420584,0.5022182786157942
E01031536,1234,632,602,0.5121555915721232,0.4878444084278768
E01031497,1589,766,823,0.48206419131529266,0.5179358086847073
E01031511,1495,682,813,0.4561872909698997,0.5438127090301004
E01031512,1970,903,1067,0.4583756345177665,0.5416243654822335
E01035320,1905,868,1037,0.45564304461942257,0.5443569553805774
E01035321,1031,486,545,0.4713870029097963,0.5286129970902037
E01031478,1295,637,658,0.4918918918918919,0.5081081081081081
E01031479,1020,485,535,0.47549019607843135,0.5245098039215687
E01031498,1048,507,541,0.48377862595419846,0.5162213740458015
E01031514,1599,778,821,0.48655409631019386,0.5134459036898061
E01031515,1695,793,902,0.4678466076696165,0.5321533923303835
E01031516,1505,732,773,0.4863787375415282,0.5136212624584717
E01031477,2243,1072,1171,0.47793134195274184,0.5220686580472581
E01031485,1513,728,785,0.48116325181758096,0.518836748182419
E01031487,1524,700,824,0.45931758530183725,0.5406824146981627
E01035322,1442,657,785,0.45561719833564496,0.544382801664355
E01035323,1511,739,772,0.48908007941760423,0.5109199205823958
E01031506,1266,610,656,0.48183254344391785,0.5181674565560821
E01031507,1342,656,686,0.488822652757079,0.511177347242921
E01031531,1286,610,676,0.47433903576982894,0.5256609642301711
E01031533,1394,642,752,0.460545193687231,0.539454806312769
E01031543,2395,1158,1237,0.48350730688935284,0.5164926931106472
E01031482,1542,743,799,0.48184176394293127,0.5181582360570688
E01031483,2382,1135,1247,0.47649034424853065,0.5235096557514693
E01031486,1845,827,1018,0.44823848238482383,0.5517615176151761
E01031494,1672,770,902,0.4605263157894737,0.5394736842105263
E01031495,1477,691,786,0.46784021665538256,0.5321597833446174
E01035324,1585,734,851,0.4630914826498423,0.5369085173501578
E01035325,1802,849,953,0.4711431742508324,0.5288568257491676
E01031475,1908,934,974,0.48951781970649894,0.510482180293501
E01031476,1576,748,828,0.4746192893401015,0.5253807106598984
E01031532,2230,1467,763,0.657847533632287,0.342152466367713
E01031534,1816,861,955,0.4741189427312775,0.5258810572687225
E01031535,2093,1002,1091,0.47873865265169613,0.5212613473483039
E01031480,1316,641,675,0.4870820668693009,0.5129179331306991
E01031481,1551,766,785,0.4938749194068343,0.5061250805931657
E01031484,1828,856,972,0.4682713347921225,0.5317286652078774
E01031490,2370,988,1382,0.41687763713080167,0.5831223628691983
E01031491,1842,856,986,0.46471226927252984,0.5352877307274702
E01031474,1390,662,728,0.4762589928057554,0.5237410071942447
E01031493,1807,831,976,0.45987825124515774,0.5401217487548423
E01031496,2653,1274,1379,0.48021108179419525,0.5197889182058048
E01031505,2664,1298,1366,0.4872372372372372,0.5127627627627628
E01031489,1519,739,780,0.48650427913100724,0.5134957208689928
E01031492,1837,855,982,0.46543277082199236,0.5345672291780076
E01031530,1290,622,668,0.4821705426356589,0.517829457364341
E01031538,1595,771,824,0.4833855799373041,0.516614420062696
E01031539,1739,813,926,0.4675100632547441,0.5324899367452559
E01035326,1715,839,876,0.4892128279883382,0.5107871720116618
E01035327,1791,877,914,0.4896705750977108,0.5103294249022893
E01031499,1738,793,945,0.4562715765247411,0.543728423475259
E01031500,2362,1136,1226,0.4809483488569009,0.519051651143099
E01031501,1436,667,769,0.46448467966573814,0.5355153203342619
E01031529,1304,639,665,0.49003067484662577,0.5099693251533742
E01031540,1375,655,720,0.4763636363636364,0.5236363636363637
E01031541,1397,653,744,0.4674302075876879,0.5325697924123121
E01031542,2016,967,1049,0.47966269841269843,0.5203373015873016
E01031522,2014,969,1045,0.4811320754716981,0.5188679245283019
E01031523,1659,809,850,0.48764315852923446,0.5123568414707655
E01031524,1740,827,913,0.4752873563218391,0.524712643678161
E01031525,1337,622,715,0.46522064323111445,0.5347793567688855
E01031526,1254,589,665,0.4696969696969697,0.5303030303030303
E01031527,1450,683,767,0.4710344827586207,0.5289655172413793
E01031528,1469,712,757,0.4846834581347856,0.5153165418652145
E01031573,1842,947,895,0.5141150922909881,0.48588490770901194
E01031574,2020,1035,985,0.5123762376237624,0.4876237623762376
E01031575,1784,965,819,0.5409192825112108,0.45908071748878926
E01031576,1859,953,906,0.5126412049488973,0.48735879505110274
E01031577,1439,755,684,0.5246699096594858,0.47533009034051427
E01031586,1749,857,892,0.48999428244711263,0.5100057175528874
E01031588,1502,739,763,0.49201065246338216,0.5079893475366178
E01031590,1568,773,795,0.492984693877551,0.5070153061224489
E01031593,1451,728,723,0.5017229496898691,0.4982770503101309
E01035328,2077,1044,1033,0.5026480500722196,0.4973519499277805
E01035329,2367,1197,1170,0.5057034220532319,0.49429657794676807
E01031570,1405,701,704,0.498932384341637,0.501067615658363
E01031571,1796,863,933,0.48051224944320714,0.5194877505567929
E01031572,2226,1049,1177,0.47124887690925427,0.5287511230907457
E01031609,1660,823,837,0.49578313253012046,0.5042168674698795
E01031610,2004,989,1015,0.4935129740518962,0.5064870259481038
E01031583,2307,1214,1093,0.5262245340268747,0.47377546597312525
E01031584,1890,957,933,0.5063492063492063,0.4936507936507937
E01031585,2615,1331,1284,0.5089866156787763,0.4910133843212237
E01031601,1473,747,726,0.5071283095723014,0.49287169042769857
E01032835,1964,973,991,0.4954175152749491,0.504582484725051
E01032836,2335,1201,1134,0.5143468950749465,0.48565310492505354
E01031589,1785,900,885,0.5042016806722689,0.4957983193277311
E01031591,1904,965,939,0.506827731092437,0.49317226890756305
E01031594,1485,755,730,0.5084175084175084,0.49158249158249157
E01031600,1584,772,812,0.48737373737373735,0.5126262626262627
E01031603,1593,845,748,0.5304456999372253,0.46955430006277465
E01031564,1522,730,792,0.47963206307490147,0.5203679369250985
E01031565,2317,1169,1148,0.5045317220543807,0.4954682779456193
E01031566,1682,838,844,0.4982164090368609,0.5017835909631391
E01031567,1365,659,706,0.4827838827838828,0.5172161172161173
E01031568,1513,756,757,0.4996695307336418,0.5003304692663583
E01031596,2043,1003,1040,0.49094468918257467,0.5090553108174254
E01031597,1661,834,827,0.50210716435882,0.49789283564118003
E01031598,1902,909,993,0.47791798107255523,0.5220820189274448
E01031599,2197,1113,1084,0.5065999089667729,0.49340009103322713
E01031608,2552,1282,1270,0.5023510971786834,0.49764890282131663
E01031578,1775,880,895,0.49577464788732395,0.504225352112676
E01031580,2361,1173,1188,0.49682337992376113,0.5031766200762389
E01031581,1735,870,865,0.5014409221902018,0.49855907780979825
E01031592,1978,992,986,0.5015166835187057,0.49848331648129424
E01031560,1564,776,788,0.4961636828644501,0.5038363171355499
E01031561,1541,786,755,0.5100584036340039,0.4899415963659961
E01031562,1362,651,711,0.4779735682819383,0.5220264317180616
E01031563,1536,777,759,0.505859375,0.494140625
E01031579,1618,776,842,0.4796044499381953,0.5203955500618047
E01031582,1860,933,927,0.5016129032258064,0.49838709677419357
E01031547,1309,651,658,0.49732620320855614,0.5026737967914439
E01031548,1684,818,866,0.4857482185273159,0.5142517814726841
E01031549,1772,857,915,0.48363431151241537,0.5163656884875847
E01031550,1395,686,709,0.4917562724014337,0.5082437275985663
E01031569,1680,811,869,0.48273809523809524,0.5172619047619048
E01031595,1802,854,948,0.4739178690344062,0.5260821309655938
E01031604,1604,757,847,0.47194513715710723,0.5280548628428927
E01031605,1630,795,835,0.48773006134969327,0.5122699386503068
E01031606,1701,826,875,0.48559670781893005,0.51440329218107
E01031607,1577,779,798,0.4939759036144578,0.5060240963855421
E01031546,1483,767,716,0.5171948752528658,0.48280512474713416
E01031551,1620,808,812,0.49876543209876545,0.5012345679012346
E01031553,1514,733,781,0.48414795244385733,0.5158520475561427
E01031554,1837,939,898,0.5111594991834513,0.48884050081654873
E01031555,1583,785,798,0.49589387239418825,0.5041061276058117
E01031552,1846,883,963,0.4783315276273023,0.5216684723726978
E01031556,1600,752,848,0.47,0.53
E01031557,1835,918,917,0.5002724795640326,0.4997275204359673
E01031558,1621,770,851,0.47501542257865514,0.5249845774213449
E01031559,1635,830,805,0.5076452599388379,0.4923547400611621
E01031670,1525,746,779,0.48918032786885246,0.5108196721311475
E01031671,1557,779,778,0.5003211303789339,0.49967886962106617
E01031673,1552,756,796,0.48711340206185566,0.5128865979381443
E01035330,1395,697,698,0.4996415770609319,0.5003584229390681
E01035331,1288,609,679,0.47282608695652173,0.5271739130434783
E01035332,1476,742,734,0.502710027100271,0.497289972899729
E01035333,1617,804,813,0.4972170686456401,0.5027829313543599
E01031644,1900,935,965,0.4921052631578947,0.5078947368421053
E01031645,1387,656,731,0.47296322999279017,0.5270367700072098
E01031646,1440,702,738,0.4875,0.5125
E01031647,1192,569,623,0.4773489932885906,0.5226510067114094
E01031649,1057,517,540,0.489120151371807,0.510879848628193
E01031650,1300,645,655,0.49615384615384617,0.5038461538461538
E01031666,1583,773,810,0.4883133291219204,0.5116866708780796
E01031668,1486,715,771,0.48115746971736206,0.5188425302826379
E01031620,2097,1023,1074,0.48783977110157367,0.5121602288984263
E01031648,1558,777,781,0.4987163029525032,0.5012836970474968
E01031651,1589,752,837,0.473253618628068,0.5267463813719321
E01031658,2050,996,1054,0.48585365853658535,0.5141463414634146
E01031689,1488,708,780,0.47580645161290325,0.5241935483870968
E01031654,1620,795,825,0.49074074074074076,0.5092592592592593
E01031655,1621,816,805,0.5033929673041333,0.49660703269586676
E01031667,1480,733,747,0.49527027027027026,0.5047297297297297
E01031669,1648,813,835,0.4933252427184466,0.5066747572815534
E01031672,1904,982,922,0.5157563025210085,0.4842436974789916
E01031657,1929,947,982,0.4909279419388284,0.5090720580611716
E01031659,1782,903,879,0.5067340067340067,0.49326599326599324
E01031674,1404,676,728,0.48148148148148145,0.5185185185185185
E01031675,1564,752,812,0.48081841432225064,0.5191815856777494
E01031652,1689,822,867,0.4866785079928952,0.5133214920071048
E01031653,1947,955,992,0.49049820236260916,0.5095017976373909
E01031656,1930,950,980,0.49222797927461137,0.5077720207253886
E01031688,1373,655,718,0.4770575382374363,0.5229424617625638
E01031691,1782,887,895,0.49775533108866443,0.5022446689113356
E01035334,1171,550,621,0.46968403074295473,0.5303159692570453
E01035335,1394,699,695,0.5014347202295553,0.49856527977044474
E01031638,1759,869,890,0.49403069926094373,0.5059693007390563
E01031690,1533,745,788,0.48597521200260924,0.5140247879973907
E01035336,1151,560,591,0.48653344917463076,0.5134665508253693
E01035337,1310,635,675,0.4847328244274809,0.5152671755725191
E01035338,1751,861,890,0.49171901770416904,0.508280982295831
E01035339,1796,876,920,0.48775055679287305,0.512249443207127
E01035340,1640,788,852,0.48048780487804876,0.5195121951219512
E01031639,2023,966,1057,0.47750865051903113,0.5224913494809689
E01031640,1822,888,934,0.48737650933040616,0.5126234906695939
E01031660,1349,657,692,0.4870274277242402,0.5129725722757599
E01031661,1714,855,859,0.49883313885647607,0.5011668611435239
E01031679,2049,993,1056,0.48462664714494874,0.5153733528550513
E01031677,1605,801,804,0.49906542056074765,0.5009345794392523
E01031678,1909,929,980,0.48664222105814564,0.5133577789418544
E01031680,1520,740,780,0.4868421052631579,0.5131578947368421
E01031681,1762,883,879,0.5011350737797957,0.4988649262202043
E01031682,1111,554,557,0.49864986498649866,0.5013501350135013
E01031683,1453,716,737,0.4927735719201652,0.5072264280798349
E01031611,2863,1404,1459,0.4903946908836884,0.5096053091163115
E01031612,2106,1036,1070,0.4919278252611586,0.5080721747388414
E01031614,2592,1269,1323,0.4895833333333333,0.5104166666666666
E01031615,1786,855,931,0.4787234042553192,0.5212765957446809
E01035341,1643,798,845,0.48569689592209375,0.5143031040779062
E01035342,1405,708,697,0.5039145907473309,0.49608540925266903
E01031632,1588,816,772,0.5138539042821159,0.48614609571788414
E01031633,1228,627,601,0.510586319218241,0.48941368078175895
E01031634,1315,613,702,0.4661596958174905,0.5338403041825095
E01031635,1324,663,661,0.5007552870090635,0.49924471299093653
E01031621,1707,851,856,0.4985354422964265,0.5014645577035736
E01031623,1709,859,850,0.502633118782914,0.497366881217086
E01031627,1873,892,981,0.4762413240790176,0.5237586759209824
E01031664,1601,801,800,0.5003123048094941,0.49968769519050593
E01031626,1471,712,759,0.4840244731475187,0.5159755268524813
E01031630,1705,779,926,0.45689149560117304,0.543108504398827
E01031631,1679,779,900,0.4639666468135795,0.5360333531864205
E01031662,1552,737,815,0.47487113402061853,0.5251288659793815
E01031663,2236,1067,1169,0.47719141323792486,0.5228085867620751
E01031665,1223,615,608,0.5028618152085037,0.4971381847914963
E01031618,1343,675,668,0.5026061057334326,0.4973938942665674
E01031641,1529,709,820,0.46370176586003925,0.5362982341399608
E01031642,2540,1248,1292,0.49133858267716535,0.5086614173228347
E01031643,1900,872,1028,0.4589473684210526,0.5410526315789473
E01031687,1644,789,855,0.47992700729927007,0.5200729927007299
E01031622,1630,818,812,0.501840490797546,0.498159509202454
E01031624,1709,831,878,0.48624926857811585,0.5137507314218841
E01031625,1952,969,983,0.4964139344262295,0.5035860655737705
E01031628,1887,910,977,0.48224695283518815,0.5177530471648119
E01031629,1540,773,767,0.5019480519480519,0.4980519480519481
E01031616,1634,771,863,0.4718482252141983,0.5281517747858017
E01031617,2377,1155,1222,0.48590660496424065,0.5140933950357593
E01031684,1417,689,728,0.48623853211009177,0.5137614678899083
E01031685,1649,737,912,0.44693753790175866,0.5530624620982414
E01031686,1392,658,734,0.47270114942528735,0.5272988505747126
E01031731,1968,966,1002,0.49085365853658536,0.5091463414634146
E01031732,1809,823,986,0.45494748479823105,0.5450525152017689
E01031733,1733,858,875,0.49509521061742645,0.5049047893825735
E01031734,1556,747,809,0.4800771208226221,0.5199228791773779
E01031741,2195,1097,1098,0.4997722095671982,0.5002277904328019
E01031743,1681,851,830,0.5062462819750149,0.49375371802498513
E01035343,1171,608,563,0.5192143467122118,0.4807856532877882
E01035344,1167,543,624,0.4652956298200514,0.5347043701799485
E01031718,1818,879,939,0.4834983498349835,0.5165016501650165
E01031719,1739,822,917,0.47268545140885565,0.5273145485911443
E01031720,1454,730,724,0.5020632737276479,0.49793672627235214
E01031722,1354,709,645,0.5236336779911374,0.47636632200886264
E01031695,1437,672,765,0.46764091858037576,0.5323590814196242
E01031696,1323,627,696,0.47392290249433106,0.5260770975056689
E01031729,2228,1062,1166,0.47666068222621183,0.5233393177737882
E01031730,1783,861,922,0.482893998878295,0.517106001121705
E01031735,1579,762,817,0.4825839138695377,0.5174160861304623
E01031736,1643,792,851,0.48204503956177724,0.5179549604382228
E01031737,1589,767,822,0.48269351793580867,0.5173064820641913
E01031738,1536,758,778,0.4934895833333333,0.5065104166666666
E01031739,1888,957,931,0.506885593220339,0.493114406779661
E01031740,1304,629,675,0.48236196319018404,0.5176380368098159
E01031721,1932,934,998,0.4834368530020704,0.5165631469979296
E01031723,1623,794,829,0.48921749845964263,0.5107825015403573
E01031724,1291,633,658,0.4903175832687839,0.5096824167312161
E01031725,1487,711,776,0.4781439139206456,0.5218560860793544
E01031694,1878,910,968,0.4845580404685836,0.5154419595314164
E01031764,1376,689,687,0.5007267441860465,0.4992732558139535
E01031765,1583,783,800,0.49463044851547694,0.505369551484523
E01031766,2052,1024,1028,0.49902534113060426,0.5009746588693957
E01031693,1903,936,967,0.49185496584340516,0.5081450341565948
E01031697,1158,584,574,0.5043177892918825,0.49568221070811747
E01031727,1722,858,864,0.49825783972125437,0.5017421602787456
E01035345,1687,824,863,0.4884410195613515,0.5115589804386484
E01035346,1399,659,740,0.4710507505360972,0.5289492494639028
E01031758,1405,688,717,0.4896797153024911,0.5103202846975089
E01031760,1802,863,939,0.47891231964483905,0.521087680355161
E01031772,2058,970,1088,0.4713313896987366,0.5286686103012633
E01031773,1906,905,1001,0.47481636935991606,0.525183630640084
E01031774,2497,1178,1319,0.47176611934321183,0.5282338806567881
E01031775,1814,888,926,0.4895259095920617,0.5104740904079382
E01031751,2616,1297,1319,0.49579510703363916,0.5042048929663608
E01031759,1736,862,874,0.4965437788018433,0.5034562211981567
E01032837,2472,1179,1293,0.47694174757281554,0.5230582524271845
E01032838,1479,704,775,0.4759972954699121,0.5240027045300879
E01032839,1290,664,626,0.5147286821705427,0.48527131782945737
E01035347,1210,608,602,0.5024793388429752,0.4975206611570248
E01035348,1024,500,524,0.48828125,0.51171875
E01031752,1876,910,966,0.48507462686567165,0.5149253731343284
E01031753,1434,677,757,0.4721059972105997,0.5278940027894002
E01031754,1599,767,832,0.4796747967479675,0.5203252032520326
E01031755,1426,700,726,0.4908835904628331,0.5091164095371669
E01031757,1414,653,761,0.4618104667609618,0.5381895332390382
E01031726,1638,748,890,0.45665445665445664,0.5433455433455433
E01031749,1526,747,779,0.4895150720838794,0.5104849279161205
E01031750,1481,715,766,0.48278190411883865,0.5172180958811614
E01031763,2084,1017,1067,0.4880038387715931,0.511996161228407
E01035349,1429,704,725,0.4926522043386984,0.5073477956613016
E01035350,1302,621,681,0.4769585253456221,0.5230414746543779
E01035351,1644,816,828,0.49635036496350365,0.5036496350364964
E01035352,1745,867,878,0.49684813753581664,0.5031518624641834
E01031699,1608,759,849,0.47201492537313433,0.5279850746268657
E01031700,1615,810,805,0.5015479876160991,0.4984520123839009
E01031701,1937,949,988,0.4899328859060403,0.5100671140939598
E01031714,1900,932,968,0.4905263157894737,0.5094736842105263
E01031704,1721,846,875,0.4915746658919233,0.5084253341080767
E01031706,1681,827,854,0.49196906603212376,0.5080309339678762
E01031712,1447,704,743,0.4865238424326192,0.5134761575673807
E01031713,1711,838,873,0.48977206312098187,0.5102279368790181
E01035353,1568,771,797,0.4917091836734694,0.5082908163265306
E01035354,1711,831,880,0.4856808883693746,0.5143191116306254
E01031705,1565,745,820,0.476038338658147,0.5239616613418531
E01031707,1475,726,749,0.4922033898305085,0.5077966101694915
E01031708,1773,890,883,0.5019740552735477,0.49802594472645234
E01031709,1770,852,918,0.48135593220338985,0.5186440677966102
E01031716,1173,558,615,0.47570332480818417,0.5242966751918159
E01031717,1378,670,708,0.4862119013062409,0.5137880986937591
E01031702,1632,784,848,0.4803921568627451,0.5196078431372549
E01031703,1757,804,953,0.45759817871371655,0.5424018212862834
E01031710,1416,663,753,0.4682203389830508,0.5317796610169492
E01031715,1654,824,830,0.49818621523579204,0.501813784764208
E01031698,1772,907,865,0.5118510158013544,0.4881489841986456
E01031767,2278,1088,1190,0.47761194029850745,0.5223880597014925
E01031769,1732,817,915,0.47170900692840645,0.5282909930715936
E01031770,1737,847,890,0.48762233736327,0.51237766263673
E01031771,1560,761,799,0.4878205128205128,0.5121794871794871
E01031744,1768,842,926,0.4762443438914027,0.5237556561085973
E01031745,2060,951,1109,0.4616504854368932,0.5383495145631068
E01031746,1685,816,869,0.48427299703264093,0.5157270029673591
E01031747,1575,721,854,0.4577777777777778,0.5422222222222223
E01031748,1411,705,706,0.49964564138908574,0.5003543586109143
E01031768,1540,721,819,0.4681818181818182,0.5318181818181819
E01031793,1337,647,690,0.4839192221391174,0.5160807778608826
E01031820,1749,859,890,0.4911377930245855,0.5088622069754145
E01031821,1719,822,897,0.4781849912739965,0.5218150087260035
E01031828,1296,645,651,0.4976851851851852,0.5023148148148148
E01031829,1591,785,806,0.49340037712130735,0.5065996228786926
E01031822,1569,767,802,0.4888463989802422,0.5111536010197578
E01031825,1623,798,825,0.49168207024029575,0.5083179297597042
E01031826,1468,720,748,0.4904632152588556,0.5095367847411444
E01031827,1494,719,775,0.48125836680053546,0.5187416331994645
E01031839,1735,844,891,0.48645533141210373,0.5135446685878963
E01031792,1371,644,727,0.4697301239970824,0.5302698760029175
E01031794,1467,694,773,0.4730743012951602,0.5269256987048399
E01031795,1664,771,893,0.46334134615384615,0.5366586538461539
E01031818,1970,926,1044,0.4700507614213198,0.5299492385786801
E01031830,1614,770,844,0.4770755885997522,0.5229244114002478
E01031778,1518,758,760,0.4993412384716733,0.5006587615283268
E01031797,1286,645,641,0.5015552099533437,0.4984447900466563
E01031800,1586,765,821,0.4823455233291299,0.5176544766708702
E01031823,1633,825,808,0.5052051439069197,0.4947948560930802
E01031824,1307,634,673,0.48508033664881406,0.5149196633511859
E01031776,1556,728,828,0.46786632390745503,0.532133676092545
E01031777,1823,880,943,0.4827207899067471,0.5172792100932528
E01031780,1487,721,766,0.48486886348352387,0.5151311365164761
E01031781,1638,789,849,0.4816849816849817,0.5183150183150184
E01031798,1548,794,754,0.5129198966408268,0.4870801033591731
E01031783,1590,763,827,0.479874213836478,0.520125786163522
E01031785,1482,715,767,0.4824561403508772,0.5175438596491229
E01031786,1604,778,826,0.4850374064837905,0.5149625935162094
E01031817,1777,828,949,0.46595385481148,0.53404614518852
E01034826,1856,873,983,0.4703663793103448,0.5296336206896551
E01034827,1877,918,959,0.48907831646244004,0.51092168353756
E01031782,1806,869,937,0.48117386489479513,0.5188261351052049
E01031836,1615,778,837,0.48173374613003095,0.518266253869969
E01031838,1526,733,793,0.4803407601572739,0.5196592398427261
E01031840,1710,815,895,0.4766081871345029,0.5233918128654971
E01034828,1599,780,819,0.4878048780487805,0.5121951219512195
E01034829,1352,693,659,0.5125739644970414,0.4874260355029586
E01031791,2111,1046,1065,0.4954997631454287,0.5045002368545712
E01031796,1584,764,820,0.4823232323232323,0.5176767676767676
E01031799,1653,771,882,0.4664246823956443,0.5335753176043557
E01031801,1714,853,861,0.49766627771295213,0.5023337222870479
E01031837,1881,909,972,0.48325358851674644,0.5167464114832536
E01031779,1291,630,661,0.487993803253292,0.512006196746708
E01031831,1661,764,897,0.4599638771824202,0.5400361228175797
E01031832,1607,763,844,0.4747977598008712,0.5252022401991289
E01031833,1639,802,837,0.48932275777913364,0.5106772422208664
E01031834,1617,785,832,0.48546691403834263,0.5145330859616574
E01031790,1895,899,996,0.47440633245382585,0.5255936675461741
E01031807,1826,856,970,0.4687842278203724,0.5312157721796276
E01031809,1816,888,928,0.4889867841409692,0.5110132158590308
E01031810,1805,902,903,0.4997229916897507,0.5002770083102493
E01031811,1565,752,813,0.4805111821086262,0.5194888178913738
E01031787,2019,977,1042,0.48390292223873205,0.516097077761268
E01031788,2123,1015,1108,0.4780970325011776,0.5219029674988224
E01031808,1734,882,852,0.5086505190311419,0.4913494809688581
E01031835,1899,953,946,0.5018430753027909,0.49815692469720907
E01034830,1202,559,643,0.4650582362728785,0.5349417637271214
E01034831,1207,647,560,0.536039768019884,0.463960231980116
E01031812,1586,749,837,0.47225725094577553,0.5277427490542245
E01031813,1742,850,892,0.48794489092996557,0.5120551090700345
E01031814,1713,830,883,0.4845300642148278,0.5154699357851722
E01031815,1561,738,823,0.4727738629083921,0.5272261370916079
E01031816,1642,773,869,0.4707673568818514,0.5292326431181485
E01031802,1671,764,907,0.4572112507480551,0.542788749251945
E01031803,1567,771,796,0.4920229738353542,0.5079770261646458
E01031804,1731,825,906,0.47660311958405543,0.5233968804159446
E01031805,1648,742,906,0.45024271844660196,0.5497572815533981
E01031806,1789,877,912,0.490217998882057,0.509782001117943
E01014399,2468,1176,1292,0.47649918962722854,0.5235008103727715
E01014400,2625,1282,1343,0.48838095238095236,0.5116190476190476
E01014401,1698,835,863,0.4917550058892815,0.5082449941107184
E01014403,1774,809,965,0.4560315670800451,0.5439684329199549
E01014404,2099,1003,1096,0.4778465936160076,0.5221534063839923
E01035205,1693,794,899,0.4689899586532782,0.5310100413467218
E01035206,1470,735,735,0.5,0.5
E01014395,1282,626,656,0.48829953198127923,0.5117004680187207
E01014396,1513,742,771,0.4904163912756114,0.5095836087243887
E01014397,1323,654,669,0.4943310657596372,0.5056689342403629
E01014398,1656,814,842,0.4915458937198068,0.5084541062801933
E01014409,1611,747,864,0.46368715083798884,0.5363128491620112
E01014410,1786,897,889,0.5022396416573348,0.4977603583426652
E01014411,2178,1068,1110,0.4903581267217631,0.509641873278237
E01014477,1478,724,754,0.489851150202977,0.510148849797023
E01014478,1193,544,649,0.4559932942162615,0.5440067057837384
E01014479,1414,668,746,0.4724186704384724,0.5275813295615276
E01014480,1463,692,771,0.4730006835269993,0.5269993164730007
E01014465,1543,730,813,0.47310434219053793,0.5268956578094621
E01014466,1298,612,686,0.4714946070878274,0.5285053929121726
E01014467,1541,789,752,0.5120051914341337,0.4879948085658663
E01014468,1475,731,744,0.49559322033898306,0.504406779661017
E01014370,1814,951,863,0.5242557883131201,0.4757442116868798
E01014371,1959,976,983,0.49821337417049516,0.5017866258295048
E01014372,1880,926,954,0.4925531914893617,0.5074468085106383
E01014412,1333,654,679,0.490622655663916,0.5093773443360841
E01014413,2485,1157,1328,0.46559356136820923,0.5344064386317907
E01014414,1526,797,729,0.5222804718217562,0.47771952817824376
E01014427,1264,576,688,0.45569620253164556,0.5443037974683544
E01014428,1316,633,683,0.4810030395136778,0.5189969604863222
E01014429,1570,760,810,0.4840764331210191,0.5159235668789809
E01014430,1581,699,882,0.44212523719165087,0.5578747628083491
E01014405,2137,1008,1129,0.471689284043051,0.528310715956949
E01014407,1672,781,891,0.46710526315789475,0.5328947368421053
E01033080,2224,1162,1062,0.5224820143884892,0.47751798561151076
E01014373,1608,782,826,0.486318407960199,0.513681592039801
E01014374,1556,751,805,0.48264781491002573,0.5173521850899743
E01014375,1293,625,668,0.4833720030935808,0.5166279969064191
E01014376,1583,755,828,0.47694251421351863,0.5230574857864814
E01014377,1476,721,755,0.48848238482384826,0.5115176151761518
E01033078,1882,926,956,0.4920297555791711,0.5079702444208289
E01033079,1160,564,596,0.4862068965517241,0.5137931034482759
E01014461,1189,568,621,0.47771236333052985,0.5222876366694701
E01014462,1511,709,802,0.4692256783587028,0.5307743216412971
E01014463,1602,802,800,0.5006242197253433,0.4993757802746567
E01014464,1485,716,769,0.48215488215488217,0.5178451178451179
E01014380,4215,2162,2053,0.5129300118623962,0.48706998813760377
E01014381,1497,745,752,0.49766199064796257,0.5023380093520374
E01014481,1389,705,684,0.5075593952483801,0.4924406047516199
E01014482,1309,663,646,0.5064935064935064,0.4935064935064935
E01014483,1471,727,744,0.49422161794697483,0.5057783820530252
E01014484,1893,968,925,0.5113576333861596,0.4886423666138405
E01014473,1789,905,884,0.5058692006707658,0.4941307993292342
E01014474,1282,611,671,0.4765990639625585,0.5234009360374415
E01014476,1533,761,772,0.4964122635355512,0.5035877364644488
E01035207,1461,725,736,0.49623545516769335,0.5037645448323066
E01035208,2265,1028,1237,0.4538631346578366,0.5461368653421633
E01014435,1693,876,817,0.5174246898995866,0.4825753101004135
E01014436,1582,788,794,0.49810366624525915,0.5018963337547409
E01014437,1433,669,764,0.4668527564549895,0.5331472435450104
E01014438,1271,636,635,0.5003933910306845,0.4996066089693155
E01014455,1352,673,679,0.4977810650887574,0.5022189349112426
E01014456,1504,742,762,0.4933510638297872,0.5066489361702128
E01014457,1411,696,715,0.49326718639262934,0.5067328136073707
E01014458,1376,647,729,0.470203488372093,0.529796511627907
E01014391,1700,829,871,0.48764705882352943,0.5123529411764706
E01014392,1102,541,561,0.4909255898366606,0.5090744101633394
E01014452,1413,690,723,0.4883227176220807,0.5116772823779193
E01014453,1352,657,695,0.4859467455621302,0.5140532544378699
E01014454,1368,656,712,0.47953216374269003,0.52046783625731
E01014459,1508,737,771,0.4887267904509284,0.5112732095490716
E01014460,1130,540,590,0.4778761061946903,0.5221238938053098
E01014415,1956,958,998,0.4897750511247444,0.5102249488752556
E01014416,1744,832,912,0.47706422018348627,0.5229357798165137
E01014417,1843,922,921,0.5002712967986978,0.49972870320130225
E01014387,1679,842,837,0.5014889815366289,0.49851101846337104
E01014388,1292,613,679,0.4744582043343653,0.5255417956656346
E01014389,1949,927,1022,0.47562852744997436,0.5243714725500257
E01014390,1411,679,732,0.481218993621545,0.518781006378455
E01014431,1226,559,667,0.4559543230016313,0.5440456769983687
E01014432,1389,706,683,0.5082793376529877,0.4917206623470122
E01014433,1364,655,709,0.4802052785923754,0.5197947214076246
E01014434,1945,937,1008,0.4817480719794344,0.5182519280205655
E01014385,1461,726,735,0.49691991786447637,0.5030800821355236
E01014386,1213,618,595,0.5094806265457543,0.4905193734542457
E01014419,1517,746,771,0.4917600527356625,0.5082399472643375
E01014446,1201,608,593,0.5062447960033306,0.49375520399666945
E01014447,1992,1003,989,0.5035140562248996,0.4964859437751004
E01014382,2519,1231,1288,0.4886859865025804,0.5113140134974196
E01014383,1146,552,594,0.4816753926701571,0.518324607329843
E01014384,1624,813,811,0.500615763546798,0.49938423645320196
E01014418,1484,729,755,0.4912398921832884,0.5087601078167115
E01014442,1664,774,890,0.4651442307692308,0.5348557692307693
E01014443,1621,797,824,0.49167180752621836,0.5083281924737816
E01014444,1672,827,845,0.4946172248803828,0.5053827751196173
E01014445,1711,844,867,0.49327878433664524,0.5067212156633548
E01035209,1009,493,516,0.4886025768087215,0.5113974231912785
E01035210,2326,1034,1292,0.4445399828030954,0.5554600171969045
E01014393,1344,651,693,0.484375,0.515625
E01014394,1747,856,891,0.4899828277046365,0.5100171722953635
E01014439,1826,849,977,0.4649507119386637,0.5350492880613362
E01014440,2582,1326,1256,0.5135553834237025,0.48644461657629745
E01014441,2095,998,1097,0.4763723150357995,0.5236276849642004
E01014448,1477,724,753,0.4901828029790115,0.5098171970209885
E01014449,1464,719,745,0.491120218579235,0.5088797814207651
E01014450,1467,730,737,0.49761417859577367,0.5023858214042263
E01014451,1743,845,898,0.48479632816982215,0.5152036718301779
E01014420,1485,725,760,0.4882154882154882,0.5117845117845118
E01014421,1519,742,777,0.48847926267281105,0.511520737327189
E01014422,1712,850,862,0.49649532710280375,0.5035046728971962
E01014423,1499,746,753,0.49766511007338227,0.5023348899266178
E01014469,1382,680,702,0.492040520984081,0.507959479015919
E01014470,1713,828,885,0.48336252189141854,0.5166374781085814
E01014471,1573,790,783,0.5022250476795931,0.49777495232040686
E01014472,1875,925,950,0.49333333333333335,0.5066666666666667
E01014424,2181,1064,1117,0.4878496102705181,0.5121503897294819
E01014425,2341,1151,1190,0.4916702263989748,0.5083297736010252
E01014426,1458,729,729,0.5,0.5
E01014601,1860,909,951,0.48870967741935484,0.5112903225806451
E01014602,1969,959,1010,0.48704926358557643,0.5129507364144236
E01014603,2610,1301,1309,0.4984674329501916,0.5015325670498084
E01014605,1835,916,919,0.4991825613079019,0.500817438692098
E01032516,1986,965,1021,0.48590130916414903,0.5140986908358509
E01032517,1836,883,953,0.4809368191721133,0.5190631808278867
E01014688,1890,940,950,0.4973544973544973,0.5026455026455027
E01014689,1649,795,854,0.48211036992116435,0.5178896300788357
E01014690,2257,1131,1126,0.5011076650420913,0.49889233495790875
E01014691,2006,954,1052,0.47557328015952144,0.5244267198404786
E01014692,1748,907,841,0.5188787185354691,0.48112128146453087
E01014693,1399,683,716,0.4882058613295211,0.511794138670479
E01014694,1720,868,852,0.5046511627906977,0.49534883720930234
E01014497,1738,856,882,0.49252013808975836,0.5074798619102416
E01014498,1701,815,886,0.479129923574368,0.520870076425632
E01014638,1810,873,937,0.4823204419889503,0.5176795580110497
E01014639,1585,754,831,0.4757097791798107,0.5242902208201893
E01014640,1673,843,830,0.5038852361028093,0.49611476389719067
E01014631,1229,631,598,0.5134255492270138,0.48657445077298617
E01014632,2203,1123,1080,0.5097594189741262,0.4902405810258738
E01014633,1871,937,934,0.5008017103153394,0.4991982896846606
E01014636,1562,751,811,0.48079385403329067,0.5192061459667093
E01014630,2234,1130,1104,0.5058191584601611,0.4941808415398389
E01014634,1859,1005,854,0.5406132329209252,0.4593867670790748
E01014659,2181,1116,1065,0.5116918844566712,0.48830811554332876
E01014661,1772,884,888,0.49887133182844245,0.5011286681715575
E01014616,1549,709,840,0.45771465461588123,0.5422853453841188
E01014719,1448,724,724,0.5,0.5
E01014720,1637,779,858,0.4758704948075748,0.5241295051924252
E01014721,1676,751,925,0.448090692124105,0.551909307875895
E01014641,1526,737,789,0.4829619921363041,0.5170380078636959
E01014642,1525,739,786,0.4845901639344262,0.5154098360655738
E01014643,1466,707,759,0.48226466575716237,0.5177353342428377
E01014644,1704,837,867,0.49119718309859156,0.5088028169014085
E01014492,1670,802,868,0.4802395209580838,0.5197604790419161
E01014493,1597,784,813,0.49092047589229804,0.509079524107702
E01014494,1577,773,804,0.4901712111604312,0.5098287888395688
E01014495,1761,883,878,0.501419647927314,0.498580352072686
E01014496,1948,1036,912,0.5318275154004107,0.4681724845995893
E01014499,1698,835,863,0.4917550058892815,0.5082449941107184
E01014715,1703,826,877,0.48502642395772166,0.5149735760422783
E01014716,1563,749,814,0.47920665387076133,0.5207933461292387
E01014717,1691,737,954,0.4358367829686576,0.5641632170313424
E01014718,1525,741,784,0.4859016393442623,0.5140983606557377
E01014510,2129,1095,1034,0.5143259746359793,0.48567402536402066
E01014635,1993,999,994,0.5012543903662819,0.498745609633718
E01014637,1644,826,818,0.5024330900243309,0.4975669099756691
E01014662,1722,881,841,0.5116144018583043,0.4883855981416957
E01014615,1571,780,791,0.49649904519414384,0.5035009548058561
E01014617,1407,708,699,0.5031982942430704,0.4968017057569296
E01014618,1623,773,850,0.4762784966112138,0.5237215033887862
E01014620,1645,783,862,0.47598784194528876,0.5240121580547112
E01014571,1725,838,887,0.48579710144927535,0.5142028985507247
E01014577,1651,838,813,0.5075711689884919,0.4924288310115082
E01014586,1553,755,798,0.4861558274307791,0.5138441725692209
E01014587,1749,794,955,0.4539736992567181,0.5460263007432818
E01014588,2350,1195,1155,0.5085106382978724,0.49148936170212765
E01014589,1634,792,842,0.4847001223990208,0.5152998776009792
E01014590,2360,1155,1205,0.4894067796610169,0.510593220338983
E01014591,1944,959,985,0.4933127572016461,0.5066872427983539
E01014592,1722,844,878,0.4901277584204414,0.5098722415795587
E01014660,2222,1094,1128,0.49234923492349236,0.5076507650765076
E01014663,1578,746,832,0.47275031685678076,0.5272496831432193
E01014664,1720,876,844,0.5093023255813953,0.4906976744186046
E01014665,2200,1110,1090,0.5045454545454545,0.4954545454545455
E01014709,1276,622,654,0.48746081504702193,0.512539184952978
E01014710,1590,798,792,0.5018867924528302,0.4981132075471698
E01014711,1326,631,695,0.475867269984917,0.524132730015083
E01014712,1277,614,663,0.480814408770556,0.519185591229444
E01014713,1326,643,683,0.48491704374057315,0.5150829562594268
E01014714,3461,1695,1766,0.4897428488876047,0.5102571511123952
E01014507,1892,953,939,0.5036997885835095,0.4963002114164905
E01014508,1679,870,809,0.5181655747468732,0.48183442525312686
E01014509,2600,1310,1290,0.5038461538461538,0.49615384615384617
E01014511,1433,690,743,0.48150732728541523,0.5184926727145848
E01014512,1542,753,789,0.4883268482490272,0.5116731517509727
E01014513,1662,810,852,0.48736462093862815,0.5126353790613718
E01014514,2406,1318,1088,0.5477971737323358,0.45220282626766417
E01014619,1464,701,763,0.47882513661202186,0.5211748633879781
E01014621,1557,765,792,0.4913294797687861,0.5086705202312138
E01014666,1926,949,977,0.49273104880581514,0.5072689511941848
E01014667,1709,837,872,0.4897600936220012,0.5102399063779989
E01014672,2113,1047,1066,0.4955040227165168,0.5044959772834832
E01014624,1745,854,891,0.48939828080229225,0.5106017191977077
E01014629,1581,792,789,0.5009487666034156,0.4990512333965844
E01032518,2099,1012,1087,0.4821343496903287,0.5178656503096712
E01032519,1265,599,666,0.4735177865612648,0.5264822134387351
E01014572,2046,1089,957,0.532258064516129,0.46774193548387094
E01014573,2024,1022,1002,0.5049407114624506,0.4950592885375494
E01014575,1613,818,795,0.5071295722256665,0.49287042777433354
E01014576,2247,1130,1117,0.5028927458834,0.4971072541165999
E01014487,1986,1023,963,0.5151057401812689,0.48489425981873113
E01014491,2071,1037,1034,0.5007242877836794,0.4992757122163206
E01014668,1601,787,814,0.4915677701436602,0.5084322298563397
E01014669,1595,788,807,0.49404388714733544,0.5059561128526646
E01014670,1513,791,722,0.5228023793787178,0.47719762062128224
E01014671,1710,855,855,0.5,0.5
E01014622,1752,898,854,0.5125570776255708,0.4874429223744292
E01014623,1785,900,885,0.5042016806722689,0.4957983193277311
E01014626,2714,1367,1347,0.5036845983787767,0.4963154016212233
E01014627,2196,1099,1097,0.5004553734061931,0.49954462659380694
E01014557,1684,831,853,0.49346793349168644,0.5065320665083135
E01014558,1812,894,918,0.49337748344370863,0.5066225165562914
E01014559,1934,932,1002,0.48190279214064113,0.5180972078593589
E01014560,1659,812,847,0.48945147679324896,0.510548523206751
E01014562,1696,760,936,0.4481132075471698,0.5518867924528302
E01014539,1870,940,930,0.5026737967914439,0.49732620320855614
E01014561,1667,819,848,0.4913017396520696,0.5086982603479304
E01014563,1790,894,896,0.4994413407821229,0.5005586592178771
E01033342,1975,1026,949,0.5194936708860759,0.48050632911392405
E01033367,1379,771,608,0.5591007976794778,0.4408992023205221
E01014551,1803,861,942,0.47753743760399336,0.5224625623960066
E01014552,1847,917,930,0.4964807796426638,0.5035192203573362
E01014553,1913,929,984,0.4856246732880293,0.5143753267119707
E01014554,1787,877,910,0.49076664801343034,0.5092333519865697
E01014556,1791,898,893,0.5013958682300391,0.49860413176996093
E01014673,1866,923,943,0.4946409431939979,0.5053590568060021
E01014674,1708,826,882,0.48360655737704916,0.5163934426229508
E01014675,1787,912,875,0.51035254616676,0.48964745383324004
E01014676,1579,768,811,0.4863837872070931,0.5136162127929069
E01014682,1727,843,884,0.4881297046902142,0.5118702953097858
E01014683,1881,971,910,0.5162147793726741,0.4837852206273259
E01014685,1701,821,880,0.4826572604350382,0.5173427395649618
E01014686,1894,921,973,0.48627243928194297,0.513727560718057
E01014687,1593,794,799,0.49843063402385435,0.5015693659761457
E01014565,1763,911,852,0.5167328417470222,0.4832671582529779
E01014566,1698,893,805,0.5259128386336867,0.4740871613663133
E01014567,1936,1004,932,0.518595041322314,0.48140495867768596
E01014681,2523,1202,1321,0.4764169639318272,0.5235830360681728
E01014684,1938,948,990,0.4891640866873065,0.5108359133126935
E01014544,1135,572,563,0.5039647577092511,0.4960352422907489
E01014545,1871,974,897,0.5205772314270444,0.4794227685729556
E01014546,1545,757,788,0.4899676375404531,0.510032362459547
E01014547,1658,821,837,0.4951749095295537,0.5048250904704463
E01014677,1563,794,769,0.5079974408189379,0.49200255918106206
E01014678,1679,854,825,0.5086360929124479,0.4913639070875521
E01014679,1592,799,793,0.5018844221105527,0.4981155778894472
E01014680,1301,639,662,0.49116064565718676,0.5088393543428132
E01014548,1656,826,830,0.49879227053140096,0.501207729468599
E01014549,1166,568,598,0.48713550600343053,0.5128644939965694
E01014550,2217,1093,1124,0.4930085701398286,0.5069914298601714
E01014555,1885,882,1003,0.4679045092838196,0.5320954907161803
E01014528,1590,776,814,0.4880503144654088,0.5119496855345912
E01014529,1487,714,773,0.4801613987895091,0.519838601210491
E01014530,1481,750,731,0.5064145847400405,0.49358541525995947
E01014531,2135,1062,1073,0.497423887587822,0.502576112412178
E01014532,1475,708,767,0.48,0.52
E01014537,1826,903,923,0.4945235487404162,0.5054764512595837
E01014695,2083,1087,996,0.5218434949591935,0.47815650504080653
E01014696,1859,908,951,0.48843464228079614,0.5115653577192039
E01014698,1965,966,999,0.4916030534351145,0.5083969465648855
E01014699,1648,781,867,0.47390776699029125,0.5260922330097088
E01014700,1680,851,829,0.506547619047619,0.493452380952381
E01014701,1890,981,909,0.5190476190476191,0.48095238095238096
E01014730,1666,883,783,0.5300120048019208,0.4699879951980792
E01014731,1608,808,800,0.5024875621890548,0.4975124378109453
E01014732,1740,892,848,0.5126436781609195,0.48735632183908045
E01014735,1817,906,911,0.49862410566868465,0.5013758943313154
E01014523,1670,860,810,0.5149700598802395,0.48502994011976047
E01014524,1617,807,810,0.49907235621521334,0.5009276437847866
E01014525,1656,813,843,0.49094202898550726,0.5090579710144928
E01014526,1605,799,806,0.49781931464174456,0.5021806853582554
E01014527,1375,692,683,0.5032727272727273,0.49672727272727274
E01014500,1864,945,919,0.5069742489270386,0.49302575107296137
E01014502,2062,1045,1017,0.5067895247332687,0.49321047526673134
E01033359,1686,941,745,0.5581257413997628,0.44187425860023727
E01033361,1500,757,743,0.5046666666666667,0.49533333333333335
E01033362,1298,665,633,0.512326656394453,0.487673343605547
E01033364,1777,940,837,0.5289814293753518,0.4710185706246483
E01014729,1842,907,935,0.49239956568946797,0.507600434310532
E01014733,1830,929,901,0.5076502732240438,0.4923497267759563
E01014734,1708,849,859,0.4970725995316159,0.502927400468384
E01014736,2204,1092,1112,0.4954627949183303,0.5045372050816697
E01014501,2131,1021,1110,0.4791177850774284,0.5208822149225716
E01014504,1615,783,832,0.4848297213622291,0.5151702786377709
E01014505,1835,879,956,0.4790190735694823,0.5209809264305177
E01014506,1642,811,831,0.4939098660170524,0.5060901339829477
E01014645,1639,805,834,0.49115314215985356,0.5088468578401464
E01014646,1766,888,878,0.5028312570781427,0.4971687429218573
E01014648,1708,857,851,0.5017564402810304,0.49824355971896955
E01014649,1769,893,876,0.5048049745618994,0.4951950254381006
E01014651,1757,873,884,0.4968696642003415,0.5031303357996585
E01014533,1614,810,804,0.5018587360594795,0.49814126394052044
E01014534,1676,854,822,0.5095465393794749,0.4904534606205251
E01014535,2005,972,1033,0.48478802992518705,0.515211970074813
E01014536,1609,771,838,0.4791796146674953,0.5208203853325046
E01014578,1861,894,967,0.48038688876947877,0.5196131112305212
E01014583,1787,851,936,0.4762171236709569,0.5237828763290431
E01014585,1998,941,1057,0.47097097097097096,0.529029029029029
E01014647,1805,871,934,0.4825484764542936,0.5174515235457063
E01014650,1679,843,836,0.5020845741512805,0.49791542584871945
E01014579,1563,782,781,0.5003198976327575,0.4996801023672425
E01014580,1571,738,833,0.4697644812221515,0.5302355187778485
E01014581,1634,778,856,0.47613219094247244,0.5238678090575275
E01014582,1403,695,708,0.4953670705630791,0.5046329294369208
E01014584,1518,730,788,0.48089591567852435,0.5191040843214756
E01014518,1780,907,873,0.5095505617977528,0.4904494382022472
E01014519,1392,661,731,0.47485632183908044,0.5251436781609196
E01014520,1652,792,860,0.4794188861985472,0.5205811138014528
E01014521,1394,676,718,0.48493543758967,0.5150645624103299
E01014607,1676,779,897,0.4647971360381862,0.5352028639618138
E01014608,1809,859,950,0.4748479823106689,0.5251520176893312
E01014609,1852,905,947,0.4886609071274298,0.5113390928725702
E01014610,1565,771,794,0.4926517571884984,0.5073482428115016
E01014613,1566,772,794,0.4929757343550447,0.5070242656449553
E01014614,1394,697,697,0.5,0.5
E01014594,1722,790,932,0.45876887340301975,0.5412311265969802
E01014598,2200,1123,1077,0.5104545454545455,0.48954545454545456
E01014599,1313,654,659,0.49809596344249807,0.5019040365575019
E01014600,1501,697,804,0.4643570952698201,0.5356429047301798
E01014702,1483,711,772,0.4794335805799056,0.5205664194200944
E01014703,1496,706,790,0.47192513368983957,0.5280748663101604
E01014704,1855,910,945,0.49056603773584906,0.5094339622641509
E01014705,1364,682,682,0.5,0.5
E01014706,1364,643,721,0.4714076246334311,0.5285923753665689
E01014707,1624,807,817,0.49692118226600984,0.5030788177339901
E01014708,1899,905,994,0.4765666140073723,0.5234333859926277
E01014515,1546,758,788,0.49029754204398446,0.5097024579560155
E01014516,1478,708,770,0.4790257104194858,0.5209742895805142
E01014517,1371,631,740,0.4602479941648432,0.5397520058351568
E01014522,1871,904,967,0.4831640833778728,0.5168359166221272
E01014593,1554,724,830,0.46589446589446587,0.5341055341055341
E01014595,1392,674,718,0.48419540229885055,0.5158045977011494
E01014596,1628,769,859,0.47235872235872234,0.5276412776412777
E01014597,1392,693,699,0.4978448275862069,0.5021551724137931
E01014611,1388,681,707,0.49063400576368876,0.5093659942363112
E01014612,1502,712,790,0.474034620505992,0.525965379494008
E01014722,1549,769,780,0.4964493221433183,0.5035506778566817
E01014723,1379,686,693,0.49746192893401014,0.5025380710659898
E01014725,1462,731,731,0.5,0.5
E01014726,1724,809,915,0.46925754060324826,0.5307424593967517
E01014727,1566,707,859,0.45146871008939976,0.5485312899106003
E01032514,2137,986,1151,0.4613944782405241,0.5386055217594758
E01032515,1981,957,1024,0.48308934881373045,0.5169106511862696
E01033352,1744,958,786,0.5493119266055045,0.4506880733944954
E01033353,2012,1096,916,0.5447316103379721,0.4552683896620278
E01033358,2561,1365,1196,0.5329949238578681,0.467005076142132
E01033370,1356,701,655,0.5169616519174042,0.4830383480825959
E01033902,1291,726,565,0.5623547637490317,0.43764523625096824
E01033903,1144,586,558,0.5122377622377622,0.48776223776223776
E01014564,1920,968,952,0.5041666666666667,0.49583333333333335
E01014653,2774,1410,1364,0.5082912761355444,0.49170872386445563
E01014655,2584,1348,1236,0.521671826625387,0.47832817337461303
E01014654,2535,1305,1230,0.514792899408284,0.48520710059171596
E01014658,2510,1244,1266,0.4956175298804781,0.5043824701195219
E01033356,1726,860,866,0.4982618771726535,0.5017381228273464
E01033369,1458,713,745,0.4890260631001372,0.5109739368998628
E01014568,2589,1319,1270,0.5094631131711085,0.49053688682889146
E01014569,2266,1120,1146,0.4942630185348632,0.5057369814651368
E01014570,1991,977,1014,0.49070818684078354,0.5092918131592165
E01014574,2319,1178,1141,0.5079775765416128,0.49202242345838726
E01014485,1966,949,1017,0.482706002034588,0.517293997965412
E01014486,2689,1376,1313,0.5117143919672741,0.4882856080327259
E01014488,2032,1057,975,0.5201771653543307,0.47982283464566927
E01014489,2575,1302,1273,0.5056310679611651,0.494368932038835
E01033347,2212,1185,1027,0.5357142857142857,0.4642857142857143
E01033348,1189,617,572,0.5189234650967199,0.48107653490328006
E01033366,1572,739,833,0.47010178117048346,0.5298982188295165
E01014538,1806,912,894,0.5049833887043189,0.4950166112956811
E01033344,1836,926,910,0.5043572984749455,0.49564270152505446
E01033904,2386,1209,1177,0.5067057837384744,0.4932942162615256
E01033905,1382,714,668,0.516642547033285,0.4833574529667149
E01033906,1126,590,536,0.5239786856127886,0.47602131438721135
E01033350,1192,647,545,0.5427852348993288,0.45721476510067116
E01033907,1812,961,851,0.5303532008830022,0.4696467991169978
E01033908,1489,776,713,0.5211551376762928,0.4788448623237072
E01033909,2149,1039,1110,0.48348068869241506,0.5165193113075849
E01033910,1379,684,695,0.4960116026105874,0.5039883973894126
E01014790,1572,759,813,0.48282442748091603,0.517175572519084
E01014795,1477,731,746,0.4949221394719025,0.5050778605280974
E01014797,1814,885,929,0.48787210584343993,0.5121278941565601
E01032675,1609,799,810,0.49658172778123055,0.5034182722187694
E01032676,2000,993,1007,0.4965,0.5035
E01032681,1310,610,700,0.46564885496183206,0.5343511450381679
E01014789,1363,666,697,0.4886280264123258,0.5113719735876743
E01014793,1525,755,770,0.49508196721311476,0.5049180327868853
E01014794,1766,866,900,0.49037372593431483,0.5096262740656852
E01014798,1487,721,766,0.48486886348352387,0.5151311365164761
E01014792,1816,846,970,0.4658590308370044,0.5341409691629956
E01014796,1787,868,919,0.48573027420257414,0.5142697257974258
E01032677,1946,920,1026,0.4727646454265159,0.527235354573484
E01032678,1584,766,818,0.48358585858585856,0.5164141414141414
E01032682,1049,478,571,0.45567206863679693,0.544327931363203
E01014766,1432,723,709,0.5048882681564246,0.49511173184357543
E01014767,1363,672,691,0.4930300807043287,0.5069699192956714
E01014786,1684,868,816,0.5154394299287411,0.4845605700712589
E01014787,1907,929,978,0.4871525957000524,0.5128474042999476
E01014752,1619,769,850,0.4749845583693638,0.5250154416306362
E01014754,1331,622,709,0.4673178061607814,0.5326821938392187
E01014758,1275,589,686,0.4619607843137255,0.5380392156862746
E01014759,1453,713,740,0.4907088781830695,0.5092911218169305
E01014849,1809,887,922,0.49032614704256494,0.5096738529574351
E01014850,2172,1081,1091,0.4976979742173112,0.5023020257826888
E01014851,2674,1267,1407,0.4738219895287958,0.5261780104712042
E01014852,1653,798,855,0.4827586206896552,0.5172413793103449
E01032680,1903,946,957,0.49710982658959535,0.5028901734104047
E01035211,1333,654,679,0.490622655663916,0.5093773443360841
E01035212,1819,904,915,0.49697636063771305,0.503023639362287
E01014750,1704,819,885,0.48063380281690143,0.5193661971830986
E01014751,1585,759,826,0.4788643533123028,0.5211356466876972
E01014753,1922,902,1020,0.46930280957336107,0.5306971904266389
E01014755,1367,637,730,0.46598390636430137,0.5340160936356986
E01014760,1454,699,755,0.48074277854195324,0.5192572214580468
E01014780,1622,770,852,0.4747225647348952,0.5252774352651048
E01014781,1731,782,949,0.4517619872905835,0.5482380127094165
E01014782,1348,670,678,0.4970326409495549,0.5029673590504451
E01014783,1540,755,785,0.4902597402597403,0.5097402597402597
E01014784,1630,758,872,0.46503067484662575,0.5349693251533743
E01014785,1376,687,689,0.4992732558139535,0.5007267441860465
E01014775,1211,600,611,0.495458298926507,0.5045417010734929
E01014776,1216,602,614,0.49506578947368424,0.5049342105263158
E01014777,1472,718,754,0.48777173913043476,0.5122282608695652
E01014778,1279,633,646,0.4949179046129789,0.5050820953870211
E01014779,1112,539,573,0.4847122302158273,0.5152877697841727
E01014756,1531,729,802,0.4761593729588504,0.5238406270411495
E01014757,1419,668,751,0.47075405214940097,0.529245947850599
E01014761,1527,717,810,0.46954813359528486,0.5304518664047151
E01014762,1474,707,767,0.4796472184531886,0.5203527815468114
E01014763,1742,828,914,0.4753157290470723,0.5246842709529277
E01014737,1607,775,832,0.48226509023024267,0.5177349097697573
E01014738,1522,741,781,0.4868593955321945,0.5131406044678055
E01014739,1584,761,823,0.48042929292929293,0.5195707070707071
E01014740,1484,750,734,0.5053908355795148,0.4946091644204852
E01014855,1455,727,728,0.49965635738831615,0.5003436426116838
E01014856,2167,1076,1091,0.49653899400092294,0.5034610059990771
E01014857,1497,733,764,0.48964595858383436,0.5103540414161657
E01014858,1732,852,880,0.49191685912240185,0.5080831408775982
E01014859,1500,697,803,0.4646666666666667,0.5353333333333333
E01014860,1495,723,772,0.4836120401337793,0.5163879598662208
E01014847,1812,886,926,0.488962472406181,0.5110375275938189
E01014848,1399,704,695,0.503216583273767,0.496783416726233
E01014853,1708,824,884,0.48243559718969553,0.5175644028103045
E01014854,1410,691,719,0.4900709219858156,0.5099290780141844
E01014764,1835,854,981,0.4653950953678474,0.5346049046321526
E01014765,1889,864,1025,0.45738485971413445,0.5426151402858655
E01014773,1767,880,887,0.4980192416525184,0.5019807583474816
E01014774,1870,918,952,0.4909090909090909,0.509090909090909
E01014821,1130,531,599,0.46991150442477875,0.5300884955752212
E01014822,1402,693,709,0.4942938659058488,0.5057061340941512
E01014823,1261,635,626,0.5035685963521015,0.4964314036478985
E01014824,1442,703,739,0.48751733703190014,0.5124826629680999
E01014825,1221,617,604,0.5053235053235053,0.49467649467649466
E01014826,1468,719,749,0.48978201634877383,0.5102179836512262
E01014827,1363,662,701,0.4856933235509905,0.5143066764490095
E01014817,1571,759,812,0.48313176320814766,0.5168682367918523
E01014820,1476,693,783,0.4695121951219512,0.5304878048780488
E01014835,1403,658,745,0.4689950106913756,0.5310049893086244
E01014836,1440,680,760,0.4722222222222222,0.5277777777777778
E01014838,1393,683,710,0.49030868628858576,0.5096913137114142
E01014840,1377,680,697,0.49382716049382713,0.5061728395061729
E01014812,1419,694,725,0.48907681465821,0.51092318534179
E01014813,1805,874,931,0.4842105263157895,0.5157894736842106
E01014815,1378,678,700,0.49201741654571846,0.5079825834542816
E01014816,1482,723,759,0.48785425101214575,0.5121457489878543
E01014818,1757,874,883,0.4974388161639158,0.5025611838360843
E01014819,1552,748,804,0.48195876288659795,0.5180412371134021
E01014841,1758,936,822,0.5324232081911263,0.46757679180887374
E01014842,1595,798,797,0.5003134796238244,0.49968652037617556
E01014843,1461,658,803,0.45037645448323066,0.5496235455167693
E01014844,1462,746,716,0.5102599179206566,0.4897400820793434
E01014845,1298,606,692,0.46687211093990755,0.5331278890600925
E01014846,1466,732,734,0.49931787175989084,0.5006821282401092
E01014799,1758,895,863,0.5091012514220705,0.4908987485779295
E01014800,1805,925,880,0.5124653739612188,0.48753462603878117
E01014801,1632,823,809,0.5042892156862745,0.4957107843137255
E01014802,1644,813,831,0.49452554744525545,0.5054744525547445
E01014809,2032,1033,999,0.5083661417322834,0.49163385826771655
E01014811,1800,849,951,0.4716666666666667,0.5283333333333333
E01014829,1965,934,1031,0.4753180661577608,0.5246819338422392
E01014830,1487,732,755,0.49226630800269,0.50773369199731
E01014831,1373,653,720,0.47560087399854334,0.5243991260014567
E01014832,1543,761,782,0.4931950745301361,0.5068049254698639
E01014833,1498,689,809,0.45994659546061417,0.5400534045393859
E01014804,1447,686,761,0.47408431237042153,0.5259156876295784
E01014806,1687,801,886,0.4748073503260225,0.5251926496739775
E01014807,1597,783,814,0.49029430181590483,0.5097056981840952
E01014808,1396,695,701,0.4978510028653295,0.5021489971346705
E01014744,1465,726,739,0.4955631399317406,0.5044368600682594
E01014746,1574,740,834,0.4701397712833545,0.5298602287166455
E01014770,1347,652,695,0.4840386043058649,0.5159613956941351
E01014771,1390,674,716,0.4848920863309353,0.5151079136690647
E01014772,1427,706,721,0.49474421864050455,0.5052557813594954
E01035213,1913,941,972,0.49189754312598016,0.5081024568740199
E01035214,1694,840,854,0.49586776859504134,0.5041322314049587
E01014741,1509,701,808,0.464546056991385,0.5354539430086149
E01014742,1517,772,745,0.5088991430454846,0.4911008569545155
E01014745,1727,837,890,0.4846554719166184,0.5153445280833816
E01014747,1457,707,750,0.4852436513383665,0.5147563486616334
E01014748,1395,652,743,0.46738351254480287,0.5326164874551972
E01014749,1440,713,727,0.4951388888888889,0.5048611111111111
E01014803,1464,717,747,0.48975409836065575,0.5102459016393442
E01014805,1609,777,832,0.4829086389061529,0.5170913610938471
E01014828,1506,736,770,0.48871181938911024,0.5112881806108898
E01014834,1382,630,752,0.4558610709117221,0.5441389290882779
E01014839,1581,759,822,0.48007590132827327,0.5199240986717267
E01032666,1300,619,681,0.47615384615384615,0.5238461538461539
E01032667,1157,557,600,0.4814174589455488,0.5185825410544511
E01032668,1494,738,756,0.4939759036144578,0.5060240963855421
E01032672,2763,1333,1430,0.4824466159971046,0.5175533840028954
E01032673,1343,628,715,0.4676098287416232,0.5323901712583767
E01032669,1481,749,732,0.5057393652937204,0.49426063470627957
E01032670,1755,874,881,0.498005698005698,0.501994301994302
E01032671,1316,645,671,0.49012158054711247,0.5098784194528876
E01032679,1182,562,620,0.4754653130287648,0.5245346869712352
E01035215,1474,723,751,0.49050203527815467,0.5094979647218453
E01035216,2500,1234,1266,0.4936,0.5064
E01014985,1307,642,665,0.4912012241775057,0.5087987758224942
E01014986,1680,773,907,0.4601190476190476,0.5398809523809524
E01014987,2459,1205,1254,0.49003660024400164,0.5099633997559984
E01014988,1734,845,889,0.4873125720876586,0.5126874279123415
E01014989,2260,1004,1256,0.44424778761061945,0.5557522123893806
E01014990,1458,724,734,0.49657064471879286,0.5034293552812071
E01014991,2195,1015,1180,0.4624145785876993,0.5375854214123007
E01014992,1432,720,712,0.5027932960893855,0.4972067039106145
E01014993,1636,804,832,0.49144254278728605,0.508557457212714
E01014884,2063,1291,772,0.6257876878332526,0.37421231216674744
E01014885,2346,1158,1188,0.4936061381074169,0.5063938618925832
E01014929,2262,1104,1158,0.4880636604774536,0.5119363395225465
E01014930,2085,983,1102,0.471462829736211,0.528537170263789
E01014863,1516,729,787,0.4808707124010554,0.5191292875989446
E01014864,1528,772,756,0.5052356020942408,0.49476439790575916
E01014962,1748,858,890,0.49084668192219677,0.5091533180778032
E01014963,1890,946,944,0.5005291005291005,0.49947089947089945
E01014861,2353,1162,1191,0.49383765405864855,0.5061623459413515
E01014862,2937,1455,1482,0.49540347293156284,0.5045965270684372
E01014953,2060,1028,1032,0.49902912621359224,0.5009708737864078
E01014954,1548,800,748,0.5167958656330749,0.48320413436692505
E01015014,2999,1479,1520,0.49316438812937646,0.5068356118706235
E01015015,1586,802,784,0.5056746532156369,0.4943253467843632
E01015016,1117,556,561,0.4977618621307073,0.5022381378692927
E01015017,1422,679,743,0.47749648382559773,0.5225035161744023
E01015018,1488,719,769,0.4831989247311828,0.5168010752688172
E01015019,1636,786,850,0.480440097799511,0.519559902200489
E01015020,1571,767,804,0.48822406110757477,0.5117759388924252
E01015021,1508,751,757,0.4980106100795756,0.5019893899204244
E01015022,1587,770,817,0.48519218651543794,0.5148078134845621
E01014886,1790,849,941,0.47430167597765366,0.5256983240223464
E01014887,1397,661,736,0.47315676449534716,0.5268432355046528
E01014888,1861,870,991,0.4674905964535196,0.5325094035464804
E01014889,1457,729,728,0.5003431708991077,0.49965682910089226
E01014872,1558,788,770,0.5057766367137355,0.4942233632862644
E01014874,1452,752,700,0.5179063360881543,0.4820936639118457
E01014876,1735,869,866,0.500864553314121,0.49913544668587895
E01014877,1591,806,785,0.5065996228786926,0.49340037712130735
E01014879,1748,907,841,0.5188787185354691,0.48112128146453087
E01014881,1946,959,987,0.49280575539568344,0.5071942446043165
E01015009,1375,687,688,0.49963636363636366,0.5003636363636363
E01015010,1369,677,692,0.49452154857560265,0.5054784514243974
E01015011,1782,865,917,0.48540965207631875,0.5145903479236813
E01015012,1784,858,926,0.48094170403587444,0.5190582959641256
E01015013,1321,662,659,0.5011355034065103,0.4988644965934898
E01014873,1397,698,699,0.49964209019327127,0.5003579098067287
E01014875,1776,901,875,0.5073198198198198,0.49268018018018017
E01014878,2152,1078,1074,0.5009293680297398,0.49907063197026025
E01014880,1970,972,998,0.4934010152284264,0.5065989847715736
E01014882,2137,1063,1074,0.49742629854936826,0.5025737014506317
E01014883,1229,609,620,0.4955248169243287,0.5044751830756713
E01014911,1486,728,758,0.4899057873485868,0.5100942126514132
E01014912,1827,957,870,0.5238095238095238,0.47619047619047616
E01014913,1669,829,840,0.49670461354104256,0.5032953864589574
E01014914,2182,1063,1119,0.48716773602199814,0.5128322639780019
E01014892,1795,890,905,0.4958217270194986,0.5041782729805014
E01014893,1472,731,741,0.49660326086956524,0.5033967391304348
E01014894,1205,612,593,0.5078838174273859,0.4921161825726141
E01014895,1411,676,735,0.47909284195605956,0.5209071580439405
E01014896,1300,647,653,0.4976923076923077,0.5023076923076923
E01014979,1494,735,759,0.4919678714859438,0.5080321285140562
E01014980,1531,754,777,0.4924885695623775,0.5075114304376225
E01014982,1457,751,706,0.515442690459849,0.48455730954015097
E01014983,1518,739,779,0.4868247694334651,0.5131752305665349
E01014984,1531,758,773,0.4951012410189419,0.5048987589810582
E01014998,1561,734,827,0.47021140294682895,0.529788597053171
E01014999,1627,805,822,0.4947756607252612,0.5052243392747388
E01015000,1631,796,835,0.4880441446965052,0.5119558553034947
E01015001,1587,765,822,0.4820415879017013,0.5179584120982986
E01014904,1564,821,743,0.5249360613810742,0.4750639386189258
E01014905,1693,921,772,0.5440047253396337,0.4559952746603662
E01014906,1748,846,902,0.4839816933638444,0.5160183066361556
E01014907,1649,879,770,0.533050333535476,0.46694966646452396
E01014908,1447,723,724,0.4996544574982723,0.5003455425017277
E01014909,1587,878,709,0.5532451165721487,0.4467548834278513
E01014910,1607,843,764,0.5245799626633478,0.47542003733665217
E01014867,1629,1002,627,0.6151012891344383,0.3848987108655617
E01014994,1941,967,974,0.4981968057702215,0.5018031942297785
E01014995,1625,780,845,0.48,0.52
E01033338,1699,861,838,0.5067686874632137,0.49323131253678637
E01033339,1495,725,770,0.48494983277591974,0.5150501672240803
E01035217,1597,785,812,0.4915466499686913,0.5084533500313086
E01035218,1656,798,858,0.48188405797101447,0.5181159420289855
E01035219,1067,527,540,0.4939081537019681,0.5060918462980318
E01014901,1769,863,906,0.4878462408140192,0.5121537591859808
E01014902,1338,645,693,0.4820627802690583,0.5179372197309418
E01014903,1522,754,768,0.49540078843626806,0.5045992115637319
E01014965,1588,769,819,0.48425692695214106,0.5157430730478589
E01014964,1704,833,871,0.48884976525821594,0.511150234741784
E01014967,2118,1017,1101,0.4801699716713881,0.5198300283286119
E01014969,1609,793,816,0.49285270354257305,0.507147296457427
E01033334,1579,779,800,0.493350221659278,0.506649778340722
E01033336,1695,806,889,0.4755162241887906,0.5244837758112094
E01035220,2062,994,1068,0.48205625606207564,0.5179437439379243
E01035221,1639,793,846,0.4838316046369738,0.5161683953630263
E01014897,1552,771,781,0.49677835051546393,0.5032216494845361
E01014898,1797,885,912,0.49248747913188645,0.5075125208681135
E01014899,1757,838,919,0.47694934547524187,0.5230506545247581
E01014900,1572,790,782,0.5025445292620865,0.49745547073791346
E01014959,1413,702,711,0.4968152866242038,0.5031847133757962
E01014960,1756,892,864,0.5079726651480638,0.4920273348519362
E01014961,1584,783,801,0.4943181818181818,0.5056818181818182
E01014968,1788,862,926,0.48210290827740493,0.5178970917225951
E01014865,2167,1061,1106,0.4896169820027688,0.5103830179972312
E01014869,1584,785,799,0.49558080808080807,0.5044191919191919
E01014870,1608,810,798,0.503731343283582,0.4962686567164179
E01014871,1240,620,620,0.5,0.5
E01014890,2192,1078,1114,0.49178832116788324,0.5082116788321168
E01014891,1690,840,850,0.4970414201183432,0.5029585798816568
E01014955,1388,690,698,0.49711815561959655,0.5028818443804035
E01014956,1507,748,759,0.49635036496350365,0.5036496350364964
E01014957,1187,570,617,0.4802021903959562,0.5197978096040438
E01014974,1699,848,851,0.4991171277221895,0.5008828722778105
E01014977,1464,703,761,0.4801912568306011,0.519808743169399
E01014922,1379,692,687,0.5018129079042785,0.49818709209572154
E01014923,1487,716,771,0.48150638870208473,0.5184936112979153
E01014924,1809,915,894,0.5058043117744611,0.494195688225539
E01014973,1518,718,800,0.47299077733860345,0.5270092226613966
E01014975,1750,890,860,0.5085714285714286,0.49142857142857144
E01014976,1770,880,890,0.4971751412429379,0.5028248587570622
E01014925,1560,720,840,0.46153846153846156,0.5384615384615384
E01014926,1709,817,892,0.47805734347571677,0.5219426565242832
E01014927,1819,899,920,0.49422759758108853,0.5057724024189115
E01014928,1474,726,748,0.4925373134328358,0.5074626865671642
E01014958,1207,557,650,0.4614747307373654,0.5385252692626347
E01014915,1673,791,882,0.47280334728033474,0.5271966527196653
E01015003,1638,796,842,0.48595848595848595,0.514041514041514
E01015005,2364,1185,1179,0.501269035532995,0.4987309644670051
E01015007,1976,976,1000,0.4939271255060729,0.5060728744939271
E01015008,1763,873,890,0.4951786727169597,0.5048213272830403
E01014943,1685,805,880,0.47774480712166173,0.5222551928783383
E01014944,1724,841,883,0.48781902552204176,0.5121809744779582
E01014972,1705,830,875,0.4868035190615836,0.5131964809384164
E01015002,1519,717,802,0.4720210664911126,0.5279789335088875
E01015004,1646,799,847,0.48541919805589306,0.5145808019441069
E01015006,1624,811,813,0.49938423645320196,0.500615763546798
E01014936,1418,706,712,0.4978843441466855,0.5021156558533145
E01014938,1557,761,796,0.48876043673731534,0.5112395632626846
E01014939,1228,603,625,0.49104234527687296,0.508957654723127
E01014940,1323,660,663,0.4988662131519274,0.5011337868480725
E01014941,1625,770,855,0.47384615384615386,0.5261538461538462
E01014942,1536,759,777,0.494140625,0.505859375
E01014945,1658,811,847,0.48914354644149577,0.5108564535585042
E01014916,1599,813,786,0.5084427767354597,0.4915572232645403
E01014917,1686,809,877,0.47983392645314354,0.5201660735468565
E01014918,1469,713,756,0.4853641933287951,0.5146358066712049
E01014919,1407,699,708,0.4968017057569296,0.5031982942430704
E01014920,1370,682,688,0.4978102189781022,0.5021897810218978
E01014921,1670,809,861,0.4844311377245509,0.5155688622754491
E01014866,1550,757,793,0.48838709677419356,0.5116129032258064
E01014931,1667,807,860,0.48410317936412717,0.5158968206358728
E01014932,1562,756,806,0.4839948783610755,0.5160051216389244
E01014933,1338,673,665,0.5029895366218237,0.4970104633781764
E01014934,1266,632,634,0.49921011058451814,0.5007898894154819
E01014935,1416,684,732,0.4830508474576271,0.5169491525423728
E01014937,1320,640,680,0.48484848484848486,0.5151515151515151
E01014946,1613,808,805,0.5009299442033478,0.4990700557966522
E01014947,1458,732,726,0.5020576131687243,0.49794238683127573
E01014948,1658,801,857,0.48311218335343786,0.5168878166465621
E01014950,1524,764,760,0.5013123359580053,0.49868766404199477
E01035222,1667,845,822,0.5068986202759448,0.4931013797240552
E01014951,1376,638,738,0.4636627906976744,0.5363372093023255
E01035223,1516,736,780,0.48548812664907653,0.5145118733509235
E01035224,1438,712,726,0.4951321279554937,0.5048678720445062
E01035225,1667,851,816,0.510497900419916,0.489502099580084
E01035226,1863,912,951,0.4895330112721417,0.5104669887278583
E01035227,1321,693,628,0.5246025738077215,0.4753974261922786
E01035228,2509,1330,1179,0.530091669988043,0.469908330011957
E01035229,2784,1442,1342,0.5179597701149425,0.48204022988505746
E01035230,1256,626,630,0.4984076433121019,0.5015923566878981
E01035231,1295,689,606,0.532046332046332,0.46795366795366794
E01014978,1533,769,764,0.5016307893020222,0.4983692106979778
E01014996,1824,901,923,0.49396929824561403,0.5060307017543859
E01035232,1744,874,870,0.5011467889908257,0.4988532110091743
E01035233,1834,917,917,0.5,0.5
E01015025,1729,799,930,0.46211683053788316,0.5378831694621168
E01015097,2232,1056,1176,0.4731182795698925,0.5268817204301075
E01015160,1445,698,747,0.48304498269896196,0.5169550173010381
E01015164,1901,922,979,0.4850078905839032,0.5149921094160967
E01015027,1613,790,823,0.4897706137631742,0.5102293862368258
E01015159,1726,805,921,0.466396292004635,0.533603707995365
E01015161,1685,810,875,0.4807121661721068,0.5192878338278932
E01015162,1505,688,817,0.45714285714285713,0.5428571428571428
E01015166,2198,1069,1129,0.48635122838944495,0.513648771610555
E01015023,1775,870,905,0.49014084507042255,0.5098591549295775
E01015026,1544,717,827,0.4643782383419689,0.5356217616580311
E01015028,1685,809,876,0.4801186943620178,0.5198813056379822
E01015163,1600,762,838,0.47625,0.52375
E01015165,1700,841,859,0.49470588235294116,0.5052941176470588
E01015024,1326,639,687,0.4819004524886878,0.5180995475113123
E01015082,1630,806,824,0.49447852760736194,0.505521472392638
E01015083,1599,790,809,0.49405878674171355,0.5059412132582864
E01015084,1474,717,757,0.4864314789687924,0.5135685210312076
E01015090,1324,649,675,0.4901812688821752,0.5098187311178247
E01015091,1431,723,708,0.5052410901467506,0.4947589098532495
E01015092,2804,1263,1541,0.4504279600570613,0.5495720399429387
E01015093,1332,657,675,0.49324324324324326,0.5067567567567568
E01015094,1526,698,828,0.45740498034076016,0.5425950196592398
E01015085,1590,757,833,0.4761006289308176,0.5238993710691824
E01015087,1591,769,822,0.4833438089252043,0.5166561910747958
E01015088,1590,756,834,0.47547169811320755,0.5245283018867924
E01015147,1268,615,653,0.48501577287066244,0.5149842271293376
E01015148,1490,727,763,0.4879194630872483,0.5120805369127517
E01015030,1627,802,825,0.4929317762753534,0.5070682237246465
E01015070,2757,1332,1425,0.48313384113166485,0.5168661588683352
E01015081,1706,813,893,0.4765533411488863,0.5234466588511137
E01015086,1377,631,746,0.45824255628177196,0.541757443718228
E01015089,1709,793,916,0.46401404330017554,0.5359859566998244
E01015029,1957,944,1013,0.4823709759836484,0.5176290240163516
E01015064,1609,780,829,0.4847731510254817,0.5152268489745183
E01015065,1317,637,680,0.48367501898253606,0.5163249810174639
E01015071,1528,728,800,0.47643979057591623,0.5235602094240838
E01015076,1404,698,706,0.49715099715099714,0.5028490028490028
E01015142,1405,707,698,0.503202846975089,0.496797153024911
E01015143,1294,638,656,0.49304482225656876,0.5069551777434312
E01015144,1578,791,787,0.5012674271229405,0.4987325728770596
E01015146,1943,923,1020,0.4750386001029336,0.5249613998970664
E01015149,1487,695,792,0.4673839946200404,0.5326160053799597
E01015150,1419,696,723,0.4904862579281184,0.5095137420718816
E01015063,1451,674,777,0.46450723638869745,0.5354927636113026
E01015068,1583,790,793,0.4990524320909665,0.5009475679090335
E01015069,1521,725,796,0.47666009204470744,0.5233399079552926
E01015095,1370,652,718,0.4759124087591241,0.5240875912408759
E01015096,1361,608,753,0.446730345334313,0.553269654665687
E01015074,1506,721,785,0.47875166002656044,0.5212483399734396
E01015077,2494,1179,1315,0.47273456295108257,0.5272654370489174
E01015079,1728,856,872,0.49537037037037035,0.5046296296296297
E01015102,1642,824,818,0.5018270401948843,0.4981729598051157
E01015104,1500,729,771,0.486,0.514
E01015035,1438,704,734,0.48956884561891517,0.5104311543810849
E01015037,1324,617,707,0.466012084592145,0.533987915407855
E01015058,1602,773,829,0.48252184769038703,0.517478152309613
E01015066,1357,653,704,0.4812085482682388,0.5187914517317612
E01015067,1408,692,716,0.4914772727272727,0.5085227272727273
E01015072,1347,637,710,0.4729027468448404,0.5270972531551597
E01015073,1471,728,743,0.49490142760027195,0.5050985723997281
E01015078,1452,689,763,0.47451790633608815,0.5254820936639119
E01015080,1454,707,747,0.4862448418156809,0.5137551581843192
E01015106,1211,594,617,0.49050371593724196,0.509496284062758
E01015039,1049,514,535,0.4899904671115348,0.5100095328884652
E01015040,1524,756,768,0.49606299212598426,0.5039370078740157
E01015041,1652,882,770,0.5338983050847458,0.4661016949152542
E01015075,1518,724,794,0.4769433465085639,0.5230566534914362
E01015145,1335,621,714,0.4651685393258427,0.5348314606741573
E01015120,1571,753,818,0.47931253978357735,0.5206874602164226
E01015121,1506,709,797,0.4707835325365206,0.5292164674634794
E01015123,1645,783,862,0.47598784194528876,0.5240121580547112
E01015124,1532,719,813,0.46932114882506526,0.5306788511749347
E01015125,1476,727,749,0.49254742547425473,0.5074525745257452
E01015033,1560,787,773,0.5044871794871795,0.49551282051282053
E01015034,1466,687,779,0.4686221009549795,0.5313778990450204
E01015036,1535,735,800,0.4788273615635179,0.5211726384364821
E01015038,1721,827,894,0.48053457292271934,0.5194654270772806
E01015101,1583,773,810,0.4883133291219204,0.5116866708780796
E01015098,1609,754,855,0.46861404599129897,0.531385954008701
E01015099,1433,688,745,0.4801116538729937,0.5198883461270063
E01015100,1478,722,756,0.4884979702300406,0.5115020297699594
E01015103,1493,724,769,0.48492967180174146,0.5150703281982585
E01015105,1528,735,793,0.48102094240837695,0.518979057591623
E01015107,1848,880,968,0.47619047619047616,0.5238095238095238
E01015110,1496,749,747,0.5006684491978609,0.49933155080213903
E01015111,1730,803,927,0.4641618497109827,0.5358381502890174
E01015119,1618,795,823,0.49134734239802225,0.5086526576019778
E01015112,1651,781,870,0.4730466384009691,0.526953361599031
E01015113,1461,721,740,0.4934976043805613,0.5065023956194388
E01015114,1467,730,737,0.49761417859577367,0.5023858214042263
E01015118,1633,781,852,0.4782608695652174,0.5217391304347826
E01015122,1601,767,834,0.4790755777638976,0.5209244222361025
E01015042,1447,730,717,0.5044920525224602,0.49550794747753973
E01015044,1472,765,707,0.5197010869565217,0.48029891304347827
E01015167,1479,758,721,0.5125084516565247,0.4874915483434753
E01015168,1818,944,874,0.5192519251925193,0.4807480748074808
E01015171,1744,904,840,0.518348623853211,0.481651376146789
E01015055,1451,737,714,0.5079255685733977,0.49207443142660234
E01015056,1646,810,836,0.49210206561360875,0.5078979343863913
E01015057,1686,786,900,0.46619217081850534,0.5338078291814946
E01015059,1527,750,777,0.4911591355599214,0.5088408644400786
E01015060,1490,712,778,0.4778523489932886,0.5221476510067115
E01015176,1406,682,724,0.4850640113798009,0.5149359886201992
E01015108,1816,906,910,0.4988986784140969,0.501101321585903
E01015109,1335,667,668,0.49962546816479403,0.500374531835206
E01015115,1370,613,757,0.4474452554744526,0.5525547445255474
E01015116,1423,700,723,0.49191848208011246,0.5080815179198875
E01015117,1378,653,725,0.47387518142235124,0.5261248185776488
E01015031,1515,750,765,0.49504950495049505,0.504950495049505
E01015032,1724,950,774,0.5510440835266821,0.44895591647331784
E01015049,1655,840,815,0.5075528700906344,0.49244712990936557
E01015050,1817,941,876,0.5178866263070996,0.48211337369290036
E01015051,1784,877,907,0.4915919282511211,0.5084080717488789
E01015169,1786,908,878,0.5083986562150056,0.4916013437849944
E01015170,1557,765,792,0.4913294797687861,0.5086705202312138
E01015173,1659,847,812,0.510548523206751,0.48945147679324896
E01015174,1672,818,854,0.4892344497607656,0.5107655502392344
E01015061,1554,772,782,0.4967824967824968,0.5032175032175032
E01015062,1789,899,890,0.5025153717160424,0.4974846282839575
E01015175,1607,831,776,0.5171126322339763,0.48288736776602365
E01015177,1704,867,837,0.5088028169014085,0.49119718309859156
E01015178,1947,1004,943,0.5156651258346173,0.4843348741653826
E01015043,1409,708,701,0.5024840312278211,0.49751596877217885
E01015045,1462,738,724,0.5047879616963065,0.4952120383036936
E01015046,1917,945,972,0.49295774647887325,0.5070422535211268
E01015047,2015,948,1067,0.4704714640198511,0.5295285359801489
E01015048,2379,1264,1115,0.5313156788566624,0.4686843211433375
E01015053,1205,667,538,0.5535269709543569,0.4464730290456432
E01015054,2740,1333,1407,0.4864963503649635,0.5135036496350365
E01015152,2514,1261,1253,0.5015910898965792,0.49840891010342087
E01015156,2012,1085,927,0.5392644135188867,0.46073558648111335
E01032657,1305,632,673,0.4842911877394636,0.5157088122605364
E01032658,1540,773,767,0.5019480519480519,0.4980519480519481
E01015052,1850,914,936,0.49405405405405406,0.505945945945946
E01015179,1633,831,802,0.5088793631353338,0.4911206368646663
E01015180,1722,940,782,0.5458768873403019,0.454123112659698
E01015181,2170,1211,959,0.5580645161290323,0.44193548387096776
E01015182,1956,983,973,0.5025562372188139,0.49744376278118607
E01015126,1531,713,818,0.46570868713259306,0.5342913128674069
E01015127,1454,698,756,0.48005502063273725,0.5199449793672627
E01015131,2430,1175,1255,0.4835390946502058,0.5164609053497943
E01015132,1492,718,774,0.4812332439678284,0.5187667560321716
E01015133,1458,704,754,0.4828532235939643,0.5171467764060357
E01015136,1471,719,752,0.48878314072059825,0.5112168592794017
E01015137,1779,871,908,0.4896008993816751,0.5103991006183249
E01015138,1884,946,938,0.5021231422505308,0.4978768577494692
E01015139,1441,698,743,0.48438584316446914,0.5156141568355309
E01015141,1763,862,901,0.48893930799773117,0.5110606920022689
E01034157,1868,934,934,0.5,0.5
E01034158,1128,532,596,0.4716312056737589,0.5283687943262412
E01015128,1548,729,819,0.47093023255813954,0.5290697674418605
E01015129,1374,638,736,0.4643377001455604,0.5356622998544396
E01015130,1553,774,779,0.4983902124919511,0.501609787508049
E01015134,1531,738,793,0.48203788373612017,0.5179621162638798
E01015140,1434,693,741,0.48326359832635984,0.5167364016736402
E01015151,1818,968,850,0.5324532453245324,0.4675467546754675
E01015153,1809,960,849,0.5306799336650083,0.4693200663349917
E01015172,1723,867,856,0.5031921067904818,0.4968078932095183
E01015155,1852,960,892,0.5183585313174947,0.4816414686825054
E01034159,1178,643,535,0.5458404074702886,0.4541595925297114
E01034160,1457,746,711,0.5120109814687714,0.48798901853122856
E01034161,1214,662,552,0.5453047775947282,0.4546952224052718
E01034162,1043,551,492,0.5282837967401726,0.47171620325982744
E01015262,1376,668,708,0.48546511627906974,0.5145348837209303
E01015263,1635,788,847,0.4819571865443425,0.5180428134556575
E01015264,1331,626,705,0.47032306536438767,0.5296769346356123
E01015265,1365,666,699,0.4879120879120879,0.512087912087912
E01015266,1572,758,814,0.4821882951653944,0.5178117048346056
E01015236,1478,730,748,0.4939106901217862,0.5060893098782138
E01015237,1353,682,671,0.5040650406504065,0.4959349593495935
E01015238,1357,656,701,0.4834193072955048,0.5165806927044952
E01015239,1690,760,930,0.44970414201183434,0.5502958579881657
E01015249,1506,707,799,0.46945551128818064,0.5305444887118194
E01015250,1511,727,784,0.4811383189940437,0.5188616810059563
E01015251,1223,573,650,0.46852003270645953,0.5314799672935405
E01015253,2007,965,1042,0.4808171400099651,0.5191828599900349
E01015254,1436,694,742,0.4832869080779944,0.5167130919220055
E01034169,1554,767,787,0.49356499356499356,0.5064350064350064
E01034170,1394,678,716,0.48637015781922527,0.5136298421807748
E01015257,1475,712,763,0.48271186440677966,0.5172881355932203
E01015258,2071,981,1090,0.47368421052631576,0.5263157894736842
E01015259,1601,778,823,0.48594628357276703,0.514053716427233
E01015260,1701,888,813,0.5220458553791887,0.47795414462081126
E01015240,1531,694,837,0.45329849771391245,0.5467015022860875
E01015241,1585,804,781,0.5072555205047319,0.4927444794952681
E01015242,1361,615,746,0.4518736223365173,0.5481263776634827
E01015243,1281,598,683,0.46682279469164717,0.5331772053083529
E01015214,1554,763,791,0.49099099099099097,0.509009009009009
E01015215,1442,713,729,0.4944521497919556,0.5055478502080444
E01015216,1490,732,758,0.4912751677852349,0.508724832214765
E01015218,1539,748,791,0.48602988953866144,0.5139701104613386
E01015217,1660,854,806,0.5144578313253012,0.4855421686746988
E01015255,1818,987,831,0.5429042904290429,0.4570957095709571
E01015256,1988,1117,871,0.5618712273641852,0.4381287726358149
E01015261,2292,1135,1157,0.4952006980802792,0.5047993019197208
E01015267,1696,887,809,0.5229952830188679,0.47700471698113206
E01015268,1695,830,865,0.4896755162241888,0.5103244837758112
E01015269,1543,746,797,0.48347375243033053,0.5165262475696695
E01015270,1703,891,812,0.5231943628890193,0.4768056371109806
E01015271,1487,692,795,0.4653665097511769,0.5346334902488231
E01015224,1619,764,855,0.4718962322421248,0.5281037677578753
E01015225,1466,712,754,0.48567530695770805,0.514324693042292
E01015226,1401,684,717,0.48822269807280516,0.5117773019271948
E01015227,1593,773,820,0.485247959824231,0.514752040175769
E01015228,1559,739,820,0.4740218088518281,0.5259781911481719
E01015230,1390,664,726,0.4776978417266187,0.5223021582733813
E01015202,1499,739,760,0.49299533022014674,0.5070046697798533
E01015203,1247,611,636,0.48997594226142743,0.5100240577385726
E01015204,1525,766,759,0.5022950819672131,0.4977049180327869
E01015205,1495,693,802,0.4635451505016722,0.5364548494983278
E01015206,1560,736,824,0.4717948717948718,0.5282051282051282
E01015190,2001,980,1021,0.4897551224387806,0.5102448775612194
E01015191,1615,779,836,0.4823529411764706,0.5176470588235295
E01015192,1579,747,832,0.47308423052564913,0.5269157694743508
E01015193,1347,660,687,0.48997772828507796,0.5100222717149221
E01015194,1415,699,716,0.4939929328621908,0.5060070671378092
E01015196,1810,901,909,0.4977900552486188,0.5022099447513813
E01034171,1164,576,588,0.4948453608247423,0.5051546391752577
E01034172,2026,1006,1020,0.49654491609081935,0.5034550839091807
E01015229,1487,708,779,0.4761264290517821,0.5238735709482178
E01015231,1798,904,894,0.5027808676307007,0.4972191323692992
E01015232,1942,1023,919,0.5267765190525232,0.47322348094747685
E01015233,1494,741,753,0.4959839357429719,0.5040160642570282
E01015234,1347,681,666,0.5055679287305123,0.49443207126948774
E01015235,1783,859,924,0.4817722938867078,0.5182277061132922
E01015219,1389,659,730,0.4744420446364291,0.5255579553635709
E01015220,1415,681,734,0.4812720848056537,0.5187279151943462
E01015221,1500,693,807,0.462,0.538
E01015222,1575,732,843,0.46476190476190476,0.5352380952380953
E01015223,1269,611,658,0.48148148148148145,0.5185185185185185
E01015197,1383,673,710,0.4866232827187274,0.5133767172812725
E01015198,1562,719,843,0.46030729833546735,0.5396927016645326
E01015199,1357,660,697,0.4863669859985262,0.5136330140014739
E01015200,1059,516,543,0.48725212464589235,0.5127478753541076
E01015201,1243,597,646,0.48028962188254226,0.5197103781174578
E01015183,1370,654,716,0.47737226277372263,0.5226277372262774
E01015184,1255,598,657,0.47649402390438245,0.5235059760956176
E01015185,1320,639,681,0.48409090909090907,0.5159090909090909
E01015186,1302,652,650,0.500768049155146,0.49923195084485406
E01015187,1703,828,875,0.48620082207868465,0.5137991779213154
E01015188,1504,684,820,0.45478723404255317,0.5452127659574468
E01015189,1018,496,522,0.48722986247544203,0.5127701375245579
E01015244,1410,696,714,0.49361702127659574,0.5063829787234042
E01015245,1255,613,642,0.48844621513944225,0.5115537848605578
E01015246,1439,689,750,0.4788047255038221,0.5211952744961779
E01015247,1810,892,918,0.49281767955801103,0.507182320441989
E01015248,1445,691,754,0.4782006920415225,0.5217993079584775
E01015207,1551,751,800,0.4842037395228885,0.5157962604771116
E01015208,1980,974,1006,0.4919191919191919,0.5080808080808081
E01015209,1514,725,789,0.47886393659180976,0.5211360634081902
E01015210,1713,779,934,0.45475773496789257,0.5452422650321074
E01015211,1511,720,791,0.47650562541363334,0.5234943745863666
E01015212,1501,722,779,0.4810126582278481,0.5189873417721519
E01015213,1516,735,781,0.48482849604221634,0.5151715039577837
E01015519,1505,725,780,0.48172757475083056,0.5182724252491694
E01015520,1252,610,642,0.48722044728434505,0.512779552715655
E01015521,1586,802,784,0.5056746532156369,0.4943253467843632
E01015522,1328,609,719,0.4585843373493976,0.5414156626506024
E01015523,1612,797,815,0.4944168734491315,0.5055831265508685
E01015524,1085,537,548,0.4949308755760369,0.5050691244239631
E01015543,1529,751,778,0.49117069980379335,0.5088293001962066
E01015544,1767,830,937,0.46972269383135257,0.5302773061686474
E01015545,1696,803,893,0.47346698113207547,0.5265330188679245
E01015546,1867,885,982,0.4740224959828602,0.5259775040171398
E01015513,1445,725,720,0.5017301038062284,0.4982698961937716
E01015514,1200,586,614,0.48833333333333334,0.5116666666666667
E01015515,1414,716,698,0.5063649222065064,0.49363507779349364
E01015516,1270,608,662,0.47874015748031495,0.521259842519685
E01015517,1369,661,708,0.4828341855368882,0.5171658144631117
E01015555,1478,720,758,0.4871447902571042,0.5128552097428958
E01015556,1512,745,767,0.49272486772486773,0.5072751322751323
E01015557,1800,884,916,0.4911111111111111,0.5088888888888888
E01015558,1555,737,818,0.4739549839228296,0.5260450160771705
E01015559,1484,729,755,0.4912398921832884,0.5087601078167115
E01015560,2097,1024,1073,0.48831664282308057,0.5116833571769194
E01015526,1503,744,759,0.49500998003992014,0.5049900199600799
E01015528,2162,1027,1135,0.4750231267345051,0.5249768732654949
E01015529,1619,823,796,0.5083384805435454,0.4916615194564546
E01015530,2102,1044,1058,0.4966698382492864,0.5033301617507137
E01015506,1499,762,737,0.5083388925950634,0.4916611074049366
E01015507,1609,743,866,0.4617775015537601,0.5382224984462399
E01015527,1743,836,907,0.47963281698221455,0.5203671830177854
E01015580,1712,828,884,0.48364485981308414,0.5163551401869159
E01015473,1932,955,977,0.4943064182194617,0.5056935817805382
E01015547,1860,950,910,0.510752688172043,0.489247311827957
E01015548,1562,777,785,0.4974391805377721,0.5025608194622279
E01033840,1590,777,813,0.48867924528301887,0.5113207547169811
E01033841,1511,740,771,0.48974189278623426,0.5102581072137657
E01033842,1613,821,792,0.5089894606323621,0.49101053936763794
E01033843,1336,667,669,0.49925149700598803,0.500748502994012
E01033844,1642,796,846,0.48477466504263095,0.5152253349573691
E01015549,1636,825,811,0.5042787286063569,0.495721271393643
E01015550,1854,908,946,0.48975188781014023,0.5102481121898598
E01015551,1656,801,855,0.483695652173913,0.5163043478260869
E01015552,2224,1073,1151,0.4824640287769784,0.5175359712230215
E01015553,1515,738,777,0.4871287128712871,0.5128712871287129
E01015554,1384,689,695,0.49783236994219654,0.5021676300578035
E01015508,1518,763,755,0.502635046113307,0.497364953886693
E01015509,1770,897,873,0.5067796610169492,0.49322033898305084
E01015510,2150,1129,1021,0.5251162790697674,0.47488372093023257
E01015511,1857,995,862,0.5358104469574583,0.4641895530425417
E01015562,1498,751,747,0.5013351134846462,0.4986648865153538
E01015563,1490,766,724,0.5140939597315436,0.48590604026845635
E01015565,1470,689,781,0.46870748299319726,0.5312925170068027
E01015566,1559,795,764,0.5099422706863374,0.4900577293136626
E01015578,2137,1104,1033,0.516612072999532,0.48338792700046795
E01015579,1660,829,831,0.49939759036144576,0.5006024096385542
E01015581,1632,826,806,0.5061274509803921,0.49387254901960786
E01015582,2170,1114,1056,0.5133640552995392,0.48663594470046084
E01032708,1714,909,805,0.530338389731622,0.46966161026837805
E01032716,1583,808,775,0.5104232469993683,0.4895767530006317
E01015481,1761,826,935,0.4690516751845542,0.5309483248154457
E01015482,1230,616,614,0.5008130081300813,0.4991869918699187
E01015483,1355,646,709,0.47675276752767526,0.5232472324723247
E01015484,1415,697,718,0.4925795053003534,0.5074204946996467
E01015485,1386,684,702,0.4935064935064935,0.5064935064935064
E01015486,1383,685,698,0.4953000723065799,0.5046999276934201
E01015561,1588,805,783,0.506926952141058,0.49307304785894207
E01015564,1525,743,782,0.48721311475409834,0.5127868852459017
E01015567,1622,796,826,0.4907521578298397,0.5092478421701603
E01015568,1698,825,873,0.48586572438162545,0.5141342756183745
E01015475,2472,1317,1155,0.5327669902912622,0.4672330097087379
E01015477,1726,899,827,0.5208574739281576,0.47914252607184243
E01015480,3155,1651,1504,0.523296354992076,0.47670364500792395
E01033845,1737,941,796,0.5417386298215314,0.45826137017846863
E01033846,1576,857,719,0.5437817258883249,0.45621827411167515
E01015538,1945,949,996,0.4879177377892031,0.5120822622107969
E01015572,1385,681,704,0.49169675090252707,0.5083032490974729
E01015573,2293,1094,1199,0.47710423026602705,0.522895769733973
E01015575,1388,675,713,0.48631123919308356,0.5136887608069164
E01015479,2331,1178,1153,0.5053625053625054,0.4946374946374946
E01015493,2228,1193,1035,0.5354578096947935,0.46454219030520644
E01015574,1628,813,815,0.49938574938574937,0.5006142506142506
E01015576,1593,781,812,0.49026993094789706,0.5097300690521029
E01015499,1410,697,713,0.49432624113475176,0.5056737588652482
E01015500,1473,695,778,0.47182620502376105,0.528173794976239
E01015504,1291,607,684,0.4701781564678544,0.5298218435321457
E01015505,1490,759,731,0.5093959731543625,0.4906040268456376
E01015494,2177,1170,1007,0.5374368396876436,0.46256316031235645
E01015496,1872,1011,861,0.5400641025641025,0.4599358974358974
E01015497,1608,851,757,0.529228855721393,0.47077114427860695
E01032714,1839,974,865,0.5296356715606307,0.4703643284393692
E01032715,1232,638,594,0.5178571428571429,0.48214285714285715
E01015537,1800,875,925,0.4861111111111111,0.5138888888888888
E01015539,1662,837,825,0.5036101083032491,0.4963898916967509
E01015540,1853,884,969,0.47706422018348627,0.5229357798165137
E01015541,1813,870,943,0.4798676227247656,0.5201323772752344
E01015542,1415,678,737,0.4791519434628975,0.5208480565371024
E01015478,1566,792,774,0.5057471264367817,0.4942528735632184
E01015498,1716,901,815,0.5250582750582751,0.47494172494172493
E01015532,1654,861,793,0.5205562273276905,0.47944377267230953
E01032706,1540,777,763,0.5045454545454545,0.4954545454545455
E01032707,2097,1027,1070,0.4897472579876013,0.5102527420123987
E01015501,1329,667,662,0.5018811136192626,0.49811888638073737
E01015502,1557,742,815,0.4765574823378292,0.5234425176621709
E01015503,1310,622,688,0.47480916030534354,0.5251908396946565
E01015569,1520,707,813,0.4651315789473684,0.5348684210526315
E01015570,1479,766,713,0.5179175118323192,0.48208248816768084
E01015571,1541,762,779,0.4944841012329656,0.5055158987670344
E01015487,1483,727,756,0.49022252191503707,0.5097774780849629
E01015488,1462,713,749,0.48768809849521205,0.512311901504788
E01015489,1433,732,701,0.5108164689462665,0.4891835310537334
E01015490,1264,636,628,0.5031645569620253,0.49683544303797467
E01015491,1418,679,739,0.4788434414668547,0.5211565585331452
E01015492,1402,701,701,0.5,0.5
E01015533,1487,720,767,0.484196368527236,0.515803631472764
E01015534,2166,1064,1102,0.49122807017543857,0.5087719298245614
E01015535,2091,1027,1064,0.49115255858440937,0.5088474414155906
E01033847,1632,803,829,0.49203431372549017,0.5079656862745098
E01033848,1984,1004,980,0.5060483870967742,0.4939516129032258
E01015584,1428,686,742,0.4803921568627451,0.5196078431372549
E01015585,1978,930,1048,0.47017189079878663,0.5298281092012134
E01015586,1374,661,713,0.4810771470160116,0.5189228529839883
E01015587,1851,879,972,0.47487844408427876,0.5251215559157212
E01015588,1777,871,906,0.49015194147439506,0.509848058525605
E01033849,2218,1093,1125,0.4927862939585212,0.5072137060414789
E01033850,2167,1057,1110,0.48777111213659435,0.5122288878634056
E01015525,1571,789,782,0.5022278803309994,0.49777211966900065
E01032700,1768,867,901,0.49038461538461536,0.5096153846153846
E01032703,1602,780,822,0.4868913857677903,0.5131086142322098
E01032705,1526,757,769,0.49606815203145477,0.5039318479685452
E01032709,1378,690,688,0.5007256894049347,0.49927431059506533
E01032713,2062,1023,1039,0.4961202715809893,0.5038797284190106
E01032701,1253,638,615,0.5091779728651237,0.49082202713487627
E01032702,1432,719,713,0.5020949720670391,0.4979050279329609
E01032704,1876,944,932,0.5031982942430704,0.4968017057569296
E01032711,1587,798,789,0.502835538752363,0.497164461247637
E01032712,2421,1212,1209,0.5006195786864932,0.4993804213135068
E01015471,2138,1069,1069,0.5,0.5
E01015512,1648,820,828,0.4975728155339806,0.5024271844660194
E01015518,1488,739,749,0.49663978494623656,0.5033602150537635
E01032710,1388,696,692,0.5014409221902018,0.49855907780979825
E01033860,1818,912,906,0.5016501650165016,0.49834983498349833
E01033861,1854,923,931,0.49784250269687164,0.5021574973031284
E01018753,1759,858,901,0.4877771461057419,0.5122228538942581
E01018754,1884,937,947,0.4973460721868365,0.5026539278131635
E01018755,1448,714,734,0.4930939226519337,0.5069060773480663
E01018756,1554,739,815,0.47554697554697556,0.5244530244530244
E01018777,2103,1048,1055,0.4983357108892059,0.5016642891107941
E01018782,1476,701,775,0.4749322493224932,0.5250677506775068
E01018783,1493,738,755,0.4943067649028801,0.5056932350971199
E01018784,1535,768,767,0.5003257328990228,0.4996742671009772
E01018750,2259,1063,1196,0.47056219566179724,0.5294378043382028
E01018751,1578,821,757,0.5202788339670469,0.4797211660329531
E01018752,2146,1048,1098,0.48835041938490215,0.5116495806150979
E01018779,2285,1129,1156,0.49409190371991246,0.5059080962800875
E01018768,2094,1014,1080,0.48424068767908307,0.5157593123209169
E01018778,1765,852,913,0.4827195467422096,0.5172804532577904
E01034849,1469,708,761,0.48196051735874745,0.5180394826412525
E01034850,1398,689,709,0.4928469241773963,0.5071530758226037
E01034851,1209,581,628,0.48056244830438377,0.5194375516956162
E01034852,1584,777,807,0.49053030303030304,0.509469696969697
E01018767,1474,693,781,0.4701492537313433,0.5298507462686567
E01018770,1310,650,660,0.4961832061068702,0.5038167938931297
E01018771,1319,668,651,0.5064442759666414,0.4935557240333586
E01018772,1838,872,966,0.47442872687704024,0.5255712731229597
E01018764,1474,714,760,0.4843962008141113,0.5156037991858887
E01018787,1523,757,766,0.4970453053184504,0.5029546946815495
E01018795,1218,599,619,0.4917898193760263,0.5082101806239737
E01018796,1172,565,607,0.48208191126279865,0.5179180887372014
E01018757,2181,1033,1148,0.47363594681338833,0.5263640531866116
E01018763,1103,534,569,0.4841341795104261,0.5158658204895739
E01018765,1507,727,780,0.48241539482415396,0.517584605175846
E01018785,1932,949,983,0.4912008281573499,0.5087991718426501
E01018786,1244,599,645,0.4815112540192926,0.5184887459807074
E01018788,1416,660,756,0.4661016949152542,0.5338983050847458
E01018790,1203,583,620,0.484621778886118,0.515378221113882
E01018794,1416,698,718,0.4929378531073446,0.5070621468926554
E01018789,1403,671,732,0.4782608695652174,0.5217391304347826
E01018791,1280,596,684,0.465625,0.534375
E01018792,2720,1328,1392,0.48823529411764705,0.5117647058823529
E01018793,1691,812,879,0.48018923713778827,0.5198107628622117
E01018759,1547,762,785,0.49256625727213965,0.5074337427278603
E01018760,1337,679,658,0.5078534031413613,0.49214659685863876
E01018761,1842,867,975,0.47068403908794787,0.5293159609120521
E01018766,1677,850,827,0.5068574836016696,0.49314251639833034
E01018774,1883,880,1003,0.46733935209771643,0.5326606479022836
E01018797,1122,528,594,0.47058823529411764,0.5294117647058824
E01018798,1515,715,800,0.47194719471947194,0.528052805280528
E01018799,1168,559,609,0.4785958904109589,0.521404109589041
E01018800,1478,735,743,0.4972936400541272,0.5027063599458728
E01018780,2298,1113,1185,0.48433420365535246,0.5156657963446475
E01018781,1734,835,899,0.4815455594002307,0.5184544405997693
E01033294,2161,1055,1106,0.4881999074502545,0.5118000925497455
E01018762,1201,592,609,0.4929225645295587,0.5070774354704413
E01018773,1528,781,747,0.5111256544502618,0.48887434554973824
E01034858,2276,1120,1156,0.492091388400703,0.507908611599297
E01018815,2466,1213,1253,0.49188969991889697,0.508110300081103
E01018831,1536,724,812,0.4713541666666667,0.5286458333333334
E01018832,1330,642,688,0.48270676691729325,0.5172932330827068
E01018847,1822,905,917,0.49670691547749724,0.5032930845225028
E01018833,1953,967,986,0.49513568868407576,0.5048643113159242
E01018842,1725,823,902,0.4771014492753623,0.5228985507246376
E01018843,1432,707,725,0.4937150837988827,0.5062849162011173
E01018844,1289,630,659,0.4887509697439876,0.5112490302560124
E01018825,1710,812,898,0.47485380116959064,0.5251461988304094
E01018826,2388,1130,1258,0.4731993299832496,0.5268006700167505
E01018851,1311,624,687,0.4759725400457666,0.5240274599542334
E01034859,1535,731,804,0.4762214983713355,0.5237785016286645
E01034860,1526,758,768,0.4967234600262123,0.5032765399737876
E01018823,1518,711,807,0.4683794466403162,0.5316205533596838
E01018824,2677,1285,1392,0.48001494209936496,0.519985057900635
E01018853,2848,1365,1483,0.47928370786516855,0.5207162921348315
E01018854,1415,670,745,0.4734982332155477,0.5265017667844523
E01018819,1452,689,763,0.47451790633608815,0.5254820936639119
E01018822,1404,680,724,0.4843304843304843,0.5156695156695157
E01018856,1318,645,673,0.48937784522003036,0.5106221547799696
E01018857,1440,675,765,0.46875,0.53125
E01018858,1445,653,792,0.4519031141868512,0.5480968858131487
E01034862,1431,655,776,0.45772187281621246,0.5422781271837875
E01034863,2249,1070,1179,0.4757670075589151,0.5242329924410849
E01018807,1948,890,1058,0.45687885010266943,0.5431211498973306
E01018808,1524,657,867,0.4311023622047244,0.5688976377952756
E01018810,1370,631,739,0.46058394160583943,0.5394160583941606
E01034864,1015,457,558,0.45024630541871924,0.5497536945812808
E01034865,1110,546,564,0.4918918918918919,0.5081081081081081
E01018816,1589,767,822,0.48269351793580867,0.5173064820641913
E01018817,2087,1011,1076,0.4844274077623383,0.5155725922376617
E01018818,1797,848,949,0.47189760712298273,0.5281023928770172
E01018820,1860,939,921,0.5048387096774194,0.49516129032258066
E01018821,1785,868,917,0.48627450980392156,0.5137254901960784
E01018845,1854,867,987,0.46763754045307443,0.5323624595469255
E01018846,1462,729,733,0.49863201094391246,0.5013679890560876
E01018848,1718,822,896,0.47846332945285214,0.5215366705471478
E01018849,1828,890,938,0.486870897155361,0.513129102844639
E01018850,1314,642,672,0.4885844748858447,0.5114155251141552
E01018827,1511,722,789,0.47782925215089345,0.5221707478491066
E01018828,1487,710,777,0.47747141896435774,0.5225285810356423
E01018829,1339,653,686,0.4876773711725168,0.5123226288274833
E01018830,1602,778,824,0.48564294631710364,0.5143570536828964
E01018834,1997,984,1013,0.4927391086629945,0.5072608913370055
E01018835,2164,1057,1107,0.48844731977818856,0.5115526802218114
E01018836,1761,859,902,0.48779102782509937,0.5122089721749006
E01018837,2554,1253,1301,0.49060297572435396,0.509397024275646
E01018838,1615,804,811,0.4978328173374613,0.5021671826625387
E01018839,1174,571,603,0.48637137989778534,0.5136286201022147
E01018840,1901,836,1065,0.43976854287217254,0.5602314571278275
E01018841,1712,791,921,0.46203271028037385,0.5379672897196262
E01018860,1882,904,978,0.48034006376195537,0.5196599362380446
E01018803,1945,880,1065,0.4524421593830334,0.5475578406169666
E01018804,1953,870,1083,0.445468509984639,0.554531490015361
E01018805,1537,716,821,0.46584255042290174,0.5341574495770982
E01018806,1629,737,892,0.45242480049109884,0.5475751995089012
E01018811,1631,791,840,0.48497854077253216,0.5150214592274678
E01018812,1780,852,928,0.4786516853932584,0.5213483146067416
E01018813,1648,786,862,0.47694174757281554,0.5230582524271845
E01018814,1513,736,777,0.48645076007931265,0.5135492399206874
E01018859,1775,834,941,0.46985915492957747,0.5301408450704226
E01018889,1265,618,647,0.48853754940711464,0.5114624505928854
E01018890,1657,801,856,0.48340374170187084,0.5165962582981292
E01018891,1295,622,673,0.4803088803088803,0.5196911196911197
E01018892,1672,789,883,0.47188995215311,0.52811004784689
E01018893,1328,643,685,0.48418674698795183,0.5158132530120482
E01018908,1848,893,955,0.4832251082251082,0.5167748917748918
E01018909,1689,775,914,0.45885139135583186,0.5411486086441681
E01018910,2077,983,1094,0.4732787674530573,0.5267212325469427
E01018911,1751,885,866,0.5054254711593376,0.4945745288406625
E01018912,1965,987,978,0.5022900763358779,0.49770992366412214
E01018913,1905,979,926,0.5139107611548557,0.4860892388451444
E01018914,2181,1079,1102,0.4947271893626777,0.5052728106373223
E01018915,2209,1069,1140,0.4839293798098687,0.5160706201901313
E01018916,1413,672,741,0.47558386411889597,0.524416135881104
E01018917,1435,709,726,0.49407665505226483,0.5059233449477352
E01018918,1912,889,1023,0.4649581589958159,0.5350418410041841
E01018919,1526,729,797,0.47771952817824376,0.5222804718217562
E01018894,1985,992,993,0.49974811083123427,0.5002518891687657
E01018895,1965,1004,961,0.510941475826972,0.489058524173028
E01018896,1420,709,711,0.4992957746478873,0.5007042253521127
E01018897,2385,1225,1160,0.5136268343815513,0.4863731656184486
E01018898,1284,613,671,0.47741433021806856,0.5225856697819314
E01018865,2291,1162,1129,0.5072020951549542,0.4927979048450458
E01018866,2208,1083,1125,0.4904891304347826,0.5095108695652174
E01018868,1936,1013,923,0.5232438016528925,0.4767561983471074
E01034866,1667,803,864,0.48170365926814634,0.5182963407318536
E01034867,1422,707,715,0.4971870604781997,0.5028129395218003
E01018874,1307,628,679,0.48048967100229534,0.5195103289977047
E01018875,1319,622,697,0.4715693707354056,0.5284306292645944
E01018876,1485,732,753,0.49292929292929294,0.5070707070707071
E01018877,1578,781,797,0.49493029150823825,0.5050697084917617
E01018878,1674,803,871,0.479689366786141,0.5203106332138591
E01018869,1782,912,870,0.5117845117845118,0.4882154882154882
E01018870,1321,681,640,0.5155185465556397,0.48448145344436033
E01018871,1687,831,856,0.49259039715471253,0.5074096028452875
E01018872,1264,623,641,0.49287974683544306,0.507120253164557
E01018873,1219,576,643,0.4725184577522559,0.527481542247744
E01018863,1745,866,879,0.4962750716332378,0.5037249283667622
E01018864,1760,857,903,0.4869318181818182,0.5130681818181818
E01018921,2244,1104,1140,0.4919786096256685,0.5080213903743316
E01018922,2584,1265,1319,0.48955108359133126,0.5104489164086687
E01018879,1939,927,1012,0.4780814853017019,0.5219185146982981
E01018880,2296,1090,1206,0.47473867595818814,0.5252613240418118
E01018899,2936,1434,1502,0.4884196185286104,0.5115803814713896
E01018900,2033,988,1045,0.48598130841121495,0.514018691588785
E01018901,1540,752,788,0.4883116883116883,0.5116883116883116
E01018882,1497,713,784,0.47628590514362057,0.5237140948563794
E01018883,1630,785,845,0.4815950920245399,0.5184049079754601
E01018884,1624,800,824,0.49261083743842365,0.5073891625615764
E01018885,1460,694,766,0.47534246575342465,0.5246575342465754
E01018886,1729,863,866,0.4991324465008676,0.5008675534991325
E01018887,1944,913,1031,0.4696502057613169,0.5303497942386831
E01018888,2287,1065,1222,0.4656755574989069,0.5343244425010931
E01018861,1549,789,760,0.5093608779857973,0.49063912201420273
E01018862,1450,726,724,0.5006896551724138,0.4993103448275862
E01018905,1463,719,744,0.4914559125085441,0.508544087491456
E01018906,1086,512,574,0.4714548802946593,0.5285451197053407
E01018907,1355,628,727,0.46346863468634686,0.5365313653136531
E01018881,2129,1037,1092,0.4870831376232973,0.5129168623767026
E01018902,1207,601,606,0.4979287489643745,0.5020712510356256
E01018903,1194,610,584,0.5108877721943048,0.48911222780569513
E01018904,2302,1105,1197,0.4800173761946134,0.5199826238053866
E01018920,2075,1004,1071,0.483855421686747,0.516144578313253
E01018936,1584,768,816,0.48484848484848486,0.5151515151515151
E01018937,2085,1010,1075,0.4844124700239808,0.5155875299760192
E01018938,1643,766,877,0.4662203286670724,0.5337796713329276
E01018959,1436,667,769,0.46448467966573814,0.5355153203342619
E01018960,2435,1145,1290,0.4702258726899384,0.5297741273100616
E01018961,1414,685,729,0.48444130127298446,0.5155586987270155
E01018943,2371,1181,1190,0.4981020666385491,0.5018979333614508
E01018951,2428,1168,1260,0.48105436573311366,0.5189456342668863
E01018974,2706,1334,1372,0.49297856614929786,0.5070214338507022
E01018940,1622,771,851,0.4753390875462392,0.5246609124537608
E01018941,1646,810,836,0.49210206561360875,0.5078979343863913
E01018942,1486,718,768,0.4831763122476447,0.5168236877523553
E01018969,2249,1092,1157,0.48554913294797686,0.5144508670520231
E01018953,1288,616,672,0.4782608695652174,0.5217391304347826
E01018968,2533,1267,1266,0.5001973943939992,0.4998026056060008
E01033291,1832,900,932,0.4912663755458515,0.5087336244541485
E01033292,1546,731,815,0.47283311772315656,0.5271668822768435
E01018946,1499,733,766,0.48899266177451634,0.5110073382254836
E01018948,1708,842,866,0.4929742388758782,0.5070257611241218
E01018949,1392,654,738,0.4698275862068966,0.5301724137931034
E01018950,1692,850,842,0.5023640661938534,0.49763593380614657
E01034847,1820,887,933,0.48736263736263735,0.5126373626373626
E01034848,2136,1016,1120,0.4756554307116105,0.5243445692883895
E01018925,2232,1082,1150,0.48476702508960573,0.5152329749103942
E01018952,1238,626,612,0.505654281098546,0.49434571890145396
E01018965,2451,1201,1250,0.4900040799673603,0.5099959200326397
E01018966,1088,547,541,0.5027573529411765,0.49724264705882354
E01018967,1323,664,659,0.5018896447467877,0.4981103552532124
E01018924,1297,650,647,0.5011565150346955,0.49884348496530456
E01018962,1936,944,992,0.48760330578512395,0.512396694214876
E01033289,2038,985,1053,0.4833169774288518,0.5166830225711482
E01018954,1603,795,808,0.4959451029320025,0.5040548970679976
E01018955,1589,760,829,0.47828823159219636,0.5217117684078036
E01018956,1067,536,531,0.5023430178069354,0.49765698219306465
E01018957,1512,784,728,0.5185185185185185,0.48148148148148145
E01018958,1005,494,511,0.49154228855721394,0.5084577114427861
E01018970,1632,778,854,0.47671568627450983,0.5232843137254902
E01018971,1904,875,1029,0.45955882352941174,0.5404411764705882
E01018972,1759,826,933,0.4695849914724275,0.5304150085275725
E01018973,1514,694,820,0.4583883751651255,0.5416116248348745
E01018923,1403,688,715,0.4903777619387028,0.5096222380612973
E01018926,2496,1210,1286,0.484775641025641,0.5152243589743589
E01018944,1118,557,561,0.49821109123434704,0.501788908765653
E01018945,1359,646,713,0.4753495217071376,0.5246504782928624
E01018932,1666,791,875,0.47478991596638653,0.5252100840336135
E01018933,1932,969,963,0.5015527950310559,0.4984472049689441
E01018934,2661,1369,1292,0.5144682450206689,0.4855317549793311
E01018935,2662,1301,1361,0.48873027798647634,0.5112697220135237
E01018927,1740,837,903,0.4810344827586207,0.5189655172413793
E01018928,1672,838,834,0.5011961722488039,0.4988038277511962
E01018929,1895,935,960,0.49340369393139843,0.5065963060686016
E01018930,1584,785,799,0.49558080808080807,0.5044191919191919
E01018931,1097,545,552,0.4968094804010939,0.5031905195989061
E01019008,1331,594,737,0.4462809917355372,0.5537190082644629
E01019009,1557,745,812,0.47848426461143223,0.5215157353885678
E01019010,1186,574,612,0.4839797639123103,0.5160202360876898
E01019011,1584,737,847,0.4652777777777778,0.5347222222222222
E01019012,1226,581,645,0.4738988580750408,0.5261011419249593
E01018978,1534,725,809,0.4726205997392438,0.5273794002607562
E01018981,2059,975,1084,0.47353084021369596,0.526469159786304
E01018982,2052,965,1087,0.4702729044834308,0.5297270955165692
E01018983,1537,716,821,0.46584255042290174,0.5341574495770982
E01034868,1462,675,787,0.46169630642954856,0.5383036935704515
E01034869,1654,842,812,0.5090689238210399,0.4909310761789601
E01018985,2359,1109,1250,0.47011445527766005,0.52988554472234
E01018986,1507,734,773,0.4870603848706038,0.5129396151293961
E01018987,2033,1002,1031,0.4928676832267585,0.5071323167732416
E01018975,2119,1021,1098,0.4818310523831996,0.5181689476168003
E01018979,1511,753,758,0.4983454665784249,0.5016545334215751
E01018980,1635,826,809,0.5051987767584097,0.4948012232415902
E01018990,1846,859,987,0.46533044420368364,0.5346695557963164
E01019007,2360,1170,1190,0.4957627118644068,0.5042372881355932
E01018988,1637,789,848,0.48197923029932804,0.518020769700672
E01018989,1835,875,960,0.4768392370572207,0.5231607629427792
E01018991,1537,728,809,0.47364996746909566,0.5263500325309044
E01019006,1524,733,791,0.4809711286089239,0.5190288713910761
E01018976,2088,1022,1066,0.48946360153256707,0.5105363984674329
E01018977,1317,643,674,0.4882308276385725,0.5117691723614275
E01018994,1950,987,963,0.5061538461538462,0.4938461538461538
E01018996,1503,715,788,0.47571523619427813,0.5242847638057219
E01018997,1502,724,778,0.48202396804260983,0.5179760319573902
E01018995,2084,1032,1052,0.4952015355086372,0.5047984644913628
E01018998,1373,669,704,0.48725418790968683,0.5127458120903132
E01018999,1594,748,846,0.46925972396486826,0.5307402760351317
E01019001,1511,726,785,0.4804765056254136,0.5195234943745863
E01018992,1747,810,937,0.4636519748139668,0.5363480251860332
E01018993,1486,689,797,0.4636608344549125,0.5363391655450875
E01019005,2163,1072,1091,0.49560795191863155,0.5043920480813685
E01019000,1440,672,768,0.4666666666666667,0.5333333333333333
E01019002,1202,566,636,0.47088186356073214,0.5291181364392679
E01019003,1704,827,877,0.48532863849765256,0.5146713615023474
E01019004,1467,680,787,0.46353101567825494,0.5364689843217451
E01019048,1906,960,946,0.5036726128016789,0.4963273871983211
E01019050,1834,897,937,0.48909487459105777,0.5109051254089422
E01019051,1627,769,858,0.47264904732636753,0.5273509526736324
E01034853,1324,630,694,0.47583081570996977,0.5241691842900302
E01034854,1503,727,776,0.48369926813040587,0.5163007318695941
E01034855,1545,775,770,0.5016181229773463,0.49838187702265374
E01019060,1368,672,696,0.49122807017543857,0.5087719298245614
E01019061,1837,902,935,0.49101796407185627,0.5089820359281437
E01019062,1824,878,946,0.48135964912280704,0.518640350877193
E01019063,2251,1106,1145,0.49133718347401156,0.5086628165259884
E01019064,2208,1070,1138,0.4846014492753623,0.5153985507246377
E01019065,1338,664,674,0.4962630792227205,0.5037369207772795
E01019028,2137,1058,1079,0.49508656995788486,0.5049134300421151
E01019029,1678,851,827,0.5071513706793802,0.4928486293206198
E01019030,2087,1027,1060,0.4920939147101102,0.5079060852898898
E01019031,1728,857,871,0.49594907407407407,0.5040509259259259
E01019018,1574,762,812,0.4841168996188056,0.5158831003811944
E01019019,1812,846,966,0.46688741721854304,0.5331125827814569
E01019020,1609,858,751,0.5332504661280298,0.46674953387197016
E01019021,1596,763,833,0.4780701754385965,0.5219298245614035
E01019022,1821,847,974,0.46512904997254256,0.5348709500274574
E01019023,1665,808,857,0.4852852852852853,0.5147147147147147
E01019052,2002,993,1009,0.49600399600399603,0.503996003996004
E01019053,2266,1119,1147,0.49382171226831423,0.5061782877316858
E01019054,1958,943,1015,0.4816138917262513,0.5183861082737488
E01019055,1522,767,755,0.5039421813403416,0.49605781865965837
E01019035,1701,823,878,0.48383303938859495,0.5161669606114051
E01019036,1823,903,920,0.4953373560065826,0.5046626439934174
E01019037,1603,762,841,0.47535870243293826,0.5246412975670618
E01019074,1922,963,959,0.5010405827263268,0.49895941727367327
E01019075,1889,921,968,0.4875595553202753,0.5124404446797247
E01019076,2160,1117,1043,0.5171296296296296,0.4828703703703704
E01019069,1248,621,627,0.49759615384615385,0.5024038461538461
E01019070,2086,1037,1049,0.4971236816874401,0.50287631831256
E01019071,1781,893,888,0.5014037057832679,0.4985962942167322
E01019072,1498,727,771,0.48531375166889185,0.5146862483311081
E01019073,1588,778,810,0.4899244332493703,0.5100755667506297
E01019056,1350,619,731,0.4585185185185185,0.5414814814814815
E01019057,1864,882,982,0.47317596566523606,0.526824034334764
E01019058,2236,1071,1165,0.4789803220035778,0.5210196779964222
E01019059,1480,718,762,0.4851351351351351,0.5148648648648648
E01019024,1511,712,799,0.47121111846459296,0.528788881535407
E01019025,1518,711,807,0.4683794466403162,0.5316205533596838
E01019026,1416,670,746,0.4731638418079096,0.5268361581920904
E01019027,1242,593,649,0.4774557165861514,0.5225442834138486
E01019013,2087,1020,1067,0.48873981792046,0.51126018207954
E01019014,1509,727,782,0.48177601060304837,0.5182239893969516
E01019015,1357,661,696,0.4871039056742815,0.5128960943257185
E01019016,1848,895,953,0.4843073593073593,0.5156926406926406
E01034856,1578,782,796,0.4955640050697085,0.5044359949302915
E01034857,1224,587,637,0.4795751633986928,0.5204248366013072
E01019032,1450,720,730,0.496551724137931,0.503448275862069
E01019034,1574,793,781,0.5038119440914867,0.49618805590851334
E01019045,2707,1333,1374,0.4924270410048024,0.5075729589951976
E01019047,1528,734,794,0.4803664921465969,0.5196335078534031
E01019033,1601,767,834,0.4790755777638976,0.5209244222361025
E01019041,1895,907,988,0.47862796833773086,0.5213720316622691
E01019042,1743,854,889,0.4899598393574297,0.5100401606425703
E01019043,1977,990,987,0.5007587253414264,0.4992412746585736
E01019044,1490,704,786,0.47248322147651006,0.5275167785234899
E01019046,1334,661,673,0.4955022488755622,0.5044977511244377
E01019038,1043,502,541,0.4813039309683605,0.5186960690316395
E01019039,1316,650,666,0.4939209726443769,0.506079027355623
E01019040,1319,633,686,0.4799090219863533,0.5200909780136467
E01019066,1369,662,707,0.4835646457268079,0.5164353542731921
E01019067,1380,660,720,0.4782608695652174,0.5217391304347826
E01019068,1591,791,800,0.497171590194846,0.502828409805154
E01019077,2054,1004,1050,0.48880233690360275,0.5111976630963972
E01031841,1865,925,940,0.4959785522788204,0.5040214477211796
E01031868,1761,870,891,0.4940374787052811,0.5059625212947189
E01031873,1844,879,965,0.47668112798264645,0.5233188720173536
E01031874,1540,734,806,0.4766233766233766,0.5233766233766234
E01031884,1559,758,801,0.48620910840282233,0.5137908915971777
E01031861,2771,1297,1474,0.46806207145434864,0.5319379285456514
E01031862,1486,715,771,0.48115746971736206,0.5188425302826379
E01031863,1098,519,579,0.4726775956284153,0.5273224043715847
E01031864,1205,574,631,0.4763485477178423,0.5236514522821577
E01031865,2568,1286,1282,0.5007788161993769,0.4992211838006231
E01031866,1590,779,811,0.489937106918239,0.510062893081761
E01031869,1950,934,1016,0.47897435897435897,0.521025641025641
E01031870,1846,879,967,0.4761646803900325,0.5238353196099675
E01031871,1707,834,873,0.48857644991212656,0.5114235500878734
E01031850,1941,941,1000,0.48480164863472436,0.5151983513652756
E01031851,1515,756,759,0.499009900990099,0.500990099009901
E01031852,2058,1008,1050,0.4897959183673469,0.5102040816326531
E01032688,1272,632,640,0.4968553459119497,0.5031446540880503
E01032689,1275,611,664,0.4792156862745098,0.5207843137254902
E01032692,1144,554,590,0.48426573426573427,0.5157342657342657
E01032693,1821,874,947,0.47995606809445357,0.5200439319055464
E01031853,1485,731,754,0.4922558922558923,0.5077441077441077
E01031854,1758,836,922,0.47554038680318544,0.5244596131968146
E01031855,1491,717,774,0.48088531187122735,0.5191146881287726
E01031856,1633,806,827,0.4935701163502756,0.5064298836497244
E01031845,1667,819,848,0.4913017396520696,0.5086982603479304
E01031846,1546,788,758,0.5097024579560155,0.49029754204398446
E01031848,2153,1294,859,0.6010218300046447,0.3989781699953553
E01031872,1543,721,822,0.4672715489306546,0.5327284510693454
E01031876,1509,735,774,0.4870775347912525,0.5129224652087475
E01031843,1790,865,925,0.48324022346368717,0.5167597765363129
E01031847,1931,941,990,0.4873122734334542,0.5126877265665458
E01031849,1631,813,818,0.4984671980380135,0.5015328019619865
E01031877,1965,975,990,0.4961832061068702,0.5038167938931297
E01031857,1515,727,788,0.47986798679867987,0.5201320132013202
E01031858,1865,882,983,0.47292225201072385,0.5270777479892761
E01031883,1939,954,985,0.4920061887570913,0.5079938112429088
E01034538,1296,606,690,0.4675925925925926,0.5324074074074074
E01034539,1627,795,832,0.48862937922556854,0.5113706207744315
E01031842,1902,950,952,0.49947423764458465,0.5005257623554153
E01031867,1784,871,913,0.4882286995515695,0.5117713004484304
E01031882,1983,1032,951,0.5204236006051437,0.4795763993948563
E01031887,1778,862,916,0.484814398200225,0.515185601799775
E01031934,1903,932,971,0.48975302154492906,0.5102469784550709
E01031935,1703,837,866,0.4914856136230182,0.5085143863769818
E01031936,1427,683,744,0.47862648913805184,0.5213735108619482
E01031885,1725,855,870,0.4956521739130435,0.5043478260869565
E01031947,1655,802,853,0.4845921450151057,0.5154078549848943
E01031948,2671,1331,1340,0.49831523773867464,0.5016847622613253
E01031949,1829,886,943,0.48441771459814104,0.5155822854018589
E01031955,1585,784,801,0.4946372239747634,0.5053627760252366
E01031956,1376,684,692,0.49709302325581395,0.502906976744186
E01031962,1383,693,690,0.5010845986984815,0.49891540130151846
E01034520,1624,812,812,0.5,0.5
E01034521,2270,1125,1145,0.4955947136563877,0.5044052863436124
E01031886,1421,700,721,0.49261083743842365,0.5073891625615764
E01031892,1453,725,728,0.4989676531314522,0.5010323468685478
E01031893,1646,822,824,0.4993924665856622,0.5006075334143378
E01031894,1585,784,801,0.4946372239747634,0.5053627760252366
E01031957,1477,712,765,0.4820582261340555,0.5179417738659445
E01031958,1393,679,714,0.48743718592964824,0.5125628140703518
E01031959,1901,923,978,0.4855339295107838,0.5144660704892162
E01031960,1514,760,754,0.5019815059445178,0.49801849405548215
E01031963,2151,1040,1111,0.48349604834960486,0.5165039516503952
E01031964,1945,958,987,0.49254498714652956,0.5074550128534704
E01031967,2203,1069,1134,0.4852473899228325,0.5147526100771675
E01031969,1367,707,660,0.5171909290416972,0.48280907095830283
E01031944,1050,519,531,0.4942857142857143,0.5057142857142857
E01031946,3518,2547,971,0.7239909039226834,0.27600909607731666
E01031961,1383,675,708,0.4880694143167028,0.5119305856832972
E01031965,1385,691,694,0.49891696750902526,0.5010830324909747
E01031966,2807,1340,1467,0.4773779836123976,0.5226220163876024
E01031968,1713,845,868,0.493286631640397,0.506713368359603
E01032699,2143,1059,1084,0.49416705552963136,0.5058329444703686
E01031939,2394,1171,1223,0.48913951545530493,0.5108604845446951
E01031940,2208,1082,1126,0.490036231884058,0.509963768115942
E01031950,1367,669,698,0.4893928310168252,0.5106071689831748
E01031951,1313,708,605,0.5392231530845393,0.4607768469154608
E01031907,2392,1180,1212,0.49331103678929766,0.5066889632107023
E01031910,1541,738,803,0.4789097988319273,0.5210902011680727
E01031914,1351,656,695,0.4855662472242783,0.5144337527757217
E01031915,1559,765,794,0.490699166132136,0.5093008338678641
E01031919,1652,837,815,0.5066585956416465,0.4933414043583535
E01031920,1214,602,612,0.4958813838550247,0.5041186161449753
E01031905,1349,681,668,0.5048183839881394,0.4951816160118606
E01031906,1362,687,675,0.5044052863436124,0.4955947136563877
E01031908,1744,872,872,0.5,0.5
E01031909,1273,636,637,0.4996072270227808,0.5003927729772192
E01031925,1364,669,695,0.4904692082111437,0.5095307917888563
E01031926,1514,710,804,0.46895640686922063,0.5310435931307794
E01031927,1244,637,607,0.5120578778135049,0.4879421221864952
E01031911,1353,660,693,0.4878048780487805,0.5121951219512195
E01031912,1535,803,732,0.5231270358306189,0.47687296416938113
E01031913,1537,767,770,0.4990240728692258,0.5009759271307742
E01031917,1414,727,687,0.5141442715700142,0.48585572842998587
E01031918,2511,1224,1287,0.4874551971326165,0.5125448028673835
E01031928,1235,592,643,0.47935222672064776,0.5206477732793522
E01031904,2581,1254,1327,0.4858581944982565,0.5141418055017435
E01031937,1116,558,558,0.5,0.5
E01031938,1544,765,779,0.4954663212435233,0.5045336787564767
E01034522,1436,719,717,0.5006963788300836,0.49930362116991645
E01034523,1502,721,781,0.4800266311584554,0.5199733688415447
E01031916,1326,654,672,0.49321266968325794,0.5067873303167421
E01031921,1318,626,692,0.47496206373292865,0.5250379362670713
E01031922,1237,639,598,0.5165723524656427,0.4834276475343573
E01031923,1245,614,631,0.4931726907630522,0.5068273092369477
E01031924,1580,773,807,0.4892405063291139,0.510759493670886
E01031895,2573,1264,1309,0.491255343956471,0.5087446560435289
E01031896,1457,696,761,0.4776938915579959,0.5223061084420041
E01031897,1973,1009,964,0.5114039533705018,0.48859604662949824
E01031898,1803,714,1089,0.39600665557404324,0.6039933444259568
E01032690,1875,927,948,0.4944,0.5056
E01032691,1435,692,743,0.48222996515679445,0.5177700348432056
E01031901,1393,670,723,0.4809763101220388,0.5190236898779612
E01031902,1837,907,930,0.49373979314099076,0.5062602068590093
E01031903,2260,1105,1155,0.4889380530973451,0.5110619469026548
E01034524,1221,564,657,0.4619164619164619,0.538083538083538
E01034525,1242,614,628,0.4943639291465378,0.5056360708534622
E01031888,1417,694,723,0.48976711362032466,0.5102328863796753
E01031889,2476,1245,1231,0.502827140549273,0.497172859450727
E01031890,1769,847,922,0.4788015828151498,0.5211984171848502
E01031929,1290,624,666,0.48372093023255813,0.5162790697674419
E01031930,1411,754,657,0.5343727852586818,0.46562721474131824
E01031931,1915,915,1000,0.47780678851174935,0.5221932114882507
E01031932,1567,752,815,0.47989789406509253,0.5201021059349075
E01031933,1808,863,945,0.47732300884955753,0.5226769911504425
E01031941,1762,884,878,0.5017026106696936,0.4982973893303065
E01031942,1338,659,679,0.49252615844544095,0.507473841554559
E01031952,2348,1123,1225,0.4782793867120954,0.5217206132879046
E01034526,1287,618,669,0.4801864801864802,0.5198135198135199
E01034527,1506,694,812,0.46082337317397076,0.5391766268260292
E01031988,2786,1589,1197,0.5703517587939698,0.4296482412060301
E01032026,1613,770,843,0.4773713577185369,0.5226286422814631
E01032696,2303,1196,1107,0.5193226226660878,0.4806773773339123
E01034542,1920,1242,678,0.646875,0.353125
E01034543,1342,686,656,0.511177347242921,0.488822652757079
E01031989,2117,1068,1049,0.5044874822862542,0.4955125177137459
E01031996,1437,725,712,0.5045233124565066,0.4954766875434934
E01031997,1350,659,691,0.48814814814814816,0.5118518518518519
E01031999,2398,1205,1193,0.5025020850708924,0.4974979149291076
E01031974,1312,647,665,0.49314024390243905,0.506859756097561
E01031975,1236,575,661,0.465210355987055,0.5347896440129449
E01031976,2395,1199,1196,0.5006263048016701,0.49937369519832986
E01031978,1612,799,813,0.4956575682382134,0.5043424317617866
E01031979,2074,996,1078,0.4802314368370299,0.5197685631629702
E01034544,1553,804,749,0.5177076625885383,0.4822923374114617
E01034545,1311,637,674,0.4858886346300534,0.5141113653699466
E01034546,1504,736,768,0.48936170212765956,0.5106382978723404
E01032013,2031,969,1062,0.4771048744460857,0.5228951255539144
E01032032,1531,773,758,0.5048987589810582,0.4951012410189419
E01032033,1375,664,711,0.4829090909090909,0.517090909090909
E01032034,1455,716,739,0.49209621993127145,0.5079037800687285
E01032010,2138,1040,1098,0.4864359214218896,0.5135640785781104
E01032035,1664,818,846,0.49158653846153844,0.5084134615384616
E01032036,1435,690,745,0.4808362369337979,0.519163763066202
E01032037,1510,721,789,0.4774834437086093,0.5225165562913907
E01031984,2814,1351,1463,0.48009950248756217,0.5199004975124378
E01031985,1324,625,699,0.47205438066465255,0.5279456193353474
E01031986,1224,608,616,0.49673202614379086,0.5032679738562091
E01032017,1508,727,781,0.48209549071618035,0.5179045092838196
E01031980,2685,1305,1380,0.4860335195530726,0.5139664804469274
E01031981,1576,778,798,0.4936548223350254,0.5063451776649747
E01031982,1416,689,727,0.4865819209039548,0.5134180790960452
E01031983,1945,960,985,0.493573264781491,0.506426735218509
E01032018,1583,779,804,0.4921036007580543,0.5078963992419456
E01032019,1432,655,777,0.4574022346368715,0.5425977653631285
E01032020,1476,684,792,0.4634146341463415,0.5365853658536586
E01032025,1398,687,711,0.49141630901287553,0.5085836909871244
E01031990,1951,937,1014,0.48026652998462327,0.5197334700153767
E01032004,2281,1138,1143,0.498903989478299,0.501096010521701
E01032027,1317,629,688,0.4776006074411541,0.5223993925588458
E01032038,1323,627,696,0.47392290249433106,0.5260770975056689
E01032039,2113,1013,1100,0.4794131566493138,0.5205868433506863
E01032040,1402,660,742,0.47075606276747506,0.5292439372325249
E01032001,1471,740,731,0.5030591434398368,0.4969408565601632
E01032002,1317,675,642,0.5125284738041003,0.4874715261958998
E01032003,1773,872,901,0.4918217710095883,0.5081782289904118
E01032024,2345,1169,1176,0.49850746268656715,0.5014925373134328
E01032014,1892,871,1021,0.46035940803382663,0.5396405919661733
E01032015,1295,651,644,0.5027027027027027,0.4972972972972973
E01032016,1321,621,700,0.47009841029523086,0.5299015897047691
E01032021,1648,786,862,0.47694174757281554,0.5230582524271845
E01032000,2161,1015,1146,0.4696899583526145,0.5303100416473855
E01032012,1792,829,963,0.46261160714285715,0.5373883928571429
E01034547,1367,654,713,0.47841989758595466,0.5215801024140454
E01034548,1558,752,806,0.48267008985879334,0.5173299101412067
E01034549,1486,731,755,0.4919246298788694,0.5080753701211306
E01034550,1136,552,584,0.4859154929577465,0.5140845070422535
E01032008,1496,734,762,0.49064171122994654,0.5093582887700535
E01032009,1797,863,934,0.4802448525319978,0.5197551474680022
E01032022,1745,825,920,0.47277936962750716,0.5272206303724928
E01032005,1300,608,692,0.4676923076923077,0.5323076923076923
E01032006,1213,574,639,0.47320692497938993,0.52679307502061
E01032007,1715,849,866,0.49504373177842564,0.5049562682215744
E01032023,1820,894,926,0.4912087912087912,0.5087912087912088
E01031970,1643,781,862,0.4753499695678637,0.5246500304321363
E01031971,1200,572,628,0.4766666666666667,0.5233333333333333
E01031972,1549,752,797,0.4854744996772111,0.5145255003227889
E01032041,1943,977,966,0.5028306742151313,0.4971693257848688
E01032042,1710,832,878,0.4865497076023392,0.5134502923976608
E01031991,2006,1012,994,0.5044865403788634,0.4955134596211366
E01032029,1354,623,731,0.4601181683899557,0.5398818316100443
E01032030,1664,802,862,0.48197115384615385,0.5180288461538461
E01032031,1139,566,573,0.49692712906057945,0.5030728709394205
E01031973,1862,935,927,0.5021482277121375,0.49785177228786254
E01031992,1462,726,736,0.49658002735978113,0.5034199726402189
E01031993,1424,682,742,0.4789325842696629,0.5210674157303371
E01031994,1321,623,698,0.47161241483724453,0.5283875851627555
E01031995,1875,903,972,0.4816,0.5184
E01032063,2231,1070,1161,0.4796055580457194,0.5203944419542806
E01032064,1328,655,673,0.4932228915662651,0.5067771084337349
E01032065,1553,748,805,0.4816484224082421,0.5183515775917579
E01032073,1408,735,673,0.5220170454545454,0.47798295454545453
E01032074,1298,618,680,0.4761171032357473,0.5238828967642527
E01032043,1293,602,691,0.46558391337973704,0.534416086620263
E01032044,1556,747,809,0.4800771208226221,0.5199228791773779
E01032057,1228,612,616,0.498371335504886,0.501628664495114
E01032070,1837,899,938,0.4893848666303756,0.5106151333696244
E01032072,1901,935,966,0.4918463966333509,0.5081536033666492
E01034528,1467,724,743,0.49352419904567146,0.5064758009543285
E01034529,1463,699,764,0.47778537252221465,0.5222146274777854
E01034530,1701,864,837,0.5079365079365079,0.49206349206349204
E01032062,1913,926,987,0.48405645582854157,0.5159435441714585
E01032066,1656,777,879,0.4692028985507246,0.5307971014492754
E01032067,1425,703,722,0.49333333333333335,0.5066666666666667
E01032068,1384,682,702,0.49277456647398843,0.5072254335260116
E01032069,1225,605,620,0.49387755102040815,0.5061224489795918
E01032058,1353,665,688,0.49150036954915005,0.50849963045085
E01032059,1861,940,921,0.5051047823750672,0.4948952176249328
E01032060,1603,796,807,0.49656893325015594,0.5034310667498441
E01032061,1128,532,596,0.4716312056737589,0.5283687943262412
E01032045,1737,810,927,0.46632124352331605,0.533678756476684
E01032046,1565,757,808,0.4837060702875399,0.51629392971246
E01032047,1502,693,809,0.4613848202396804,0.5386151797603196
E01032048,1692,812,880,0.4799054373522459,0.5200945626477541
E01032049,1581,747,834,0.47248576850094876,0.5275142314990512
E01034531,1144,536,608,0.46853146853146854,0.5314685314685315
E01034532,1184,552,632,0.46621621621621623,0.5337837837837838
E01032077,1758,877,881,0.4988623435722412,0.5011376564277589
E01032078,2854,1395,1459,0.48878766643307636,0.5112123335669236
E01032079,1519,747,772,0.49177090190915074,0.5082290980908493
E01032080,1913,940,973,0.4913748039728176,0.5086251960271825
E01032085,1590,803,787,0.5050314465408805,0.4949685534591195
E01032087,2149,1048,1101,0.48766868310842254,0.5123313168915775
E01034533,2075,1013,1062,0.48819277108433734,0.5118072289156627
E01034534,1051,546,505,0.5195052331113226,0.4804947668886774
E01032100,1815,858,957,0.4727272727272727,0.5272727272727272
E01032101,1653,813,840,0.49183303085299457,0.5081669691470054
E01032102,2472,1216,1256,0.4919093851132686,0.5080906148867314
E01034535,1316,657,659,0.4992401215805471,0.5007598784194529
E01034536,1406,705,701,0.5014224751066856,0.49857752489331436
E01034537,1493,716,777,0.4795713328868051,0.5204286671131949
E01032096,1948,952,996,0.4887063655030801,0.5112936344969199
E01032097,1861,908,953,0.4879097259537883,0.5120902740462118
E01032098,1619,771,848,0.4762198888202594,0.5237801111797405
E01032092,1445,711,734,0.49204152249134947,0.5079584775086505
E01032093,2479,1239,1240,0.499798305768455,0.5002016942315449
E01032094,2408,1207,1201,0.5012458471760798,0.49875415282392027
E01032095,1786,863,923,0.4832026875699888,0.5167973124300111
E01032088,1469,707,762,0.48127978216473793,0.5187202178352621
E01032089,1446,742,704,0.5131396957123098,0.48686030428769017
E01032090,1458,689,769,0.4725651577503429,0.5274348422496571
E01032091,1178,591,587,0.50169779286927,0.49830220713073003
E01032053,1460,721,739,0.49383561643835616,0.5061643835616438
E01032083,2456,1225,1231,0.4987785016286645,0.5012214983713354
E01034540,1505,719,786,0.4777408637873754,0.5222591362126245
E01034541,1595,750,845,0.4702194357366771,0.5297805642633229
E01032052,1278,614,664,0.48043818466353677,0.5195618153364632
E01032054,1261,606,655,0.48057097541633625,0.5194290245836638
E01032055,1150,544,606,0.47304347826086957,0.5269565217391304
E01032056,1335,659,676,0.4936329588014981,0.5063670411985018
E01032121,1969,962,1007,0.48857287963433216,0.5114271203656678
E01032104,1531,816,715,0.5329849771391247,0.46701502286087526
E01032105,1455,701,754,0.481786941580756,0.518213058419244
E01032107,1307,666,641,0.5095638867635807,0.4904361132364193
E01032108,1296,619,677,0.47762345679012347,0.5223765432098766
E01032110,2386,1143,1243,0.4790444258172674,0.5209555741827326
E01032111,1300,647,653,0.4976923076923077,0.5023076923076923
E01032112,1440,703,737,0.48819444444444443,0.5118055555555555
E01032113,1344,661,683,0.49181547619047616,0.5081845238095238
E01032103,1696,857,839,0.5053066037735849,0.4946933962264151
E01032106,1498,714,784,0.4766355140186916,0.5233644859813084
E01032109,1430,685,745,0.479020979020979,0.5209790209790209
E01032114,1491,720,771,0.482897384305835,0.5171026156941649
E01032051,1393,687,706,0.49318018664752333,0.5068198133524767
E01032075,1307,638,669,0.4881407804131599,0.5118592195868401
E01032076,1215,583,632,0.47983539094650207,0.5201646090534979
E01032081,1321,628,693,0.4753974261922786,0.5246025738077215
E01032082,1198,593,605,0.494991652754591,0.505008347245409
E01032117,2710,1339,1371,0.4940959409594096,0.5059040590405904
E01032118,1626,794,832,0.4883148831488315,0.5116851168511685
E01034551,1749,818,931,0.4676958261863922,0.5323041738136077
E01034552,1756,884,872,0.5034168564920274,0.49658314350797267
E01032115,1702,817,885,0.4800235017626322,0.5199764982373678
E01032119,1888,945,943,0.5005296610169492,0.4994703389830508
E01032694,1868,893,975,0.47805139186295503,0.521948608137045
E01032695,1497,738,759,0.49298597194388777,0.5070140280561122
E01031859,1573,775,798,0.4926891290527654,0.5073108709472346
E01031860,1503,721,782,0.479707252162342,0.520292747837658
E01034553,1541,756,785,0.49059052563270605,0.509409474367294
E01034554,1824,880,944,0.4824561403508772,0.5175438596491229
E01034555,2177,1330,847,0.6109324758842444,0.3890675241157556
E01031879,1875,1139,736,0.6074666666666667,0.39253333333333335
E01032697,1582,760,822,0.4804045512010114,0.5195954487989887
E01034556,1617,775,842,0.479282622139765,0.520717377860235
E01034557,2176,1365,811,0.6272977941176471,0.3727022058823529
E01034558,1618,846,772,0.522867737948084,0.47713226205191595
E01015301,1612,788,824,0.48883374689826303,0.511166253101737
E01015303,1631,807,824,0.49478847332924586,0.5052115266707541
E01015305,1583,773,810,0.4883133291219204,0.5116866708780796
E01015306,1674,833,841,0.497610513739546,0.502389486260454
E01015302,1828,884,944,0.48358862144420134,0.5164113785557987
E01015304,1811,832,979,0.45941468801766977,0.5405853119823302
E01015308,1813,855,958,0.47159404302261443,0.5284059569773856
E01015311,1384,675,709,0.4877167630057804,0.5122832369942196
E01015332,1587,784,803,0.49401386263390046,0.5059861373660995
E01015333,1546,754,792,0.48771021992238034,0.5122897800776197
E01015334,1663,807,856,0.48526758869512926,0.5147324113048707
E01015335,1672,823,849,0.4922248803827751,0.5077751196172249
E01015337,1860,913,947,0.4908602150537634,0.5091397849462366
E01015343,1669,817,852,0.4895146794487717,0.5104853205512283
E01015349,1749,832,917,0.47570040022870214,0.5242995997712979
E01015351,1481,715,766,0.48278190411883865,0.5172180958811614
E01015352,1633,763,870,0.4672382118799755,0.5327617881200245
E01015353,1113,536,577,0.481581311769991,0.518418688230009
E01015354,1786,834,952,0.4669652855543113,0.5330347144456887
E01015307,1525,757,768,0.4963934426229508,0.5036065573770492
E01015309,1484,706,778,0.4757412398921833,0.5242587601078167
E01015312,1510,717,793,0.47483443708609274,0.5251655629139073
E01015313,1352,632,720,0.46745562130177515,0.5325443786982249
E01015359,1624,786,838,0.4839901477832512,0.5160098522167488
E01015320,1714,834,880,0.4865810968494749,0.5134189031505251
E01015323,1678,844,834,0.5029797377830751,0.4970202622169249
E01015324,1719,848,871,0.49331006399069227,0.5066899360093078
E01015325,1799,877,922,0.4874930516953863,0.5125069483046136
E01015350,1547,733,814,0.4738202973497091,0.5261797026502909
E01015310,1574,747,827,0.47458703939008895,0.525412960609911
E01015336,1784,868,916,0.48654708520179374,0.5134529147982063
E01015355,1728,842,886,0.48726851851851855,0.5127314814814815
E01015357,1505,739,766,0.49102990033222593,0.5089700996677741
E01015358,2163,1048,1115,0.4845122515025428,0.5154877484974573
E01015338,1760,860,900,0.48863636363636365,0.5113636363636364
E01015339,1603,802,801,0.5003119151590767,0.49968808484092325
E01015340,1651,799,852,0.48394912174439736,0.5160508782556027
E01015341,1437,666,771,0.46346555323590816,0.5365344467640919
E01015321,1908,917,991,0.4806079664570231,0.5193920335429769
E01015356,1805,901,904,0.49916897506925206,0.5008310249307479
E01015374,2548,1265,1283,0.49646781789638933,0.5035321821036107
E01015375,2136,1076,1060,0.5037453183520599,0.49625468164794007
E01015377,1720,829,891,0.4819767441860465,0.5180232558139535
E01015322,1711,844,867,0.49327878433664524,0.5067212156633548
E01015330,1889,903,986,0.47803070407623083,0.5219692959237692
E01015342,1654,788,866,0.47642079806529625,0.5235792019347038
E01015373,1760,891,869,0.50625,0.49375
E01015378,1824,944,880,0.5175438596491229,0.4824561403508772
E01015314,1552,781,771,0.5032216494845361,0.49677835051546393
E01015315,1898,952,946,0.5015806111696522,0.49841938883034775
E01015318,1763,831,932,0.471355643788996,0.5286443562110039
E01015319,1362,635,727,0.46622613803230545,0.5337738619676946
E01015344,1866,916,950,0.4908896034297964,0.5091103965702036
E01015346,1621,813,808,0.5015422578655151,0.4984577421344849
E01015348,1858,914,944,0.49192680301399355,0.5080731969860065
E01015360,2002,911,1091,0.45504495504495507,0.544955044955045
E01015326,1946,978,968,0.5025693730729702,0.49743062692702983
E01015331,2410,1223,1187,0.5074688796680498,0.49253112033195023
E01015345,1902,967,935,0.5084121976866456,0.49158780231335436
E01015376,1840,916,924,0.49782608695652175,0.5021739130434782
E01015316,1653,798,855,0.4827586206896552,0.5172413793103449
E01015317,1676,809,867,0.48269689737470167,0.5173031026252983
E01015361,1395,676,719,0.4845878136200717,0.5154121863799284
E01015362,1172,549,623,0.4684300341296928,0.5315699658703071
E01015363,1704,824,880,0.4835680751173709,0.5164319248826291
E01015292,1889,961,928,0.5087347803070408,0.4912652196929592
E01015293,1609,778,831,0.48353014294592916,0.5164698570540709
E01015294,2123,1066,1057,0.5021196420160151,0.49788035798398494
E01015327,2126,1057,1069,0.49717779868297274,0.5028222013170273
E01015329,1689,883,806,0.5227945529899348,0.4772054470100651
E01015272,1875,914,961,0.48746666666666666,0.5125333333333333
E01015273,2167,1085,1082,0.5006922011998154,0.4993077988001846
E01015275,1671,828,843,0.4955116696588869,0.5044883303411131
E01015276,1790,856,934,0.4782122905027933,0.5217877094972067
E01015277,2013,998,1015,0.49577744659711875,0.5042225534028812
E01015286,2012,1042,970,0.5178926441351889,0.4821073558648111
E01015328,1971,990,981,0.502283105022831,0.4977168949771689
E01033242,1023,541,482,0.5288367546432062,0.47116324535679377
E01033285,1337,700,637,0.5235602094240838,0.47643979057591623
E01034271,2782,1303,1479,0.46836808051761325,0.5316319194823867
E01034272,1268,580,688,0.45741324921135645,0.5425867507886435
E01034273,1231,666,565,0.5410235580828595,0.45897644191714054
E01034274,1575,856,719,0.5434920634920635,0.45650793650793653
E01015274,1883,906,977,0.4811471056824217,0.5188528943175783
E01015297,1507,674,833,0.44724618447246184,0.5527538155275381
E01015364,1688,837,851,0.4958530805687204,0.5041469194312796
E01015365,1622,813,809,0.501233045622688,0.49876695437731194
E01015366,1802,844,958,0.4683684794672586,0.5316315205327414
E01015279,1925,995,930,0.5168831168831168,0.4831168831168831
E01015280,2142,1118,1024,0.5219421101774043,0.4780578898225957
E01015281,1823,902,921,0.4947888096544158,0.5052111903455841
E01033241,1097,581,516,0.5296262534184139,0.47037374658158615
E01033283,1195,569,626,0.47615062761506277,0.5238493723849372
E01034275,1109,610,499,0.5500450856627592,0.4499549143372408
E01034276,1082,572,510,0.5286506469500925,0.4713493530499076
E01015295,1511,727,784,0.4811383189940437,0.5188616810059563
E01015296,1902,871,1031,0.4579390115667718,0.5420609884332281
E01015298,1555,725,830,0.4662379421221865,0.5337620578778135
E01015299,1800,821,979,0.45611111111111113,0.5438888888888889
E01015300,1602,766,836,0.4781523096129838,0.5218476903870163
E01015288,2039,1045,994,0.5125061304561059,0.48749386954389407
E01015289,2006,1068,938,0.5324027916251246,0.4675972083748754
E01015290,2799,1423,1376,0.5083958556627367,0.4916041443372633
E01015291,1893,942,951,0.4976228209191759,0.5023771790808241
E01034277,2443,1252,1191,0.5124846500204666,0.4875153499795334
E01034278,2007,1006,1001,0.5012456402590931,0.4987543597409068
E01015431,1474,752,722,0.5101763907734057,0.4898236092265943
E01015432,1738,842,896,0.4844649021864212,0.5155350978135789
E01015433,1515,730,785,0.48184818481848185,0.5181518151815182
E01015434,1605,765,840,0.4766355140186916,0.5233644859813084
E01015379,1454,714,740,0.49105914718019256,0.5089408528198074
E01015435,1864,902,962,0.48390557939914164,0.5160944206008584
E01015436,1364,669,695,0.4904692082111437,0.5095307917888563
E01015437,1242,591,651,0.4758454106280193,0.5241545893719807
E01015395,1367,671,696,0.4908558888076079,0.5091441111923921
E01015396,1575,765,810,0.4857142857142857,0.5142857142857142
E01015397,1400,665,735,0.475,0.525
E01015398,1318,632,686,0.4795144157814871,0.5204855842185129
E01015399,1555,713,842,0.4585209003215434,0.5414790996784566
E01015400,1625,797,828,0.49046153846153845,0.5095384615384615
E01015401,1450,699,751,0.4820689655172414,0.5179310344827586
E01015412,1298,662,636,0.5100154083204931,0.4899845916795069
E01015413,1423,695,728,0.4884047786366831,0.5115952213633169
E01015414,1574,741,833,0.4707750952986023,0.5292249047013977
E01015415,1240,585,655,0.4717741935483871,0.5282258064516129
E01015416,1300,640,660,0.49230769230769234,0.5076923076923077
E01015407,1509,737,772,0.48840291583830353,0.5115970841616965
E01015408,1750,873,877,0.49885714285714283,0.5011428571428571
E01015409,1430,665,765,0.46503496503496505,0.534965034965035
E01015410,1493,738,755,0.4943067649028801,0.5056932350971199
E01015411,1366,670,696,0.4904831625183016,0.5095168374816984
E01015417,1521,726,795,0.47731755424063116,0.5226824457593688
E01015418,1526,742,784,0.48623853211009177,0.5137614678899083
E01015419,1773,872,901,0.4918217710095883,0.5081782289904118
E01015420,1650,776,874,0.4703030303030303,0.5296969696969697
E01015421,1593,759,834,0.4764595103578154,0.5235404896421846
E01015422,1408,683,725,0.4850852272727273,0.5149147727272727
E01015380,1799,882,917,0.490272373540856,0.5097276264591439
E01015381,1736,873,863,0.5028801843317973,0.4971198156682028
E01015382,1961,959,1002,0.4890362060173381,0.5109637939826619
E01015383,1474,705,769,0.47829036635006783,0.5217096336499322
E01015384,1644,817,827,0.49695863746958635,0.5030413625304136
E01015385,1790,856,934,0.4782122905027933,0.5217877094972067
E01015438,1581,775,806,0.49019607843137253,0.5098039215686274
E01015439,1838,925,913,0.5032644178454843,0.4967355821545158
E01015441,1984,1006,978,0.5070564516129032,0.49294354838709675
E01015442,2040,999,1041,0.48970588235294116,0.5102941176470588
E01015443,1982,951,1031,0.4798183652875883,0.5201816347124117
E01015444,1736,862,874,0.4965437788018433,0.5034562211981567
E01015386,1677,842,835,0.5020870602265951,0.4979129397734049
E01015387,1524,736,788,0.48293963254593175,0.5170603674540682
E01015388,1477,764,713,0.5172647257955315,0.4827352742044685
E01015389,1438,727,711,0.5055632823365785,0.4944367176634214
E01015390,1710,834,876,0.48771929824561405,0.512280701754386
E01015391,1461,734,727,0.5023956194387406,0.4976043805612594
E01015392,1478,689,789,0.46617050067659,0.5338294993234101
E01015393,1302,637,665,0.489247311827957,0.510752688172043
E01015394,1652,824,828,0.49878934624697335,0.5012106537530266
E01015440,2112,1071,1041,0.5071022727272727,0.4928977272727273
E01015447,1714,810,904,0.4725787631271879,0.5274212368728122
E01015449,1778,868,910,0.4881889763779528,0.5118110236220472
E01015456,1820,852,968,0.46813186813186813,0.5318681318681319
E01015457,1865,919,946,0.4927613941018767,0.5072386058981233
E01015445,1906,930,976,0.4879328436516264,0.5120671563483735
E01015446,1628,780,848,0.47911547911547914,0.5208845208845209
E01015448,1612,794,818,0.49255583126550867,0.5074441687344913
E01015450,1736,878,858,0.5057603686635944,0.4942396313364055
E01015451,1579,739,840,0.4680177327422419,0.5319822672577581
E01015458,1550,749,801,0.4832258064516129,0.516774193548387
E01015460,1858,900,958,0.48439181916038754,0.5156081808396125
E01015461,1652,855,797,0.5175544794188862,0.4824455205811138
E01015462,1692,845,847,0.49940898345153667,0.5005910165484634
E01015463,1655,811,844,0.4900302114803625,0.5099697885196375
E01015464,1637,794,843,0.48503359804520463,0.5149664019547954
E01015427,1727,918,809,0.5315576143601621,0.46844238563983787
E01015428,2431,1175,1256,0.4833401892225422,0.5166598107774578
E01015429,1783,842,941,0.4722378014582165,0.5277621985417835
E01015430,1491,729,762,0.48893360160965793,0.5110663983903421
E01015465,1748,845,903,0.4834096109839817,0.5165903890160183
E01015466,1778,868,910,0.4881889763779528,0.5118110236220472
E01032659,1278,604,674,0.4726134585289515,0.5273865414710485
E01032660,1634,797,837,0.48776009791921665,0.5122399020807834
E01032661,1346,670,676,0.49777117384843983,0.5022288261515602
E01032662,1188,581,607,0.4890572390572391,0.5109427609427609
E01034281,1168,507,661,0.4340753424657534,0.5659246575342466
E01034282,1291,596,695,0.4616576297443842,0.5383423702556158
E01015424,1417,691,726,0.4876499647141849,0.5123500352858151
E01015425,1303,613,690,0.47045280122793554,0.5295471987720645
E01015426,1426,693,733,0.48597475455820477,0.5140252454417953
E01034283,1521,734,787,0.482577251808021,0.517422748191979
E01034284,1114,524,590,0.4703770197486535,0.5296229802513465
E01015452,2094,1000,1094,0.4775549188156638,0.5224450811843362
E01015453,1932,946,986,0.489648033126294,0.510351966873706
E01015454,2085,1036,1049,0.49688249400479617,0.5031175059952039
E01015455,1911,883,1028,0.4620617477760335,0.5379382522239665
E01015459,1784,877,907,0.4915919282511211,0.5084080717488789
E01015402,1837,891,946,0.48502994011976047,0.5149700598802395
E01015403,1723,791,932,0.4590829947765525,0.5409170052234474
E01015404,1777,855,922,0.4811480022509848,0.5188519977490152
E01015405,1679,827,852,0.4925550923168553,0.5074449076831448
E01015406,1524,775,749,0.5085301837270341,0.4914698162729659
E01020343,1520,736,784,0.4842105263157895,0.5157894736842106
E01020344,1502,757,745,0.503994673768309,0.4960053262316911
E01020345,1328,655,673,0.4932228915662651,0.5067771084337349
E01020365,1876,900,976,0.47974413646055436,0.5202558635394456
E01020351,1278,627,651,0.49061032863849763,0.5093896713615024
E01020352,1485,720,765,0.48484848484848486,0.5151515151515151
E01020353,1739,805,934,0.4629097182288672,0.5370902817711328
E01020359,1366,652,714,0.4773060029282577,0.5226939970717424
E01020366,2275,1112,1163,0.4887912087912088,0.5112087912087913
E01020349,1808,811,997,0.4485619469026549,0.5514380530973452
E01020350,1951,917,1034,0.47001537672988214,0.5299846232701179
E01020357,2214,1053,1161,0.47560975609756095,0.524390243902439
E01020358,1509,723,786,0.47912524850894633,0.5208747514910537
E01020369,1371,629,742,0.4587892049598833,0.5412107950401167
E01020370,1652,776,876,0.46973365617433416,0.5302663438256658
E01020371,1657,785,872,0.47374773687386845,0.5262522631261316
E01020372,1561,721,840,0.4618834080717489,0.5381165919282511
E01020346,1599,762,837,0.47654784240150094,0.5234521575984991
E01020347,1726,828,898,0.4797219003476246,0.5202780996523755
E01020348,1647,813,834,0.4936247723132969,0.5063752276867031
E01020363,1135,524,611,0.4616740088105727,0.5383259911894274
E01020360,1741,816,925,0.46869615163699024,0.5313038483630098
E01020361,1760,862,898,0.48977272727272725,0.5102272727272728
E01020364,1594,748,846,0.46925972396486826,0.5307402760351317
E01020367,1787,820,967,0.45886961387800784,0.5411303861219922
E01034279,1515,737,778,0.4864686468646865,0.5135313531353135
E01034280,1072,517,555,0.4822761194029851,0.5177238805970149
E01020354,1468,684,784,0.4659400544959128,0.5340599455040872
E01020355,1923,924,999,0.48049921996879874,0.5195007800312013
E01020356,1616,740,876,0.45792079207920794,0.5420792079207921
E01020362,1464,700,764,0.4781420765027322,0.5218579234972678
E01015371,1369,701,668,0.5120525931336742,0.48794740686632576
E01015372,2031,958,1073,0.47168882323978334,0.5283111767602167
E01033286,1134,581,553,0.5123456790123457,0.4876543209876543
E01033288,1187,598,589,0.5037910699241785,0.4962089300758214
E01015367,2453,1314,1139,0.5356706074194864,0.46432939258051364
E01015368,1740,860,880,0.4942528735632184,0.5057471264367817
E01015369,1647,804,843,0.48816029143898,0.51183970856102
E01015370,1618,806,812,0.49814585908529047,0.5018541409147095
E01020373,1328,652,676,0.49096385542168675,0.5090361445783133
E01020374,1541,755,786,0.4899415963659961,0.5100584036340039
E01020389,2160,1058,1102,0.4898148148148148,0.5101851851851852
E01020397,1419,686,733,0.4834390415785765,0.5165609584214236
E01020416,1518,731,787,0.48155467720685113,0.5184453227931489
E01020417,1144,567,577,0.4956293706293706,0.5043706293706294
E01020418,1541,749,792,0.48604802076573655,0.5139519792342635
E01020419,2034,997,1037,0.49016715830875124,0.5098328416912488
E01020420,1452,708,744,0.48760330578512395,0.512396694214876
E01020411,1129,539,590,0.47741364038972545,0.5225863596102746
E01020412,1416,680,736,0.480225988700565,0.519774011299435
E01020413,1479,712,767,0.48140635564570655,0.5185936443542934
E01020414,1969,963,1006,0.48908075165058407,0.5109192483494159
E01020415,1497,732,765,0.48897795591182364,0.5110220440881763
E01020403,1645,800,845,0.48632218844984804,0.513677811550152
E01020404,1686,790,896,0.46856465005931197,0.531435349940688
E01020405,2075,1023,1052,0.49301204819277106,0.5069879518072289
E01020406,2498,1229,1269,0.4919935948759007,0.5080064051240992
E01020396,1119,558,561,0.49865951742627346,0.5013404825737265
E01020398,2406,1185,1221,0.4925187032418953,0.5074812967581047
E01020409,1298,636,662,0.4899845916795069,0.5100154083204931
E01020410,1259,627,632,0.4980142970611596,0.5019857029388404
E01020421,1315,632,683,0.4806083650190114,0.5193916349809886
E01020422,1621,727,894,0.4484885872917952,0.5515114127082048
E01020423,1453,680,773,0.4679972470750172,0.5320027529249828
E01020424,1383,659,724,0.4765003615328995,0.5234996384671005
E01020425,1631,782,849,0.47946045370938073,0.5205395462906193
E01020377,1568,752,816,0.47959183673469385,0.5204081632653061
E01020379,1514,733,781,0.48414795244385733,0.5158520475561427
E01020380,1701,844,857,0.49617871840094063,0.5038212815990594
E01020381,1246,622,624,0.49919743178170145,0.5008025682182986
E01020390,1335,648,687,0.4853932584269663,0.5146067415730337
E01020391,1464,704,760,0.4808743169398907,0.5191256830601093
E01020392,1754,806,948,0.45952109464082097,0.540478905359179
E01020393,1523,751,772,0.4931057124097177,0.5068942875902823
E01020394,1717,805,912,0.46884100174723353,0.5311589982527665
E01020375,1337,624,713,0.4667165295437547,0.5332834704562454
E01020376,1098,508,590,0.46265938069216755,0.5373406193078324
E01020378,1558,725,833,0.4653401797175867,0.5346598202824133
E01020407,1202,585,617,0.48668885191347755,0.5133111480865225
E01020408,1127,530,597,0.4702750665483585,0.5297249334516415
E01020426,1810,843,967,0.46574585635359117,0.5342541436464089
E01020427,2231,1029,1202,0.4612281488121918,0.5387718511878081
E01020428,1926,895,1031,0.46469366562824505,0.5353063343717549
E01020429,2020,949,1071,0.4698019801980198,0.5301980198019802
E01020395,1905,888,1017,0.46614173228346456,0.5338582677165354
E01020400,1632,818,814,0.5012254901960784,0.4987745098039216
E01020401,1638,784,854,0.47863247863247865,0.5213675213675214
E01020402,1561,761,800,0.4875080076873799,0.5124919923126201
E01034372,1434,698,736,0.48675034867503486,0.5132496513249651
E01034373,1631,781,850,0.47884733292458614,0.5211526670754139
E01020382,1521,748,773,0.4917817225509533,0.5082182774490467
E01020383,1996,944,1052,0.4729458917835671,0.5270541082164328
E01020384,1659,803,856,0.48402652200120555,0.5159734779987944
E01020385,1275,664,611,0.5207843137254902,0.4792156862745098
E01020386,1331,704,627,0.5289256198347108,0.47107438016528924
E01020387,1108,555,553,0.5009025270758123,0.4990974729241877
E01020388,1485,704,781,0.4740740740740741,0.5259259259259259
E01020443,2412,1160,1252,0.48092868988391374,0.5190713101160862
E01020447,1732,804,928,0.46420323325635104,0.535796766743649
E01020463,1640,781,859,0.47621951219512193,0.5237804878048781
E01020464,1531,733,798,0.47877204441541477,0.5212279555845852
E01020440,1997,973,1024,0.4872308462694041,0.5127691537305958
E01020450,2265,1103,1162,0.4869757174392936,0.5130242825607064
E01020462,1852,888,964,0.4794816414686825,0.5205183585313174
E01033156,1705,815,890,0.4780058651026393,0.5219941348973607
E01033158,1367,655,712,0.479151426481346,0.520848573518654
E01020454,2014,1004,1010,0.4985104270109235,0.5014895729890765
E01020456,1819,902,917,0.4958768554150632,0.5041231445849368
E01020457,1595,745,850,0.4670846394984326,0.5329153605015674
E01034374,2184,1044,1140,0.47802197802197804,0.521978021978022
E01034375,1546,738,808,0.47736093143596375,0.5226390685640362
E01020433,1771,877,894,0.49520045172219085,0.5047995482778092
E01020434,1787,869,918,0.48628987129266926,0.5137101287073307
E01020449,2036,964,1072,0.47347740667976423,0.5265225933202358
E01020458,2193,1052,1141,0.4797081623347013,0.5202918376652986
E01034376,1318,670,648,0.5083459787556904,0.49165402124430957
E01034377,1334,638,696,0.4782608695652174,0.5217391304347826
E01020444,1800,858,942,0.4766666666666667,0.5233333333333333
E01020445,1452,693,759,0.4772727272727273,0.5227272727272727
E01020446,1547,739,808,0.4776987718164189,0.5223012281835812
E01020460,2357,1350,1007,0.5727619855748833,0.42723801442511666
E01020442,1974,963,1011,0.4878419452887538,0.5121580547112462
E01020452,2583,1326,1257,0.5133565621370499,0.48664343786295006
E01020453,1826,884,942,0.484118291347207,0.515881708652793
E01034378,2642,1547,1095,0.5855412566237699,0.4144587433762301
E01020435,1733,853,880,0.49221004039238314,0.5077899596076169
E01020436,2215,1086,1129,0.490293453724605,0.509706546275395
E01020437,1979,958,1021,0.48408287013643253,0.5159171298635674
E01020438,2047,941,1106,0.4596971177332682,0.5403028822667318
E01020439,2385,1188,1197,0.4981132075471698,0.5018867924528302
E01020430,1429,712,717,0.4982505248425472,0.5017494751574527
E01020431,1208,629,579,0.5206953642384106,0.4793046357615894
E01020432,1304,635,669,0.4869631901840491,0.5130368098159509
E01020441,1967,944,1023,0.4799186578546009,0.5200813421453991
E01020448,1980,974,1006,0.4919191919191919,0.5080808080808081
E01020465,1946,968,978,0.49743062692702983,0.5025693730729702
E01020469,2076,1016,1060,0.48940269749518306,0.5105973025048169
E01020470,1812,851,961,0.4696467991169978,0.5303532008830022
E01020471,1324,644,680,0.486404833836858,0.513595166163142
E01020472,1473,717,756,0.48676171079429736,0.5132382892057027
E01020473,1601,750,851,0.4684572142410993,0.5315427857589007
E01020474,1929,936,993,0.48522550544323484,0.5147744945567652
E01020475,2322,1144,1178,0.4926787252368648,0.5073212747631353
E01020476,1195,575,620,0.4811715481171548,0.5188284518828452
E01020477,1422,688,734,0.4838255977496484,0.5161744022503516
E01020485,1448,669,779,0.4620165745856354,0.5379834254143646
E01020486,1710,782,928,0.45730994152046783,0.5426900584795321
E01020487,1229,589,640,0.4792514239218877,0.5207485760781123
E01020488,1494,710,784,0.47523427041499333,0.5247657295850067
E01020489,1314,663,651,0.5045662100456622,0.4954337899543379
E01020490,1642,821,821,0.5,0.5
E01020491,1652,807,845,0.48849878934624696,0.511501210653753
E01020492,1158,566,592,0.48877374784110533,0.5112262521588946
E01020493,2564,1402,1162,0.546801872074883,0.453198127925117
E01020466,1694,826,868,0.48760330578512395,0.512396694214876
E01020467,1830,913,917,0.4989071038251366,0.5010928961748634
E01020468,1533,742,791,0.4840182648401826,0.5159817351598174
E01020478,1110,543,567,0.4891891891891892,0.5108108108108108
E01020479,1128,515,613,0.45656028368794327,0.5434397163120568
E01020480,1696,796,900,0.4693396226415094,0.5306603773584906
E01020481,1326,631,695,0.475867269984917,0.524132730015083
E01020482,1561,740,821,0.4740550928891736,0.5259449071108264
E01020483,1185,591,594,0.49873417721518987,0.5012658227848101
E01020484,1422,696,726,0.48945147679324896,0.510548523206751
E01020542,1329,620,709,0.46651617757712566,0.5334838224228743
E01020543,1454,678,776,0.46629986244841815,0.5337001375515819
E01020544,1607,698,909,0.4343497199751089,0.5656502800248911
E01020546,1481,902,579,0.6090479405806887,0.39095205941931127
E01020547,1135,505,630,0.44493392070484583,0.5550660792951542
E01034379,1766,706,1060,0.39977349943374857,0.6002265005662514
E01034380,1587,703,884,0.44297416509136733,0.5570258349086327
E01020497,1872,881,991,0.4706196581196581,0.5293803418803419
E01020508,2115,1048,1067,0.4955082742316785,0.5044917257683215
E01020541,2110,1030,1080,0.4881516587677725,0.5118483412322274
E01020550,1698,818,880,0.4817432273262662,0.5182567726737338
E01020494,1265,620,645,0.4901185770750988,0.5098814229249012
E01020495,1394,681,713,0.4885222381635581,0.5114777618364419
E01020496,1599,739,860,0.46216385240775487,0.5378361475922452
E01020506,1767,868,899,0.49122807017543857,0.5087719298245614
E01020530,1871,955,916,0.5104222340994121,0.48957776590058794
E01020534,2146,1032,1114,0.4808946877912395,0.5191053122087604
E01020509,2837,1349,1488,0.475502291152626,0.524497708847374
E01020510,2423,1129,1294,0.46595130004127117,0.5340486999587288
E01020529,2275,1099,1176,0.48307692307692307,0.5169230769230769
E01020539,2089,1031,1058,0.4935375777884155,0.5064624222115844
E01020540,2582,1235,1347,0.4783113865220759,0.5216886134779241
E01020511,1690,783,907,0.46331360946745564,0.5366863905325444
E01020532,1590,769,821,0.48364779874213837,0.5163522012578616
E01020533,2153,1009,1144,0.46864839758476545,0.5313516024152346
E01020535,1741,846,895,0.4859276278001149,0.5140723721998851
E01020498,2057,989,1068,0.48079727758872143,0.5192027224112785
E01020499,1331,649,682,0.48760330578512395,0.512396694214876
E01020500,1652,747,905,0.45217917675544794,0.5478208232445521
E01020501,1374,661,713,0.4810771470160116,0.5189228529839883
E01020507,1848,893,955,0.4832251082251082,0.5167748917748918
E01020517,1785,870,915,0.48739495798319327,0.5126050420168067
E01020531,1747,818,929,0.4682312535775615,0.5317687464224384
E01020536,2284,1118,1166,0.489492119089317,0.510507880910683
E01020502,1741,782,959,0.4491671453187823,0.5508328546812177
E01020503,1657,763,894,0.4604707302353651,0.5395292697646349
E01020504,2155,991,1164,0.45986078886310905,0.540139211136891
E01020518,1625,755,870,0.4646153846153846,0.5353846153846153
E01020519,1740,798,942,0.4586206896551724,0.5413793103448276
E01020520,1459,710,749,0.4866346812885538,0.5133653187114462
E01020523,1244,595,649,0.4782958199356913,0.5217041800643086
E01020524,1449,708,741,0.4886128364389234,0.5113871635610766
E01020525,1300,633,667,0.4869230769230769,0.5130769230769231
E01020505,1949,959,990,0.49204720369420213,0.5079527963057978
E01020537,2108,1021,1087,0.4843453510436433,0.5156546489563567
E01020538,1857,911,946,0.4905761981690899,0.5094238018309101
E01020549,2109,1026,1083,0.4864864864864865,0.5135135135135135
E01020512,2084,987,1097,0.4736084452975048,0.5263915547024952
E01020513,1684,825,859,0.48990498812351546,0.5100950118764845
E01020514,1931,942,989,0.4878301398239254,0.5121698601760746
E01020515,1170,572,598,0.4888888888888889,0.5111111111111111
E01020516,1506,729,777,0.48406374501992033,0.5159362549800797
E01020551,2211,1076,1135,0.4866576209859792,0.5133423790140208
E01020552,1753,843,910,0.48088990302338847,0.5191100969766115
E01020570,1546,759,787,0.4909443725743855,0.5090556274256145
E01020571,2154,1050,1104,0.48746518105849584,0.5125348189415042
E01020557,1538,714,824,0.46423927178153446,0.5357607282184655
E01020558,1775,859,916,0.483943661971831,0.516056338028169
E01020559,1744,829,915,0.47534403669724773,0.5246559633027523
E01020560,1826,900,926,0.4928806133625411,0.5071193866374589
E01020561,1965,891,1074,0.4534351145038168,0.5465648854961832
E01020574,1917,944,973,0.4924360980699009,0.5075639019300991
E01020575,1804,902,902,0.5,0.5
E01020576,1696,834,862,0.49174528301886794,0.5082547169811321
E01020579,2143,1074,1069,0.5011665888940737,0.49883341110592627
E01020580,1507,721,786,0.47843397478433974,0.5215660252156602
E01020553,1466,743,723,0.5068212824010914,0.4931787175989086
E01020554,1739,890,849,0.5117883841288097,0.48821161587119033
E01020555,1435,748,687,0.5212543554006969,0.47874564459930313
E01020556,1574,779,795,0.4949174078780178,0.5050825921219823
E01020581,1796,861,935,0.47939866369710465,0.5206013363028953
E01020582,1514,720,794,0.47556142668428003,0.52443857331572
E01020572,1955,983,972,0.5028132992327365,0.4971867007672634
E01020573,1801,874,927,0.4852859522487507,0.5147140477512493
E01020577,1876,972,904,0.5181236673773987,0.48187633262260127
E01020578,2074,952,1122,0.45901639344262296,0.5409836065573771
E01020583,1867,899,968,0.4815211569362614,0.5184788430637386
E01020584,1661,804,857,0.48404575556893437,0.5159542444310656
E01020585,1504,745,759,0.4953457446808511,0.504654255319149
E01020586,1260,602,658,0.4777777777777778,0.5222222222222223
E01020587,1459,684,775,0.4688142563399589,0.5311857436600411
E01020588,1460,790,670,0.541095890410959,0.4589041095890411
E01020589,1395,658,737,0.47168458781362005,0.5283154121863799
E01020563,1644,1054,590,0.6411192214111923,0.3588807785888078
E01020569,1771,896,875,0.5059288537549407,0.49407114624505927
E01033200,2782,1649,1133,0.5927390366642703,0.4072609633357297
E01020562,2175,1085,1090,0.49885057471264366,0.5011494252873563
E01020564,1612,770,842,0.47766749379652607,0.5223325062034739
E01020565,1519,723,796,0.4759710335747202,0.5240289664252797
E01020566,2056,991,1065,0.48200389105058367,0.5179961089494164
E01032643,1529,750,779,0.49051667756703726,0.5094833224329627
E01032644,1216,569,647,0.46792763157894735,0.5320723684210527
E01032645,1556,750,806,0.4820051413881748,0.5179948586118251
E01034381,1457,648,809,0.4447494852436513,0.5552505147563487
E01020526,1325,626,699,0.47245283018867923,0.5275471698113208
E01020527,1466,722,744,0.4924965893587995,0.5075034106412005
E01020528,2453,1147,1306,0.4675907052588667,0.5324092947411333
E01034382,1541,697,844,0.45230369889682026,0.5476963011031798
E01019902,2284,1136,1148,0.4973730297723292,0.5026269702276708
E01019938,2452,1242,1210,0.5065252854812398,0.4934747145187602
E01019967,1345,666,679,0.49516728624535317,0.5048327137546469
E01019927,1316,615,701,0.4673252279635258,0.5326747720364742
E01019932,1656,784,872,0.47342995169082125,0.5265700483091788
E01019933,1329,642,687,0.48306997742663654,0.5169300225733634
E01019934,1870,862,1008,0.46096256684491976,0.5390374331550802
E01019928,1464,694,770,0.47404371584699456,0.5259562841530054
E01019929,1372,655,717,0.4774052478134111,0.5225947521865889
E01019930,1455,688,767,0.47285223367697593,0.5271477663230241
E01019931,1200,590,610,0.49166666666666664,0.5083333333333333
E01019925,1311,641,670,0.4889397406559878,0.5110602593440122
E01019959,1238,608,630,0.4911147011308562,0.5088852988691438
E01019960,1452,727,725,0.5006887052341598,0.49931129476584024
E01019962,2303,1129,1174,0.4902301346070343,0.5097698653929656
E01032628,2590,1247,1343,0.4814671814671815,0.5185328185328185
E01019887,1700,806,894,0.47411764705882353,0.5258823529411765
E01019888,1712,800,912,0.4672897196261682,0.5327102803738317
E01019889,1781,866,915,0.4862436833239753,0.5137563166760247
E01019966,1125,546,579,0.48533333333333334,0.5146666666666667
E01034618,1759,845,914,0.48038658328595796,0.519613416714042
E01034619,1736,849,887,0.4890552995391705,0.5109447004608295
E01019899,1442,684,758,0.47434119278779474,0.5256588072122053
E01019900,1836,862,974,0.46949891067538124,0.5305010893246187
E01019935,1352,626,726,0.4630177514792899,0.5369822485207101
E01019936,1180,568,612,0.48135593220338985,0.5186440677966102
E01019961,2549,1240,1309,0.4864652805021577,0.5135347194978422
E01019939,1715,821,894,0.4787172011661808,0.5212827988338192
E01019940,1734,833,901,0.4803921568627451,0.5196078431372549
E01019942,2437,1144,1293,0.46942962659006976,0.5305703734099303
E01019943,1806,860,946,0.47619047619047616,0.5238095238095238
E01019944,1801,860,941,0.47751249305941146,0.5224875069405885
E01019890,1793,885,908,0.4935861684327942,0.5064138315672058
E01019901,1431,721,710,0.5038434661076171,0.49615653389238296
E01019951,2101,986,1115,0.46930033317467873,0.5306996668253213
E01019946,1413,654,759,0.46284501061571126,0.5371549893842887
E01019947,2142,987,1155,0.46078431372549017,0.5392156862745098
E01019948,1270,610,660,0.48031496062992124,0.5196850393700787
E01019949,1593,745,848,0.46767106089139987,0.5323289391086001
E01019950,1269,590,679,0.4649330181245075,0.5350669818754925
E01019952,1771,834,937,0.4709203839638622,0.5290796160361377
E01019953,1583,748,835,0.47252053063802907,0.527479469361971
E01019954,2012,949,1063,0.4716699801192843,0.5283300198807157
E01019955,1638,784,854,0.47863247863247865,0.5213675213675214
E01019956,1737,760,977,0.43753598157743234,0.5624640184225677
E01019957,1747,780,967,0.44647967945048656,0.5535203205495135
E01019958,1787,839,948,0.46950195858981536,0.5304980414101846
E01019937,2301,1096,1205,0.4763146458061712,0.5236853541938288
E01019945,2208,1083,1125,0.4904891304347826,0.5095108695652174
E01019963,1750,827,923,0.4725714285714286,0.5274285714285715
E01019898,2777,1400,1377,0.5041411595246669,0.4958588404753331
E01019964,1775,1226,549,0.6907042253521126,0.3092957746478873
E01019965,1838,888,950,0.48313384113166485,0.5168661588683352
E01019904,1449,667,782,0.4603174603174603,0.5396825396825397
E01019905,1886,936,950,0.49628844114528103,0.503711558854719
E01019906,1515,709,806,0.467986798679868,0.532013201320132
E01019907,1493,691,802,0.46282652377762895,0.5371734762223711
E01019908,1721,807,914,0.46891342242882045,0.5310865775711795
E01019909,1820,879,941,0.48296703296703297,0.5170329670329671
E01019910,1709,824,885,0.4821533060269163,0.5178466939730837
E01019911,1614,759,855,0.47026022304832715,0.5297397769516728
E01019894,1387,620,767,0.44700793078586876,0.5529920692141312
E01019895,1544,755,789,0.4889896373056995,0.5110103626943006
E01019896,1587,714,873,0.4499054820415879,0.5500945179584121
E01019897,1588,747,841,0.4704030226700252,0.5295969773299748
E01019920,1624,772,852,0.4753694581280788,0.5246305418719212
E01019921,1587,748,839,0.47132955261499687,0.5286704473850031
E01019922,1581,756,825,0.4781783681214421,0.5218216318785579
E01019923,1285,638,647,0.4964980544747082,0.5035019455252918
E01019924,1467,714,753,0.4867075664621677,0.5132924335378323
E01019916,1981,960,1021,0.4846037354871277,0.5153962645128722
E01019917,1558,735,823,0.47175866495507063,0.5282413350449294
E01019918,1715,887,828,0.5172011661807581,0.482798833819242
E01019919,1720,826,894,0.48023255813953486,0.5197674418604651
E01019912,1633,755,878,0.4623392529087569,0.5376607470912431
E01019913,1802,826,976,0.4583795782463929,0.5416204217536071
E01019914,2467,1162,1305,0.47101743007701663,0.5289825699229834
E01019915,1874,845,1029,0.45090715048025615,0.5490928495197439
E01019891,1694,833,861,0.49173553719008267,0.5082644628099173
E01019903,2155,1060,1095,0.4918793503480278,0.5081206496519721
E01034620,1781,878,903,0.49298147108366086,0.5070185289163391
E01034621,1767,856,911,0.4844368986983588,0.5155631013016412
E01034622,1767,871,896,0.49292586304470853,0.5070741369552915
E01034623,1707,821,886,0.48096074985354426,0.5190392501464558
E01034624,1760,865,895,0.4914772727272727,0.5085227272727273
E01034625,1674,841,833,0.502389486260454,0.497610513739546
E01034626,1431,707,724,0.49406009783368277,0.5059399021663172
E01034627,1245,625,620,0.5020080321285141,0.4979919678714859
E01019998,1385,696,689,0.5025270758122744,0.49747292418772565
E01019999,1375,637,738,0.4632727272727273,0.5367272727272727
E01020001,1305,598,707,0.4582375478927203,0.5417624521072797
E01034628,3565,1721,1844,0.48274894810659186,0.5172510518934081
E01034629,3436,1669,1767,0.48573923166472643,0.5142607683352736
E01019990,1461,675,786,0.4620123203285421,0.5379876796714579
E01019991,1594,772,822,0.48431618569636137,0.5156838143036386
E01019993,1155,573,582,0.4961038961038961,0.5038961038961038
E01020000,1310,632,678,0.48244274809160304,0.517557251908397
E01020007,1576,847,729,0.5374365482233503,0.46256345177664976
E01019992,1603,782,821,0.4878353087960075,0.5121646912039926
E01020002,2295,1123,1172,0.48932461873638344,0.5106753812636166
E01020003,1742,827,915,0.47474167623421354,0.5252583237657864
E01020004,2403,1175,1228,0.4889721181856013,0.5110278818143986
E01020005,2031,1000,1031,0.49236829148202854,0.5076317085179715
E01019997,1587,793,794,0.49968494013862635,0.5003150598613737
E01020019,2058,898,1160,0.4363459669582119,0.5636540330417882
E01020020,2175,1037,1138,0.4767816091954023,0.5232183908045978
E01020021,1946,1045,901,0.5369989722507709,0.4630010277492292
E01020022,1967,973,994,0.49466192170818507,0.505338078291815
E01019980,1699,860,839,0.5061801059446733,0.49381989405532667
E01019982,1663,823,840,0.49488875526157544,0.5051112447384245
E01019983,1455,721,734,0.49553264604811,0.50446735395189
E01019984,1313,660,653,0.5026656511805027,0.49733434881949734
E01019985,1358,646,712,0.47569955817378495,0.524300441826215
E01019987,1758,805,953,0.4579067121729238,0.5420932878270762
E01019989,1160,537,623,0.46293103448275863,0.5370689655172414
E01020006,2156,1052,1104,0.48794063079777367,0.5120593692022264
E01020008,1835,932,903,0.5079019073569482,0.49209809264305177
E01020009,1386,702,684,0.5064935064935064,0.4935064935064935
E01019986,1441,696,745,0.48299791811242193,0.5170020818875781
E01020036,1438,697,741,0.4847009735744089,0.5152990264255911
E01020037,1405,662,743,0.4711743772241993,0.5288256227758007
E01020039,1862,898,964,0.4822771213748657,0.5177228786251342
E01020040,1313,638,675,0.4859101294744859,0.5140898705255141
E01019994,1546,793,753,0.5129366106080206,0.4870633893919793
E01019995,2352,1144,1208,0.48639455782312924,0.5136054421768708
E01020017,2797,1346,1451,0.48122988916696463,0.5187701108330354
E01020018,2145,1035,1110,0.4825174825174825,0.5174825174825175
E01034630,1432,735,697,0.513268156424581,0.486731843575419
E01034631,1352,703,649,0.5199704142011834,0.48002958579881655
E01019996,1175,553,622,0.4706382978723404,0.5293617021276595
E01020023,2239,1089,1150,0.48637784725323807,0.5136221527467619
E01020024,1525,720,805,0.4721311475409836,0.5278688524590164
E01020025,1410,679,731,0.48156028368794324,0.5184397163120568
E01019975,1316,654,662,0.4969604863221885,0.5030395136778115
E01020029,1603,800,803,0.4990642545227698,0.5009357454772302
E01020030,1961,977,984,0.4982151963284039,0.5017848036715962
E01020031,1626,817,809,0.502460024600246,0.497539975399754
E01020032,1555,773,782,0.49710610932475885,0.5028938906752412
E01020026,1704,834,870,0.4894366197183099,0.5105633802816901
E01020027,1615,842,773,0.5213622291021672,0.4786377708978328
E01020038,2624,1301,1323,0.4958079268292683,0.5041920731707317
E01033232,1458,696,762,0.4773662551440329,0.522633744855967
E01033234,2079,1023,1056,0.49206349206349204,0.5079365079365079
E01034632,1169,561,608,0.4798973481608212,0.5201026518391788
E01034633,2120,1031,1089,0.4863207547169811,0.5136792452830189
E01019973,1483,730,753,0.49224544841537426,0.5077545515846258
E01019974,1384,687,697,0.4963872832369942,0.5036127167630058
E01019976,1474,690,784,0.4681139755766621,0.5318860244233379
E01019977,1471,719,752,0.48878314072059825,0.5112168592794017
E01019981,1402,691,711,0.492867332382311,0.507132667617689
E01019988,1404,651,753,0.4636752136752137,0.5363247863247863
E01020010,1994,973,1021,0.4879638916750251,0.5120361083249749
E01020013,1339,639,700,0.4772218073188947,0.5227781926811053
E01020014,1488,729,759,0.4899193548387097,0.5100806451612904
E01020015,2072,984,1088,0.4749034749034749,0.525096525096525
E01019968,1470,710,760,0.48299319727891155,0.5170068027210885
E01019969,1278,629,649,0.4921752738654147,0.5078247261345853
E01019970,1221,559,662,0.45782145782145783,0.5421785421785422
E01019971,1543,770,773,0.49902786779001945,0.5009721322099806
E01019972,1425,705,720,0.49473684210526314,0.5052631578947369
E01020011,1341,675,666,0.5033557046979866,0.4966442953020134
E01020012,1575,777,798,0.49333333333333335,0.5066666666666667
E01033235,1194,517,677,0.43299832495812396,0.567001675041876
E01033236,1007,453,554,0.44985104270109233,0.5501489572989077
E01034634,1827,868,959,0.47509578544061304,0.524904214559387
E01034635,1308,601,707,0.459480122324159,0.540519877675841
E01020046,1551,778,773,0.501611863313991,0.498388136686009
E01020049,1349,669,680,0.49592290585618976,0.5040770941438102
E01020050,2167,1012,1155,0.467005076142132,0.5329949238578681
E01020077,1736,844,892,0.4861751152073733,0.5138248847926268
E01020047,2125,1011,1114,0.4757647058823529,0.524235294117647
E01020051,1684,797,887,0.47327790973871736,0.5267220902612827
E01020080,1980,975,1005,0.49242424242424243,0.5075757575757576
E01034636,1572,778,794,0.494910941475827,0.5050890585241731
E01034637,1516,732,784,0.48284960422163586,0.5171503957783641
E01020063,2455,1174,1281,0.47820773930753563,0.5217922606924643
E01020074,2319,1130,1189,0.4872789995687796,0.5127210004312204
E01020075,2005,985,1020,0.4912718204488778,0.5087281795511222
E01020052,1825,887,938,0.486027397260274,0.513972602739726
E01020053,1445,684,761,0.473356401384083,0.5266435986159169
E01020065,2012,1018,994,0.5059642147117296,0.49403578528827036
E01020067,1882,900,982,0.4782146652497343,0.5217853347502657
E01020048,2203,1092,1111,0.49568769859282796,0.5043123014071721
E01020078,1346,659,687,0.48959881129271915,0.5104011887072808
E01020079,1328,655,673,0.4932228915662651,0.5067771084337349
E01020081,1375,669,706,0.48654545454545456,0.5134545454545455
E01020045,1769,882,887,0.49858677218767666,0.5014132278123233
E01020059,2334,1146,1188,0.4910025706940874,0.5089974293059126
E01020062,1639,806,833,0.4917632702867602,0.5082367297132397
E01020064,1838,913,925,0.4967355821545158,0.5032644178454843
E01020054,2609,1279,1330,0.4902261402836336,0.5097738597163665
E01020055,1866,911,955,0.4882100750267953,0.5117899249732047
E01020057,2338,1128,1210,0.48246364414029086,0.5175363558597091
E01020058,1995,1004,991,0.5032581453634085,0.4967418546365915
E01020043,2005,961,1044,0.4793017456359102,0.5206982543640898
E01020044,1656,833,823,0.5030193236714976,0.4969806763285024
E01020056,2951,1452,1499,0.49203659776347003,0.50796340223653
E01020071,1908,916,992,0.480083857442348,0.519916142557652
E01020072,1660,809,851,0.48734939759036144,0.5126506024096386
E01020073,1758,885,873,0.5034129692832765,0.49658703071672355
E01020076,1809,899,910,0.49695964621337757,0.5030403537866225
E01020082,1274,616,658,0.4835164835164835,0.5164835164835165
E01020068,1586,765,821,0.4823455233291299,0.5176544766708702
E01020069,1476,726,750,0.491869918699187,0.508130081300813
E01020070,1870,923,947,0.49358288770053477,0.5064171122994653
E01020083,2560,1278,1282,0.49921875,0.50078125
E01020041,2587,1253,1334,0.4843448009277155,0.5156551990722845
E01020042,1689,806,883,0.4772054470100651,0.5227945529899348
E01020060,1731,846,885,0.48873483535528595,0.511265164644714
E01020061,2070,976,1094,0.4714975845410628,0.5285024154589372
E01020111,1330,628,702,0.47218045112781953,0.5278195488721804
E01020112,1473,730,743,0.4955872369314325,0.5044127630685675
E01020114,1162,590,572,0.5077452667814114,0.49225473321858865
E01020115,1181,586,595,0.4961896697713802,0.5038103302286198
E01020099,1403,689,714,0.49109052031361367,0.5089094796863863
E01020100,1150,573,577,0.49826086956521737,0.5017391304347826
E01020101,1405,693,712,0.49323843416370106,0.5067615658362989
E01020126,1608,774,834,0.48134328358208955,0.5186567164179104
E01020113,1404,714,690,0.5085470085470085,0.49145299145299143
E01020116,1629,788,841,0.48373235113566604,0.516267648864334
E01020117,1533,743,790,0.4846705805609915,0.5153294194390085
E01020118,1325,624,701,0.47094339622641507,0.5290566037735849
E01020090,1893,930,963,0.49128367670364503,0.508716323296355
E01020108,2037,1004,1033,0.49288168875797744,0.5071183112420226
E01020109,1325,651,674,0.4913207547169811,0.5086792452830189
E01020089,2210,1062,1148,0.4805429864253394,0.5194570135746607
E01020091,1254,590,664,0.4704944178628389,0.529505582137161
E01020092,1406,674,732,0.4793741109530583,0.5206258890469416
E01020093,1442,677,765,0.4694868238557559,0.5305131761442441
E01020110,2895,1563,1332,0.5398963730569948,0.46010362694300516
E01020088,2055,1023,1032,0.4978102189781022,0.5021897810218978
E01020120,2235,1083,1152,0.48456375838926175,0.5154362416107383
E01020127,2223,1103,1120,0.49617633828160146,0.5038236617183985
E01020132,1695,800,895,0.471976401179941,0.528023598820059
E01020133,1490,693,797,0.4651006711409396,0.5348993288590604
E01020134,1103,509,594,0.4614687216681777,0.5385312783318223
E01020139,1440,720,720,0.5,0.5
E01020094,1684,871,813,0.5172209026128266,0.4827790973871734
E01020095,1472,731,741,0.49660326086956524,0.5033967391304348
E01020140,1292,609,683,0.4713622291021672,0.5286377708978328
E01020141,1824,881,943,0.4830043859649123,0.5169956140350878
E01020096,1677,838,839,0.49970184853905786,0.5002981514609421
E01020123,1446,691,755,0.4778699861687414,0.5221300138312587
E01020124,1394,695,699,0.49856527977044474,0.5014347202295553
E01020125,1326,629,697,0.47435897435897434,0.5256410256410257
E01020102,1530,728,802,0.47581699346405226,0.5241830065359477
E01020103,1572,764,808,0.4860050890585242,0.5139949109414759
E01020104,1305,619,686,0.47432950191570883,0.5256704980842912
E01020128,1512,748,764,0.4947089947089947,0.5052910052910053
E01020129,1172,564,608,0.4812286689419795,0.5187713310580204
E01020130,1472,710,762,0.48233695652173914,0.5176630434782609
E01020105,2268,1072,1196,0.47266313932980597,0.527336860670194
E01020106,1337,638,699,0.47718773373223633,0.5228122662677637
E01020107,1626,787,839,0.484009840098401,0.515990159901599
E01020119,1467,710,757,0.4839809134287662,0.5160190865712339
E01020084,1380,657,723,0.47608695652173916,0.5239130434782608
E01020085,1490,687,803,0.4610738255033557,0.5389261744966443
E01020121,1961,938,1023,0.47832738398776137,0.5216726160122387
E01020122,2294,1094,1200,0.4768962510897995,0.5231037489102005
E01034638,1623,794,829,0.48921749845964263,0.5107825015403573
E01034639,1411,665,746,0.4712969525159461,0.5287030474840538
E01020097,2338,1164,1174,0.49786142001710865,0.5021385799828914
E01020131,2326,1143,1183,0.49140154772141015,0.5085984522785899
E01020135,1673,821,852,0.4907352062163778,0.5092647937836222
E01020136,2465,1170,1295,0.4746450304259635,0.5253549695740365
E01020137,1950,946,1004,0.48512820512820515,0.5148717948717949
E01020087,2132,1058,1074,0.49624765478424016,0.5037523452157598
E01020098,2326,1140,1186,0.4901117798796217,0.5098882201203784
E01020138,2560,1243,1317,0.485546875,0.514453125
E01020144,1433,721,712,0.5031402651779484,0.49685973482205165
E01020145,2032,1000,1032,0.4921259842519685,0.5078740157480315
E01020146,1242,621,621,0.5,0.5
E01020149,1425,702,723,0.4926315789473684,0.5073684210526316
E01020148,1122,558,564,0.49732620320855614,0.5026737967914439
E01020157,2488,1225,1263,0.49236334405144694,0.507636655948553
E01020160,2452,1176,1276,0.4796084828711256,0.5203915171288744
E01020176,1142,526,616,0.46059544658493873,0.5394045534150613
E01020177,1501,708,793,0.47168554297135246,0.5283144570286475
E01020180,2329,1078,1251,0.4628595963933018,0.5371404036066981
E01020181,1888,863,1025,0.4570974576271186,0.5429025423728814
E01020182,1596,726,870,0.4548872180451128,0.5451127819548872
E01020183,1472,676,796,0.4592391304347826,0.5407608695652174
E01020184,1745,794,951,0.45501432664756447,0.5449856733524355
E01020153,1094,531,563,0.4853747714808044,0.5146252285191956
E01020156,2173,1043,1130,0.47998159226875287,0.5200184077312471
E01020170,2302,1108,1194,0.48132059079061684,0.5186794092093832
E01020188,2134,1036,1098,0.4854732895970009,0.514526710402999
E01020161,2461,1148,1313,0.46647704185290534,0.5335229581470947
E01020162,1604,771,833,0.48067331670822944,0.5193266832917706
E01020163,1814,876,938,0.4829106945975744,0.5170893054024256
E01020164,1462,698,764,0.4774281805745554,0.5225718194254446
E01020165,1433,670,763,0.4675505931612003,0.5324494068387997
E01020166,1437,692,745,0.4815588030619346,0.5184411969380655
E01020167,1695,842,853,0.4967551622418879,0.5032448377581121
E01020142,2770,1365,1405,0.4927797833935018,0.5072202166064982
E01020143,2466,1209,1257,0.4902676399026764,0.5097323600973236
E01020150,2147,990,1157,0.46110852352119236,0.5388914764788076
E01020151,1485,716,769,0.48215488215488217,0.5178451178451179
E01020152,1292,625,667,0.48374613003095973,0.5162538699690402
E01020154,1387,726,661,0.5234318673395818,0.47656813266041814
E01020155,1094,533,561,0.48720292504570384,0.5127970749542962
E01020147,2079,999,1080,0.4805194805194805,0.5194805194805194
E01020158,2008,973,1035,0.4845617529880478,0.5154382470119522
E01020159,1597,790,807,0.4946775203506575,0.5053224796493425
E01020190,2417,1176,1241,0.48655357881671496,0.5134464211832851
E01020171,1774,878,896,0.49492671927846676,0.5050732807215332
E01020185,1475,712,763,0.48271186440677966,0.5172881355932203
E01020186,1387,652,735,0.4700793078586878,0.5299206921413122
E01020187,2596,1262,1334,0.4861325115562404,0.5138674884437596
E01020168,2044,951,1093,0.4652641878669276,0.5347358121330724
E01020169,2197,1054,1143,0.4797451069640419,0.5202548930359582
E01020189,2046,943,1103,0.4608993157380254,0.5391006842619745
E01020174,1591,806,785,0.5065996228786926,0.49340037712130735
E01020175,2090,1016,1074,0.4861244019138756,0.5138755980861244
E01020178,2082,1003,1079,0.4817483189241114,0.5182516810758886
E01020172,2012,967,1045,0.48061630218687873,0.5193836978131213
E01020173,1175,582,593,0.49531914893617024,0.5046808510638298
E01020179,1935,941,994,0.48630490956072353,0.5136950904392765
E01020243,1250,605,645,0.484,0.516
E01020262,1370,666,704,0.48613138686131385,0.5138686131386861
E01020263,1551,747,804,0.4816247582205029,0.5183752417794971
E01020274,1315,639,676,0.4859315589353612,0.5140684410646388
E01020240,1902,917,985,0.482124079915878,0.517875920084122
E01020241,1865,919,946,0.4927613941018767,0.5072386058981233
E01020242,1953,917,1036,0.46953405017921146,0.5304659498207885
E01020244,1372,648,724,0.47230320699708456,0.5276967930029155
E01020245,1603,767,836,0.4784778540237056,0.5215221459762944
E01020205,1414,678,736,0.4794908062234795,0.5205091937765205
E01020258,1729,828,901,0.47888953152111047,0.5211104684788895
E01020259,1093,528,565,0.4830741079597438,0.5169258920402562
E01020273,1507,734,773,0.4870603848706038,0.5129396151293961
E01020203,1709,809,900,0.473376243417203,0.5266237565827969
E01020206,1553,758,795,0.4880875724404379,0.5119124275595621
E01020220,1793,869,924,0.48466257668711654,0.5153374233128835
E01020221,1779,887,892,0.4985947161326588,0.5014052838673412
E01020222,1176,556,620,0.47278911564625853,0.5272108843537415
E01020223,1810,883,927,0.4878453038674033,0.5121546961325967
E01020230,1826,838,988,0.4589266155531216,0.5410733844468785
E01020231,1527,737,790,0.48264571054354943,0.5173542894564506
E01020232,1838,847,991,0.46082698585418935,0.5391730141458106
E01034165,1519,761,758,0.500987491770902,0.4990125082290981
E01034166,1881,920,961,0.4891015417331207,0.5108984582668793
E01020228,1721,840,881,0.48808832074375363,0.5119116792562464
E01020233,1838,864,974,0.470076169749728,0.529923830250272
E01020234,1393,667,726,0.47882268485283563,0.5211773151471644
E01020235,1721,814,907,0.47298082510168504,0.527019174898315
E01020202,2402,1163,1239,0.4841798501248959,0.515820149875104
E01020204,1497,727,770,0.48563794255177023,0.5143620574482298
E01020236,1187,556,631,0.468407750631845,0.531592249368155
E01020237,1635,770,865,0.4709480122324159,0.5290519877675841
E01020265,1824,878,946,0.48135964912280704,0.518640350877193
E01020266,1659,841,818,0.5069318866787221,0.49306811332127787
E01020267,1420,705,715,0.4964788732394366,0.5035211267605634
E01020268,1770,824,946,0.4655367231638418,0.5344632768361582
E01020270,1656,795,861,0.48007246376811596,0.519927536231884
E01020250,1539,755,784,0.49057829759584143,0.5094217024041585
E01020252,2208,1055,1153,0.47780797101449274,0.5221920289855072
E01020253,1423,680,743,0.47786366830639493,0.5221363316936051
E01020254,1418,696,722,0.4908321579689704,0.5091678420310296
E01020255,1417,688,729,0.4855328158080452,0.5144671841919548
E01020257,1230,588,642,0.47804878048780486,0.5219512195121951
E01020264,1489,702,787,0.4714573539288113,0.5285426460711887
E01020269,1745,819,926,0.46934097421203436,0.5306590257879656
E01020271,1511,741,770,0.49040370615486434,0.5095962938451357
E01020272,1858,910,948,0.4897739504843918,0.5102260495156081
E01020200,1072,498,574,0.46455223880597013,0.5354477611940298
E01020201,1561,730,831,0.4676489429852659,0.5323510570147342
E01020251,1511,747,764,0.4943745863666446,0.5056254136333554
E01020260,1236,581,655,0.47006472491909385,0.5299352750809061
E01020261,1215,582,633,0.47901234567901235,0.5209876543209877
E01020208,1261,635,626,0.5035685963521015,0.4964314036478985
E01020209,1420,663,757,0.4669014084507042,0.5330985915492957
E01020210,1403,660,743,0.47042052744119744,0.5295794725588026
E01020219,2086,1078,1008,0.5167785234899329,0.48322147651006714
E01020191,2007,1290,717,0.6427503736920778,0.3572496263079223
E01020194,1483,734,749,0.4949426837491571,0.5050573162508429
E01020256,1982,965,1017,0.48688193743693237,0.5131180625630676
E01034167,1915,908,1007,0.4741514360313316,0.5258485639686684
E01034168,1772,872,900,0.49209932279909707,0.5079006772009029
E01020211,1588,771,817,0.48551637279596976,0.5144836272040302
E01020217,1708,852,856,0.49882903981264637,0.5011709601873536
E01020218,1588,782,806,0.4924433249370277,0.5075566750629723
E01020224,1198,566,632,0.4724540901502504,0.5275459098497496
E01020216,1625,776,849,0.4775384615384615,0.5224615384615384
E01020225,1269,625,644,0.4925137903861308,0.5074862096138691
E01020226,1506,703,803,0.46679946879150064,0.5332005312084993
E01020227,1427,697,730,0.48843728100911005,0.51156271899089
E01020212,1266,626,640,0.49447077409162715,0.5055292259083728
E01020213,1436,702,734,0.48885793871866295,0.5111420612813371
E01020214,1552,759,793,0.4890463917525773,0.5109536082474226
E01020215,1303,641,662,0.49194167306216424,0.5080583269378358
E01020195,1776,856,920,0.481981981981982,0.5180180180180181
E01020196,1720,808,912,0.4697674418604651,0.5302325581395348
E01020197,1287,615,672,0.47785547785547783,0.5221445221445221
E01020198,1394,691,703,0.49569583931133426,0.5043041606886657
E01020199,1615,804,811,0.4978328173374613,0.5021671826625387
E01020246,1356,647,709,0.4771386430678466,0.5228613569321534
E01020247,1607,766,841,0.47666459240821407,0.523335407591786
E01020248,1781,843,938,0.47332959011791126,0.5266704098820887
E01020249,1381,672,709,0.4866039102099928,0.5133960897900073
E01020192,1448,688,760,0.47513812154696133,0.5248618784530387
E01020193,1620,786,834,0.48518518518518516,0.5148148148148148
E01020238,1208,551,657,0.45612582781456956,0.5438741721854304
E01020239,1314,623,691,0.4741248097412481,0.525875190258752
E01020275,1199,570,629,0.475396163469558,0.5246038365304421
E01020276,1490,710,780,0.47651006711409394,0.5234899328859061
E01020297,1491,695,796,0.466130114017438,0.533869885982562
E01020299,1801,867,934,0.4813992226540811,0.5186007773459189
E01020298,2144,1006,1138,0.46921641791044777,0.5307835820895522
E01020300,1807,857,950,0.4742667404537908,0.5257332595462092
E01034640,1128,546,582,0.48404255319148937,0.5159574468085106
E01034641,1291,624,667,0.4833462432223083,0.5166537567776918
E01020280,2140,1118,1022,0.5224299065420561,0.47757009345794393
E01020281,2055,1016,1039,0.4944038929440389,0.505596107055961
E01020282,1545,750,795,0.4854368932038835,0.5145631067961165
E01020277,2078,1002,1076,0.4821944177093359,0.5178055822906641
E01020278,1634,824,810,0.5042839657282742,0.49571603427172584
E01020279,2814,1381,1433,0.49076048329779676,0.5092395167022032
E01020283,2453,1191,1262,0.4855279249898084,0.5144720750101917
E01020284,2093,1041,1052,0.4973721930243669,0.502627806975633
E01020285,1948,957,991,0.4912731006160164,0.5087268993839835
E01020288,1632,820,812,0.5024509803921569,0.49754901960784315
E01020292,1566,789,777,0.5038314176245211,0.49616858237547895
E01020295,1753,853,900,0.48659440958357103,0.513405590416429
E01020296,1496,736,760,0.4919786096256685,0.5080213903743316
E01020304,1684,789,895,0.4685273159144893,0.5314726840855107
E01020305,1077,533,544,0.4948932219127205,0.5051067780872794
E01020306,1303,623,680,0.4781273983115886,0.5218726016884113
E01020307,1737,839,898,0.4830166954519286,0.5169833045480714
E01020287,1513,733,780,0.48446794448116326,0.5155320555188367
E01020303,1719,864,855,0.5026178010471204,0.4973821989528796
E01020308,1883,938,945,0.49814126394052044,0.5018587360594795
E01020311,2190,1058,1132,0.4831050228310502,0.5168949771689497
E01020291,1675,846,829,0.5050746268656716,0.4949253731343284
E01020293,2516,1235,1281,0.4908585055643879,0.5091414944356121
E01020294,2323,1093,1230,0.47051226861816614,0.5294877313818338
E01020302,1809,919,890,0.5080154781647319,0.4919845218352681
E01020309,1860,929,931,0.49946236559139784,0.5005376344086021
E01020286,1851,896,955,0.48406266882766075,0.5159373311723393
E01020289,1580,804,776,0.5088607594936709,0.4911392405063291
E01020290,1771,848,923,0.47882552230378317,0.5211744776962168
E01020301,2069,1049,1020,0.5070082165297245,0.4929917834702755
E01020320,1870,937,933,0.5010695187165776,0.49893048128342243
E01020321,2447,1197,1250,0.4891704127503065,0.5108295872496935
E01020326,2278,1133,1145,0.49736611062335384,0.5026338893766462
E01034642,1561,765,796,0.49007046764894296,0.509929532351057
E01034643,1800,857,943,0.4761111111111111,0.5238888888888888
E01020327,1808,887,921,0.4905973451327434,0.5094026548672567
E01020328,2404,1183,1221,0.4920965058236273,0.5079034941763727
E01020329,1618,806,812,0.49814585908529047,0.5018541409147095
E01020330,1880,943,937,0.5015957446808511,0.49840425531914895
E01020318,1540,728,812,0.4727272727272727,0.5272727272727272
E01020319,1759,852,907,0.48436611711199545,0.5156338828880046
E01020323,2107,1310,797,0.6217370669197911,0.3782629330802088
E01020339,1681,793,888,0.47174301011302794,0.528256989886972
E01020314,1740,855,885,0.49137931034482757,0.5086206896551724
E01020325,1718,833,885,0.4848661233993015,0.5151338766006985
E01020331,1692,831,861,0.49113475177304966,0.5088652482269503
E01020340,1754,879,875,0.5011402508551881,0.49885974914481185
E01020332,1770,867,903,0.48983050847457626,0.5101694915254237
E01020333,2208,1065,1143,0.48233695652173914,0.5176630434782609
E01020334,1966,906,1060,0.46083418107833163,0.5391658189216684
E01020335,1621,748,873,0.46144355336212217,0.5385564466378778
E01020336,1346,633,713,0.4702823179791976,0.5297176820208024
E01020337,1417,681,736,0.48059280169371915,0.5194071983062809
E01020338,2342,1129,1213,0.482066609735269,0.517933390264731
E01020317,1425,691,734,0.4849122807017544,0.5150877192982456
E01020324,1601,758,843,0.47345409119300436,0.5265459088069956
E01020341,1651,781,870,0.4730466384009691,0.526953361599031
E01020342,1547,735,812,0.4751131221719457,0.5248868778280543
E01020312,1638,803,835,0.4902319902319902,0.5097680097680097
E01020313,1472,712,760,0.483695652173913,0.5163043478260869
E01020315,1611,755,856,0.4686530105524519,0.5313469894475481
E01020316,1820,881,939,0.48406593406593407,0.515934065934066
E01022163,1455,697,758,0.47903780068728524,0.5209621993127148
E01022164,1417,708,709,0.49964714184897674,0.5003528581510233
E01022165,1459,742,717,0.5085675119945168,0.4914324880054832
E01022166,1231,593,638,0.48172217709179527,0.5182778229082047
E01022143,2125,974,1151,0.4583529411764706,0.5416470588235294
E01022144,1433,695,738,0.48499651081646894,0.515003489183531
E01022145,1237,613,624,0.49555375909458366,0.5044462409054163
E01022146,1351,630,721,0.46632124352331605,0.533678756476684
E01022122,1451,673,778,0.4638180565127498,0.5361819434872501
E01022160,2234,1084,1150,0.4852282900626679,0.5147717099373321
E01022161,1464,732,732,0.5,0.5
E01022162,1583,777,806,0.490840176879343,0.509159823120657
E01022139,1881,898,983,0.47740563530037217,0.5225943646996278
E01022151,1666,779,887,0.46758703481392555,0.5324129651860744
E01022152,1253,614,639,0.49002394253790904,0.509976057462091
E01022153,1469,784,685,0.5336963921034718,0.46630360789652825
E01022154,1827,935,892,0.511767925561029,0.488232074438971
E01022120,1636,812,824,0.4963325183374083,0.5036674816625917
E01022121,1819,874,945,0.4804837822979659,0.519516217702034
E01022147,1698,814,884,0.4793875147232038,0.5206124852767963
E01022157,1511,733,778,0.48510919920582396,0.514890800794176
E01022159,1650,808,842,0.4896969696969697,0.5103030303030303
E01022131,1364,648,716,0.4750733137829912,0.5249266862170088
E01022132,1495,716,779,0.4789297658862876,0.5210702341137123
E01022133,1434,700,734,0.4881450488145049,0.5118549511854951
E01022134,1576,752,824,0.47715736040609136,0.5228426395939086
E01022148,1579,818,761,0.5180493983533883,0.4819506016466118
E01022149,1485,754,731,0.5077441077441077,0.4922558922558923
E01022150,1521,755,766,0.49638395792241946,0.5036160420775806
E01022155,1565,778,787,0.4971246006389776,0.5028753993610223
E01022156,1915,987,928,0.5154046997389033,0.4845953002610966
E01034777,1317,677,640,0.5140470766894457,0.4859529233105543
E01034778,1057,547,510,0.5175023651844843,0.4824976348155156
E01022100,1656,816,840,0.4927536231884058,0.5072463768115942
E01022101,1745,832,913,0.47679083094555874,0.5232091690544413
E01022102,1961,1084,877,0.5527791942886282,0.44722080571137174
E01022140,1418,648,770,0.45698166431593795,0.5430183356840621
E01022141,1384,714,670,0.5158959537572254,0.4841040462427746
E01022142,1381,677,704,0.49022447501810285,0.5097755249818972
E01022116,1508,764,744,0.506631299734748,0.493368700265252
E01022117,1634,870,764,0.5324357405140759,0.4675642594859241
E01022119,1223,573,650,0.46852003270645953,0.5314799672935405
E01022124,1206,597,609,0.49502487562189057,0.5049751243781094
E01022125,1172,582,590,0.49658703071672355,0.5034129692832765
E01022126,1365,689,676,0.5047619047619047,0.49523809523809526
E01022127,1807,682,1125,0.3774211400110681,0.6225788599889319
E01022106,1711,848,863,0.49561659848042083,0.5043834015195792
E01022107,1575,789,786,0.5009523809523809,0.4990476190476191
E01022108,1672,821,851,0.4910287081339713,0.5089712918660287
E01022123,2195,1131,1064,0.5152619589977221,0.4847380410022779
E01022135,1680,808,872,0.48095238095238096,0.5190476190476191
E01022136,1347,623,724,0.46250927988121754,0.5374907201187825
E01022137,1520,733,787,0.48223684210526313,0.5177631578947368
E01022138,1673,854,819,0.5104602510460251,0.4895397489539749
E01022174,1358,671,687,0.49410898379970547,0.5058910162002945
E01022104,1713,851,862,0.4967892586106246,0.5032107413893754
E01022105,1475,720,755,0.488135593220339,0.511864406779661
E01022109,1581,786,795,0.4971537001897533,0.5028462998102466
E01022110,1410,674,736,0.47801418439716314,0.5219858156028369
E01022111,1531,735,796,0.4800783801436969,0.519921619856303
E01022112,1370,658,712,0.4802919708029197,0.5197080291970803
E01034779,1654,822,832,0.4969770253929867,0.5030229746070133
E01034780,1463,738,725,0.504442925495557,0.4955570745044429
E01022167,1253,599,654,0.47805267358339987,0.5219473264166001
E01022168,1124,548,576,0.4875444839857651,0.5124555160142349
E01022169,1506,701,805,0.46547144754316067,0.5345285524568393
E01022170,1377,683,694,0.49600580973129993,0.5039941902687001
E01022171,1296,630,666,0.4861111111111111,0.5138888888888888
E01022172,1456,698,758,0.4793956043956044,0.5206043956043956
E01022173,1327,636,691,0.47927656367746796,0.520723436322532
E01022113,1744,847,897,0.4856651376146789,0.5143348623853211
E01022114,1601,778,823,0.48594628357276703,0.514053716427233
E01022115,1562,748,814,0.4788732394366197,0.5211267605633803
E01022118,1480,727,753,0.4912162162162162,0.5087837837837837
E01022128,1560,740,820,0.47435897435897434,0.5256410256410257
E01022129,2397,1113,1284,0.4643304130162703,0.5356695869837297
E01022130,1608,747,861,0.46455223880597013,0.5354477611940298
E01022179,1960,931,1029,0.475,0.525
E01022182,1690,814,876,0.4816568047337278,0.5183431952662721
E01022183,1542,729,813,0.4727626459143969,0.5272373540856031
E01022184,1544,732,812,0.4740932642487047,0.5259067357512953
E01022185,1965,930,1035,0.4732824427480916,0.5267175572519084
E01022177,1901,900,1001,0.47343503419253025,0.5265649658074697
E01022178,1301,625,676,0.4803996925441968,0.5196003074558032
E01022205,1792,865,927,0.48270089285714285,0.5172991071428571
E01022211,1945,885,1060,0.455012853470437,0.5449871465295629
E01034781,1772,871,901,0.4915349887133183,0.5084650112866818
E01034782,1296,611,685,0.4714506172839506,0.5285493827160493
E01022181,1792,854,938,0.4765625,0.5234375
E01022222,1912,934,978,0.4884937238493724,0.5115062761506276
E01034783,1362,653,709,0.47944199706314244,0.5205580029368576
E01034784,1414,680,734,0.4809052333804809,0.5190947666195191
E01034785,1431,680,751,0.4751921733053808,0.5248078266946191
E01034786,1599,757,842,0.4734208880550344,0.5265791119449656
E01022186,1631,809,822,0.4960147148988351,0.5039852851011649
E01022187,1921,946,975,0.4924518479958355,0.5075481520041645
E01022201,1812,880,932,0.4856512141280353,0.5143487858719646
E01022216,1905,922,983,0.483989501312336,0.516010498687664
E01022175,1790,894,896,0.4994413407821229,0.5005586592178771
E01022207,1675,830,845,0.4955223880597015,0.5044776119402985
E01022213,1995,971,1024,0.4867167919799499,0.5132832080200501
E01022215,1734,848,886,0.48904267589388695,0.510957324106113
E01022188,2092,1013,1079,0.48422562141491393,0.515774378585086
E01022189,1231,594,637,0.4825345247766044,0.5174654752233956
E01022190,1483,736,747,0.49629130141604855,0.5037086985839514
E01022196,1758,842,916,0.4789533560864619,0.5210466439135382
E01022197,1845,903,942,0.4894308943089431,0.510569105691057
E01022194,1739,815,924,0.4686601495112133,0.5313398504887866
E01022195,1593,729,864,0.4576271186440678,0.5423728813559322
E01022199,1616,744,872,0.4603960396039604,0.5396039603960396
E01022200,1183,570,613,0.4818258664412511,0.518174133558749
E01022191,1318,634,684,0.48103186646433993,0.5189681335356601
E01022192,1282,604,678,0.4711388455538221,0.5288611544461779
E01022193,1054,540,514,0.5123339658444023,0.4876660341555977
E01022198,1251,620,631,0.495603517186251,0.504396482813749
E01022225,2604,1249,1355,0.47964669738863286,0.5203533026113671
E01022202,1379,676,703,0.4902102973168963,0.5097897026831038
E01022203,2167,1023,1144,0.4720812182741117,0.5279187817258884
E01022204,1394,684,710,0.49067431850789095,0.509325681492109
E01022208,1648,806,842,0.4890776699029126,0.5109223300970874
E01022209,1187,602,585,0.5071609098567817,0.4928390901432182
E01022210,1490,733,757,0.4919463087248322,0.5080536912751678
E01022221,2091,1034,1057,0.49450023912003827,0.5054997608799617
E01022224,1532,742,790,0.48433420365535246,0.5156657963446475
E01034787,1711,807,904,0.4716540035067212,0.5283459964932787
E01034788,1249,590,659,0.4723779023218575,0.5276220976781425
E01022176,1861,927,934,0.49811929070392263,0.5018807092960774
E01022217,1255,594,661,0.47330677290836654,0.5266932270916335
E01022218,1215,582,633,0.47901234567901235,0.5209876543209877
E01022219,1494,737,757,0.4933065595716198,0.5066934404283802
E01022220,1590,744,846,0.4679245283018868,0.5320754716981132
E01034789,1315,638,677,0.48517110266159696,0.5148288973384031
E01034790,1531,714,817,0.46636185499673416,0.5336381450032658
E01022233,1886,955,931,0.5063626723223754,0.4936373276776246
E01022235,1804,860,944,0.47671840354767187,0.5232815964523282
E01022247,2612,1154,1458,0.44180704441041346,0.5581929555895865
E01022270,1977,971,1006,0.49114820435002526,0.5088517956499747
E01022271,1688,797,891,0.4721563981042654,0.5278436018957346
E01022261,2369,1133,1236,0.4782608695652174,0.5217391304347826
E01022262,2209,1069,1140,0.4839293798098687,0.5160706201901313
E01022267,1798,868,930,0.4827586206896552,0.5172413793103449
E01022251,1434,702,732,0.4895397489539749,0.5104602510460251
E01022252,1813,890,923,0.49089906232763375,0.5091009376723662
E01022258,1244,600,644,0.48231511254019294,0.5176848874598071
E01022259,1530,758,772,0.4954248366013072,0.5045751633986928
E01022260,1887,897,990,0.4753577106518283,0.5246422893481717
E01022236,2060,1030,1030,0.5,0.5
E01022237,1492,740,752,0.4959785522788204,0.5040214477211796
E01022238,1551,728,823,0.4693745970341715,0.5306254029658285
E01022239,1577,782,795,0.49587824984147116,0.5041217501585289
E01022240,2093,1066,1027,0.5093167701863354,0.4906832298136646
E01022249,2040,1041,999,0.5102941176470588,0.48970588235294116
E01022250,2148,1042,1106,0.4851024208566108,0.5148975791433892
E01022228,1683,835,848,0.49613784907902553,0.5038621509209744
E01022230,1815,874,941,0.4815426997245179,0.5184573002754821
E01022265,1691,835,856,0.4937906564163217,0.5062093435836783
E01022266,1395,685,710,0.4910394265232975,0.5089605734767025
E01022234,1527,739,788,0.4839554682383759,0.5160445317616241
E01022253,1665,802,863,0.4816816816816817,0.5183183183183183
E01022263,1912,950,962,0.49686192468619245,0.5031380753138075
E01022229,1583,756,827,0.4775742261528743,0.5224257738471257
E01022241,1849,892,957,0.4824229313142239,0.5175770686857761
E01022242,1822,885,937,0.4857299670691548,0.5142700329308453
E01022243,1407,680,727,0.48329779673063256,0.5167022032693674
E01022244,1540,761,779,0.4941558441558442,0.5058441558441559
E01022245,1349,680,669,0.5040770941438102,0.49592290585618976
E01022246,1304,645,659,0.4946319018404908,0.5053680981595092
E01022231,1678,828,850,0.4934445768772348,0.5065554231227652
E01022232,1584,776,808,0.4898989898989899,0.51010101010101
E01022264,1528,724,804,0.4738219895287958,0.5261780104712042
E01022268,1665,799,866,0.4798798798798799,0.5201201201201201
E01022269,1869,939,930,0.5024077046548957,0.49759229534510435
E01022226,1418,687,731,0.4844851904090268,0.5155148095909732
E01022227,1572,778,794,0.494910941475827,0.5050890585241731
E01022254,2539,1218,1321,0.4797164237888933,0.5202835762111068
E01022255,2272,1151,1121,0.5066021126760564,0.4933978873239437
E01022256,1745,844,901,0.4836676217765043,0.5163323782234956
E01022257,1758,835,923,0.474971558589306,0.5250284414106939
E01022248,1670,841,829,0.5035928143712575,0.49640718562874253
E01022272,1338,633,705,0.4730941704035874,0.5269058295964125
E01022273,1421,849,572,0.597466572836031,0.40253342716396906
E01022274,1201,597,604,0.4970857618651124,0.5029142381348876
E01022275,1992,962,1030,0.48293172690763053,0.5170682730923695
E01022313,1621,807,814,0.49784083898827886,0.5021591610117212
E01022315,1474,728,746,0.49389416553595655,0.5061058344640434
E01022316,1537,761,776,0.4951203643461288,0.5048796356538712
E01022317,1520,775,745,0.5098684210526315,0.4901315789473684
E01022318,1713,829,884,0.4839462930531232,0.5160537069468768
E01022309,1546,774,772,0.500646830530401,0.49935316946959896
E01022310,1817,899,918,0.49477160154100164,0.5052283984589984
E01022311,2000,1071,929,0.5355,0.4645
E01022312,2299,1140,1159,0.49586776859504134,0.5041322314049587
E01022314,1670,808,862,0.48383233532934133,0.5161676646706587
E01022295,1375,665,710,0.48363636363636364,0.5163636363636364
E01022296,1542,768,774,0.4980544747081712,0.5019455252918288
E01022297,1354,675,679,0.4985228951255539,0.5014771048744461
E01022298,1634,820,814,0.5018359853121175,0.4981640146878825
E01022332,1856,952,904,0.5129310344827587,0.4870689655172414
E01032932,1766,884,882,0.5005662514156285,0.49943374858437145
E01032937,1506,816,690,0.5418326693227091,0.4581673306772908
E01034791,1498,743,755,0.4959946595460614,0.5040053404539386
E01034792,1517,790,727,0.5207646671061306,0.4792353328938695
E01034793,1476,849,627,0.5752032520325203,0.4247967479674797
E01034794,1934,942,992,0.4870734229576008,0.5129265770423992
E01022288,2032,1015,1017,0.49950787401574803,0.500492125984252
E01022289,1770,933,837,0.5271186440677966,0.4728813559322034
E01022290,1414,698,716,0.49363507779349364,0.5063649222065064
E01022291,1842,939,903,0.509771986970684,0.49022801302931596
E01022292,1556,782,774,0.5025706940874036,0.4974293059125964
E01022283,1468,706,762,0.48092643051771117,0.5190735694822888
E01022303,1401,662,739,0.4725196288365453,0.5274803711634547
E01022304,1740,811,929,0.46609195402298853,0.5339080459770115
E01022305,1364,659,705,0.4831378299120235,0.5168621700879765
E01022308,1410,691,719,0.4900709219858156,0.5099290780141844
E01022278,1617,794,823,0.49103277674706247,0.5089672232529375
E01022279,1466,711,755,0.4849931787175989,0.515006821282401
E01022282,2657,1311,1346,0.49341362438840797,0.506586375611592
E01022284,1272,676,596,0.5314465408805031,0.46855345911949686
E01022285,1407,701,706,0.4982231698649609,0.501776830135039
E01022286,1723,842,881,0.4886825304701103,0.5113174695298898
E01022287,1956,992,964,0.5071574642126789,0.49284253578732107
E01022293,1611,797,814,0.49472377405338297,0.505276225946617
E01022294,1780,868,912,0.48764044943820223,0.5123595505617977
E01022323,1784,864,920,0.484304932735426,0.515695067264574
E01022328,1392,696,696,0.5,0.5
E01022329,1676,794,882,0.4737470167064439,0.5262529832935561
E01022326,1354,661,693,0.4881831610044313,0.5118168389955687
E01022327,1497,734,763,0.49031396125584503,0.509686038744155
E01022330,1490,771,719,0.5174496644295302,0.4825503355704698
E01022331,1340,662,678,0.49402985074626865,0.5059701492537313
E01022333,1537,714,823,0.4645413142485361,0.5354586857514639
E01022334,1927,941,986,0.48832381940840686,0.5116761805915931
E01022276,1557,747,810,0.4797687861271676,0.5202312138728323
E01022277,1444,717,727,0.49653739612188363,0.5034626038781164
E01022280,1489,734,755,0.49294828744123576,0.5070517125587642
E01022281,1698,839,859,0.49411071849234395,0.5058892815076561
E01022306,1331,633,698,0.4755822689706987,0.5244177310293012
E01022307,1540,782,758,0.5077922077922078,0.4922077922077922
E01022319,1622,767,855,0.47287299630086316,0.5271270036991369
E01022320,1679,854,825,0.5086360929124479,0.4913639070875521
E01022321,1635,842,793,0.5149847094801223,0.4850152905198777
E01022322,1361,634,727,0.46583394562821456,0.5341660543717854
E01022324,1644,816,828,0.49635036496350365,0.5036496350364964
E01022325,1278,640,638,0.5007824726134585,0.49921752738654146
E01022343,1414,695,719,0.4915134370579915,0.5084865629420084
E01022344,1554,770,784,0.4954954954954955,0.5045045045045045
E01022345,1685,836,849,0.49614243323442137,0.5038575667655787
E01022346,1520,709,811,0.4664473684210526,0.5335526315789474
E01022299,1304,621,683,0.4762269938650307,0.5237730061349694
E01022300,1287,617,670,0.4794094794094794,0.5205905205905206
E01022301,1568,770,798,0.49107142857142855,0.5089285714285714
E01022302,1522,743,779,0.48817345597897505,0.511826544021025
E01022339,1762,863,899,0.4897843359818388,0.5102156640181612
E01022340,1363,661,702,0.48495964783565665,0.5150403521643434
E01022341,2490,1203,1287,0.4831325301204819,0.516867469879518
E01022342,1699,838,861,0.49323131253678637,0.5067686874632137
E01022335,1454,707,747,0.4862448418156809,0.5137551581843192
E01022336,1149,552,597,0.4804177545691906,0.5195822454308094
E01022338,1324,645,679,0.4871601208459215,0.5128398791540786
E01032933,1687,836,851,0.4955542382928275,0.5044457617071725
E01032935,1541,783,758,0.5081116158338741,0.4918883841661259
E01034795,2158,1019,1139,0.4721964782205746,0.5278035217794254
E01034796,2134,1038,1096,0.48641049671977504,0.5135895032802249
E01034797,1470,734,736,0.4993197278911565,0.5006802721088436
E01034798,1915,935,980,0.48825065274151436,0.5117493472584856
E01022378,2199,1090,1109,0.4956798544793088,0.5043201455206913
E01022379,1430,700,730,0.48951048951048953,0.5104895104895105
E01034799,1749,888,861,0.5077186963979416,0.4922813036020583
E01034800,1823,878,945,0.4816236972024136,0.5183763027975864
E01034801,2000,980,1020,0.49,0.51
E01034802,1961,972,989,0.4956654767975523,0.5043345232024478
E01022354,2223,1101,1122,0.49527665317139,0.50472334682861
E01022390,1208,569,639,0.47102649006622516,0.5289735099337748
E01022391,1623,767,856,0.47258163894023414,0.5274183610597659
E01022392,1620,786,834,0.48518518518518516,0.5148148148148148
E01022376,2780,1324,1456,0.4762589928057554,0.5237410071942447
E01022396,1798,884,914,0.4916573971078977,0.5083426028921023
E01022397,2042,1029,1013,0.5039177277179236,0.4960822722820764
E01022398,1179,594,585,0.5038167938931297,0.4961832061068702
E01022355,1681,821,860,0.48839976204640095,0.5116002379535991
E01022356,2516,1209,1307,0.48052464228934816,0.5194753577106518
E01022357,1895,906,989,0.47810026385224275,0.5218997361477573
E01022358,1568,789,779,0.5031887755102041,0.4968112244897959
E01022377,2129,1066,1063,0.5007045561296384,0.4992954438703617
E01022389,1712,850,862,0.49649532710280375,0.5035046728971962
E01022400,1955,961,994,0.49156010230179026,0.5084398976982097
E01022401,1348,672,676,0.49851632047477745,0.5014836795252225
E01022402,1495,728,767,0.48695652173913045,0.5130434782608696
E01022403,1547,749,798,0.4841628959276018,0.5158371040723982
E01022404,1723,876,847,0.5084155542658154,0.4915844457341846
E01022399,2150,1031,1119,0.4795348837209302,0.5204651162790698
E01022410,2178,1041,1137,0.47796143250688705,0.522038567493113
E01022411,2072,999,1073,0.48214285714285715,0.5178571428571429
E01022414,2468,1207,1261,0.48905996758508913,0.5109400324149108
E01034803,1208,595,613,0.4925496688741722,0.5074503311258278
E01034804,1270,660,610,0.5196850393700787,0.48031496062992124
E01022393,1400,659,741,0.4707142857142857,0.5292857142857142
E01022394,1516,744,772,0.49076517150395776,0.5092348284960422
E01022395,1493,726,767,0.48626925653047554,0.5137307434695244
E01022408,1030,511,519,0.4961165048543689,0.503883495145631
E01022409,1290,641,649,0.4968992248062015,0.5031007751937985
E01022366,1685,818,867,0.485459940652819,0.5145400593471811
E01022367,1614,813,801,0.5037174721189591,0.4962825278810409
E01022368,1350,664,686,0.4918518518518519,0.5081481481481481
E01022369,1635,784,851,0.4795107033639144,0.5204892966360857
E01022370,1333,654,679,0.490622655663916,0.5093773443360841
E01022371,1102,531,571,0.48185117967332125,0.5181488203266787
E01022405,2107,1007,1100,0.4779307071665876,0.5220692928334124
E01022406,1255,606,649,0.4828685258964143,0.5171314741035856
E01022407,1330,643,687,0.48345864661654137,0.5165413533834586
E01022350,2156,1044,1112,0.4842300556586271,0.5157699443413729
E01022382,1621,773,848,0.4768661320172733,0.5231338679827268
E01022383,1499,694,805,0.4629753168779186,0.5370246831220814
E01022384,1399,689,710,0.49249463902787705,0.507505360972123
E01022359,1533,743,790,0.4846705805609915,0.5153294194390085
E01022360,1480,726,754,0.4905405405405405,0.5094594594594595
E01022361,1199,574,625,0.4787322768974145,0.5212677231025855
E01022362,1129,562,567,0.4977856510186005,0.5022143489813995
E01022363,2043,1025,1018,0.5017131669114048,0.4982868330885952
E01022364,1136,543,593,0.4779929577464789,0.5220070422535211
E01022351,1613,808,805,0.5009299442033478,0.4990700557966522
E01022352,1299,651,648,0.5011547344110855,0.49884526558891457
E01022353,1630,776,854,0.47607361963190187,0.5239263803680981
E01022413,2026,983,1043,0.48519249753208293,0.5148075024679171
E01022385,1624,785,839,0.4833743842364532,0.5166256157635468
E01022386,1546,723,823,0.46765847347994827,0.5323415265200517
E01022387,1528,739,789,0.4836387434554974,0.5163612565445026
E01022388,1799,889,910,0.49416342412451364,0.5058365758754864
E01022372,2442,1222,1220,0.5004095004095004,0.4995904995904996
E01022373,1688,830,858,0.49170616113744076,0.5082938388625592
E01022374,2065,1044,1021,0.5055690072639225,0.4944309927360775
E01022375,1268,625,643,0.49290220820189273,0.5070977917981072
E01022381,2222,1097,1125,0.4936993699369937,0.5063006300630063
E01022415,1541,743,798,0.48215444516547695,0.517845554834523
E01022416,1524,748,776,0.49081364829396323,0.5091863517060368
E01022417,1792,866,926,0.48325892857142855,0.5167410714285714
E01022418,1612,811,801,0.5031017369727047,0.4968982630272953
E01022450,2088,1026,1062,0.49137931034482757,0.5086206896551724
E01022451,1458,715,743,0.49039780521262005,0.50960219478738
E01022452,1313,669,644,0.5095201827875095,0.49047981721249045
E01022455,1832,914,918,0.49890829694323147,0.5010917030567685
E01032938,2394,1186,1208,0.4954051796157059,0.504594820384294
E01032939,1475,720,755,0.488135593220339,0.511864406779661
E01032940,1524,748,776,0.49081364829396323,0.5091863517060368
E01022456,1265,625,640,0.49407114624505927,0.5059288537549407
E01022457,1354,658,696,0.4859675036927622,0.5140324963072378
E01022458,1420,687,733,0.4838028169014085,0.5161971830985915
E01022459,1453,698,755,0.4803854094975912,0.5196145905024088
E01022460,1896,904,992,0.4767932489451477,0.5232067510548524
E01022461,1340,664,676,0.4955223880597015,0.5044776119402985
E01022462,1939,958,981,0.49406910778751933,0.5059308922124807
E01022449,2042,991,1051,0.4853085210577865,0.5146914789422136
E01022463,1429,656,773,0.45906228131560534,0.5409377186843947
E01022464,1568,721,847,0.45982142857142855,0.5401785714285714
E01022465,1785,863,922,0.4834733893557423,0.5165266106442578
E01022466,2281,1085,1196,0.4756685664182376,0.5243314335817624
E01022434,2109,1033,1076,0.489805595068753,0.510194404931247
E01022441,1551,754,797,0.48613797549967763,0.5138620245003224
E01022445,1436,702,734,0.48885793871866295,0.5111420612813371
E01022453,2401,1175,1226,0.4893794252394835,0.5106205747605165
E01022440,2342,1156,1186,0.4935952177625961,0.5064047822374039
E01022442,1672,820,852,0.4904306220095694,0.5095693779904307
E01022443,1488,727,761,0.4885752688172043,0.5114247311827957
E01022444,1633,834,799,0.5107164727495407,0.48928352725045926
E01022425,1218,586,632,0.48111658456486045,0.5188834154351396
E01022426,1415,704,711,0.4975265017667845,0.5024734982332155
E01022427,1392,666,726,0.47844827586206895,0.521551724137931
E01022428,1907,929,978,0.4871525957000524,0.5128474042999476
E01022429,1551,758,793,0.4887169568020632,0.5112830431979368
E01022430,1471,687,784,0.46702923181509176,0.5329707681849082
E01022431,1898,914,984,0.4815595363540569,0.5184404636459431
E01022447,1497,789,708,0.5270541082164328,0.4729458917835671
E01022448,2238,1074,1164,0.47989276139410186,0.5201072386058981
E01022454,2587,1230,1357,0.4754541940471589,0.5245458059528412
E01034805,1838,881,957,0.47932535364526657,0.5206746463547334
E01034806,1105,569,536,0.5149321266968325,0.4850678733031674
E01022421,1720,819,901,0.4761627906976744,0.5238372093023256
E01022423,2212,1110,1102,0.5018083182640145,0.49819168173598555
E01022424,1630,782,848,0.47975460122699387,0.5202453987730061
E01034807,1531,764,767,0.4990202482037884,0.5009797517962117
E01034808,1742,857,885,0.491963260619977,0.5080367393800229
E01034809,1356,646,710,0.47640117994100295,0.523598820058997
E01034810,2061,988,1073,0.47937894226103833,0.5206210577389617
E01022437,1458,690,768,0.4732510288065844,0.5267489711934157
E01022438,1283,633,650,0.49337490257209665,0.5066250974279034
E01022439,2651,1275,1376,0.4809505846850245,0.5190494153149755
E01034811,1608,761,847,0.4732587064676617,0.5267412935323383
E01034812,1214,588,626,0.4843492586490939,0.515650741350906
E01022432,1983,966,1017,0.48714069591527986,0.5128593040847201
E01022433,1964,918,1046,0.46741344195519346,0.5325865580448065
E01034813,1180,562,618,0.47627118644067795,0.523728813559322
E01034814,1227,579,648,0.4718826405867971,0.5281173594132029
E01034815,1466,680,786,0.4638472032742155,0.5361527967257844
E01029022,1454,687,767,0.47248968363136173,0.5275103163686382
E01029023,1315,630,685,0.4790874524714829,0.5209125475285171
E01029044,1410,690,720,0.48936170212765956,0.5106382978723404
E01029053,2364,1179,1185,0.4987309644670051,0.501269035532995
E01029057,2215,1080,1135,0.48758465011286684,0.5124153498871332
E01029024,2283,1151,1132,0.5041611914148051,0.4958388085851949
E01029025,1370,678,692,0.4948905109489051,0.5051094890510949
E01029068,1440,747,693,0.51875,0.48125
E01035107,2083,1029,1054,0.49399903984637544,0.5060009601536246
E01029030,1833,899,934,0.49045280960174575,0.5095471903982542
E01029031,1632,789,843,0.4834558823529412,0.5165441176470589
E01029032,1048,484,564,0.4618320610687023,0.5381679389312977
E01029033,1402,681,721,0.48573466476462196,0.514265335235378
E01029034,1299,610,689,0.4695919938414165,0.5304080061585835
E01029036,1869,921,948,0.492776886035313,0.507223113964687
E01029041,2043,972,1071,0.47577092511013214,0.5242290748898678
E01029042,1510,720,790,0.4768211920529801,0.5231788079470199
E01029043,1726,834,892,0.4831981460023175,0.5168018539976825
E01029045,1647,751,896,0.4559805707346691,0.5440194292653309
E01029052,2086,989,1097,0.4741131351869607,0.5258868648130393
E01029060,2006,977,1029,0.48703888334995016,0.5129611166500498
E01029083,1346,613,733,0.4554234769687964,0.5445765230312035
E01035108,1670,797,873,0.47724550898203594,0.5227544910179641
E01035109,1363,650,713,0.4768892149669846,0.5231107850330154
E01029018,2425,1180,1245,0.4865979381443299,0.51340206185567
E01029056,2336,1152,1184,0.4931506849315068,0.5068493150684932
E01029064,1506,731,775,0.4853917662682603,0.5146082337317397
E01029084,1480,682,798,0.4608108108108108,0.5391891891891892
E01029029,1684,817,867,0.4851543942992874,0.5148456057007126
E01029037,1409,689,720,0.48899929027679206,0.511000709723208
E01029038,1629,789,840,0.4843462246777164,0.5156537753222836
E01029039,1539,733,806,0.4762833008447043,0.5237166991552956
E01029040,1627,793,834,0.48740012292563,0.51259987707437
E01035110,1364,630,734,0.46187683284457476,0.5381231671554252
E01035111,1891,926,965,0.48968799576943417,0.5103120042305659
E01029078,1847,861,986,0.466161342717921,0.533838657282079
E01029079,1469,701,768,0.4771953710006807,0.5228046289993192
E01029080,1728,866,862,0.5011574074074074,0.4988425925925926
E01029081,1941,916,1025,0.47192168985059246,0.5280783101494075
E01029082,1332,625,707,0.4692192192192192,0.5307807807807807
E01029062,1531,816,715,0.5329849771391247,0.46701502286087526
E01029063,2591,1259,1332,0.48591277499035124,0.5140872250096488
E01029065,1538,761,777,0.49479843953185954,0.5052015604681405
E01029066,1724,849,875,0.49245939675174016,0.5075406032482599
E01029067,1702,815,887,0.4788484136310223,0.5211515863689776
E01029020,1528,759,769,0.4967277486910995,0.5032722513089005
E01029021,1252,622,630,0.4968051118210863,0.5031948881789138
E01029027,1572,764,808,0.4860050890585242,0.5139949109414759
E01029028,1119,569,550,0.5084897229669347,0.4915102770330652
E01029058,2321,1118,1203,0.48168892718655754,0.5183110728134425
E01029046,1359,673,686,0.4952170713760118,0.5047829286239882
E01029050,2673,1280,1393,0.4788627010849233,0.5211372989150767
E01029051,1429,700,729,0.489853044086774,0.510146955913226
E01032627,2179,1016,1163,0.46626893070215697,0.5337310692978431
E01029047,1340,620,720,0.4626865671641791,0.5373134328358209
E01029054,1681,809,872,0.4812611540749554,0.5187388459250446
E01029055,1278,640,638,0.5007824726134585,0.49921752738654146
E01029074,2205,1170,1035,0.5306122448979592,0.46938775510204084
E01029076,2291,1108,1183,0.4836316019205587,0.5163683980794412
E01029019,2640,1269,1371,0.48068181818181815,0.5193181818181818
E01029059,2190,1088,1102,0.4968036529680365,0.5031963470319635
E01029077,2102,1036,1066,0.4928639391056137,0.5071360608943863
E01029070,2516,1224,1292,0.4864864864864865,0.5135135135135135
E01029071,1463,709,754,0.48462064251537934,0.5153793574846206
E01029072,1584,769,815,0.48547979797979796,0.514520202020202
E01029073,1246,605,641,0.485553772070626,0.514446227929374
E01029075,1406,680,726,0.48364153627311524,0.5163584637268848
E01029085,1997,979,1018,0.4902353530295443,0.5097646469704556
E01029126,1539,757,782,0.4918778427550357,0.5081221572449642
E01029127,1601,753,848,0.47033104309806373,0.5296689569019363
E01029128,1882,931,951,0.4946865037194474,0.5053134962805526
E01029129,2346,1167,1179,0.49744245524296676,0.5025575447570333
E01029089,2328,1143,1185,0.49097938144329895,0.509020618556701
E01029113,1610,754,856,0.4683229813664596,0.5316770186335403
E01029115,1579,766,813,0.4851171627612413,0.5148828372387587
E01032633,2250,1125,1125,0.5,0.5
E01035112,1767,884,883,0.5002829654782116,0.49971703452178834
E01035113,1526,743,783,0.48689384010484926,0.5131061598951507
E01029086,2226,1101,1125,0.4946091644204852,0.5053908355795148
E01029147,1718,857,861,0.4988358556461001,0.5011641443538999
E01029148,1567,770,797,0.4913848117421825,0.5086151882578175
E01029149,1397,684,713,0.4896206156048676,0.5103793843951324
E01029114,1466,683,783,0.465893587994543,0.534106412005457
E01029116,1564,789,775,0.5044757033248082,0.4955242966751918
E01029117,1681,797,884,0.4741225461035098,0.5258774538964902
E01029119,1610,760,850,0.4720496894409938,0.5279503105590062
E01029120,1459,709,750,0.4859492803289925,0.5140507196710076
E01029118,1720,825,895,0.4796511627906977,0.5203488372093024
E01029131,2277,1160,1117,0.5094422485726834,0.49055775142731667
E01029132,1556,739,817,0.4749357326478149,0.5250642673521851
E01029133,1237,596,641,0.48181083265966046,0.5181891673403395
E01029134,2087,1002,1085,0.48011499760421655,0.5198850023957834
E01029135,1680,833,847,0.49583333333333335,0.5041666666666667
E01029136,2243,1137,1106,0.5069103878733838,0.4930896121266161
E01029145,2266,1101,1165,0.4858781994704325,0.5141218005295676
E01029152,2325,1094,1231,0.47053763440860213,0.5294623655913978
E01029121,1243,623,620,0.501206757843926,0.498793242156074
E01029122,1546,821,725,0.5310478654592496,0.4689521345407503
E01029123,1128,553,575,0.49024822695035464,0.5097517730496454
E01029124,1825,866,959,0.4745205479452055,0.5254794520547945
E01029125,1391,694,697,0.49892163910855497,0.501078360891445
E01029093,1528,765,763,0.5006544502617801,0.4993455497382199
E01029096,1725,897,828,0.52,0.48
E01029106,1651,797,854,0.48273773470623865,0.5172622652937614
E01029107,1557,768,789,0.4932562620423892,0.5067437379576107
E01029109,1408,729,679,0.5177556818181818,0.4822443181818182
E01029094,1950,1005,945,0.5153846153846153,0.4846153846153846
E01029095,1823,1007,816,0.5523861766319254,0.4476138233680746
E01029110,2180,1117,1063,0.5123853211009174,0.48761467889908255
E01029111,2441,1230,1211,0.5038918476034412,0.4961081523965588
E01029112,2182,1197,985,0.5485792850595783,0.45142071494042163
E01029091,1538,760,778,0.494148244473342,0.505851755526658
E01029092,1425,717,708,0.5031578947368421,0.4968421052631579
E01029108,2047,1031,1016,0.5036638983878847,0.4963361016121153
E01035114,1275,587,688,0.4603921568627451,0.5396078431372549
E01035115,1426,729,697,0.5112201963534362,0.4887798036465638
E01035116,1115,560,555,0.5022421524663677,0.4977578475336323
E01029102,1945,949,996,0.4879177377892031,0.5120822622107969
E01029103,1493,737,756,0.4936369725385131,0.506363027461487
E01029104,2000,969,1031,0.4845,0.5155
E01032631,1410,700,710,0.49645390070921985,0.5035460992907801
E01032632,1486,742,744,0.4993270524899058,0.5006729475100942
E01032634,1243,621,622,0.499597747385358,0.500402252614642
E01029130,2031,1005,1026,0.4948301329394387,0.5051698670605613
E01029137,1691,837,854,0.4949733885274985,0.5050266114725015
E01029138,1465,723,742,0.49351535836177474,0.5064846416382253
E01029139,1552,758,794,0.4884020618556701,0.5115979381443299
E01029150,1311,627,684,0.4782608695652174,0.5217391304347826
E01029151,1314,642,672,0.4885844748858447,0.5114155251141552
E01029097,1500,709,791,0.4726666666666667,0.5273333333333333
E01029098,1726,918,808,0.5318655851680185,0.4681344148319815
E01029099,1381,678,703,0.49094858797972485,0.5090514120202752
E01029100,1527,780,747,0.5108055009823183,0.48919449901768175
E01029105,1693,844,849,0.4985233313644418,0.5014766686355582
E01029101,1130,550,580,0.48672566371681414,0.5132743362831859
E01029142,1515,739,776,0.4877887788778878,0.5122112211221123
E01029143,1374,665,709,0.48398835516739447,0.5160116448326055
E01029144,1234,626,608,0.5072933549432739,0.49270664505672607
E01035117,1744,879,865,0.5040137614678899,0.4959862385321101
E01035118,1412,698,714,0.4943342776203966,0.5056657223796034
E01035119,1701,819,882,0.48148148148148145,0.5185185185185185
E01035120,1557,771,786,0.4951830443159923,0.5048169556840078
E01029157,1455,679,776,0.4666666666666667,0.5333333333333333
E01029158,1419,675,744,0.47568710359408034,0.5243128964059197
E01029221,2470,1181,1289,0.47813765182186235,0.5218623481781377
E01029166,2436,1176,1260,0.4827586206896552,0.5172413793103449
E01029167,1694,776,918,0.45808736717827625,0.5419126328217237
E01029168,1756,819,937,0.4664009111617312,0.5335990888382688
E01029210,1824,843,981,0.4621710526315789,0.537828947368421
E01029211,1378,675,703,0.4898403483309144,0.5101596516690856
E01029224,2092,1005,1087,0.4804015296367113,0.5195984703632888
E01029225,2509,1186,1323,0.47269828616978876,0.5273017138302113
E01029226,1639,761,878,0.4643075045759609,0.5356924954240391
E01029200,1587,745,842,0.4694391934467549,0.5305608065532451
E01029201,1783,871,912,0.48850252383623105,0.511497476163769
E01029222,1699,838,861,0.49323131253678637,0.5067686874632137
E01029223,1209,590,619,0.4880066170388751,0.5119933829611248
E01029155,1793,855,938,0.47685443390964866,0.5231455660903513
E01029227,2282,1117,1165,0.4894829097283085,0.5105170902716915
E01029228,2168,1068,1100,0.492619926199262,0.507380073800738
E01029229,2123,1056,1067,0.49740932642487046,0.5025906735751295
E01029164,1669,814,855,0.487717195925704,0.5122828040742959
E01029165,1207,606,601,0.5020712510356256,0.4979287489643745
E01029198,1240,636,604,0.5129032258064516,0.4870967741935484
E01029199,2807,1761,1046,0.6273601710010688,0.3726398289989312
E01029187,1198,582,616,0.48580968280467446,0.5141903171953256
E01029188,1506,718,788,0.4767596281540505,0.5232403718459495
E01029196,1774,886,888,0.49943630214205187,0.5005636978579482
E01029197,1288,638,650,0.4953416149068323,0.5046583850931677
E01029154,1907,947,960,0.49659150498164656,0.5034084950183534
E01029156,1971,971,1000,0.4926433282597666,0.5073566717402334
E01029206,1739,859,880,0.49396204715353653,0.5060379528464635
E01029207,1468,706,762,0.48092643051771117,0.5190735694822888
E01029202,1202,577,625,0.4800332778702163,0.5199667221297837
E01029203,1469,711,758,0.48400272294077606,0.5159972770592239
E01029204,1223,573,650,0.46852003270645953,0.5314799672935405
E01029205,1709,806,903,0.4716208308952604,0.5283791691047396
E01029163,2199,1074,1125,0.48840381991814463,0.5115961800818554
E01029216,1598,771,827,0.48247809762202754,0.5175219023779725
E01029217,1583,750,833,0.4737839545167404,0.5262160454832596
E01029218,2086,951,1135,0.45589645254074784,0.5441035474592522
E01029238,1482,722,760,0.48717948717948717,0.5128205128205128
E01029252,1369,680,689,0.4967129291453616,0.5032870708546384
E01029254,1325,646,679,0.48754716981132074,0.5124528301886793
E01035121,1517,718,799,0.4733025708635465,0.5266974291364536
E01035122,2052,1029,1023,0.5014619883040936,0.49853801169590645
E01029248,1558,760,798,0.4878048780487805,0.5121951219512195
E01029250,1318,645,673,0.48937784522003036,0.5106221547799696
E01029251,1776,899,877,0.5061936936936937,0.4938063063063063
E01035123,1646,848,798,0.5151883353584447,0.4848116646415553
E01035124,1428,703,725,0.49229691876750703,0.507703081232493
E01029161,1559,761,798,0.48813341885824246,0.5118665811417575
E01029162,1505,730,775,0.4850498338870432,0.5149501661129569
E01029247,1598,750,848,0.4693366708385482,0.5306633291614519
E01029255,1347,640,707,0.47512991833704527,0.5248700816629547
E01029231,1483,739,744,0.4983142279163857,0.5016857720836143
E01029233,1755,863,892,0.49173789173789173,0.5082621082621083
E01029235,1396,684,712,0.4899713467048711,0.5100286532951289
E01029236,1499,725,774,0.4836557705136758,0.5163442294863242
E01029237,1730,811,919,0.4687861271676301,0.53121387283237
E01029232,1582,791,791,0.5,0.5
E01029239,1795,923,872,0.5142061281337047,0.48579387186629525
E01029240,1603,796,807,0.49656893325015594,0.5034310667498441
E01035125,1116,592,524,0.5304659498207885,0.46953405017921146
E01035126,1120,603,517,0.5383928571428571,0.4616071428571429
E01029241,2187,1045,1142,0.47782350251486055,0.5221764974851395
E01029245,2231,1104,1127,0.4948453608247423,0.5051546391752577
E01029246,1438,686,752,0.47705146036161333,0.5229485396383866
E01029249,1344,637,707,0.4739583333333333,0.5260416666666666
E01029189,1086,521,565,0.47974217311233885,0.5202578268876611
E01029190,1435,676,759,0.4710801393728223,0.5289198606271777
E01029191,1278,625,653,0.4890453834115806,0.5109546165884195
E01029192,1404,684,720,0.48717948717948717,0.5128205128205128
E01029212,1110,552,558,0.4972972972972973,0.5027027027027027
E01029213,1295,658,637,0.5081081081081081,0.4918918918918919
E01029214,1200,592,608,0.49333333333333335,0.5066666666666667
E01029215,1155,550,605,0.47619047619047616,0.5238095238095238
E01029159,1989,989,1000,0.4972347913524384,0.5027652086475616
E01029242,1446,754,692,0.5214384508990318,0.4785615491009682
E01029243,1571,776,795,0.4939528962444303,0.5060471037555697
E01029244,1472,737,735,0.5006793478260869,0.499320652173913
E01029193,1945,942,1003,0.48431876606683805,0.515681233933162
E01029194,2655,1271,1384,0.47871939736346514,0.5212806026365349
E01029195,1546,727,819,0.4702457956015524,0.5297542043984476
E01029208,1280,617,663,0.48203125,0.51796875
E01029209,1343,649,694,0.4832464631422189,0.5167535368577811
E01029178,1546,769,777,0.4974126778783959,0.5025873221216042
E01029179,1095,529,566,0.4831050228310502,0.5168949771689497
E01029180,1474,703,771,0.4769335142469471,0.5230664857530529
E01029181,1300,650,650,0.5,0.5
E01029182,1683,808,875,0.4800950683303625,0.5199049316696376
E01029183,1692,798,894,0.4716312056737589,0.5283687943262412
E01029184,1780,845,935,0.4747191011235955,0.5252808988764045
E01029185,1675,825,850,0.4925373134328358,0.5074626865671642
E01029186,1543,728,815,0.47180816591056385,0.5281918340894362
E01029169,1740,883,857,0.5074712643678161,0.4925287356321839
E01029172,1492,726,766,0.4865951742627346,0.5134048257372654
E01029173,1460,724,736,0.4958904109589041,0.5041095890410959
E01029176,1363,669,694,0.49082905355832723,0.5091709464416728
E01029177,1296,614,682,0.4737654320987654,0.5262345679012346
E01029170,1278,622,656,0.486697965571205,0.513302034428795
E01029171,2322,1168,1154,0.5030146425495263,0.49698535745047373
E01029174,1079,540,539,0.5004633920296571,0.4995366079703429
E01029175,2259,1146,1113,0.5073041168658698,0.49269588313413015
E01029153,2390,1174,1216,0.49121338912133894,0.5087866108786611
E01029219,1444,726,718,0.502770083102493,0.49722991689750695
E01029220,1293,620,673,0.4795050270688322,0.5204949729311679
E01029230,2344,1136,1208,0.48464163822525597,0.515358361774744
E01029258,1625,789,836,0.48553846153846153,0.5144615384615384
E01029259,1501,715,786,0.4763491005996003,0.5236508994003998
E01029260,2411,1150,1261,0.476980506014102,0.523019493985898
E01029268,1628,787,841,0.4834152334152334,0.5165847665847666
E01029276,1718,889,829,0.5174621653084982,0.48253783469150174
E01029278,1464,685,779,0.46789617486338797,0.532103825136612
E01029290,1429,699,730,0.48915325402379284,0.5108467459762072
E01029306,1488,724,764,0.48655913978494625,0.5134408602150538
E01029319,2120,1054,1066,0.4971698113207547,0.5028301886792453
E01029267,1694,823,871,0.4858323494687131,0.5141676505312869
E01029320,1737,844,893,0.485895221646517,0.514104778353483
E01029321,2325,1162,1163,0.4997849462365591,0.5002150537634409
E01029297,1369,688,681,0.5025566106647188,0.4974433893352812
E01029298,1424,699,725,0.49087078651685395,0.5091292134831461
E01029304,1417,668,749,0.47141848976711365,0.5285815102328864
E01029305,1332,632,700,0.4744744744744745,0.5255255255255256
E01029307,1359,643,716,0.4731420161883738,0.5268579838116262
E01029271,1900,923,977,0.48578947368421055,0.5142105263157895
E01029273,1419,670,749,0.47216349541930935,0.5278365045806906
E01029274,1854,916,938,0.49406688241639696,0.505933117583603
E01029275,1280,606,674,0.4734375,0.5265625
E01029279,1534,768,766,0.500651890482399,0.49934810951760106
E01029282,1387,682,705,0.49170872386445563,0.5082912761355444
E01029291,1568,806,762,0.514030612244898,0.48596938775510207
E01029294,1841,858,983,0.4660510592069527,0.5339489407930472
E01029317,1885,895,990,0.47480106100795755,0.5251989389920424
E01035127,1914,927,987,0.4843260188087774,0.5156739811912225
E01035128,2147,1038,1109,0.48346530041918956,0.5165346995808104
E01029285,2546,1294,1252,0.5082482325216026,0.4917517674783975
E01029287,1529,766,763,0.5009810333551341,0.49901896664486595
E01029288,1501,733,768,0.4883411059293804,0.5116588940706196
E01029289,1873,929,944,0.49599572877736253,0.5040042712226375
E01029299,1592,793,799,0.4981155778894472,0.5018844221105527
E01029300,2264,1151,1113,0.5083922261484098,0.4916077738515901
E01029256,2220,1046,1174,0.4711711711711712,0.5288288288288289
E01029257,2241,1055,1186,0.4707719767960732,0.5292280232039268
E01029277,1403,666,737,0.4746970776906629,0.5253029223093372
E01032651,1865,1022,843,0.5479892761394102,0.4520107238605898
E01032652,2201,1065,1136,0.4838709677419355,0.5161290322580645
E01029280,1731,811,920,0.4685153090699018,0.5314846909300982
E01029281,1668,787,881,0.47182254196642687,0.5281774580335732
E01029283,1733,833,900,0.48066935949221,0.51933064050779
E01029292,1556,759,797,0.4877892030848329,0.5122107969151671
E01029293,1708,783,925,0.45843091334894615,0.5415690866510539
E01029266,1300,606,694,0.46615384615384614,0.5338461538461539
E01029284,1706,893,813,0.5234466588511137,0.4765533411488863
E01029286,1709,855,854,0.5002925687536571,0.49970743124634287
E01029301,2062,973,1089,0.47187196896217265,0.5281280310378274
E01029303,1890,902,988,0.47724867724867726,0.5227513227513227
E01029263,1403,644,759,0.45901639344262296,0.5409836065573771
E01029264,1369,656,713,0.47918188458729,0.5208181154127101
E01029265,1359,649,710,0.4775570272259014,0.5224429727740986
E01029302,1754,835,919,0.47605473204104903,0.523945267958951
E01029308,2088,1008,1080,0.4827586206896552,0.5172413793103449
E01029311,2487,1206,1281,0.48492159227985526,0.5150784077201448
E01029312,1364,652,712,0.4780058651026393,0.5219941348973607
E01029313,1614,830,784,0.5142503097893433,0.4857496902106567
E01029316,1710,808,902,0.47251461988304094,0.5274853801169591
E01035129,2000,963,1037,0.4815,0.5185
E01035130,1345,647,698,0.48104089219330853,0.5189591078066914
E01029262,2326,1137,1189,0.4888220120378332,0.5111779879621668
E01029269,2180,1063,1117,0.48761467889908255,0.5123853211009174
E01029310,1917,955,962,0.4981742305685968,0.5018257694314032
E01029315,1378,636,742,0.46153846153846156,0.5384615384615384
E01035131,1391,687,704,0.49388928828181167,0.5061107117181883
E01035132,1463,711,752,0.4859876965140123,0.5140123034859877
E01029261,2288,1136,1152,0.4965034965034965,0.5034965034965035
E01029270,2245,1096,1149,0.488195991091314,0.5118040089086859
E01029295,1563,781,782,0.4996801023672425,0.5003198976327575
E01029296,2193,1061,1132,0.483812129502964,0.5161878704970361
E01029324,1760,875,885,0.4971590909090909,0.5028409090909091
E01029329,1757,830,927,0.4723961297666477,0.5276038702333523
E01029330,1911,927,984,0.4850863422291994,0.5149136577708007
E01032636,2012,984,1028,0.48906560636182905,0.510934393638171
E01029322,1647,795,852,0.48269581056466304,0.517304189435337
E01029331,1489,701,788,0.470785762256548,0.529214237743452
E01029333,1179,564,615,0.47837150127226463,0.5216284987277354
E01029336,2069,985,1084,0.47607539874335425,0.5239246012566457
E01029326,1251,594,657,0.4748201438848921,0.5251798561151079
E01029334,1123,536,587,0.4772929652715939,0.5227070347284061
E01029339,1566,730,836,0.4661558109833972,0.5338441890166028
E01029341,1290,655,635,0.5077519379844961,0.49224806201550386
E01032635,2322,1097,1225,0.47243755383290265,0.5275624461670974
E01029327,2044,1014,1030,0.49608610567514677,0.5039138943248532
E01029335,1096,529,567,0.48266423357664234,0.5173357664233577
E01029337,2145,1075,1070,0.5011655011655012,0.4988344988344988
E01029342,1081,503,578,0.4653098982423682,0.5346901017576319
E01029343,1605,758,847,0.4722741433021807,0.5277258566978194
E01029325,1991,940,1051,0.4721245605223506,0.5278754394776495
E01029328,1926,934,992,0.48494288681204567,0.5150571131879543
E01029338,1679,826,853,0.4919594997022037,0.5080405002977963
W01000003,2440,1225,1215,0.5020491803278688,0.4979508196721312
W01000004,1255,601,654,0.4788844621513944,0.5211155378486055
W01000018,1177,576,601,0.4893797790994053,0.5106202209005948
W01000028,1980,994,986,0.502020202020202,0.49797979797979797
W01000031,1551,773,778,0.498388136686009,0.501611863313991
W01000010,1808,860,948,0.4756637168141593,0.5243362831858407
W01000021,2313,1160,1153,0.5015131863380891,0.49848681366191094
W01002005,2244,1086,1158,0.4839572192513369,0.516042780748663
W01000016,1194,609,585,0.5100502512562815,0.4899497487437186
W01000017,1683,810,873,0.48128342245989303,0.5187165775401069
W01000029,1609,771,838,0.4791796146674953,0.5208203853325046
W01000030,2325,1092,1233,0.4696774193548387,0.5303225806451612
W01000033,1557,746,811,0.47912652536929995,0.5208734746307001
W01000036,1104,555,549,0.5027173913043478,0.49728260869565216
W01000037,1159,563,596,0.4857635893011217,0.5142364106988784
W01000022,1606,810,796,0.5043586550435866,0.49564134495641343
W01000034,1448,687,761,0.4744475138121547,0.5255524861878453
W01000040,1053,510,543,0.4843304843304843,0.5156695156695157
W01000044,1080,525,555,0.4861111111111111,0.5138888888888888
W01002007,2210,1078,1132,0.48778280542986424,0.5122171945701357
W01000005,1612,776,836,0.4813895781637717,0.5186104218362283
W01000013,2181,1040,1141,0.4768454837230628,0.5231545162769372
W01000019,1337,639,698,0.4779356768885565,0.5220643231114436
W01000026,1244,600,644,0.48231511254019294,0.5176848874598071
W01000035,1787,866,921,0.4846110800223839,0.5153889199776162
W01000006,1540,787,753,0.5110389610389611,0.488961038961039
W01000012,1697,817,880,0.48143783146729524,0.5185621685327048
W01000014,2209,1079,1130,0.48845631507469445,0.5115436849253056
W01000041,1594,770,824,0.48306148055207027,0.5169385194479298
W01000009,1871,913,958,0.4879743452699091,0.5120256547300909
W01000023,1571,755,816,0.4805856142584341,0.5194143857415658
W01000024,1357,708,649,0.5217391304347826,0.4782608695652174
W01002008,2095,1012,1083,0.483054892601432,0.516945107398568
W01000008,1446,670,776,0.4633471645919779,0.5366528354080221
W01000011,1005,502,503,0.49950248756218907,0.5004975124378109
W01000015,1457,691,766,0.4742621825669183,0.5257378174330817
W01000042,2041,996,1045,0.48799608035276826,0.5120039196472318
W01000007,1773,892,881,0.503102086858432,0.49689791314156795
W01000025,2166,1088,1078,0.5023084025854109,0.4976915974145891
W01000027,1860,935,925,0.5026881720430108,0.49731182795698925
W01000038,2235,1089,1146,0.487248322147651,0.512751677852349
W01000062,1988,917,1071,0.4612676056338028,0.5387323943661971
W01000076,1295,629,666,0.4857142857142857,0.5142857142857142
W01000077,1178,592,586,0.5025466893039049,0.49745331069609505
W01000091,1106,555,551,0.5018083182640145,0.49819168173598555
W01000092,3049,1474,1575,0.4834371925221384,0.5165628074778615
W01000064,2002,1031,971,0.514985014985015,0.485014985014985
W01000072,1675,812,863,0.4847761194029851,0.515223880597015
W01000075,1406,684,722,0.4864864864864865,0.5135135135135135
W01000090,1362,632,730,0.46402349486049926,0.5359765051395007
W01000102,1932,962,970,0.4979296066252588,0.5020703933747412
W01000050,1438,715,723,0.4972183588317107,0.5027816411682893
W01000071,2240,1084,1156,0.48392857142857143,0.5160714285714286
W01000096,1267,625,642,0.49329123914759276,0.5067087608524072
W01000097,1142,547,595,0.478984238178634,0.521015761821366
W01000115,2122,1034,1088,0.4872761545711593,0.5127238454288408
W01000052,1090,536,554,0.4917431192660551,0.5082568807339449
W01000053,1179,604,575,0.5122985581000848,0.48770144189991516
W01000087,1826,872,954,0.47754654983570644,0.5224534501642936
W01000119,2330,1147,1183,0.492274678111588,0.507725321888412
W01000063,1896,935,961,0.4931434599156118,0.5068565400843882
W01000081,2007,978,1029,0.4872944693572496,0.5127055306427504
W01000099,1670,852,818,0.5101796407185629,0.48982035928143713
W01000103,1168,566,602,0.4845890410958904,0.5154109589041096
W01000059,2114,1033,1081,0.48864711447492903,0.511352885525071
W01000093,2256,1072,1184,0.475177304964539,0.524822695035461
W01000098,2548,1218,1330,0.47802197802197804,0.521978021978022
W01000110,1597,760,837,0.47589229805886035,0.5241077019411396
W01000054,1003,480,523,0.4785643070787637,0.5214356929212363
W01000088,2082,998,1084,0.4793467819404419,0.5206532180595581
W01000111,1564,747,817,0.47762148337595906,0.5223785166240409
W01000118,1710,840,870,0.49122807017543857,0.5087719298245614
W01000073,1666,805,861,0.4831932773109244,0.5168067226890757
W01000086,2175,1080,1095,0.496551724137931,0.503448275862069
W01000104,1792,886,906,0.49441964285714285,0.5055803571428571
W01000112,1942,950,992,0.48918640576725025,0.5108135942327497
W01000056,1777,895,882,0.5036578503095104,0.49634214969048956
W01000065,1032,515,517,0.499031007751938,0.500968992248062
W01000113,1857,899,958,0.4841141626278945,0.5158858373721056
W01000114,1416,733,683,0.5176553672316384,0.4823446327683616
W01000066,1173,572,601,0.4876385336743393,0.5123614663256607
W01000100,1056,516,540,0.48863636363636365,0.5113636363636364
W01000105,1729,848,881,0.49045691150954307,0.5095430884904569
W01000106,1506,741,765,0.49203187250996017,0.5079681274900398
W01000107,1196,614,582,0.5133779264214047,0.4866220735785953
W01000047,1270,593,677,0.46692913385826773,0.5330708661417323
W01000061,1736,804,932,0.4631336405529954,0.5368663594470046
W01000078,1557,747,810,0.4797687861271676,0.5202312138728323
W01000089,1919,950,969,0.49504950495049505,0.504950495049505
W01000070,1297,668,629,0.5150346954510409,0.48496530454895914
W01000094,1219,589,630,0.4831829368334701,0.51681706316653
W01000095,1290,639,651,0.49534883720930234,0.5046511627906977
W01000108,2087,1033,1054,0.49496885481552466,0.5050311451844753
W01000109,1858,913,945,0.4913885898815931,0.5086114101184069
W01000074,1803,905,898,0.5019412090959512,0.4980587909040488
W01000101,1368,667,701,0.48757309941520466,0.5124269005847953
W01002003,2380,1146,1234,0.4815126050420168,0.5184873949579832
W01000080,1456,709,747,0.48695054945054944,0.5130494505494505
W01000084,1068,542,526,0.5074906367041199,0.49250936329588013
W01001932,2759,1369,1390,0.496194273287423,0.5038057267125771
W01000051,1993,962,1031,0.4826894129453086,0.5173105870546915
W01000060,1254,625,629,0.4984051036682616,0.5015948963317385
W01000082,1086,550,536,0.5064456721915286,0.49355432780847147
W01000083,1346,714,632,0.5304606240713224,0.46953937592867756
W01000057,1382,719,663,0.5202604920405209,0.479739507959479
W01000067,1182,577,605,0.48815566835871405,0.511844331641286
W01000068,1418,682,736,0.4809590973201692,0.5190409026798307
W01002004,2146,1048,1098,0.48835041938490215,0.5116495806150979
W01000085,1923,972,951,0.5054602184087363,0.49453978159126366
W01000116,1669,757,912,0.45356500898741764,0.5464349910125824
W01000117,1464,715,749,0.4883879781420765,0.5116120218579235
W01001933,1900,942,958,0.4957894736842105,0.5042105263157894
W01000132,1546,786,760,0.5084087968952135,0.49159120310478654
W01000146,2032,1007,1025,0.4955708661417323,0.5044291338582677
W01000147,1491,720,771,0.482897384305835,0.5171026156941649
W01000169,1764,859,905,0.48696145124716556,0.5130385487528345
W01000186,1587,754,833,0.4751102709514808,0.5248897290485193
W01000133,1780,847,933,0.47584269662921347,0.5241573033707865
W01000168,1829,870,959,0.4756697648988518,0.5243302351011482
W01000187,1513,695,818,0.4593522802379379,0.5406477197620622
W01000188,1589,744,845,0.4682190056639396,0.5317809943360604
W01000154,1411,656,755,0.4649184975194897,0.5350815024805102
W01000173,1464,725,739,0.4952185792349727,0.5047814207650273
W01000174,1608,786,822,0.48880597014925375,0.5111940298507462
W01000175,1517,726,791,0.47857613711272246,0.5214238628872775
W01000155,1409,681,728,0.48332150461320084,0.5166784953867991
W01000156,1486,699,787,0.47039030955585465,0.5296096904441454
W01000157,1428,672,756,0.47058823529411764,0.5294117647058824
W01000158,1559,729,830,0.4676074406670943,0.5323925593329057
W01000149,1488,730,758,0.4905913978494624,0.5094086021505376
W01000150,1480,721,759,0.4871621621621622,0.5128378378378379
W01000151,1522,732,790,0.480946123521682,0.519053876478318
W01000152,1417,689,728,0.48623853211009177,0.5137614678899083
W01000184,2267,1100,1167,0.48522276135862374,0.5147772386413763
W01000135,1992,919,1073,0.46134538152610444,0.5386546184738956
W01000136,1770,865,905,0.4887005649717514,0.5112994350282486
W01000165,1856,907,949,0.4886853448275862,0.5113146551724138
W01000166,2770,1273,1497,0.4595667870036101,0.5404332129963899
W01000139,1628,818,810,0.5024570024570024,0.4975429975429975
W01000143,1577,764,813,0.4844641724793913,0.5155358275206088
W01000144,1676,857,819,0.5113365155131265,0.4886634844868735
W01000182,2076,1016,1060,0.48940269749518306,0.5105973025048169
W01000138,1942,963,979,0.49588053553038103,0.504119464469619
W01000145,1298,618,680,0.4761171032357473,0.5238828967642527
W01000180,1497,757,740,0.5056780227120908,0.49432197728790916
W01000181,1462,714,748,0.4883720930232558,0.5116279069767442
W01000183,1467,686,781,0.4676209952283572,0.5323790047716428
W01000126,1684,820,864,0.48693586698337293,0.5130641330166271
W01000127,1373,680,693,0.49526584122359796,0.504734158776402
W01000128,1503,744,759,0.49500998003992014,0.5049900199600799
W01000153,1600,761,839,0.475625,0.524375
W01000163,1382,639,743,0.46237337192474676,0.5376266280752533
W01000164,1352,642,710,0.47485207100591714,0.5251479289940828
W01000140,1771,849,922,0.47939017504234893,0.5206098249576511
W01000141,1538,721,817,0.4687906371911573,0.5312093628088427
W01000142,1514,739,775,0.48811096433289297,0.511889035667107
W01000178,2021,907,1114,0.4487877288471054,0.5512122711528946
W01000179,2009,937,1072,0.46640119462419116,0.5335988053758088
W01001927,1346,653,693,0.4851411589895988,0.5148588410104011
W01001928,1085,567,518,0.5225806451612903,0.4774193548387097
W01000167,2005,1007,998,0.5022443890274314,0.4977556109725686
W01000176,1621,772,849,0.47624922887106724,0.5237507711289328
W01000177,1441,704,737,0.48854961832061067,0.5114503816793893
W01001926,2129,1037,1092,0.4870831376232973,0.5129168623767026
W01000124,1942,979,963,0.504119464469619,0.49588053553038103
W01000129,1178,554,624,0.4702886247877759,0.5297113752122241
W01000130,1409,669,740,0.47480482611781405,0.525195173882186
W01000131,1680,798,882,0.475,0.525
W01000123,1751,870,881,0.49685893774985723,0.5031410622501428
W01000125,1537,757,780,0.49251789199739754,0.5074821080026025
W01000170,1790,862,928,0.48156424581005586,0.5184357541899441
W01000171,1493,704,789,0.4715338245144005,0.5284661754855995
W01000172,1266,623,643,0.4921011058451817,0.5078988941548184
W01000122,1953,997,956,0.5104966717869943,0.48950332821300563
W01000159,1426,704,722,0.49368863955119213,0.5063113604488079
W01000162,1819,945,874,0.519516217702034,0.4804837822979659
W01000190,1400,666,734,0.4757142857142857,0.5242857142857142
W01000121,1148,577,571,0.5026132404181185,0.49738675958188155
W01000134,2045,1006,1039,0.4919315403422983,0.5080684596577018
W01000137,1538,728,810,0.47334200260078024,0.5266579973992198
W01000148,1085,518,567,0.4774193548387097,0.5225806451612903
W01000185,1235,610,625,0.4939271255060729,0.5060728744939271
W01000189,1467,747,720,0.50920245398773,0.49079754601226994
W01000218,1585,773,812,0.48769716088328074,0.5123028391167193
W01000219,2635,1254,1381,0.4759013282732448,0.5240986717267552
W01000220,1642,787,855,0.47929354445797806,0.5207064555420219
W01000213,1328,610,718,0.45933734939759036,0.5406626506024096
W01000214,1157,529,628,0.45721694036300775,0.5427830596369922
W01000215,1465,717,748,0.489419795221843,0.510580204778157
W01000216,1296,615,681,0.47453703703703703,0.5254629629629629
W01000212,2166,1023,1143,0.47229916897506924,0.5277008310249307
W01000221,1345,640,705,0.4758364312267658,0.5241635687732342
W01000222,1788,826,962,0.46196868008948544,0.5380313199105146
W01000226,1540,711,829,0.4616883116883117,0.5383116883116883
W01000227,1485,740,745,0.4983164983164983,0.5016835016835017
W01000228,1627,750,877,0.46097111247695144,0.5390288875230486
W01000239,1720,899,821,0.5226744186046511,0.47732558139534886
W01000240,1669,905,764,0.542240862792091,0.45775913720790895
W01000241,1524,754,770,0.494750656167979,0.505249343832021
W01000236,1997,939,1058,0.47020530796194293,0.5297946920380571
W01000237,1772,841,931,0.47460496613995484,0.5253950338600452
W01000238,1797,876,921,0.48747913188647746,0.5125208681135225
W01000200,1282,640,642,0.49921996879875197,0.500780031201248
W01000201,1719,813,906,0.47294938917975565,0.5270506108202443
W01000217,2002,990,1012,0.4945054945054945,0.5054945054945055
W01000248,1655,811,844,0.4900302114803625,0.5099697885196375
W01000191,2092,1013,1079,0.48422562141491393,0.515774378585086
W01000223,1291,621,670,0.4810224632068164,0.5189775367931836
W01000224,1572,742,830,0.4720101781170484,0.5279898218829516
W01000225,1426,682,744,0.4782608695652174,0.5217391304347826
W01000245,1846,910,936,0.49295774647887325,0.5070422535211268
W01000246,1638,761,877,0.4645909645909646,0.5354090354090354
W01000247,1817,856,961,0.47110621904237754,0.5288937809576224
W01000194,1914,948,966,0.4952978056426332,0.5047021943573667
W01000198,1386,684,702,0.4935064935064935,0.5064935064935064
W01000199,1704,836,868,0.49061032863849763,0.5093896713615024
W01000195,1439,693,746,0.4815844336344684,0.5184155663655317
W01000196,1406,687,719,0.48862019914651494,0.5113798008534851
W01000197,1677,812,865,0.4841979725700656,0.5158020274299344
W01000211,1797,902,895,0.5019476905954369,0.4980523094045632
W01000203,2432,1222,1210,0.5024671052631579,0.4975328947368421
W01000204,1462,735,727,0.5027359781121751,0.49726402188782487
W01000206,2239,1126,1113,0.5029030817329165,0.4970969182670835
W01000242,1978,964,1014,0.487360970677452,0.512639029322548
W01000243,2118,1069,1049,0.5047214353163362,0.4952785646836638
W01000244,1603,771,832,0.4809731752963194,0.5190268247036806
W01000193,1245,628,617,0.5044176706827309,0.4955823293172691
W01000202,1634,807,827,0.4938800489596083,0.5061199510403916
W01000207,2308,1144,1164,0.49566724436741766,0.5043327556325823
W01000192,997,505,492,0.506519558676028,0.4934804413239719
W01000205,1212,598,614,0.4933993399339934,0.5066006600660066
W01000208,1283,670,613,0.5222135619641465,0.47778643803585347
W01000209,1411,689,722,0.4883061658398299,0.5116938341601701
W01000210,1333,636,697,0.477119279819955,0.522880720180045
W01000229,1537,719,818,0.4677944046844502,0.5322055953155498
W01000230,1919,938,981,0.4887962480458572,0.5112037519541428
W01000231,1329,635,694,0.4778028592927013,0.5221971407072987
W01000232,1636,789,847,0.48227383863080686,0.5177261613691931
W01000233,1304,603,701,0.4624233128834356,0.5375766871165644
W01000234,2298,1106,1192,0.48128807658833767,0.5187119234116623
W01000235,1335,660,675,0.4943820224719101,0.5056179775280899
W01000287,1883,918,965,0.4875199150292087,0.5124800849707913
W01000298,1478,704,774,0.476319350473613,0.523680649526387
W01000338,1769,857,912,0.4844544940644432,0.5155455059355568
W01000306,2442,1227,1215,0.5024570024570024,0.4975429975429975
W01000320,1892,945,947,0.49947145877378435,0.5005285412262156
W01000340,2244,1126,1118,0.5017825311942959,0.4982174688057041
W01000253,1851,917,934,0.495407887628309,0.504592112371691
W01000254,2118,1021,1097,0.48205854579792257,0.5179414542020774
W01000296,1549,738,811,0.47643641058747577,0.5235635894125242
W01000297,1228,602,626,0.49022801302931596,0.509771986970684
W01000304,2083,1049,1034,0.5036005760921748,0.49639942390782527
W01000305,1922,927,995,0.48231009365244537,0.5176899063475546
W01000288,2176,1034,1142,0.47518382352941174,0.5248161764705882
W01000290,1272,600,672,0.4716981132075472,0.5283018867924528
W01000292,1475,701,774,0.4752542372881356,0.5247457627118645
W01000293,2707,1367,1340,0.5049870705578131,0.49501292944218694
W01000289,1330,653,677,0.49097744360902257,0.5090225563909775
W01000291,1323,620,703,0.46863189720332576,0.5313681027966742
W01000294,1885,936,949,0.496551724137931,0.503448275862069
W01000295,1568,746,822,0.475765306122449,0.5242346938775511
W01000258,2107,1045,1062,0.4959658281917418,0.5040341718082582
W01000270,1247,635,612,0.5092221331194867,0.4907778668805132
W01000271,1243,613,630,0.49316170555108607,0.5068382944489139
W01000272,1790,856,934,0.4782122905027933,0.5217877094972067
W01000301,1717,848,869,0.4938846825859057,0.5061153174140943
W01000273,1539,732,807,0.4756335282651072,0.5243664717348928
W01000274,1918,955,963,0.49791449426485923,0.5020855057351408
W01000275,1187,606,581,0.510530749789385,0.489469250210615
W01000278,1476,722,754,0.489159891598916,0.510840108401084
W01000276,1212,616,596,0.5082508250825083,0.49174917491749176
W01000277,1368,655,713,0.4788011695906433,0.5211988304093568
W01000279,1180,578,602,0.48983050847457626,0.5101694915254237
W01000281,1176,569,607,0.483843537414966,0.516156462585034
W01000283,2339,1180,1159,0.5044890979050877,0.49551090209491233
W01000332,1826,919,907,0.5032858707557503,0.49671412924424974
W01000333,1519,751,768,0.49440421329822254,0.5055957867017775
W01000334,1744,894,850,0.5126146788990825,0.4873853211009174
W01000335,1174,591,583,0.5034071550255537,0.49659284497444633
W01000336,1434,670,764,0.46722454672245467,0.5327754532775453
W01000337,2147,1063,1084,0.49510945505356313,0.5048905449464369
W01000252,1626,753,873,0.46309963099630996,0.5369003690036901
W01000280,1742,864,878,0.49598163030998854,0.5040183696900115
W01000282,1634,827,807,0.5061199510403916,0.4938800489596083
W01000325,1827,869,958,0.4756431308155446,0.5243568691844553
W01000311,1674,816,858,0.4874551971326165,0.5125448028673835
W01000312,1612,811,801,0.5031017369727047,0.4968982630272953
W01000328,1908,990,918,0.5188679245283019,0.4811320754716981
W01000264,1716,844,872,0.49184149184149184,0.5081585081585082
W01000265,1486,710,776,0.477792732166891,0.522207267833109
W01000323,1561,759,802,0.48622677770659833,0.5137732222934016
W01000324,1498,718,780,0.47930574098798395,0.520694259012016
W01000251,1541,754,787,0.4892926670992862,0.5107073329007138
W01000268,1656,819,837,0.4945652173913043,0.5054347826086957
W01000284,1727,814,913,0.4713375796178344,0.5286624203821656
W01000285,1596,798,798,0.5,0.5
W01000286,2179,1086,1093,0.4983937586048646,0.5016062413951354
W01000302,1928,931,997,0.4828838174273859,0.5171161825726142
W01000249,1188,573,615,0.4823232323232323,0.5176767676767676
W01000250,1424,704,720,0.4943820224719101,0.5056179775280899
W01000261,1412,682,730,0.4830028328611898,0.5169971671388102
W01000321,1636,804,832,0.49144254278728605,0.508557457212714
W01000322,1379,698,681,0.5061638868745467,0.4938361131254532
W01000255,2270,1133,1137,0.49911894273127755,0.5008810572687225
W01000256,1544,718,826,0.4650259067357513,0.5349740932642487
W01000257,2717,1355,1362,0.4987118145012882,0.5012881854987118
W01000329,1622,792,830,0.4882860665844636,0.5117139334155364
W01000330,2073,1018,1055,0.4910757356488181,0.5089242643511819
W01000331,1443,726,717,0.5031185031185031,0.4968814968814969
W01000313,1604,770,834,0.4800498753117207,0.5199501246882793
W01000314,1122,528,594,0.47058823529411764,0.5294117647058824
W01000315,1958,926,1032,0.4729315628192033,0.5270684371807968
W01000316,1227,580,647,0.47269763651181745,0.5273023634881826
W01000317,1602,802,800,0.5006242197253433,0.4993757802746567
W01000318,1197,579,618,0.48370927318295737,0.5162907268170426
W01000319,1437,689,748,0.47947112038970074,0.5205288796102993
W01000259,1672,796,876,0.47607655502392343,0.5239234449760766
W01000260,1719,825,894,0.4799301919720768,0.5200698080279232
W01000262,1418,706,712,0.4978843441466855,0.5021156558533145
W01000263,1344,642,702,0.47767857142857145,0.5223214285714286
W01000266,1660,803,857,0.48373493975903614,0.5162650602409639
W01000267,2039,1019,1020,0.49975478175576266,0.5002452182442374
W01000303,1731,833,898,0.48122472559214324,0.5187752744078568
W01000326,2233,1090,1143,0.48813255709807435,0.5118674429019257
W01000327,2475,1222,1253,0.49373737373737375,0.5062626262626263
W01000299,1884,940,944,0.4989384288747346,0.5010615711252654
W01000300,1628,818,810,0.5024570024570024,0.4975429975429975
W01000309,2123,1022,1101,0.4813942534149788,0.5186057465850212
W01000339,1687,833,854,0.49377593360995853,0.5062240663900415
W01000269,1560,731,829,0.4685897435897436,0.5314102564102564
W01000307,1423,704,719,0.4947294448348559,0.5052705551651441
W01000308,1181,584,597,0.4944961896697714,0.5055038103302286
W01000310,1878,906,972,0.48242811501597443,0.5175718849840255
W01000374,1365,676,689,0.49523809523809526,0.5047619047619047
W01000375,2116,1030,1086,0.4867674858223062,0.5132325141776938
W01000376,1340,669,671,0.4992537313432836,0.5007462686567165
W01000391,1439,714,725,0.4961779013203614,0.5038220986796387
W01000392,1615,788,827,0.48792569659442725,0.5120743034055728
W01000377,1550,750,800,0.4838709677419355,0.5161290322580645
W01000378,1311,624,687,0.4759725400457666,0.5240274599542334
W01000379,1624,804,820,0.49507389162561577,0.5049261083743842
W01000380,1472,713,759,0.484375,0.515625
W01000351,2066,1025,1041,0.4961277831558567,0.5038722168441433
W01000373,1748,815,933,0.4662471395881007,0.5337528604118993
W01000400,1829,885,944,0.4838709677419355,0.5161290322580645
W01000401,2031,985,1046,0.48498276710979815,0.5150172328902018
W01000347,2819,1407,1412,0.499113160695282,0.500886839304718
W01000348,1442,694,748,0.4812760055478502,0.5187239944521498
W01000362,1504,717,787,0.4767287234042553,0.5232712765957447
W01000363,1474,698,776,0.4735413839891452,0.5264586160108549
W01000364,1450,747,703,0.5151724137931034,0.48482758620689653
W01000368,1976,956,1020,0.48380566801619435,0.5161943319838057
W01000371,1056,511,545,0.48390151515151514,0.5160984848484849
W01000372,1524,803,721,0.5269028871391076,0.4730971128608924
W01000387,1119,553,566,0.4941912421805183,0.5058087578194816
W01000388,1107,533,574,0.48148148148148145,0.5185185185185185
W01000422,2141,1056,1085,0.4932274638019617,0.5067725361980383
W01000413,1336,573,763,0.42889221556886226,0.5711077844311377
W01000414,1217,579,638,0.47576006573541496,0.524239934264585
W01000425,2044,997,1047,0.4877690802348337,0.5122309197651663
W01001969,2265,1105,1160,0.4878587196467991,0.5121412803532008
W01000349,2286,1108,1178,0.4846894138232721,0.5153105861767279
W01000350,1825,944,881,0.5172602739726028,0.4827397260273973
W01000365,2028,1024,1004,0.504930966469428,0.49506903353057197
W01000402,2540,1295,1245,0.5098425196850394,0.49015748031496065
W01000381,1107,536,571,0.48419150858175247,0.5158084914182475
W01000382,1398,727,671,0.5200286123032904,0.4799713876967096
W01000423,2214,1056,1158,0.47696476964769646,0.5230352303523035
W01000424,1284,628,656,0.48909657320872274,0.5109034267912772
W01001929,1189,602,587,0.5063078216989066,0.49369217830109335
W01001931,1420,733,687,0.5161971830985915,0.4838028169014085
W01000398,1209,601,608,0.49710504549214224,0.5028949545078577
W01000399,1088,526,562,0.4834558823529412,0.5165441176470589
W01000406,2186,1063,1123,0.48627630375114367,0.5137236962488564
W01000408,1221,604,617,0.49467649467649466,0.5053235053235053
W01000366,1476,711,765,0.4817073170731707,0.5182926829268293
W01000367,1284,631,653,0.4914330218068536,0.5085669781931464
W01000385,1738,844,894,0.4856156501726122,0.5143843498273878
W01000410,1700,840,860,0.49411764705882355,0.5058823529411764
W01000386,1429,682,747,0.47725682295311406,0.5227431770468859
W01000405,2286,1060,1226,0.4636920384951881,0.5363079615048119
W01000411,1526,747,779,0.4895150720838794,0.5104849279161205
W01000412,1485,734,751,0.49427609427609426,0.5057239057239057
W01000394,1166,597,569,0.5120068610634648,0.4879931389365352
W01000395,1039,491,548,0.47256977863330124,0.5274302213666987
W01000407,1383,684,699,0.4945770065075922,0.5054229934924078
W01000419,1434,709,725,0.49442119944211993,0.5055788005578801
W01000420,1531,755,776,0.4931417374265186,0.5068582625734814
W01000354,1647,841,806,0.5106253794778385,0.4893746205221615
W01000355,1755,883,872,0.5031339031339032,0.49686609686609684
W01000356,1611,799,812,0.49596523898199874,0.5040347610180013
W01000389,1995,1006,989,0.5042606516290726,0.4957393483709273
W01000409,1891,862,1029,0.4558434690639873,0.5441565309360127
W01000345,1587,777,810,0.4896030245746692,0.5103969754253308
W01000346,1477,731,746,0.4949221394719025,0.5050778605280974
W01000403,1315,656,659,0.4988593155893536,0.5011406844106464
W01000404,2005,961,1044,0.4793017456359102,0.5206982543640898
W01000359,1194,562,632,0.47068676716917923,0.5293132328308208
W01000360,1228,598,630,0.48697068403908794,0.5130293159609121
W01000361,1974,912,1062,0.46200607902735563,0.5379939209726444
W01001930,2064,1027,1037,0.49757751937984496,0.502422480620155
W01000369,1260,602,658,0.4777777777777778,0.5222222222222223
W01000370,1534,718,816,0.4680573663624511,0.5319426336375489
W01000390,1735,864,871,0.4979827089337176,0.5020172910662825
W01001970,2153,1082,1071,0.5025545750116117,0.4974454249883883
W01000384,1085,532,553,0.49032258064516127,0.5096774193548387
W01000417,1534,741,793,0.4830508474576271,0.5169491525423728
W01000418,1750,866,884,0.4948571428571429,0.5051428571428571
W01001971,2664,2088,576,0.7837837837837838,0.21621621621621623
W01001972,1312,655,657,0.4992378048780488,0.5007621951219512
W01000341,1552,742,810,0.47809278350515466,0.5219072164948454
W01000342,1535,721,814,0.46970684039087945,0.5302931596091205
W01000343,1027,499,528,0.48588120740019475,0.5141187925998053
W01000344,1241,609,632,0.49073327961321517,0.5092667203867849
W01000393,1937,926,1011,0.4780588538977801,0.52194114610222
W01000415,1429,715,714,0.5003498950314905,0.4996501049685094
W01000416,1175,568,607,0.48340425531914893,0.516595744680851
W01000523,1864,894,970,0.4796137339055794,0.5203862660944206
W01000548,1769,847,922,0.4788015828151498,0.5211984171848502
W01000549,1774,860,914,0.48478015783540024,0.5152198421645998
W01001937,1955,941,1014,0.4813299232736573,0.5186700767263427
W01000512,1355,657,698,0.48487084870848707,0.5151291512915129
W01000513,2109,1125,984,0.5334281650071123,0.4665718349928876
W01000517,1172,636,536,0.5426621160409556,0.45733788395904434
W01002000,2921,1443,1478,0.49400890106128037,0.5059910989387196
W01002001,1414,679,735,0.4801980198019802,0.5198019801980198
W01000515,1319,628,691,0.4761182714177407,0.5238817285822593
W01000516,1643,773,870,0.4704808277541083,0.5295191722458916
W01000518,1008,491,517,0.4871031746031746,0.5128968253968254
W01001935,1036,512,524,0.4942084942084942,0.5057915057915058
W01001936,1453,719,734,0.49483826565726086,0.5051617343427391
W01000506,1268,600,668,0.47318611987381703,0.526813880126183
W01000524,1920,940,980,0.4895833333333333,0.5104166666666666
W01000538,1544,767,777,0.49676165803108807,0.5032383419689119
W01000539,1187,608,579,0.5122156697556866,0.4877843302443134
W01000540,1156,572,584,0.49480968858131485,0.5051903114186851
W01000545,1982,963,1019,0.4858728557013118,0.5141271442986882
W01002002,4348,2138,2210,0.4917203311867525,0.5082796688132475
W01000527,1152,560,592,0.4861111111111111,0.5138888888888888
W01000528,1352,648,704,0.47928994082840237,0.5207100591715976
W01000535,2036,1016,1020,0.49901768172888017,0.5009823182711198
W01000537,1390,675,715,0.4856115107913669,0.5143884892086331
W01000541,1742,817,925,0.4690011481056257,0.5309988518943742
W01000507,1140,558,582,0.48947368421052634,0.5105263157894737
W01000508,1043,502,541,0.4813039309683605,0.5186960690316395
W01000509,1861,850,1011,0.4567436861902203,0.5432563138097797
W01000510,1182,575,607,0.48646362098138746,0.5135363790186125
W01000511,1174,602,572,0.5127768313458262,0.48722316865417375
W01000546,1136,549,587,0.48327464788732394,0.516725352112676
W01000547,1137,545,592,0.4793315743183817,0.5206684256816183
W01000519,1762,856,906,0.4858115777525539,0.5141884222474461
W01000522,1199,602,597,0.5020850708924104,0.49791492910758967
W01000531,1765,833,932,0.47195467422096316,0.5280453257790368
W01000533,1339,645,694,0.4817027632561613,0.5182972367438387
W01000551,1380,670,710,0.4855072463768116,0.5144927536231884
W01000525,1226,552,674,0.45024469820554647,0.5497553017944535
W01000534,1517,769,748,0.5069215557020436,0.4930784442979565
W01000536,1365,699,666,0.512087912087912,0.4879120879120879
W01000542,2204,1099,1105,0.4986388384754991,0.5013611615245009
W01000543,2011,988,1023,0.49129786176031826,0.5087021382396818
W01000550,1154,546,608,0.4731369150779896,0.5268630849220104
W01000552,2006,1011,995,0.503988035892323,0.49601196410767695
W01000558,2120,1069,1051,0.504245283018868,0.49575471698113205
W01000559,1454,728,726,0.5006877579092159,0.49931224209078406
W01000560,1297,645,652,0.4973014649190439,0.5026985350809561
W01000561,1293,647,646,0.5003866976024749,0.49961330239752516
W01000613,2058,986,1072,0.47910592808551994,0.5208940719144801
W01000562,1608,784,824,0.48756218905472637,0.5124378109452736
W01000565,1833,880,953,0.4800872885979269,0.5199127114020731
W01000566,1589,778,811,0.4896161107614852,0.5103838892385147
W01000567,2020,988,1032,0.4891089108910891,0.5108910891089109
W01000597,1058,495,563,0.4678638941398866,0.5321361058601134
W01000617,1520,746,774,0.49078947368421055,0.5092105263157894
W01000579,2376,1150,1226,0.484006734006734,0.515993265993266
W01000581,1401,724,677,0.516773733047823,0.483226266952177
W01000612,1751,854,897,0.48772130211307824,0.5122786978869217
W01000618,1712,918,794,0.5362149532710281,0.463785046728972
W01000582,1671,783,888,0.46858168761220825,0.5314183123877917
W01000583,1428,705,723,0.49369747899159666,0.5063025210084033
W01000611,2108,1022,1086,0.484819734345351,0.5151802656546489
W01000623,2018,1009,1009,0.5,0.5
W01000569,1104,546,558,0.4945652173913043,0.5054347826086957
W01000570,1468,686,782,0.4673024523160763,0.5326975476839237
W01000572,1832,889,943,0.48526200873362446,0.5147379912663755
W01002009,1194,594,600,0.49748743718592964,0.5025125628140703
W01002010,1109,562,547,0.5067628494138864,0.4932371505861136
W01000571,2430,1129,1301,0.4646090534979424,0.5353909465020577
W01000573,2555,1213,1342,0.47475538160469666,0.5252446183953033
W01000586,2220,1027,1193,0.4626126126126126,0.5373873873873873
W01000577,1548,750,798,0.4844961240310077,0.5155038759689923
W01000585,1355,687,668,0.5070110701107011,0.4929889298892989
W01000595,2367,1139,1228,0.4811998310097169,0.518800168990283
W01000596,1708,815,893,0.4771662763466042,0.5228337236533958
W01000555,1520,752,768,0.49473684210526314,0.5052631578947369
W01000556,1181,565,616,0.47840812870448773,0.5215918712955123
W01000575,2777,1321,1456,0.4756931940943464,0.5243068059056536
W01000614,1389,681,708,0.490280777537797,0.509719222462203
W01000622,1410,695,715,0.4929078014184397,0.5070921985815603
W01000554,1857,931,926,0.5013462574044157,0.49865374259558426
W01000580,2311,1100,1211,0.47598442232799654,0.5240155776720035
W01000598,2173,1053,1120,0.4845835250805338,0.5154164749194662
W01000599,1991,951,1040,0.4776494224008036,0.5223505775991963
W01000587,2003,981,1022,0.48976535197204196,0.510234648027958
W01000588,2337,1131,1206,0.4839537869062901,0.5160462130937099
W01002011,1573,783,790,0.49777495232040686,0.5022250476795931
W01002012,1437,676,761,0.4704244954766875,0.5295755045233125
W01000553,1226,584,642,0.4763458401305057,0.5236541598694943
W01000563,1125,581,544,0.5164444444444445,0.48355555555555557
W01000564,1300,630,670,0.4846153846153846,0.5153846153846153
W01000576,2299,1117,1182,0.48586341887777296,0.514136581122227
W01002013,2352,1146,1206,0.4872448979591837,0.5127551020408163
W01000589,1144,573,571,0.5008741258741258,0.4991258741258741
W01000590,1140,534,606,0.46842105263157896,0.531578947368421
W01000591,1641,801,840,0.48811700182815354,0.5118829981718465
W01000592,1330,648,682,0.48721804511278194,0.512781954887218
W01000594,2193,1089,1104,0.49658002735978113,0.5034199726402189
W01000600,1598,827,771,0.5175219023779725,0.48247809762202754
W01000601,1527,690,837,0.4518664047151277,0.5481335952848723
W01000602,1215,596,619,0.4905349794238683,0.5094650205761316
W01000603,1803,932,871,0.516916250693289,0.48308374930671105
W01000604,1715,803,912,0.46822157434402334,0.5317784256559767
W01000605,1799,905,894,0.5030572540300167,0.49694274596998333
W01000557,1534,745,789,0.48565840938722293,0.5143415906127771
W01000578,1724,867,857,0.5029002320185615,0.4970997679814385
W01000584,2060,1010,1050,0.49029126213592233,0.5097087378640777
W01000609,2406,1133,1273,0.470906068162926,0.529093931837074
W01000574,1720,858,862,0.49883720930232556,0.5011627906976744
W01000606,1688,796,892,0.471563981042654,0.5284360189573459
W01000607,2454,1182,1272,0.48166259168704156,0.5183374083129584
W01000608,1418,707,711,0.498589562764457,0.501410437235543
W01000610,1695,803,892,0.4737463126843658,0.5262536873156343
W01000619,1996,938,1058,0.46993987975951906,0.530060120240481
W01002014,2095,1009,1086,0.4816229116945107,0.5183770883054892
W01000685,1557,777,780,0.49903660886319845,0.5009633911368016
W01000686,1223,607,616,0.4963205233033524,0.5036794766966476
W01000701,1606,794,812,0.4943960149439601,0.5056039850560399
W01000702,1182,576,606,0.4873096446700508,0.5126903553299492
W01000647,1420,704,716,0.49577464788732395,0.504225352112676
W01000650,1565,781,784,0.49904153354632586,0.5009584664536741
W01000678,1363,708,655,0.5194424064563463,0.4805575935436537
W01000679,1231,609,622,0.49471974004874086,0.5052802599512591
W01000646,2126,1010,1116,0.47507055503292567,0.5249294449670743
W01000688,1693,833,860,0.4920259893679858,0.5079740106320142
W01000689,1731,843,888,0.48700173310225303,0.512998266897747
W01000728,2056,1043,1013,0.507295719844358,0.49270428015564205
W01000676,1510,740,770,0.4900662251655629,0.5099337748344371
W01000677,1449,674,775,0.46514837819185645,0.5348516218081435
W01000687,1941,971,970,0.5002575991756827,0.49974240082431737
W01000709,2189,1073,1116,0.4901781635449977,0.5098218364550022
W01000624,2330,1184,1146,0.5081545064377683,0.4918454935622318
W01000682,1396,663,733,0.47492836676217765,0.5250716332378224
W01000683,1050,538,512,0.5123809523809524,0.4876190476190476
W01000684,1749,862,887,0.4928530588907947,0.5071469411092052
W01000643,1671,799,872,0.4781567923399162,0.5218432076600837
W01000644,1880,903,977,0.4803191489361702,0.5196808510638298
W01000645,1970,970,1000,0.49238578680203043,0.5076142131979695
W01000648,1422,711,711,0.5,0.5
W01000649,1526,745,781,0.48820445609436436,0.5117955439056356
W01000637,1388,649,739,0.4675792507204611,0.5324207492795389
W01000638,1150,562,588,0.48869565217391303,0.5113043478260869
W01000639,1521,729,792,0.47928994082840237,0.5207100591715976
W01000640,1229,585,644,0.4759967453213995,0.5240032546786005
W01000641,2063,1061,1002,0.5142995637421232,0.4857004362578769
W01000642,1760,840,920,0.4772727272727273,0.5227272727272727
W01000693,1129,519,610,0.45969884853852966,0.5403011514614703
W01000694,1499,723,776,0.48232154769846564,0.5176784523015343
W01000656,2050,988,1062,0.4819512195121951,0.5180487804878049
W01000657,1157,567,590,0.49006050129645634,0.5099394987035436
W01000658,1347,685,662,0.5085374907201188,0.4914625092798812
W01000718,1403,690,713,0.4918032786885246,0.5081967213114754
W01000719,1450,716,734,0.49379310344827587,0.5062068965517241
W01000680,2303,1099,1204,0.47720364741641336,0.5227963525835866
W01000681,2087,1011,1076,0.4844274077623383,0.5155725922376617
W01000724,1957,939,1018,0.47981604496678587,0.5201839550332141
W01000725,2306,1109,1197,0.48091934084995663,0.5190806591500433
W01000675,2070,1015,1055,0.49033816425120774,0.5096618357487923
W01000695,2239,1138,1101,0.5082626172398392,0.49173738276016077
W01000696,1651,804,847,0.48697758933979407,0.5130224106602059
W01000722,1349,644,705,0.47739065974796147,0.5226093402520385
W01000723,1361,662,699,0.4864070536370316,0.5135929463629684
W01000625,1128,544,584,0.48226950354609927,0.5177304964539007
W01000626,1619,793,826,0.4898085237801112,0.5101914762198888
W01000627,2398,1180,1218,0.4920767306088407,0.5079232693911593
W01000714,1416,668,748,0.4717514124293785,0.5282485875706214
W01000715,1276,630,646,0.493730407523511,0.5062695924764891
W01000697,1925,927,998,0.4815584415584416,0.5184415584415585
W01000698,1964,950,1014,0.48370672097759676,0.5162932790224033
W01000699,1479,763,716,0.5158891142663962,0.4841108857336038
W01000712,1689,831,858,0.4920071047957371,0.5079928952042628
W01000713,1363,664,699,0.4871606749816581,0.5128393250183418
W01000662,2163,1056,1107,0.4882108183079057,0.5117891816920943
W01000663,2479,1182,1297,0.47680516337232753,0.5231948366276724
W01000664,2603,1288,1315,0.49481367652708413,0.5051863234729159
W01000716,1400,710,690,0.5071428571428571,0.4928571428571429
W01000717,1463,726,737,0.49624060150375937,0.5037593984962406
W01000665,1808,865,943,0.478429203539823,0.521570796460177
W01000666,1666,791,875,0.47478991596638653,0.5252100840336135
W01000731,2412,1210,1202,0.5016583747927031,0.49834162520729686
W01000670,1559,748,811,0.47979474021808854,0.5202052597819115
W01000671,2133,1003,1130,0.4702297233942804,0.5297702766057196
W01000729,1239,604,635,0.48748991121872476,0.5125100887812752
W01000730,1261,635,626,0.5035685963521015,0.4964314036478985
W01000690,1782,870,912,0.4882154882154882,0.5117845117845118
W01000691,1857,870,987,0.46849757673667203,0.531502423263328
W01000692,1543,776,767,0.5029163966299417,0.4970836033700583
W01001999,2471,1168,1303,0.4726831242411979,0.5273168757588022
W01000651,1498,733,765,0.4893190921228304,0.5106809078771696
W01000652,1782,844,938,0.47362514029180697,0.5263748597081931
W01000655,1915,923,992,0.48198433420365533,0.5180156657963446
W01000632,1331,635,696,0.47708489857250186,0.5229151014274981
W01000633,1409,692,717,0.49112845990063875,0.5088715400993612
W01000634,1294,615,679,0.4752704791344668,0.5247295208655333
W01000710,2153,1035,1118,0.48072457036692984,0.5192754296330702
W01000711,2022,957,1065,0.4732937685459941,0.526706231454006
W01000703,1772,861,911,0.48589164785553046,0.5141083521444695
W01000704,1647,793,854,0.48148148148148145,0.5185185185185185
W01000705,1917,894,1023,0.46635367762128327,0.5336463223787168
W01000653,1464,679,785,0.46379781420765026,0.5362021857923497
W01000654,1663,832,831,0.5003006614552015,0.49969933854479853
W01000667,2118,1037,1081,0.48961284230406044,0.5103871576959396
W01001925,2190,1043,1147,0.4762557077625571,0.5237442922374429
W01000628,1537,702,835,0.4567338972023422,0.5432661027976577
W01000629,1633,818,815,0.5009185548071035,0.4990814451928965
W01000630,1587,782,805,0.4927536231884058,0.5072463768115942
W01000631,1830,881,949,0.4814207650273224,0.5185792349726775
W01000635,2402,1155,1247,0.48084929225645295,0.519150707743547
W01000636,2372,1159,1213,0.48861720067453623,0.5113827993254637
W01000706,1563,753,810,0.4817658349328215,0.5182341650671785
W01000707,1453,713,740,0.4907088781830695,0.5092911218169305
W01000708,1374,682,692,0.4963609898107715,0.5036390101892285
W01000659,1789,864,925,0.4829513694801565,0.5170486305198435
W01000660,1484,743,741,0.5006738544474394,0.49932614555256066
W01000732,1302,642,660,0.4930875576036866,0.5069124423963134
W01000733,1199,607,592,0.5062552126772311,0.493744787322769
W01000734,1399,718,681,0.5132237312365976,0.4867762687634024
W01001923,1764,898,866,0.5090702947845805,0.4909297052154195
W01001924,1372,676,696,0.49271137026239065,0.5072886297376094
W01000672,1489,733,756,0.4922766957689725,0.5077233042310275
W01000673,1099,524,575,0.4767970882620564,0.5232029117379435
W01000674,2097,1043,1054,0.497377205531712,0.5026227944682881
W01000700,1971,965,1006,0.4895991882293252,0.5104008117706748
W01000720,1822,888,934,0.48737650933040616,0.5126234906695939
W01000721,1396,670,726,0.4799426934097421,0.5200573065902578
W01000735,2381,1186,1195,0.498110037799244,0.501889962200756
W01000845,2004,973,1031,0.48552894211576847,0.5144710578842315
W01000846,2046,1032,1014,0.5043988269794721,0.49560117302052786
W01000847,1259,605,654,0.4805401111993646,0.5194598888006354
W01000848,1205,554,651,0.4597510373443983,0.5402489626556016
W01000750,1447,686,761,0.47408431237042153,0.5259156876295784
W01000751,1396,704,692,0.504297994269341,0.49570200573065903
W01000752,1492,689,803,0.46179624664879354,0.5382037533512064
W01000753,1418,674,744,0.47531734837799716,0.5246826516220028
W01000754,1551,773,778,0.498388136686009,0.501611863313991
W01000803,1829,900,929,0.4920721705850191,0.5079278294149808
W01000806,1397,674,723,0.4824624194702935,0.5175375805297066
W01000807,1292,646,646,0.5,0.5
W01000808,1387,668,719,0.4816149963950973,0.5183850036049027
W01000810,1351,627,724,0.46410066617320506,0.535899333826795
W01000815,1490,719,771,0.4825503355704698,0.5174496644295302
W01000816,1761,865,896,0.49119818285065303,0.5088018171493469
W01000791,1415,683,732,0.4826855123674912,0.5173144876325089
W01000792,1590,749,841,0.4710691823899371,0.5289308176100629
W01000793,1862,934,928,0.5016111707841031,0.4983888292158969
W01000837,2317,1142,1175,0.49287872248597325,0.5071212775140268
W01000838,1264,622,642,0.4920886075949367,0.5079113924050633
W01000774,1623,793,830,0.48860135551447936,0.5113986444855206
W01000841,1469,699,770,0.4758339006126617,0.5241660993873384
W01000842,1416,701,715,0.4950564971751412,0.5049435028248588
W01000843,1386,664,722,0.4790764790764791,0.5209235209235209
W01000844,1529,752,777,0.4918247220405494,0.5081752779594506
W01001991,1403,691,712,0.4925160370634355,0.5074839629365645
W01001992,1429,720,709,0.5038488453463961,0.49615115465360393
W01000795,1567,779,788,0.4971282705807275,0.5028717294192725
W01000800,1454,689,765,0.47386519944979366,0.5261348005502063
W01000801,1711,823,888,0.4810052600818235,0.5189947399181765
W01001993,1693,834,859,0.4926166568222091,0.5073833431777909
W01001994,1474,733,741,0.4972862957937585,0.5027137042062415
W01000784,1294,608,686,0.46986089644513135,0.5301391035548686
W01000785,1780,891,889,0.500561797752809,0.499438202247191
W01000786,1262,632,630,0.5007923930269413,0.49920760697305866
W01000802,2346,1151,1195,0.4906223358908781,0.5093776641091219
W01000877,1680,810,870,0.48214285714285715,0.5178571428571429
W01000878,1276,577,699,0.45219435736677116,0.5478056426332288
W01000809,1513,734,779,0.4851288830138797,0.5148711169861203
W01000811,1392,655,737,0.47054597701149425,0.5294540229885057
W01000812,1442,702,740,0.4868238557558946,0.5131761442441054
W01000813,1566,780,786,0.49808429118773945,0.5019157088122606
W01000814,1437,692,745,0.4815588030619346,0.5184411969380655
W01000817,1953,929,1024,0.4756784434203789,0.5243215565796211
W01000818,1505,687,818,0.4564784053156146,0.5435215946843854
W01000819,1438,703,735,0.48887343532684285,0.5111265646731572
W01000820,1393,691,702,0.49605168700646085,0.5039483129935391
W01000821,1472,731,741,0.49660326086956524,0.5033967391304348
W01000822,1186,571,615,0.4814502529510961,0.5185497470489039
W01000794,2213,1090,1123,0.49254405784003613,0.5074559421599638
W01000797,1508,730,778,0.48408488063660476,0.5159151193633952
W01000798,1426,707,719,0.4957924263674614,0.5042075736325385
W01000799,1849,893,956,0.48296376419686315,0.5170362358031368
W01000830,1822,818,1004,0.4489571899012075,0.5510428100987925
W01000832,1590,800,790,0.5031446540880503,0.4968553459119497
W01000833,1652,788,864,0.47699757869249393,0.5230024213075061
W01000834,1444,661,783,0.4577562326869806,0.5422437673130194
W01000836,2407,1121,1286,0.46572496884088077,0.5342750311591192
W01000759,1533,743,790,0.4846705805609915,0.5153294194390085
W01000777,1706,827,879,0.4847596717467761,0.515240328253224
W01000778,1781,871,910,0.48905109489051096,0.5109489051094891
W01000779,1462,716,746,0.4897400820793434,0.5102599179206566
W01000760,1579,774,805,0.4901836605446485,0.5098163394553515
W01000761,1559,761,798,0.48813341885824246,0.5118665811417575
W01000762,1681,837,844,0.49791790600832836,0.5020820939916716
W01000831,1741,799,942,0.45893164847788626,0.5410683515221137
W01000835,1452,702,750,0.4834710743801653,0.5165289256198347
W01000738,1762,803,959,0.4557321225879682,0.5442678774120318
W01000739,2211,1106,1105,0.5002261420171868,0.4997738579828132
W01000740,1561,730,831,0.4676489429852659,0.5323510570147342
W01000741,1874,886,988,0.4727854855923159,0.5272145144076841
W01000763,1415,690,725,0.4876325088339223,0.5123674911660777
W01000764,1566,763,803,0.4872286079182631,0.5127713920817369
W01000765,1621,825,796,0.5089450956199877,0.4910549043800123
W01000766,1498,704,794,0.4699599465954606,0.5300400534045394
W01000767,1427,710,717,0.49754730203223546,0.5024526979677646
W01000742,1662,822,840,0.49458483754512633,0.5054151624548736
W01000744,1522,819,703,0.538107752956636,0.461892247043364
W01000787,1442,741,701,0.513869625520111,0.48613037447988905
W01000788,1498,757,741,0.5053404539385847,0.4946595460614152
W01000789,1416,695,721,0.490819209039548,0.509180790960452
W01000790,2675,1438,1237,0.5375700934579439,0.46242990654205607
W01000755,1984,967,1017,0.4873991935483871,0.5126008064516129
W01000756,1465,736,729,0.5023890784982935,0.4976109215017065
W01000757,1434,674,760,0.4700139470013947,0.5299860529986054
W01000758,1890,929,961,0.49153439153439155,0.5084656084656085
W01000772,1476,724,752,0.4905149051490515,0.5094850948509485
W01000828,1630,800,830,0.49079754601226994,0.50920245398773
W01000829,1922,920,1002,0.4786680541103018,0.5213319458896982
W01000862,1605,815,790,0.5077881619937694,0.49221183800623053
W01000863,1681,793,888,0.47174301011302794,0.528256989886972
W01000864,1663,759,904,0.4564040889957907,0.5435959110042092
W01000865,1425,695,730,0.48771929824561405,0.512280701754386
W01000866,1177,559,618,0.4749362786745964,0.5250637213254036
W01000867,1284,586,698,0.45638629283489096,0.543613707165109
W01000849,2203,1119,1084,0.5079437131184749,0.4920562868815252
W01000851,1645,774,871,0.470516717325228,0.5294832826747721
W01000852,1458,756,702,0.5185185185185185,0.48148148148148145
W01001995,1363,688,675,0.5047688921496698,0.49523110785033014
W01001996,1407,768,639,0.5458422174840085,0.4541577825159915
W01000853,1679,825,854,0.4913639070875521,0.5086360929124479
W01000854,1503,737,766,0.490352628077179,0.5096473719228211
W01000855,1419,672,747,0.47357293868921774,0.5264270613107822
W01000856,1740,870,870,0.5,0.5
W01000857,1902,869,1033,0.4568874868559411,0.5431125131440588
W01000747,1587,880,707,0.5545053560176434,0.44549464398235666
W01000868,1103,531,572,0.4814143245693563,0.5185856754306437
W01000869,1522,809,713,0.5315374507227333,0.46846254927726677
W01000870,1379,738,641,0.5351704133430022,0.4648295866569978
W01000872,1398,670,728,0.4792560801144492,0.5207439198855508
W01000874,1791,943,848,0.5265214963707426,0.4734785036292574
W01000745,2467,1386,1081,0.5618159708147548,0.43818402918524524
W01000746,1430,730,700,0.5104895104895105,0.48951048951048953
W01001955,1930,1157,773,0.599481865284974,0.4005181347150259
W01001958,1304,763,541,0.5851226993865031,0.4148773006134969
W01001997,1989,1213,776,0.6098541980894923,0.3901458019105078
W01000749,1987,1042,945,0.5244086562657272,0.47559134373427275
W01000871,1770,1028,742,0.5807909604519774,0.4192090395480226
W01000873,1529,826,703,0.540222367560497,0.4597776324395029
W01000875,1904,1086,818,0.5703781512605042,0.42962184873949577
W01000876,1627,789,838,0.4849416103257529,0.5150583896742471
W01000858,1644,838,806,0.5097323600973236,0.4902676399026764
W01000859,1399,697,702,0.4982130092923517,0.5017869907076483
W01000860,1533,734,799,0.47879973907371165,0.5212002609262884
W01000861,1956,826,1130,0.4222903885480573,0.5777096114519428
W01000736,1748,847,901,0.4845537757437071,0.5154462242562929
W01000737,1473,690,783,0.4684317718940937,0.5315682281059063
W01000804,1422,651,771,0.4578059071729958,0.5421940928270043
W01000805,1144,570,574,0.4982517482517482,0.5017482517482518
W01000879,1679,803,876,0.4782608695652174,0.5217391304347826
W01000880,1550,740,810,0.4774193548387097,0.5225806451612903
W01000881,1316,631,685,0.479483282674772,0.520516717325228
W01000882,1733,801,932,0.46220427005193304,0.5377957299480669
W01000775,1625,780,845,0.48,0.52
W01000776,1773,877,896,0.4946418499717992,0.5053581500282008
W01000839,1043,504,539,0.48322147651006714,0.5167785234899329
W01000840,1602,784,818,0.4893882646691635,0.5106117353308365
W01000823,1820,854,966,0.46923076923076923,0.5307692307692308
W01000824,1649,789,860,0.47847180109157067,0.5215281989084294
W01000825,1283,604,679,0.47077162899454406,0.5292283710054559
W01000826,1255,621,634,0.49482071713147413,0.5051792828685259
W01000827,1249,606,643,0.4851881505204163,0.5148118494795837
W01000768,1346,658,688,0.4888558692421991,0.5111441307578009
W01000769,1394,661,733,0.47417503586800575,0.5258249641319943
W01000770,1527,740,787,0.48461034708578915,0.5153896529142109
W01000771,1300,640,660,0.49230769230769234,0.5076923076923077
W01000781,1626,794,832,0.4883148831488315,0.5116851168511685
W01000782,1073,521,552,0.48555452003727867,0.5144454799627214
W01001956,2238,1173,1065,0.5241286863270778,0.47587131367292224
W01000918,1934,962,972,0.49741468459152016,0.5025853154084798
W01000944,1171,570,601,0.48676345004269855,0.5132365499573015
W01000965,2022,986,1036,0.4876360039564787,0.5123639960435212
W01000893,1911,929,982,0.4861329147043433,0.5138670852956567
W01000925,1527,754,773,0.49377865094957435,0.5062213490504257
W01000926,1846,896,950,0.48537378114842905,0.514626218851571
W01000888,2721,1341,1380,0.4928335170893054,0.5071664829106945
W01000946,1784,858,926,0.48094170403587444,0.5190582959641256
W01000947,2181,1061,1120,0.4864740944520862,0.5135259055479138
W01000948,1809,915,894,0.5058043117744611,0.494195688225539
W01000955,1374,681,693,0.49563318777292575,0.5043668122270742
W01000956,1186,584,602,0.4924114671163575,0.5075885328836425
W01000971,1401,674,727,0.48108493932905066,0.5189150606709493
W01000904,1472,710,762,0.48233695652173914,0.5176630434782609
W01000905,1496,734,762,0.49064171122994654,0.5093582887700535
W01000908,1581,779,802,0.4927261227071474,0.5072738772928527
W01001985,2052,957,1095,0.46637426900584794,0.533625730994152
W01000907,1721,799,922,0.4642649622312609,0.5357350377687391
W01000922,1583,773,810,0.4883133291219204,0.5116866708780796
W01001986,2426,1176,1250,0.48474855729596045,0.5152514427040396
W01000934,1251,631,620,0.504396482813749,0.495603517186251
W01000935,1554,783,771,0.5038610038610039,0.49613899613899615
W01000938,1388,656,732,0.47262247838616717,0.5273775216138329
W01000939,1150,608,542,0.528695652173913,0.47130434782608693
W01000940,1263,603,660,0.47743467933491684,0.5225653206650831
W01000909,1180,562,618,0.47627118644067795,0.523728813559322
W01000910,1370,661,709,0.4824817518248175,0.5175182481751824
W01000911,1146,553,593,0.4825479930191972,0.5174520069808028
W01000969,1556,750,806,0.4820051413881748,0.5179948586118251
W01000912,1204,577,627,0.4792358803986711,0.520764119601329
W01000913,1156,562,594,0.486159169550173,0.513840830449827
W01000914,1657,775,882,0.4677127338563669,0.5322872661436331
W01000915,1120,548,572,0.48928571428571427,0.5107142857142857
W01000916,1174,585,589,0.49829642248722317,0.5017035775127768
W01001987,1512,749,763,0.49537037037037035,0.5046296296296297
W01001988,1481,750,731,0.5064145847400405,0.49358541525995947
W01001989,3409,2133,1276,0.6256966852449398,0.3743033147550601
W01000936,1377,669,708,0.485838779956427,0.514161220043573
W01000941,1550,758,792,0.4890322580645161,0.5109677419354839
W01000942,1784,875,909,0.4904708520179372,0.5095291479820628
W01000943,1471,725,746,0.4928619986403807,0.5071380013596193
W01000894,1464,724,740,0.49453551912568305,0.505464480874317
W01000895,1482,727,755,0.49055330634278005,0.50944669365722
W01000896,1601,778,823,0.48594628357276703,0.514053716427233
W01000897,1330,648,682,0.48721804511278194,0.512781954887218
W01000937,1943,995,948,0.5120946989191971,0.4879053010808029
W01000898,1462,751,711,0.5136798905608755,0.48632010943912446
W01000899,1877,932,945,0.4965370271710176,0.5034629728289824
W01000900,1576,751,825,0.47652284263959394,0.5234771573604061
W01000901,1667,779,888,0.4673065386922616,0.5326934613077384
W01000945,1155,572,583,0.49523809523809526,0.5047619047619047
W01000889,1807,895,912,0.4952960708356392,0.5047039291643608
W01000890,1535,750,785,0.48859934853420195,0.511400651465798
W01000891,1440,687,753,0.47708333333333336,0.5229166666666667
W01000892,1969,937,1032,0.47587607922803454,0.5241239207719655
W01000883,1321,649,672,0.4912944738834216,0.5087055261165784
W01000958,1553,702,851,0.45202833226014166,0.5479716677398584
W01000961,1584,760,824,0.4797979797979798,0.5202020202020202
W01000962,1535,713,822,0.46449511400651466,0.5355048859934853
W01000963,1856,865,991,0.4660560344827586,0.5339439655172413
W01000964,1810,889,921,0.49116022099447515,0.5088397790055249
W01000884,1281,662,619,0.516783762685402,0.48321623731459795
W01000885,1452,665,787,0.45798898071625344,0.5420110192837465
W01000886,1621,807,814,0.49784083898827886,0.5021591610117212
W01000957,1616,778,838,0.4814356435643564,0.5185643564356436
W01000959,1725,847,878,0.4910144927536232,0.5089855072463768
W01000960,1771,827,944,0.46696781479390176,0.5330321852060983
W01000949,1322,659,663,0.49848714069591527,0.5015128593040847
W01000950,1470,726,744,0.49387755102040815,0.5061224489795918
W01000951,1794,900,894,0.5016722408026756,0.4983277591973244
W01000952,1170,598,572,0.5111111111111111,0.4888888888888889
W01000966,1433,700,733,0.4884856943475227,0.5115143056524774
W01000932,1031,493,538,0.478176527643065,0.521823472356935
W01000933,1982,994,988,0.5015136226034309,0.49848637739656915
W01000967,1415,700,715,0.49469964664310956,0.5053003533568905
W01000968,1967,938,1029,0.47686832740213525,0.5231316725978647
W01000919,1144,563,581,0.49213286713286714,0.5078671328671329
W01000927,2075,1024,1051,0.49349397590361443,0.5065060240963856
W01000928,1596,790,806,0.4949874686716792,0.5050125313283208
W01000929,1260,609,651,0.48333333333333334,0.5166666666666667
W01000931,1362,679,683,0.4985315712187959,0.5014684287812041
W01000973,1328,631,697,0.4751506024096386,0.5248493975903614
W01001900,1411,698,713,0.49468462083628634,0.5053153791637137
W01000887,2373,1162,1211,0.4896755162241888,0.5103244837758112
W01000921,1455,706,749,0.4852233676975945,0.5147766323024054
W01000930,1144,539,605,0.47115384615384615,0.5288461538461539
W01000953,1585,784,801,0.4946372239747634,0.5053627760252366
W01000954,1345,655,690,0.48698884758364314,0.5130111524163569
W01000970,1107,531,576,0.4796747967479675,0.5203252032520326
W01001990,2136,1058,1078,0.4953183520599251,0.5046816479400749
W01000991,1141,572,569,0.5013146362839614,0.49868536371603855
W01000992,1395,683,712,0.48960573476702507,0.5103942652329749
W01000993,1364,678,686,0.4970674486803519,0.5029325513196481
W01000994,1402,682,720,0.4864479315263909,0.5135520684736091
W01000995,1363,660,703,0.4842259721203228,0.5157740278796772
W01001014,1607,763,844,0.4747977598008712,0.5252022401991289
W01001015,1457,708,749,0.48592999313658203,0.514070006863418
W01001017,1465,720,745,0.49146757679180886,0.5085324232081911
W01001018,1281,638,643,0.49804839968774395,0.501951600312256
W01001020,1364,673,691,0.4934017595307918,0.5065982404692082
W01000976,1088,516,572,0.4742647058823529,0.5257352941176471
W01000977,1420,666,754,0.46901408450704224,0.5309859154929577
W01001024,1143,566,577,0.49518810148731407,0.5048118985126859
W01001025,1230,613,617,0.4983739837398374,0.5016260162601626
W01001033,1755,863,892,0.49173789173789173,0.5082621082621083
W01001034,1345,667,678,0.49591078066914496,0.504089219330855
W01000975,2241,1068,1173,0.47657295850066933,0.5234270414993306
W01000978,1778,875,903,0.4921259842519685,0.5078740157480315
W01001009,1245,636,609,0.5108433734939759,0.4891566265060241
W01001042,1264,633,631,0.5007911392405063,0.49920886075949367
W01001043,1161,578,583,0.49784668389319553,0.5021533161068045
W01001012,1507,740,767,0.49104180491041804,0.508958195089582
W01001013,1459,718,741,0.49211788896504455,0.5078821110349554
W01001016,1633,821,812,0.5027556644213105,0.4972443355786895
W01001019,1575,761,814,0.4831746031746032,0.5168253968253969
W01000974,2384,1183,1201,0.4962248322147651,0.5037751677852349
W01001057,1736,827,909,0.4763824884792627,0.5236175115207373
W01001058,1885,899,986,0.47692307692307695,0.5230769230769231
W01000986,1686,828,858,0.49110320284697506,0.5088967971530249
W01000987,2437,1176,1261,0.48256052523594584,0.5174394747640542
W01001055,1199,577,622,0.48123436196830693,0.5187656380316931
W01001056,1178,586,592,0.49745331069609505,0.5025466893039049
W01000996,1530,748,782,0.4888888888888889,0.5111111111111111
W01001048,1415,693,722,0.48975265017667846,0.5102473498233215
W01001049,1286,615,671,0.4782270606531882,0.5217729393468118
W01001050,1542,751,791,0.48702983138780803,0.5129701686121919
W01001051,1816,883,933,0.48623348017621143,0.5137665198237885
W01001052,1288,610,678,0.47360248447204967,0.5263975155279503
W01001004,1038,531,507,0.5115606936416185,0.4884393063583815
W01001005,1586,745,841,0.4697351828499369,0.530264817150063
W01001006,2235,1088,1147,0.4868008948545861,0.5131991051454139
W01001007,1876,909,967,0.48454157782515994,0.5154584221748401
W01001039,1723,860,863,0.4991294254207777,0.5008705745792222
W01001040,1554,781,773,0.5025740025740025,0.4974259974259974
W01000999,1393,651,742,0.46733668341708545,0.5326633165829145
W01001000,1719,837,882,0.4869109947643979,0.5130890052356021
W01001001,1837,873,964,0.4752313554708764,0.5247686445291235
W01001002,2452,1205,1247,0.49143556280587275,0.5085644371941273
W01001008,2549,1271,1278,0.49862691251471164,0.5013730874852883
W01001038,2594,1242,1352,0.47879722436391675,0.5212027756360833
W01001981,2975,2268,707,0.7623529411764706,0.2376470588235294
W01001982,1349,694,655,0.514455151964418,0.4855448480355819
W01001983,1500,729,771,0.486,0.514
W01001984,1197,576,621,0.48120300751879697,0.518796992481203
W01000997,1690,835,855,0.4940828402366864,0.5059171597633136
W01001010,1162,573,589,0.49311531841652323,0.5068846815834768
W01001011,1275,615,660,0.4823529411764706,0.5176470588235295
W01001026,2001,985,1016,0.49225387306346824,0.5077461269365318
W01000989,1567,764,803,0.48755583918315254,0.5124441608168475
W01001037,1808,897,911,0.4961283185840708,0.5038716814159292
W01001041,2302,1123,1179,0.4878366637706342,0.5121633362293657
W01001021,1607,798,809,0.49657747355320475,0.5034225264467953
W01001022,1418,692,726,0.48801128349788436,0.5119887165021156
W01001023,1654,836,818,0.5054413542926239,0.49455864570737607
W01001028,1882,936,946,0.4973432518597237,0.5026567481402763
W01001035,1759,884,875,0.5025582717453099,0.4974417282546902
W01000979,1606,791,815,0.4925280199252802,0.5074719800747198
W01000983,1525,751,774,0.49245901639344264,0.5075409836065574
W01000985,1280,643,637,0.50234375,0.49765625
W01001003,1336,636,700,0.47604790419161674,0.5239520958083832
W01000980,1356,681,675,0.5022123893805309,0.497787610619469
W01000981,1254,597,657,0.47607655502392343,0.5239234449760766
W01000982,1430,698,732,0.4881118881118881,0.5118881118881119
W01000984,2168,1087,1081,0.5013837638376384,0.4986162361623616
W01000990,1562,738,824,0.47247119078104993,0.5275288092189501
W01001027,1513,719,794,0.47521480502313285,0.5247851949768672
W01001036,1605,773,832,0.48161993769470407,0.518380062305296
W01001918,1873,920,953,0.49119060331019754,0.5088093966898024
W01001919,1363,666,697,0.4886280264123258,0.5113719735876743
W01001920,1209,614,595,0.5078577336641853,0.4921422663358147
W01001921,1507,704,803,0.46715328467153283,0.5328467153284672
W01001031,1474,680,794,0.46132971506105835,0.5386702849389416
W01001032,1760,830,930,0.4715909090909091,0.5284090909090909
W01001046,1912,939,973,0.49110878661087864,0.5088912133891214
W01001047,1666,824,842,0.49459783913565425,0.5054021608643458
W01001053,1010,489,521,0.48415841584158414,0.5158415841584159
W01001054,1350,644,706,0.47703703703703704,0.522962962962963
W01001029,1708,809,899,0.47365339578454335,0.5263466042154566
W01001030,1958,930,1028,0.47497446373850866,0.5250255362614913
W01001044,1583,785,798,0.49589387239418825,0.5041061276058117
W01001045,1709,839,870,0.4909303686366296,0.5090696313633704
W01001105,2819,1377,1442,0.4884710890386662,0.5115289109613338
W01001127,1634,819,815,0.5012239902080783,0.49877600979192166
W01001128,1681,836,845,0.49732302201070794,0.5026769779892921
W01001082,1547,711,836,0.45959922430510664,0.5404007756948933
W01001083,1699,815,884,0.47969393761035906,0.5203060623896409
W01001084,1654,768,886,0.46432889963724305,0.535671100362757
W01001085,1656,823,833,0.4969806763285024,0.5030193236714976
W01001113,2308,1148,1160,0.49740034662045063,0.5025996533795494
W01001119,1865,912,953,0.48900804289544236,0.5109919571045577
W01001135,2336,1113,1223,0.4764554794520548,0.5235445205479452
W01001136,1503,735,768,0.48902195608782434,0.5109780439121756
W01001075,1175,550,625,0.46808510638297873,0.5319148936170213
W01001076,1385,672,713,0.4851985559566787,0.5148014440433213
W01001077,1407,672,735,0.47761194029850745,0.5223880597014925
W01001078,1284,595,689,0.4633956386292835,0.5366043613707165
W01001104,2090,1042,1048,0.49856459330143543,0.5014354066985646
W01001129,1656,799,857,0.482487922705314,0.517512077294686
W01001116,1930,885,1045,0.4585492227979275,0.5414507772020726
W01001123,1471,702,769,0.4772263766145479,0.5227736233854521
W01001124,1465,724,741,0.49419795221843005,0.50580204778157
W01001125,1426,673,753,0.47194950911640954,0.5280504908835905
W01001130,1269,625,644,0.4925137903861308,0.5074862096138691
W01002036,1553,771,782,0.49645846748229233,0.5035415325177076
W01002037,1066,562,504,0.5272045028142589,0.4727954971857411
W01001086,1509,748,761,0.49569251159708416,0.5043074884029158
W01001087,1520,722,798,0.475,0.525
W01001088,2142,1011,1131,0.47198879551820727,0.5280112044817927
W01001089,1600,765,835,0.478125,0.521875
W01001090,1445,708,737,0.48996539792387545,0.5100346020761246
W01001081,1739,805,934,0.4629097182288672,0.5370902817711328
W01001092,2125,1007,1118,0.4738823529411765,0.5261176470588236
W01001094,1238,559,679,0.45153473344103395,0.5484652665589661
W01001095,1404,650,754,0.46296296296296297,0.5370370370370371
W01001096,1308,652,656,0.4984709480122324,0.5015290519877675
W01001097,1540,699,841,0.4538961038961039,0.5461038961038961
W01001114,1572,755,817,0.4802798982188295,0.5197201017811705
W01001115,2148,1015,1133,0.4725325884543762,0.5274674115456238
W01001131,1743,825,918,0.47332185886402756,0.5266781411359724
W01001132,1354,654,700,0.48301329394387,0.51698670605613
W01001133,2235,1107,1128,0.49530201342281877,0.5046979865771812
W01001134,1110,511,599,0.4603603603603604,0.5396396396396397
W01001067,1390,652,738,0.46906474820143884,0.5309352517985612
W01001068,1647,800,847,0.48573163327261687,0.5142683667273831
W01001070,1043,539,504,0.5167785234899329,0.48322147651006714
W01001071,1477,723,754,0.4895057549085985,0.5104942450914015
W01001072,2721,1332,1389,0.4895259095920617,0.5104740904079382
W01001091,1623,811,812,0.49969192852741834,0.5003080714725816
W01001098,1032,498,534,0.48255813953488375,0.5174418604651163
W01001100,1470,708,762,0.4816326530612245,0.5183673469387755
W01001103,1177,583,594,0.4953271028037383,0.5046728971962616
W01001106,1441,712,729,0.49410131852879946,0.5058986814712005
W01001107,1495,706,789,0.47224080267558527,0.5277591973244147
W01001109,1372,649,723,0.47303206997084546,0.5269679300291545
W01001110,1704,767,937,0.45011737089201875,0.5498826291079812
W01001111,1348,641,707,0.4755192878338279,0.5244807121661721
W01001112,1318,607,711,0.460546282245827,0.539453717754173
W01001063,1590,763,827,0.479874213836478,0.520125786163522
W01001065,1564,758,806,0.4846547314578005,0.5153452685421995
W01001069,1566,772,794,0.4929757343550447,0.5070242656449553
W01001079,1510,711,799,0.47086092715231787,0.5291390728476821
W01001080,1581,754,827,0.4769133459835547,0.5230866540164453
W01001910,1676,818,858,0.4880668257756563,0.5119331742243437
W01001911,1146,569,577,0.4965095986038394,0.5034904013961605
W01001062,1335,636,699,0.4764044943820225,0.5235955056179775
W01001064,1409,649,760,0.46061036195883603,0.5393896380411639
W01001093,1760,831,929,0.4721590909090909,0.5278409090909091
W01001099,1195,536,659,0.4485355648535565,0.5514644351464435
W01001101,1534,740,794,0.48239895697522817,0.5176010430247718
W01001102,1533,726,807,0.4735812133072407,0.5264187866927593
W01001108,1818,870,948,0.47854785478547857,0.5214521452145214
W01001117,1283,634,649,0.49415432579890883,0.5058456742010912
W01001120,1347,654,693,0.48552338530066813,0.5144766146993318
W01001121,1700,805,895,0.47352941176470587,0.5264705882352941
W01001122,2467,1352,1115,0.5480340494527767,0.4519659505472233
W01002038,1264,630,634,0.49841772151898733,0.5015822784810127
W01002039,1760,857,903,0.4869318181818182,0.5130681818181818
W01001059,1758,882,876,0.5017064846416383,0.49829351535836175
W01001060,1401,658,743,0.4696645253390435,0.5303354746609564
W01001066,1622,754,868,0.4648581997533909,0.5351418002466092
W01001073,2089,1001,1088,0.47917663954045,0.52082336045955
W01001998,2226,1070,1156,0.4806828391734052,0.5193171608265947
W01002040,1943,919,1024,0.47297992794647453,0.5270200720535255
W01001777,1756,869,887,0.494874715261959,0.505125284738041
W01001778,1745,865,880,0.49570200573065903,0.504297994269341
W01001794,1341,647,694,0.482475764354959,0.517524235645041
W01001799,1252,569,683,0.4544728434504792,0.5455271565495208
W01001793,1356,647,709,0.4771386430678466,0.5228613569321534
W01001795,1517,739,778,0.4871456822676335,0.5128543177323666
W01001796,1422,677,745,0.4760900140646976,0.5239099859353024
W01001798,1405,671,734,0.47758007117437723,0.5224199288256228
W01001841,1914,912,1002,0.47648902821316613,0.5235109717868338
W01001842,1787,877,910,0.49076664801343034,0.5092333519865697
W01001844,1884,874,1010,0.46390658174097665,0.5360934182590233
W01002016,1225,636,589,0.5191836734693878,0.48081632653061224
W01002017,1436,700,736,0.48746518105849584,0.5125348189415042
W01002018,1547,767,780,0.4957983193277311,0.5042016806722689
W01001849,1552,733,819,0.4722938144329897,0.5277061855670103
W01001852,1868,887,981,0.4748394004282655,0.5251605995717344
W01001853,1608,767,841,0.47699004975124376,0.5230099502487562
W01001854,1521,697,824,0.45825115055884286,0.5417488494411571
W01001791,1824,875,949,0.47971491228070173,0.5202850877192983
W01001792,1612,806,806,0.5,0.5
W01001797,1437,699,738,0.48643006263048016,0.5135699373695198
W01001800,1419,639,780,0.4503171247357294,0.5496828752642706
W01001949,1298,631,667,0.4861325115562404,0.5138674884437596
W01001953,1512,733,779,0.48478835978835977,0.5152116402116402
W01001820,1194,567,627,0.4748743718592965,0.5251256281407035
W01001846,1742,854,888,0.4902411021814007,0.5097588978185993
W01001847,1543,762,781,0.4938431626701231,0.5061568373298768
W01001948,2289,1108,1181,0.48405417212756663,0.5159458278724334
W01001954,1516,713,803,0.4703166226912929,0.5296833773087071
W01001802,1707,815,892,0.4774458113649678,0.5225541886350322
W01001807,1640,791,849,0.4823170731707317,0.5176829268292683
W01001808,1720,765,955,0.44476744186046513,0.5552325581395349
W01001840,1927,940,987,0.4878048780487805,0.5121951219512195
W01001730,1535,747,788,0.4866449511400652,0.5133550488599349
W01001731,1482,720,762,0.48582995951417,0.5141700404858299
W01001736,1491,701,790,0.47015425888665324,0.5298457411133467
W01001815,1384,656,728,0.47398843930635837,0.5260115606936416
W01001811,1583,748,835,0.47252053063802907,0.527479469361971
W01001816,2778,1377,1401,0.4956803455723542,0.5043196544276458
W01001817,1374,649,725,0.4723435225618632,0.5276564774381368
W01001818,1580,754,826,0.4772151898734177,0.5227848101265823
W01001888,1657,794,863,0.4791792395896198,0.5208207604103802
W01001893,1846,880,966,0.47670639219934996,0.52329360780065
W01001894,1522,745,777,0.4894875164257556,0.5105124835742444
W01001895,1633,816,817,0.49969381506429883,0.5003061849357011
W01001877,1831,875,956,0.4778809393773894,0.5221190606226106
W01001878,1590,785,805,0.4937106918238994,0.5062893081761006
W01001882,1754,801,953,0.4566704675028506,0.5433295324971493
W01001885,2609,1242,1367,0.4760444614794941,0.5239555385205059
W01001773,2571,1240,1331,0.4823026059898872,0.5176973940101128
W01001848,1471,713,758,0.4847042828008158,0.5152957171991842
W01001850,1904,927,977,0.48686974789915966,0.5131302521008403
W01001851,1544,739,805,0.4786269430051813,0.5213730569948186
W01001879,1905,881,1024,0.4624671916010499,0.5375328083989501
W01001880,1647,771,876,0.4681238615664845,0.5318761384335154
W01001881,1473,698,775,0.47386286490156143,0.5261371350984385
W01001884,1443,668,775,0.46292446292446293,0.5370755370755371
W01001727,1214,604,610,0.4975288303130148,0.5024711696869851
W01001728,1417,676,741,0.47706422018348627,0.5229357798165137
W01001729,2898,1391,1507,0.4799861973775017,0.5200138026224983
W01001819,2373,1129,1244,0.47576906868942265,0.5242309313105773
W01001803,1676,772,904,0.4606205250596659,0.5393794749403341
W01001804,1584,810,774,0.5113636363636364,0.48863636363636365
W01001805,1548,687,861,0.4437984496124031,0.5562015503875969
W01001806,1720,823,897,0.47848837209302325,0.5215116279069767
W01001866,1577,765,812,0.4850982878883957,0.5149017121116043
W01001867,1416,620,796,0.4378531073446328,0.5621468926553672
W01001883,1660,781,879,0.47048192771084335,0.5295180722891566
W01001886,1320,640,680,0.48484848484848486,0.5151515151515151
W01001809,1218,620,598,0.5090311986863711,0.4909688013136289
W01001810,1730,826,904,0.4774566473988439,0.522543352601156
W01001812,1277,594,683,0.46515270164447925,0.5348472983555208
W01001813,1833,876,957,0.4779050736497545,0.5220949263502455
W01001814,1441,714,727,0.4954892435808466,0.5045107564191533
W01001769,1592,778,814,0.4886934673366834,0.5113065326633166
W01001770,1039,497,542,0.47834456207892206,0.5216554379210779
W01001771,1662,820,842,0.49338146811071,0.50661853188929
W01001774,1401,725,676,0.5174875089221984,0.4825124910778016
W01001732,1738,851,887,0.4896432681242808,0.5103567318757192
W01001733,1501,771,730,0.513657561625583,0.48634243837441704
W01001734,1602,793,809,0.4950062421972534,0.5049937578027466
W01001735,2042,999,1043,0.4892262487757101,0.5107737512242899
W01001887,1620,783,837,0.48333333333333334,0.5166666666666667
W01001889,1456,712,744,0.489010989010989,0.510989010989011
W01001891,1632,771,861,0.4724264705882353,0.5275735294117647
W01001892,1434,705,729,0.4916317991631799,0.5083682008368201
W01001896,1448,692,756,0.47790055248618785,0.5220994475138122
W01001772,1399,682,717,0.4874910650464618,0.5125089349535382
W01001775,1630,807,823,0.4950920245398773,0.5049079754601227
W01001776,1306,644,662,0.49310872894333846,0.5068912710566615
W01001890,1572,733,839,0.4662849872773537,0.5337150127226463
W01001863,1505,736,769,0.48903654485049836,0.5109634551495017
W01001864,1480,723,757,0.4885135135135135,0.5114864864864865
W01001865,1293,618,675,0.4779582366589327,0.5220417633410673
W01001868,1521,669,852,0.43984220907297833,0.5601577909270217
W01001785,1204,552,652,0.4584717607973422,0.5415282392026578
W01001786,1492,730,762,0.48927613941018766,0.5107238605898123
W01001787,1374,663,711,0.48253275109170307,0.517467248908297
W01001788,1601,755,846,0.47158026233604,0.52841973766396
W01001789,1535,743,792,0.48403908794788275,0.5159609120521172
W01001790,1219,575,644,0.4716981132075472,0.5283018867924528
W01001821,1712,794,918,0.463785046728972,0.5362149532710281
W01001826,1370,655,715,0.4781021897810219,0.5218978102189781
W01001827,1643,788,855,0.4796104686548996,0.5203895313451005
W01001828,1513,753,760,0.4976867151354924,0.5023132848645075
W01001755,1494,759,735,0.5080321285140562,0.4919678714859438
W01001756,4266,1823,2443,0.42733239568682607,0.572667604313174
W01001757,1456,707,749,0.4855769230769231,0.5144230769230769
W01001758,2199,1048,1151,0.47658026375625284,0.5234197362437472
W01001779,1508,735,773,0.4874005305039788,0.5125994694960212
W01001780,1621,764,857,0.4713140037014189,0.5286859962985812
W01001781,1667,810,857,0.4859028194361128,0.5140971805638872
W01001782,1460,741,719,0.5075342465753425,0.49246575342465754
W01001783,1213,560,653,0.46166529266281947,0.5383347073371806
W01001784,1307,623,684,0.47666411629686306,0.523335883703137
W01001747,1670,796,874,0.47664670658682634,0.5233532934131736
W01001748,1566,744,822,0.47509578544061304,0.524904214559387
W01001749,1542,733,809,0.47535667963683526,0.5246433203631647
W01001751,1863,846,1017,0.45410628019323673,0.5458937198067633
W01001718,1762,856,906,0.4858115777525539,0.5141884222474461
W01001719,2014,886,1128,0.4399205561072492,0.5600794438927508
W01001720,2236,1103,1133,0.4932915921288014,0.5067084078711985
W01001722,1760,740,1020,0.42045454545454547,0.5795454545454546
W01001726,1794,850,944,0.4738015607580825,0.5261984392419174
W01001822,1864,847,1017,0.4543991416309013,0.5456008583690987
W01001823,1280,616,664,0.48125,0.51875
W01001824,1548,770,778,0.4974160206718346,0.5025839793281653
W01001825,1981,1010,971,0.5098435133770823,0.4901564866229177
W01001831,1496,820,676,0.5481283422459893,0.45187165775401067
W01001836,1328,678,650,0.5105421686746988,0.4894578313253012
W01001837,1467,781,686,0.5323790047716428,0.4676209952283572
W01001838,1633,781,852,0.4782608695652174,0.5217391304347826
W01001839,1589,774,815,0.48709880427942104,0.512901195720579
W01001750,1603,770,833,0.48034934497816595,0.519650655021834
W01001752,1586,785,801,0.49495586380832285,0.5050441361916772
W01001753,1630,736,894,0.45153374233128835,0.5484662576687117
W01001754,1606,753,853,0.4688667496886675,0.5311332503113325
W01001721,2894,1345,1549,0.4647546648237733,0.5352453351762266
W01001724,2406,1054,1352,0.4380714879467997,0.5619285120532004
W01001725,2312,1156,1156,0.5,0.5
W01001922,2013,1060,953,0.5265772478887233,0.4734227521112767
W01002019,2629,1314,1315,0.499809813617345,0.500190186382655
W01001829,1993,1058,935,0.5308580030105369,0.46914199698946313
W01001830,1626,854,772,0.5252152521525215,0.4747847478474785
W01001832,1771,955,816,0.5392433653303218,0.46075663466967814
W01001833,1539,846,693,0.5497076023391813,0.4502923976608187
W01001834,1652,844,808,0.5108958837772397,0.4891041162227603
W01001835,2180,1193,987,0.5472477064220184,0.45275229357798163
W01001858,1590,794,796,0.49937106918238994,0.5006289308176101
W01001859,1506,747,759,0.4960159362549801,0.5039840637450199
W01001860,1656,820,836,0.49516908212560384,0.5048309178743962
W01001861,1539,791,748,0.5139701104613386,0.48602988953866144
W01001714,1568,763,805,0.48660714285714285,0.5133928571428571
W01001715,1552,781,771,0.5032216494845361,0.49677835051546393
W01001716,1278,617,661,0.48278560250391234,0.5172143974960877
W01001717,1539,749,790,0.4866796621182586,0.5133203378817414
W01001694,1998,1086,912,0.5435435435435435,0.45645645645645644
W01001695,3991,2243,1748,0.5620145326985718,0.43798546730142823
W01001696,1540,756,784,0.4909090909090909,0.509090909090909
W01001697,1983,1058,925,0.5335350479072113,0.4664649520927887
W01001698,2098,1142,956,0.544327931363203,0.45567206863679693
W01001870,1452,735,717,0.506198347107438,0.493801652892562
W01001871,1646,792,854,0.48116646415552855,0.5188335358444714
W01001876,1628,756,872,0.4643734643734644,0.5356265356265356
W01002020,1565,757,808,0.4837060702875399,0.51629392971246
W01002021,1499,736,763,0.49099399599733157,0.5090060040026685
W01001869,1383,676,707,0.48879248011569054,0.5112075198843095
W01001872,1597,791,806,0.49530369442705074,0.5046963055729493
W01001873,1831,888,943,0.4849808847624249,0.515019115237575
W01001874,1541,710,831,0.4607397793640493,0.5392602206359507
W01001737,1634,776,858,0.4749082007343941,0.5250917992656059
W01001738,1446,655,791,0.4529737206085754,0.5470262793914247
W01001739,1508,712,796,0.47214854111405835,0.5278514588859416
W01001740,1534,732,802,0.4771838331160365,0.5228161668839635
W01001741,1689,709,980,0.4197750148016578,0.5802249851983422
W01001710,1867,870,997,0.4659882163899304,0.5340117836100696
W01001711,2098,1030,1068,0.4909437559580553,0.5090562440419447
W01001712,1454,692,762,0.4759284731774415,0.5240715268225584
W01001713,1727,815,912,0.4719166184134337,0.5280833815865663
W01002022,1242,583,659,0.4694041867954911,0.5305958132045089
W01002023,1812,875,937,0.4828918322295806,0.5171081677704195
W01001704,1669,767,902,0.45955662073097664,0.5404433792690234
W01001706,1394,647,747,0.46413199426111906,0.5358680057388809
W01001707,2036,954,1082,0.468565815324165,0.5314341846758349
W01001746,1543,704,839,0.4562540505508749,0.5437459494491251
W01001855,1780,881,899,0.4949438202247191,0.505056179775281
W01001856,1720,907,813,0.5273255813953488,0.47267441860465115
W01001857,2101,1096,1005,0.5216563541170871,0.4783436458829129
W01001862,1860,1060,800,0.5698924731182796,0.43010752688172044
W01001742,1601,779,822,0.48657089319175517,0.5134291068082448
W01001743,1459,686,773,0.4701850582590816,0.5298149417409185
W01001744,1748,781,967,0.44679633867276886,0.5532036613272311
W01001745,1266,606,660,0.4786729857819905,0.5213270142180095
W01001764,2015,1060,955,0.5260545905707196,0.4739454094292804
W01001765,1471,778,693,0.5288919102651257,0.4711080897348742
W01001766,1690,872,818,0.5159763313609468,0.4840236686390533
W01001767,1809,906,903,0.5008291873963516,0.49917081260364843
W01001768,1667,853,814,0.5116976604679064,0.48830233953209357
W01001702,1777,861,916,0.4845244794597636,0.5154755205402364
W01001703,1227,591,636,0.48166259168704156,0.5183374083129584
W01001705,1947,889,1058,0.4565998972778634,0.5434001027221366
W01001708,1645,826,819,0.502127659574468,0.4978723404255319
W01001759,1593,814,779,0.5109855618330195,0.48901443816698054
W01001760,1662,814,848,0.4897713598074609,0.5102286401925391
W01001761,1778,906,872,0.5095613048368954,0.4904386951631046
W01001762,1841,956,885,0.5192829983704509,0.48071700162954917
W01001940,1049,587,462,0.559580552907531,0.440419447092469
W01001943,1197,666,531,0.556390977443609,0.44360902255639095
W01001944,1178,661,517,0.5611205432937182,0.4388794567062818
W01001947,1732,929,803,0.5363741339491916,0.4636258660508083
W01002024,1118,609,509,0.5447227191413238,0.4552772808586762
W01002025,1114,577,537,0.5179533213644524,0.48204667863554757
W01001699,2530,1345,1185,0.5316205533596838,0.4683794466403162
W01001942,1597,817,780,0.5115842204132749,0.4884157795867251
W01001946,1328,682,646,0.5135542168674698,0.4864457831325301
W01001950,1172,620,552,0.5290102389078498,0.4709897610921502
W01001951,1520,779,741,0.5125,0.4875
W01001952,1884,1007,877,0.5345010615711253,0.46549893842887474
W01001186,1731,848,883,0.4898902368573079,0.5101097631426921
W01001187,1360,683,677,0.5022058823529412,0.49779411764705883
W01001188,1301,627,674,0.4819369715603382,0.5180630284396618
W01001221,1420,672,748,0.4732394366197183,0.5267605633802817
W01001222,1554,721,833,0.46396396396396394,0.536036036036036
W01001233,1812,923,889,0.5093818984547461,0.49061810154525387
W01001148,1749,840,909,0.48027444253859347,0.5197255574614065
W01001152,1931,962,969,0.4981874676333506,0.5018125323666494
W01001153,1556,761,795,0.4890745501285347,0.5109254498714653
W01001155,1528,758,770,0.49607329842931935,0.5039267015706806
W01001149,1409,681,728,0.48332150461320084,0.5166784953867991
W01001150,1915,951,964,0.4966057441253264,0.5033942558746737
W01001151,1812,880,932,0.4856512141280353,0.5143487858719646
W01001154,1414,681,733,0.4816124469589816,0.5183875530410184
W01001156,1399,686,713,0.49035025017869904,0.509649749821301
W01001147,1797,910,887,0.5063995548135782,0.4936004451864218
W01001168,1388,668,720,0.4812680115273775,0.5187319884726225
W01001169,2538,1246,1292,0.4909377462568952,0.5090622537431048
W01001170,1186,579,607,0.4881956155143339,0.5118043844856661
W01001137,2389,1135,1254,0.475094181665969,0.5249058183340309
W01001138,1350,617,733,0.457037037037037,0.542962962962963
W01001139,1413,662,751,0.46850672328379334,0.5314932767162066
W01001140,1420,721,699,0.5077464788732394,0.4922535211267606
W01001141,1509,761,748,0.5043074884029158,0.49569251159708416
W01001142,1932,947,985,0.4901656314699793,0.5098343685300207
W01001204,1530,754,776,0.4928104575163399,0.5071895424836601
W01001205,1459,720,739,0.49348869088416725,0.5065113091158328
W01001206,1460,690,770,0.4726027397260274,0.5273972602739726
W01001207,1278,609,669,0.4765258215962441,0.5234741784037559
W01001208,1521,756,765,0.4970414201183432,0.5029585798816568
W01001265,1546,770,776,0.49805950840879687,0.5019404915912031
W01001266,1362,677,685,0.49706314243759175,0.5029368575624082
W01001267,1483,745,738,0.50236008091706,0.49763991908294
W01001268,1311,643,668,0.49046529366895497,0.509534706331045
W01001209,1452,724,728,0.4986225895316804,0.5013774104683195
W01001210,1454,721,733,0.4958734525447043,0.5041265474552957
W01001211,1531,698,833,0.4559111691704768,0.5440888308295232
W01001212,1311,626,685,0.4774980930587338,0.5225019069412662
W01001175,1290,587,703,0.45503875968992247,0.5449612403100775
W01001177,1280,640,640,0.5,0.5
W01001202,1769,863,906,0.4878462408140192,0.5121537591859808
W01001203,1358,651,707,0.4793814432989691,0.520618556701031
W01001269,1452,701,751,0.48278236914600553,0.5172176308539945
W01001270,1450,716,734,0.49379310344827587,0.5062068965517241
W01001271,1537,759,778,0.49381912817176316,0.5061808718282368
W01001272,1465,696,769,0.4750853242320819,0.5249146757679181
W01001273,1744,825,919,0.4730504587155963,0.5269495412844036
W01001214,1292,669,623,0.5178018575851393,0.4821981424148607
W01001216,1524,727,797,0.47703412073490814,0.5229658792650919
W01001962,2484,1206,1278,0.4855072463768116,0.5144927536231884
W01001143,1488,738,750,0.4959677419354839,0.5040322580645161
W01001144,1732,853,879,0.4924942263279446,0.5075057736720554
W01001145,1746,871,875,0.4988545246277205,0.5011454753722795
W01001146,1411,690,721,0.4890148830616584,0.5109851169383416
W01001176,1449,709,740,0.4893029675638371,0.5106970324361628
W01001274,1222,579,643,0.47381342062193127,0.5261865793780688
W01001275,1780,891,889,0.500561797752809,0.499438202247191
W01001276,1275,658,617,0.516078431372549,0.483921568627451
W01001260,1224,575,649,0.46977124183006536,0.5302287581699346
W01001285,1363,706,657,0.5179750550256786,0.48202494497432136
W01001286,1476,694,782,0.470189701897019,0.5298102981029811
W01001287,1456,738,718,0.5068681318681318,0.49313186813186816
W01001288,1425,723,702,0.5073684210526316,0.4926315789473684
W01001963,2247,1071,1176,0.4766355140186916,0.5233644859813084
W01001180,1526,723,803,0.4737876802096986,0.5262123197903015
W01001181,1389,677,712,0.48740100791936647,0.5125989920806335
W01001282,2046,996,1050,0.4868035190615836,0.5131964809384164
W01001283,1459,723,736,0.49554489376285127,0.5044551062371487
W01001284,1075,518,557,0.48186046511627906,0.5181395348837209
W01001166,1368,668,700,0.48830409356725146,0.5116959064327485
W01001167,1409,720,689,0.511000709723208,0.48899929027679206
W01001247,1583,753,830,0.4756790903348073,0.5243209096651926
W01001248,1977,982,995,0.49671219018715224,0.5032878098128477
W01001171,1285,637,648,0.49571984435797667,0.5042801556420233
W01001229,1409,740,669,0.525195173882186,0.47480482611781405
W01001230,1543,752,791,0.4873622812702528,0.5126377187297473
W01001231,1434,677,757,0.4721059972105997,0.5278940027894002
W01001280,1558,793,765,0.5089858793324775,0.4910141206675225
W01001281,1693,835,858,0.4932073242764324,0.5067926757235677
W01001217,1108,504,604,0.4548736462093863,0.5451263537906137
W01001218,1529,770,759,0.5035971223021583,0.49640287769784175
W01001219,1215,576,639,0.4740740740740741,0.5259259259259259
W01001220,1497,722,775,0.48229792919171677,0.5177020708082832
W01001259,1603,792,811,0.4940736119775421,0.5059263880224579
W01001261,1245,609,636,0.4891566265060241,0.5108433734939759
W01001164,1594,762,832,0.4780426599749059,0.5219573400250941
W01001165,1345,665,680,0.4944237918215613,0.5055762081784386
W01001256,1188,599,589,0.5042087542087542,0.4957912457912458
W01001257,1226,592,634,0.4828711256117455,0.5171288743882545
W01001258,1239,617,622,0.4979822437449556,0.5020177562550444
W01001172,1396,728,668,0.5214899713467048,0.4785100286532951
W01001173,1357,680,677,0.501105379513633,0.498894620486367
W01001174,1414,692,722,0.4893917963224894,0.5106082036775106
W01001232,1283,624,659,0.48636009353078724,0.5136399064692128
W01001227,1281,615,666,0.48009367681498827,0.5199063231850117
W01001228,1629,803,826,0.49294045426642114,0.5070595457335789
W01001234,1484,748,736,0.5040431266846361,0.49595687331536387
W01001235,1654,800,854,0.4836759371221282,0.5163240628778718
W01001236,1610,762,848,0.47329192546583854,0.5267080745341615
W01001964,2261,1116,1145,0.49358690844758957,0.5064130915524104
W01001185,2091,1016,1075,0.48589191774270685,0.5141080822572932
W01001237,1449,688,761,0.4748102139406487,0.5251897860593513
W01001238,1717,816,901,0.4752475247524752,0.5247524752475248
W01001262,1581,764,817,0.48323845667299176,0.5167615433270082
W01001263,1682,893,789,0.5309155766944114,0.4690844233055886
W01001264,1908,1051,857,0.55083857442348,0.4491614255765199
W01001178,1631,785,846,0.48129981606376454,0.5187001839362354
W01001179,1708,864,844,0.5058548009367682,0.49414519906323184
W01001253,1447,710,737,0.4906703524533518,0.5093296475466482
W01001255,2022,970,1052,0.4797230464886251,0.5202769535113749
W01001914,1916,946,970,0.49373695198329853,0.5062630480167014
W01001917,1450,723,727,0.4986206896551724,0.5013793103448276
W01001249,1452,698,754,0.4807162534435262,0.5192837465564738
W01001250,1523,766,757,0.5029546946815495,0.4970453053184504
W01001251,1513,715,798,0.47257105089226703,0.527428949107733
W01001252,1565,772,793,0.49329073482428115,0.5067092651757189
W01001162,2545,1271,1274,0.4994106090373281,0.5005893909626719
W01001244,1380,655,725,0.4746376811594203,0.5253623188405797
W01001245,1234,612,622,0.4959481361426256,0.5040518638573744
W01001246,1347,634,713,0.4706755753526355,0.5293244246473645
W01001184,2098,1029,1069,0.49046711153479505,0.509532888465205
W01001239,1297,631,666,0.4865073245952197,0.5134926754047803
W01001240,1903,923,980,0.48502364687335786,0.5149763531266421
W01001241,1647,810,837,0.4918032786885246,0.5081967213114754
W01001196,1438,726,712,0.5048678720445062,0.4951321279554937
W01001197,1216,604,612,0.4967105263157895,0.5032894736842105
W01001198,1489,722,767,0.48488918737407655,0.5151108126259234
W01001199,1658,811,847,0.48914354644149577,0.5108564535585042
W01001915,1646,817,829,0.49635479951397327,0.5036452004860267
W01001916,1498,740,758,0.4939919893190921,0.5060080106809078
W01001157,1309,624,685,0.4766997708174179,0.5233002291825821
W01001158,1489,733,756,0.4922766957689725,0.5077233042310275
W01001159,1574,765,809,0.48602287166454894,0.5139771283354511
W01001277,1114,550,564,0.49371633752244165,0.5062836624775583
W01001278,1148,553,595,0.4817073170731707,0.5182926829268293
W01001279,1104,514,590,0.46557971014492755,0.5344202898550725
W01001160,1630,801,829,0.49141104294478527,0.5085889570552147
W01001189,1512,746,766,0.4933862433862434,0.5066137566137566
W01001190,2990,1446,1544,0.4836120401337793,0.5163879598662208
W01001965,1707,817,890,0.4786174575278266,0.5213825424721734
W01001966,1736,851,885,0.4902073732718894,0.5097926267281107
W01001193,1134,550,584,0.48500881834215165,0.5149911816578483
W01001194,2110,1031,1079,0.4886255924170616,0.5113744075829384
W01001195,1452,727,725,0.5006887052341598,0.49931129476584024
W01001242,1356,661,695,0.48746312684365783,0.5125368731563422
W01001243,1411,684,727,0.4847625797306875,0.5152374202693125
W01001192,1429,685,744,0.4793561931420574,0.5206438068579426
W01001223,1744,835,909,0.47878440366972475,0.5212155963302753
W01001224,2031,983,1048,0.48399803052683404,0.5160019694731659
W01001225,1566,763,803,0.4872286079182631,0.5127713920817369
W01001226,1684,805,879,0.47802850356294535,0.5219714964370546
W01001967,1493,721,772,0.48292029470864034,0.5170797052913597
W01001968,1514,763,751,0.5039630118890357,0.4960369881109643
W01001374,1424,697,727,0.48946629213483145,0.5105337078651685
W01001375,1477,714,763,0.4834123222748815,0.5165876777251185
W01001376,1424,674,750,0.47331460674157305,0.526685393258427
W01001406,1832,933,899,0.5092794759825328,0.49072052401746724
W01001428,1233,598,635,0.48499594484995945,0.5150040551500406
W01001429,1155,567,588,0.4909090909090909,0.509090909090909
W01001360,1291,630,661,0.487993803253292,0.512006196746708
W01001361,1146,541,605,0.4720767888307155,0.5279232111692844
W01001384,1512,738,774,0.4880952380952381,0.5119047619047619
W01001385,1545,771,774,0.49902912621359224,0.5009708737864078
W01001386,1593,795,798,0.4990583804143126,0.5009416195856874
W01001325,1656,811,845,0.4897342995169082,0.5102657004830918
W01001326,2172,1037,1135,0.47744014732965007,0.5225598526703499
W01001362,1995,994,1001,0.4982456140350877,0.5017543859649123
W01001336,1419,696,723,0.4904862579281184,0.5095137420718816
W01001337,1446,720,726,0.4979253112033195,0.5020746887966805
W01001338,1734,877,857,0.505767012687428,0.4942329873125721
W01001339,1441,654,787,0.4538514920194309,0.546148507980569
W01001334,1447,716,731,0.4948168624740843,0.5051831375259157
W01001335,1262,635,627,0.5031695721077655,0.4968304278922345
W01001347,1498,715,783,0.4773030707610147,0.5226969292389854
W01001351,1393,671,722,0.48169418521177315,0.5183058147882269
W01001356,1189,594,595,0.49957947855340623,0.5004205214465938
W01001357,1695,847,848,0.49970501474926254,0.5002949852507375
W01001358,1505,759,746,0.5043189368770764,0.4956810631229236
W01001359,1407,734,673,0.5216773276474769,0.4783226723525231
W01001390,2107,1030,1077,0.48884670147128617,0.5111532985287138
W01001391,1617,792,825,0.4897959183673469,0.5102040816326531
W01001352,1748,862,886,0.4931350114416476,0.5068649885583524
W01001353,1531,758,773,0.4951012410189419,0.5048987589810582
W01001387,1191,579,612,0.48614609571788414,0.5138539042821159
W01001388,1823,865,958,0.47449259462424576,0.5255074053757542
W01001389,1100,542,558,0.49272727272727274,0.5072727272727273
W01001414,1588,776,812,0.48866498740554154,0.5113350125944585
W01001415,1732,864,868,0.49884526558891457,0.5011547344110855
W01001416,1383,674,709,0.48734634851771513,0.5126536514822849
W01001417,1386,664,722,0.4790764790764791,0.5209235209235209
W01001418,1399,659,740,0.4710507505360972,0.5289492494639028
W01001348,1758,829,929,0.47155858930602956,0.5284414106939704
W01001349,1717,849,868,0.49446709376820036,0.5055329062317997
W01001350,1737,865,872,0.49798503166378816,0.5020149683362118
W01001392,1934,924,1010,0.47776628748707345,0.5222337125129266
W01001380,1784,900,884,0.5044843049327354,0.49551569506726456
W01001381,1472,725,747,0.49252717391304346,0.5074728260869565
W01001382,1543,754,789,0.48865845755022685,0.5113415424497731
W01001383,1440,705,735,0.4895833333333333,0.5104166666666666
W01001401,2067,1022,1045,0.49443638122883404,0.505563618771166
W01001402,1600,795,805,0.496875,0.503125
W01001403,1589,791,798,0.4977973568281938,0.5022026431718062
W01001404,1347,679,668,0.504083147735709,0.495916852264291
W01001405,1781,887,894,0.498034811903425,0.501965188096575
W01001363,1800,879,921,0.48833333333333334,0.5116666666666667
W01001364,1779,865,914,0.48622821810005623,0.5137717818999438
W01001365,1931,978,953,0.5064733298808908,0.4935266701191093
W01001369,2423,1208,1215,0.4985555096987206,0.5014444903012794
W01001377,1449,683,766,0.47135955831608006,0.52864044168392
W01001378,1501,686,815,0.4570286475682878,0.5429713524317122
W01001379,1522,769,753,0.5052562417871223,0.4947437582128778
W01001432,2753,1354,1399,0.49182709771158734,0.5081729022884126
W01001433,1360,667,693,0.4904411764705882,0.5095588235294117
W01001434,1373,669,704,0.48725418790968683,0.5127458120903132
W01001327,2454,1220,1234,0.4971475142624287,0.5028524857375714
W01001328,1505,779,726,0.5176079734219269,0.48239202657807306
W01001329,1487,727,760,0.48890383322125086,0.5110961667787491
W01001354,1665,844,821,0.5069069069069069,0.49309309309309307
W01001355,1533,736,797,0.4801043705153294,0.5198956294846706
W01001430,2380,1164,1216,0.4890756302521008,0.5109243697478991
W01001431,1586,779,807,0.4911727616645649,0.5088272383354351
W01001407,1308,644,664,0.4923547400611621,0.5076452599388379
W01001408,1442,690,752,0.478502080443828,0.521497919556172
W01001409,1582,774,808,0.4892541087231353,0.5107458912768648
W01001410,1810,886,924,0.4895027624309392,0.5104972375690607
W01001411,1607,779,828,0.48475420037336653,0.5152457996266335
W01001412,1657,833,824,0.5027157513578757,0.49728424864212434
W01001413,1821,885,936,0.48599670510708404,0.514003294892916
W01001330,1443,695,748,0.48163548163548164,0.5183645183645184
W01001331,1742,859,883,0.4931113662456946,0.5068886337543054
W01001332,1845,932,913,0.5051490514905149,0.4948509485094851
W01001333,1477,712,765,0.4820582261340555,0.5179417738659445
W01001366,1556,741,815,0.4762210796915167,0.5237789203084833
W01001367,1455,704,751,0.4838487972508591,0.516151202749141
W01001368,1421,682,739,0.47994370161857847,0.5200562983814215
W01001393,1346,663,683,0.49257057949479943,0.5074294205052006
W01001397,1574,761,813,0.4834815756035578,0.5165184243964421
W01001400,1420,653,767,0.45985915492957746,0.5401408450704225
W01001340,1871,938,933,0.501336183858899,0.498663816141101
W01001341,1703,778,925,0.4568408690546095,0.5431591309453905
W01001344,1667,808,859,0.48470305938812236,0.5152969406118776
W01001346,1526,715,811,0.46854521625163825,0.5314547837483617
W01001342,1187,568,619,0.4785172704296546,0.5214827295703454
W01001343,1098,516,582,0.46994535519125685,0.5300546448087432
W01001345,1406,662,744,0.47083926031294454,0.5291607396870555
W01001419,1600,813,787,0.508125,0.491875
W01001371,1916,907,1009,0.4733820459290188,0.5266179540709812
W01001372,1796,867,929,0.482739420935412,0.517260579064588
W01001373,1940,967,973,0.4984536082474227,0.5015463917525773
W01001420,1211,561,650,0.4632535094962841,0.5367464905037159
W01001421,1440,672,768,0.4666666666666667,0.5333333333333333
W01001422,1470,716,754,0.48707482993197276,0.5129251700680272
W01001370,1829,873,956,0.47731000546746855,0.5226899945325314
W01001394,1295,645,650,0.4980694980694981,0.5019305019305019
W01001395,1312,629,683,0.4794207317073171,0.520579268292683
W01001396,1539,743,796,0.48278102664067574,0.5172189733593242
W01001399,1255,609,646,0.4852589641434263,0.5147410358565737
W01001398,2792,1371,1421,0.4910458452722063,0.5089541547277937
W01001423,1379,651,728,0.4720812182741117,0.5279187817258884
W01001424,1407,679,728,0.48258706467661694,0.5174129353233831
W01001425,1737,862,875,0.4962579159470351,0.5037420840529648
W01001426,1459,729,730,0.4996572995202193,0.5003427004797807
W01001427,1851,885,966,0.47811993517017826,0.5218800648298217
W01001440,1343,643,700,0.4787788533134773,0.5212211466865228
W01001441,1175,569,606,0.48425531914893616,0.5157446808510638
W01001442,1093,539,554,0.4931381518755718,0.5068618481244281
W01001470,1404,662,742,0.47150997150997154,0.5284900284900285
W01001471,1609,794,815,0.4934742075823493,0.5065257924176507
W01001446,1231,612,619,0.49715678310316813,0.5028432168968319
W01001447,1481,739,742,0.4989871708305199,0.5010128291694801
W01001448,1163,568,595,0.4883920894239037,0.5116079105760963
W01001449,1373,685,688,0.4989075018208303,0.5010924981791697
W01001472,1374,679,695,0.49417758369723436,0.5058224163027657
W01001473,1269,594,675,0.46808510638297873,0.5319148936170213
W01001474,1424,711,713,0.49929775280898875,0.5007022471910112
W01001475,1127,549,578,0.487133984028394,0.5128660159716061
W01001480,1466,680,786,0.4638472032742155,0.5361527967257844
W01001438,1478,722,756,0.4884979702300406,0.5115020297699594
W01001439,1606,825,781,0.5136986301369864,0.4863013698630137
W01001456,1266,607,659,0.4794628751974723,0.5205371248025277
W01001457,1791,847,944,0.47292015633724177,0.5270798436627583
W01001458,1645,809,836,0.4917933130699088,0.5082066869300912
W01001443,1232,609,623,0.4943181818181818,0.5056818181818182
W01001444,1968,921,1047,0.4679878048780488,0.5320121951219512
W01001445,1354,637,717,0.4704579025110783,0.5295420974889217
W01001467,1901,945,956,0.49710678590215673,0.5028932140978433
W01001468,1326,665,661,0.5015082956259427,0.4984917043740573
W01001469,1316,656,660,0.49848024316109424,0.5015197568389058
W01001462,1816,883,933,0.48623348017621143,0.5137665198237885
W01001463,1787,843,944,0.47174034695019584,0.5282596530498042
W01001478,1366,673,693,0.49267935578330896,0.5073206442166911
W01001479,1476,715,761,0.48441734417344173,0.5155826558265583
W01001481,1635,800,835,0.4892966360856269,0.5107033639143731
W01001450,1214,621,593,0.5115321252059308,0.48846787479406917
W01001451,1292,649,643,0.5023219814241486,0.49767801857585137
W01001452,1431,724,707,0.5059399021663172,0.49406009783368277
W01001459,1207,576,631,0.4772162386081193,0.5227837613918807
W01001460,1726,886,840,0.5133256083429896,0.48667439165701043
W01001461,1261,636,625,0.5043616177636796,0.4956383822363204
W01001435,1356,661,695,0.48746312684365783,0.5125368731563422
W01001436,1371,702,669,0.5120350109409191,0.487964989059081
W01001437,1436,698,738,0.4860724233983287,0.5139275766016713
W01001453,1486,728,758,0.4899057873485868,0.5100942126514132
W01001454,1277,618,659,0.4839467501957713,0.5160532498042286
W01001455,1685,829,856,0.4919881305637982,0.5080118694362018
W01001464,1437,746,691,0.5191370911621433,0.48086290883785665
W01001465,1525,748,777,0.4904918032786885,0.5095081967213114
W01001466,1441,746,695,0.5176960444136016,0.4823039555863983
W01001973,2261,1088,1173,0.48120300751879697,0.518796992481203
W01001487,1669,849,820,0.5086878370281606,0.49131216297183944
W01001488,1516,735,781,0.48482849604221634,0.5151715039577837
W01001489,1434,694,740,0.4839609483960948,0.5160390516039052
W01001490,1399,663,736,0.4739099356683345,0.5260900643316655
W01001482,1247,598,649,0.47955092221331197,0.520449077786688
W01001483,1446,699,747,0.483402489626556,0.516597510373444
W01001484,1631,797,834,0.48865726548129984,0.5113427345187002
W01001485,1255,614,641,0.4892430278884462,0.5107569721115538
W01001486,1464,744,720,0.5081967213114754,0.4918032786885246
W01001525,1842,888,954,0.4820846905537459,0.5179153094462541
W01001529,2035,1001,1034,0.4918918918918919,0.5081081081081081
W01001530,1792,834,958,0.4654017857142857,0.5345982142857143
W01001531,1673,815,858,0.4871488344291692,0.5128511655708309
W01001491,1701,813,888,0.47795414462081126,0.5220458553791887
W01001496,1466,692,774,0.47203274215552526,0.5279672578444747
W01001523,1422,716,706,0.5035161744022504,0.4964838255977497
W01001524,1855,929,926,0.5008086253369273,0.4991913746630728
W01001540,1269,623,646,0.4909377462568952,0.5090622537431048
W01001541,1157,561,596,0.4848746758859118,0.5151253241140882
W01001510,1597,764,833,0.47839699436443334,0.5216030056355667
W01001511,1538,728,810,0.47334200260078024,0.5266579973992198
W01001512,1294,641,653,0.4953632148377125,0.5046367851622875
W01001513,1466,717,749,0.48908594815825374,0.5109140518417462
W01001514,1078,512,566,0.4749536178107607,0.5250463821892394
W01001515,1393,688,705,0.4938980617372577,0.5061019382627423
W01001516,1435,713,722,0.4968641114982578,0.5031358885017422
W01001517,2441,1206,1235,0.49405981155264234,0.5059401884473577
W01001518,1132,561,571,0.495583038869258,0.5044169611307421
W01001519,1283,602,681,0.4692127825409197,0.5307872174590803
W01001520,2597,1271,1326,0.48941085868309586,0.5105891413169041
W01001521,1422,719,703,0.5056258790436006,0.49437412095639943
W01001522,1596,763,833,0.4780701754385965,0.5219298245614035
W01001537,1169,559,610,0.47818648417450815,0.5218135158254918
W01001493,1806,870,936,0.48172757475083056,0.5182724252491694
W01001494,1544,759,785,0.49158031088082904,0.508419689119171
W01001495,1793,863,930,0.48131622978248745,0.5186837702175126
W01001507,1937,940,997,0.4852865255549819,0.514713474445018
W01001501,1320,629,691,0.4765151515151515,0.5234848484848484
W01001503,1239,592,647,0.4778046811945117,0.5221953188054883
W01001536,1144,552,592,0.4825174825174825,0.5174825174825175
W01001538,1329,637,692,0.47930775018811134,0.5206922498118887
W01001539,1442,678,764,0.47018030513176146,0.5298196948682385
W01001506,1520,775,745,0.5098684210526315,0.4901315789473684
W01001526,1401,652,749,0.46538187009279086,0.5346181299072091
W01001527,1178,565,613,0.4796264855687606,0.5203735144312394
W01001528,1778,859,919,0.4831271091113611,0.516872890888639
W01001532,1772,866,906,0.4887133182844244,0.5112866817155757
W01001497,1391,680,711,0.4888569374550683,0.5111430625449317
W01001498,1244,600,644,0.48231511254019294,0.5176848874598071
W01001499,1161,555,606,0.4780361757105943,0.5219638242894057
W01001500,1244,615,629,0.49437299035369775,0.5056270096463023
W01001502,1201,606,595,0.5045795170691091,0.4954204829308909
W01001492,2438,1158,1280,0.4749794913863823,0.5250205086136177
W01001533,1499,741,758,0.4943295530353569,0.5056704469646431
W01001534,1404,709,695,0.5049857549857549,0.495014245014245
W01001535,1244,607,637,0.4879421221864952,0.5120578778135049
W01001504,2323,1138,1185,0.4898837709857942,0.5101162290142057
W01001505,2652,1295,1357,0.4883107088989442,0.5116892911010558
W01001508,1179,553,626,0.46904156064461405,0.5309584393553859
W01001509,1380,665,715,0.48188405797101447,0.5181159420289855
W01001545,1523,723,800,0.4747209455022981,0.525279054497702
W01001548,2083,1036,1047,0.4973595775324052,0.5026404224675948
W01001557,1802,882,920,0.4894561598224195,0.5105438401775805
W01001571,1496,758,738,0.5066844919786097,0.49331550802139035
W01001579,1574,732,842,0.4650571791613723,0.5349428208386277
W01001546,1563,757,806,0.48432501599488165,0.5156749840051184
W01001558,1573,721,852,0.45835982199618563,0.5416401780038144
W01001580,1750,824,926,0.47085714285714286,0.5291428571428571
W01001974,1437,694,743,0.48295059151009045,0.5170494084899095
W01001975,1318,605,713,0.4590288315629742,0.5409711684370258
W01001561,1601,755,846,0.47158026233604,0.52841973766396
W01001562,1369,699,670,0.5105916727538349,0.48940832724616506
W01001563,1140,566,574,0.4964912280701754,0.5035087719298246
W01001569,1342,674,668,0.5022354694485842,0.4977645305514158
W01001976,1605,808,797,0.5034267912772585,0.4965732087227414
W01001977,1463,701,762,0.47915242652084755,0.5208475734791524
W01001552,1511,720,791,0.47650562541363334,0.5234943745863666
W01001554,1523,765,758,0.5022980958634274,0.49770190413657256
W01001576,1073,504,569,0.46971109040074555,0.5302889095992545
W01001577,1292,581,711,0.44969040247678016,0.5503095975232198
W01001599,2125,1043,1082,0.4908235294117647,0.5091764705882353
W01001978,1491,726,765,0.4869215291750503,0.5130784708249497
W01001979,2036,983,1053,0.48280943025540274,0.5171905697445972
W01001568,1781,874,907,0.49073554183043233,0.5092644581695677
W01001575,1237,630,607,0.5092966855295069,0.49070331447049315
W01001581,1930,930,1000,0.48186528497409326,0.5181347150259067
W01001980,2192,1084,1108,0.49452554744525545,0.5054744525547445
W01001555,1132,559,573,0.49381625441696114,0.5061837455830389
W01001556,1368,662,706,0.48391812865497075,0.5160818713450293
W01001560,1371,705,666,0.5142231947483589,0.48577680525164113
W01001565,1814,895,919,0.4933847850055127,0.5066152149944874
W01001596,1207,731,476,0.6056338028169014,0.39436619718309857
W01001597,1420,703,717,0.4950704225352113,0.5049295774647887
W01001549,1388,716,672,0.515850144092219,0.484149855907781
W01001583,1515,741,774,0.4891089108910891,0.5108910891089109
W01001585,1281,617,664,0.4816549570647931,0.5183450429352069
W01001586,2482,1227,1255,0.4943593875906527,0.5056406124093473
W01001594,1405,687,718,0.4889679715302491,0.5110320284697509
W01001595,1289,651,638,0.5050426687354539,0.49495733126454616
W01001559,1276,614,662,0.48119122257053293,0.5188087774294671
W01001584,1759,857,902,0.4872086412734508,0.5127913587265491
W01001587,1878,946,932,0.503727369542066,0.49627263045793396
W01001592,1627,770,857,0.4732636754763368,0.5267363245236631
W01001593,1632,795,837,0.48713235294117646,0.5128676470588235
W01001542,2124,1049,1075,0.493879472693032,0.506120527306968
W01001543,1780,871,909,0.4893258426966292,0.5106741573033707
W01001578,2485,1230,1255,0.4949698189134809,0.5050301810865191
W01001590,2120,1055,1065,0.49764150943396224,0.5023584905660378
W01001551,1176,599,577,0.5093537414965986,0.4906462585034014
W01001588,1612,767,845,0.47580645161290325,0.5241935483870968
W01001589,1427,691,736,0.48423265592151365,0.5157673440784863
W01001598,1671,825,846,0.49371633752244165,0.5062836624775583
W01001908,2151,1011,1140,0.4700139470013947,0.5299860529986054
W01001572,1610,777,833,0.4826086956521739,0.5173913043478261
W01001573,1411,703,708,0.4982282069454288,0.5017717930545712
W01001574,1330,643,687,0.48345864661654137,0.5165413533834586
W01001582,1790,886,904,0.4949720670391061,0.5050279329608939
W01001591,1600,784,816,0.49,0.51
W01001623,1407,675,732,0.47974413646055436,0.5202558635394456
W01001624,1208,572,636,0.4735099337748344,0.5264900662251656
W01001625,1176,564,612,0.47959183673469385,0.5204081632653061
W01001626,1507,730,777,0.48440610484406105,0.5155938951559389
W01001627,1612,778,834,0.4826302729528536,0.5173697270471465
W01001628,1060,498,562,0.469811320754717,0.530188679245283
W01001651,1439,688,751,0.47810979847116053,0.5218902015288395
W01001652,1651,803,848,0.4863718958207147,0.5136281041792853
W01001653,1359,650,709,0.4782928623988227,0.5217071376011774
W01001654,1585,748,837,0.47192429022082016,0.5280757097791798
W01001655,1569,758,811,0.48311026131293816,0.5168897386870618
W01001617,1480,714,766,0.48243243243243245,0.5175675675675676
W01001618,1124,522,602,0.46441281138790036,0.5355871886120996
W01001619,1380,667,713,0.48333333333333334,0.5166666666666667
W01001620,1688,786,902,0.4656398104265403,0.5343601895734598
W01001621,1419,698,721,0.4918957011980268,0.5081042988019733
W01001622,1206,571,635,0.4734660033167496,0.5265339966832504
W01001639,2179,1046,1133,0.48003671408903165,0.5199632859109683
W01001640,1107,560,547,0.5058717253839206,0.4941282746160795
W01001641,1362,682,680,0.5007342143906021,0.49926578560939794
W01001650,1661,793,868,0.477423239012643,0.5225767609873571
W01002026,1869,935,934,0.5002675227394329,0.49973247726056713
W01002027,1781,876,905,0.4918585064570466,0.5081414935429533
W01001614,1601,769,832,0.4803247970018738,0.5196752029981262
W01001615,1594,809,785,0.5075282308657465,0.49247176913425345
W01001616,1415,677,738,0.4784452296819788,0.5215547703180212
W01001678,1662,784,878,0.4717208182912154,0.5282791817087846
W01001601,1551,823,728,0.5306254029658285,0.4693745970341715
W01001681,1340,632,708,0.4716417910447761,0.5283582089552239
W01001682,1395,684,711,0.49032258064516127,0.5096774193548387
W01001683,1096,530,566,0.4835766423357664,0.5164233576642335
W01001684,1412,678,734,0.4801699716713881,0.5198300283286119
W01001675,1580,765,815,0.48417721518987344,0.5158227848101266
W01001676,1855,906,949,0.4884097035040431,0.5115902964959569
W01001677,1388,677,711,0.4877521613832853,0.5122478386167147
W01001679,1108,542,566,0.4891696750902527,0.5108303249097473
W01001680,1289,618,671,0.4794414274631497,0.5205585725368502
W01001606,1270,612,658,0.4818897637795276,0.5181102362204725
W01001608,1490,745,745,0.5,0.5
W01001663,1391,618,773,0.4442846872753415,0.5557153127246586
W01001665,1643,802,841,0.4881314668289714,0.5118685331710287
W01001669,1252,621,631,0.4960063897763578,0.5039936102236422
W01001670,2290,1143,1147,0.49912663755458514,0.5008733624454148
W01001673,1420,666,754,0.46901408450704224,0.5309859154929577
W01001674,1569,757,812,0.4824729126832377,0.5175270873167622
W01002028,1942,924,1018,0.47579814624098865,0.5242018537590113
W01002029,1765,865,900,0.49008498583569404,0.509915014164306
W01001664,1230,623,607,0.5065040650406504,0.49349593495934957
W01001666,1496,719,777,0.48061497326203206,0.5193850267379679
W01001667,1310,597,713,0.45572519083969465,0.5442748091603054
W01001668,1233,639,594,0.5182481751824818,0.48175182481751827
W01001611,1202,607,595,0.5049916805324459,0.4950083194675541
W01001612,1527,790,737,0.5173542894564506,0.48264571054354943
W01001613,1523,762,761,0.5003282994090611,0.49967170059093896
W01001691,1683,892,791,0.5300059417706476,0.46999405822935236
W01001692,2349,1218,1131,0.5185185185185185,0.48148148148148145
W01001600,1847,914,933,0.494856524093124,0.505143475906876
W01001602,1624,734,890,0.45197044334975367,0.5480295566502463
W01001603,1519,767,752,0.5049374588545096,0.4950625411454905
W01001604,1494,721,773,0.4825970548862115,0.5174029451137885
W01001642,1663,805,858,0.4840649428743235,0.5159350571256764
W01001643,1905,933,972,0.48976377952755906,0.510236220472441
W01001690,2212,1155,1057,0.5221518987341772,0.4778481012658228
W01001693,2905,1491,1414,0.5132530120481927,0.4867469879518072
W01002030,1424,745,679,0.5231741573033708,0.4768258426966292
W01002031,1695,872,823,0.5144542772861357,0.4855457227138643
W01001605,1462,780,682,0.533515731874145,0.466484268125855
W01001685,1701,878,823,0.5161669606114051,0.48383303938859495
W01001686,1290,668,622,0.517829457364341,0.4821705426356589
W01001687,2331,1316,1015,0.5645645645645646,0.43543543543543545
W01001607,1363,651,712,0.4776228906823184,0.5223771093176816
W01001609,1913,898,1015,0.46941975953998955,0.5305802404600104
W01001610,1321,660,661,0.4996214988644966,0.5003785011355034
W01001645,1284,622,662,0.48442367601246106,0.5155763239875389
W01001646,1645,802,843,0.48753799392097263,0.5124620060790274
W01001648,1553,767,786,0.49388280746941404,0.506117192530586
W01002032,1279,620,659,0.4847537138389367,0.5152462861610634
W01002033,1405,715,690,0.5088967971530249,0.49110320284697506
W01001635,1324,669,655,0.5052870090634441,0.4947129909365559
W01001637,2129,1009,1120,0.4739314232033819,0.5260685767966181
W01001638,1216,614,602,0.5049342105263158,0.49506578947368424
W01001671,2313,1112,1201,0.48076091655858194,0.5192390834414181
W01001629,1375,676,699,0.49163636363636365,0.5083636363636364
W01001630,1656,794,862,0.47946859903381644,0.5205314009661836
W01001631,1343,676,667,0.5033507073715562,0.49664929262844376
W01001632,1407,679,728,0.48258706467661694,0.5174129353233831
W01001659,1913,921,992,0.4814427600627287,0.5185572399372713
W01001660,2723,1355,1368,0.4976129269188395,0.5023870730811605
W01001661,2978,1572,1406,0.5278710543989255,0.47212894560107455
W01001662,1676,810,866,0.48329355608591884,0.5167064439140812
W01001633,1719,764,955,0.4444444444444444,0.5555555555555556
W01001634,1480,703,777,0.475,0.525
W01001689,2064,927,1137,0.4491279069767442,0.5508720930232558
W01002034,1703,860,843,0.5049911920140928,0.49500880798590724
W01002035,1608,744,864,0.4626865671641791,0.5373134328358209
W01001636,1933,958,975,0.49560269011898606,0.5043973098810139
W01001657,1454,692,762,0.4759284731774415,0.5240715268225584
W01001658,2078,1045,1033,0.5028873917228104,0.4971126082771896
W01001912,1525,765,760,0.5016393442622951,0.49836065573770494
W01001913,1442,759,683,0.5263522884882108,0.4736477115117892
W01000461,1585,816,769,0.5148264984227129,0.48517350157728706
W01000470,1988,976,1012,0.4909456740442656,0.5090543259557344
W01000475,2399,1204,1195,0.5018757815756565,0.49812421842434346
W01001906,1955,984,971,0.5033248081841433,0.4966751918158568
W01001907,1382,696,686,0.5036179450072359,0.4963820549927641
W01000444,2258,1106,1152,0.48981399468556247,0.5101860053144376
W01000457,2149,1058,1091,0.4923220102373197,0.5076779897626803
W01000458,1854,913,941,0.4924487594390507,0.5075512405609492
W01000498,1488,732,756,0.49193548387096775,0.5080645161290323
W01000499,1236,595,641,0.4813915857605178,0.5186084142394822
W01000500,1711,822,889,0.4804208065458796,0.5195791934541204
W01000501,2202,1092,1110,0.49591280653950953,0.5040871934604905
W01000442,2055,984,1071,0.47883211678832116,0.5211678832116788
W01000452,1994,1034,960,0.518555667001003,0.48144433299899697
W01000473,2161,1042,1119,0.48218417399352154,0.5178158260064785
W01000428,1338,669,669,0.5,0.5
W01000441,1536,767,769,0.4993489583333333,0.5006510416666666
W01000476,1285,608,677,0.47315175097276263,0.5268482490272374
W01000497,1376,702,674,0.5101744186046512,0.4898255813953488
W01000433,2272,1128,1144,0.4964788732394366,0.5035211267605634
W01000460,1706,855,851,0.5011723329425557,0.4988276670574443
W01000488,2174,1099,1075,0.5055197792088316,0.4944802207911684
W01000434,1740,824,916,0.4735632183908046,0.5264367816091954
W01000439,2034,1022,1012,0.5024582104228122,0.4975417895771878
W01000447,2016,990,1026,0.49107142857142855,0.5089285714285714
W01000480,2105,1088,1017,0.5168646080760095,0.4831353919239905
W01000481,2199,1099,1100,0.49977262391996363,0.5002273760800364
W01000482,1890,923,967,0.4883597883597884,0.5116402116402117
W01000478,1873,925,948,0.4938601174586225,0.5061398825413774
W01000479,1454,686,768,0.4718019257221458,0.5281980742778541
W01000483,1839,879,960,0.47797716150081565,0.5220228384991843
W01000429,2324,1167,1157,0.5021514629948365,0.4978485370051635
W01000453,1382,704,678,0.5094066570188133,0.4905933429811867
W01000466,1336,624,712,0.46706586826347307,0.5329341317365269
W01000467,1449,710,739,0.48999309868875085,0.5100069013112492
W01000427,1344,684,660,0.5089285714285714,0.49107142857142855
W01000448,1398,671,727,0.4799713876967096,0.5200286123032904
W01000449,1516,745,771,0.49142480211081796,0.508575197889182
W01000464,1191,594,597,0.4987405541561713,0.5012594458438288
W01000484,1682,853,829,0.5071343638525565,0.4928656361474435
W01000485,1584,786,798,0.4962121212121212,0.5037878787878788
W01000486,1066,522,544,0.4896810506566604,0.5103189493433395
W01000438,1231,617,614,0.5012185215272137,0.49878147847278637
W01000451,1182,596,586,0.5042301184433164,0.4957698815566836
W01000472,1183,580,603,0.4902789518174134,0.5097210481825867
W01000477,1533,782,751,0.5101108936725375,0.48988910632746246
W01000487,2082,999,1083,0.47982708933717577,0.5201729106628242
W01000454,1266,665,601,0.5252764612954186,0.47472353870458134
W01000455,2185,1050,1135,0.4805491990846682,0.5194508009153318
W01000456,2147,1081,1066,0.503493246390312,0.49650675360968793
W01000431,1260,628,632,0.4984126984126984,0.5015873015873016
W01000432,1209,562,647,0.46484698097601324,0.5351530190239868
W01000450,1397,699,698,0.5003579098067287,0.49964209019327127
W01000459,1208,598,610,0.49503311258278143,0.5049668874172185
W01000471,1768,896,872,0.5067873303167421,0.49321266968325794
W01000430,1313,611,702,0.46534653465346537,0.5346534653465347
W01000443,2283,1122,1161,0.4914586070959264,0.5085413929040736
W01000445,1482,739,743,0.49865047233468285,0.5013495276653172
W01000446,1680,776,904,0.46190476190476193,0.5380952380952381
W01000494,1701,825,876,0.48500881834215165,0.5149911816578483
W01000489,1779,827,952,0.46486790331646993,0.5351320966835301
W01000492,1517,755,762,0.4976928147659855,0.5023071852340145
W01000493,1731,984,747,0.5684575389948007,0.43154246100519933
W01001901,1839,888,951,0.4828711256117455,0.5171288743882545
W01001902,1390,639,751,0.45971223021582736,0.5402877697841727
W01000465,1035,475,560,0.45893719806763283,0.5410628019323671
W01001903,2108,1024,1084,0.4857685009487666,0.5142314990512334
W01001904,1649,786,863,0.47665251667677383,0.5233474833232262
W01001905,2149,1091,1058,0.5076779897626803,0.4923220102373197
W01000440,1313,641,672,0.4881949733434882,0.5118050266565118
W01000474,1747,866,881,0.4957069261591299,0.5042930738408701
W01000503,1059,544,515,0.5136921624173749,0.48630783758262514
W01001897,1870,921,949,0.4925133689839572,0.5074866310160427
W01000426,1421,685,736,0.48205489092188597,0.517945109078114
W01000496,2082,1042,1040,0.5004803073967339,0.49951969260326606
W01000502,2064,1030,1034,0.499031007751938,0.500968992248062
W01000504,1132,527,605,0.465547703180212,0.534452296819788
W01000505,1430,703,727,0.4916083916083916,0.5083916083916084
W01001899,2219,1069,1150,0.48174853537629564,0.5182514646237044
W01001295,1510,736,774,0.48741721854304637,0.5125827814569537
W01001296,1575,806,769,0.5117460317460317,0.4882539682539683
W01001297,1816,882,934,0.4856828193832599,0.51431718061674
W01001298,1730,830,900,0.4797687861271676,0.5202312138728323
W01001310,1553,756,797,0.4867997424339987,0.5132002575660013
W01001311,1172,585,587,0.4991467576791809,0.5008532423208191
W01001291,2080,997,1083,0.4793269230769231,0.520673076923077
W01001294,1669,795,874,0.4763331336129419,0.5236668663870582
W01001305,1225,583,642,0.47591836734693876,0.5240816326530612
W01001306,1424,690,734,0.4845505617977528,0.5154494382022472
W01001324,1934,967,967,0.5,0.5
W01001292,1844,872,972,0.47288503253796094,0.527114967462039
W01001293,1679,841,838,0.5008933889219773,0.4991066110780226
W01001307,1514,718,796,0.47424042272126815,0.5257595772787318
W01001315,1701,874,827,0.5138154027042916,0.4861845972957084
W01001314,2097,1037,1060,0.4945159752026705,0.5054840247973296
W01001317,1745,849,896,0.4865329512893983,0.5134670487106017
W01001318,1481,746,735,0.5037137069547603,0.4962862930452397
W01001959,1533,755,778,0.49249836921069795,0.507501630789302
W01001960,1436,729,707,0.5076601671309192,0.4923398328690808
W01001289,1358,687,671,0.5058910162002945,0.49410898379970547
W01001302,1431,713,718,0.49825296995108315,0.5017470300489169
W01001312,1475,734,741,0.4976271186440678,0.5023728813559322
W01001313,1476,732,744,0.4959349593495935,0.5040650406504065
W01001961,2343,1163,1180,0.49637217242851045,0.5036278275714895
W01001290,2409,1208,1201,0.5014528850145289,0.49854711498547116
W01001319,1592,789,803,0.4956030150753769,0.5043969849246231
W01001320,1425,701,724,0.4919298245614035,0.5080701754385964
W01001321,1622,776,846,0.4784217016029593,0.5215782983970407
W01001322,1633,800,833,0.4898958971218616,0.5101041028781383
W01001299,1692,779,913,0.4604018912529551,0.539598108747045
W01001300,1737,819,918,0.47150259067357514,0.5284974093264249
W01001301,1913,911,1002,0.47621536853110297,0.523784631468897
W01001308,1253,557,696,0.44453312051077415,0.5554668794892259
W01001309,1301,631,670,0.48501152959262106,0.5149884704073789
W01001898,1462,705,757,0.48221614227086185,0.5177838577291382
