Location_Code,Total_Pop,Male,Female,Male_Rate,Female_Rate
E01012334,2466,1220,1246,0.49472830494728304,0.505271695052717
E01012335,1383,682,701,0.49313087490961677,0.5068691250903832
E01012366,2008,972,1036,0.48406374501992033,0.5159362549800797
E01033481,1364,680,684,0.49853372434017595,0.501466275659824
E01033482,1621,810,811,0.499691548426897,0.500308451573103
E01012323,1563,799,764,0.5111964171465131,0.4888035828534869
E01012324,1399,671,728,0.47962830593280914,0.5203716940671909
E01032545,1259,631,628,0.5011914217633042,0.4988085782366958
E01032546,1776,886,890,0.4988738738738739,0.5011261261261262
E01012328,1571,768,803,0.48886059834500317,0.5111394016549968
E01012329,1770,855,915,0.4830508474576271,0.5169491525423728
E01012330,1145,549,596,0.4794759825327511,0.5205240174672489
E01012331,1255,609,646,0.4852589641434263,0.5147410358565737
E01012349,1532,762,770,0.49738903394255873,0.5026109660574413
E01012350,1517,747,770,0.4924192485168095,0.5075807514831905
E01012351,1438,718,720,0.4993045897079277,0.5006954102920723
E01012352,1579,774,805,0.4901836605446485,0.5098163394553515
E01012325,1456,709,747,0.48695054945054944,0.5130494505494505
E01012326,1129,550,579,0.4871567759078831,0.5128432240921169
E01012332,1427,656,771,0.45970567624386827,0.5402943237561317
E01012333,1451,691,760,0.47622329427980703,0.523776705720193
E01012309,1858,916,942,0.4930032292787944,0.5069967707212056
E01012310,1960,961,999,0.4903061224489796,0.5096938775510204
E01012311,1567,731,836,0.46649649010848754,0.5335035098915124
E01012312,1351,649,702,0.48038490007401924,0.5196150999259808
E01012313,1402,662,740,0.47218259629101283,0.5278174037089871
E01012314,1364,652,712,0.4780058651026393,0.5219941348973607
E01012362,1376,677,699,0.49200581395348836,0.5079941860465116
E01012363,1334,647,687,0.48500749625187406,0.5149925037481259
E01012364,1485,690,795,0.46464646464646464,0.5353535353535354
E01012365,1255,587,668,0.46772908366533866,0.5322709163346614
E01012353,1612,822,790,0.5099255583126551,0.49007444168734493
E01012354,1608,870,738,0.5410447761194029,0.458955223880597
E01012355,1491,756,735,0.5070422535211268,0.49295774647887325
E01033483,1040,570,470,0.5480769230769231,0.4519230769230769
E01033484,1167,595,572,0.5098543273350471,0.49014567266495285
E01012307,1897,969,928,0.510806536636795,0.48919346336320507
E01012327,1575,697,878,0.44253968253968257,0.5574603174603174
E01012342,1778,829,949,0.46625421822272217,0.5337457817772778
E01012343,2004,984,1020,0.49101796407185627,0.5089820359281437
E01012315,1648,781,867,0.47390776699029125,0.5260922330097088
E01012316,2515,1256,1259,0.49940357852882705,0.500596421471173
E01012360,1742,820,922,0.4707233065442021,0.529276693455798
E01012336,1745,815,930,0.4670487106017192,0.5329512893982808
E01012337,1733,831,902,0.47951529140219273,0.5204847085978073
E01012347,1722,829,893,0.4814169570267131,0.5185830429732868
E01012348,1986,952,1034,0.47935548841893255,0.5206445115810675
E01012361,1909,897,1012,0.46987951807228917,0.5301204819277109
E01012304,1210,588,622,0.4859504132231405,0.5140495867768595
E01012305,1231,624,607,0.5069049553208773,0.4930950446791227
E01012306,1591,764,827,0.48020113136392206,0.5197988686360779
E01012340,2422,1197,1225,0.49421965317919075,0.5057803468208093
E01012341,1759,832,927,0.47299602046617395,0.527003979533826
E01012317,1370,675,695,0.4927007299270073,0.5072992700729927
E01012318,2335,1149,1186,0.49207708779443254,0.5079229122055674
E01012319,2811,1357,1454,0.48274635361081464,0.5172536463891854
E01012356,1600,790,810,0.49375,0.50625
E01012357,1447,742,705,0.5127850725639254,0.48721492743607464
E01012358,1679,835,844,0.4973198332340679,0.5026801667659321
E01012359,1586,707,879,0.4457755359394704,0.5542244640605296
E01012338,1908,918,990,0.4811320754716981,0.5188679245283019
E01012339,1732,843,889,0.4867205542725173,0.5132794457274826
E01012344,1337,649,688,0.48541510845175767,0.5145848915482424
E01012345,1480,718,762,0.4851351351351351,0.5148648648648648
E01012346,1833,911,922,0.496999454446263,0.5030005455537371
E01020613,1392,688,704,0.4942528735632184,0.5057471264367817
E01020614,1429,678,751,0.47445766270118966,0.5255423372988104
E01020622,1657,829,828,0.5003017501508751,0.4996982498491249
E01020623,1503,756,747,0.5029940119760479,0.49700598802395207
E01020606,1509,751,758,0.49768058316766073,0.5023194168323393
E01020615,1778,844,934,0.4746906636670416,0.5253093363329584
E01020616,1688,807,881,0.47808056872037913,0.5219194312796208
E01020617,1812,884,928,0.4878587196467991,0.5121412803532008
E01020596,1679,787,892,0.46873138773079215,0.5312686122692079
E01020597,1495,733,762,0.4903010033444816,0.5096989966555184
E01020598,1770,871,899,0.492090395480226,0.507909604519774
E01020611,1346,635,711,0.47176820208023773,0.5282317979197623
E01020612,1626,798,828,0.4907749077490775,0.5092250922509225
E01020592,1514,684,830,0.45178335535006603,0.5482166446499339
E01020593,1227,594,633,0.4841075794621027,0.5158924205378973
E01020599,1701,845,856,0.496766607877719,0.503233392122281
E01020601,1550,745,805,0.4806451612903226,0.5193548387096775
E01020602,1829,833,996,0.4554401312192455,0.5445598687807545
E01020618,1558,775,783,0.49743260590500643,0.5025673940949936
E01020594,1641,819,822,0.4990859232175503,0.5009140767824497
E01020595,1728,809,919,0.4681712962962963,0.5318287037037037
E01020600,1515,753,762,0.497029702970297,0.502970297029703
E01020603,1843,917,926,0.49755832881172,0.50244167118828
E01020605,1757,847,910,0.4820717131474104,0.5179282868525896
E01020590,1369,657,712,0.4799123447772096,0.5200876552227903
E01020591,1481,676,805,0.45644834571235654,0.5435516542876435
E01020608,1786,836,950,0.46808510638297873,0.5319148936170213
E01020609,1403,667,736,0.47540983606557374,0.5245901639344263
E01020610,1498,728,770,0.48598130841121495,0.514018691588785
E01020604,1420,712,708,0.5014084507042254,0.49859154929577465
E01020607,1614,817,797,0.5061957868649318,0.49380421313506817
E01020619,1540,735,805,0.4772727272727273,0.5227272727272727
E01020620,1603,796,807,0.49656893325015594,0.5034310667498441
E01020621,1856,936,920,0.5043103448275862,0.4956896551724138
E01020634,1563,756,807,0.4836852207293666,0.5163147792706334
E01020635,1379,689,690,0.49963741841914433,0.5003625815808557
E01020636,1698,851,847,0.5011778563015312,0.4988221436984688
E01020654,1746,869,877,0.497709049255441,0.502290950744559
E01020676,1514,753,761,0.49735799207397624,0.5026420079260238
E01020627,1538,766,772,0.4980494148244473,0.5019505851755527
E01020628,1648,820,828,0.4975728155339806,0.5024271844660194
E01020629,1507,716,791,0.4751161247511613,0.5248838752488387
E01020655,2008,988,1020,0.49203187250996017,0.5079681274900398
E01020656,1458,695,763,0.4766803840877915,0.5233196159122085
E01020657,1544,772,772,0.5,0.5
E01020661,1880,911,969,0.4845744680851064,0.5154255319148936
E01020662,1792,903,889,0.50390625,0.49609375
E01020663,1847,921,926,0.49864645370871685,0.5013535462912831
E01020674,1586,771,815,0.48612862547288777,0.5138713745271122
E01020678,1369,663,706,0.48429510591672753,0.5157048940832725
E01020626,1541,750,791,0.48669695003244645,0.5133030499675535
E01020638,1562,769,793,0.49231754161331626,0.5076824583866837
E01020639,1500,724,776,0.4826666666666667,0.5173333333333333
E01020653,1549,736,813,0.4751452550032279,0.5248547449967721
E01020677,1534,741,793,0.4830508474576271,0.5169491525423728
E01020647,2142,1036,1106,0.48366013071895425,0.5163398692810458
E01020648,1879,897,982,0.4773815859499734,0.5226184140500266
E01020649,1547,765,782,0.4945054945054945,0.5054945054945055
E01020673,1626,816,810,0.5018450184501845,0.4981549815498155
E01020675,1700,829,871,0.48764705882352943,0.5123529411764706
E01020624,1562,767,795,0.4910371318822023,0.5089628681177977
E01020625,1609,779,830,0.4841516469857054,0.5158483530142945
E01020670,1559,717,842,0.45991019884541373,0.5400898011545863
E01020671,1346,676,670,0.5022288261515602,0.49777117384843983
E01020672,1671,857,814,0.5128665469778576,0.48713345302214245
E01020632,1818,921,897,0.5066006600660066,0.4933993399339934
E01020640,2354,1212,1142,0.5148683092608326,0.4851316907391674
E01020641,2196,1101,1095,0.5013661202185792,0.49863387978142076
E01020642,1395,666,729,0.4774193548387097,0.5225806451612903
E01020643,2157,1065,1092,0.4937413073713491,0.5062586926286509
E01020667,1537,749,788,0.48731294729993496,0.5126870527000651
E01020650,2183,1058,1125,0.4846541456710948,0.5153458543289052
E01020651,1736,820,916,0.47235023041474655,0.5276497695852534
E01020652,2006,974,1032,0.48554336989032904,0.514456630109671
E01020668,1493,726,767,0.48626925653047554,0.5137307434695244
E01020669,1474,694,780,0.4708276797829037,0.5291723202170964
E01020630,1388,643,745,0.46325648414985593,0.5367435158501441
E01020631,1649,779,870,0.4724075197089145,0.5275924802910855
E01020637,1657,819,838,0.49426674713337354,0.5057332528666264
E01020644,2457,1234,1223,0.5022385022385022,0.49776149776149775
E01020645,1489,720,769,0.48354600402955006,0.5164539959704499
E01020633,1564,774,790,0.4948849104859335,0.5051150895140665
E01020664,1410,692,718,0.4907801418439716,0.5092198581560283
E01020665,1356,647,709,0.4771386430678466,0.5228613569321534
E01020666,1459,726,733,0.4976010966415353,0.5023989033584647
E01020646,1586,782,804,0.4930643127364439,0.5069356872635561
E01020658,1811,822,989,0.45389287686361124,0.5461071231363888
E01020659,1576,768,808,0.4873096446700508,0.5126903553299492
E01020660,1597,782,815,0.48966812773951157,0.5103318722604884
E01020709,2464,1531,933,0.6213474025974026,0.3786525974025974
E01020717,1614,777,837,0.48141263940520446,0.5185873605947955
E01020718,1323,631,692,0.47694633408919124,0.5230536659108088
E01020719,1236,596,640,0.48220064724919093,0.517799352750809
E01020721,1182,601,581,0.5084602368866328,0.49153976311336717
E01020708,1160,560,600,0.4827586206896552,0.5172413793103449
E01020710,1581,782,799,0.4946236559139785,0.5053763440860215
E01020711,1747,806,941,0.4613623354321694,0.5386376645678306
E01020720,1414,629,785,0.4448373408769448,0.5551626591230552
E01020679,1600,792,808,0.495,0.505
E01020680,1635,824,811,0.5039755351681957,0.4960244648318043
E01020681,1467,709,758,0.4832992501704158,0.5167007498295841
E01020714,1551,756,795,0.4874274661508704,0.5125725338491296
E01020716,1709,793,916,0.46401404330017554,0.5359859566998244
E01020725,1534,746,788,0.4863102998696219,0.5136897001303781
E01020726,1229,593,636,0.4825061025223759,0.5174938974776241
E01020727,1087,506,581,0.46550137994480223,0.5344986200551978
E01020729,2118,1017,1101,0.4801699716713881,0.5198300283286119
E01020730,1685,810,875,0.4807121661721068,0.5192878338278932
E01020731,1455,744,711,0.511340206185567,0.488659793814433
E01020682,1884,894,990,0.4745222929936306,0.5254777070063694
E01020683,1653,795,858,0.4809437386569873,0.5190562613430127
E01020690,1290,618,672,0.4790697674418605,0.5209302325581395
E01020691,1332,641,691,0.48123123123123124,0.5187687687687688
E01020692,1390,691,699,0.49712230215827335,0.5028776978417266
E01020693,1332,675,657,0.5067567567567568,0.49324324324324326
E01020722,2008,1001,1007,0.49850597609561753,0.5014940239043825
E01020723,1731,880,851,0.5083766608896592,0.49162333911034084
E01020724,1613,764,849,0.4736515809051457,0.5263484190948543
E01020703,2073,1059,1014,0.5108538350217077,0.48914616497829233
E01033164,2284,1155,1129,0.5056917688266199,0.49430823117338
E01033195,1387,695,692,0.5010814708002884,0.4989185291997116
E01033197,2010,1216,794,0.6049751243781094,0.39502487562189054
E01033221,4494,2229,2265,0.4959946595460614,0.5040053404539386
E01020684,2317,1145,1172,0.4941735002157963,0.5058264997842037
E01020702,2331,1138,1193,0.4882024882024882,0.5117975117975118
E01020704,1898,977,921,0.5147523709167545,0.48524762908324554
E01020712,1610,815,795,0.5062111801242236,0.4937888198757764
E01020713,2028,1043,985,0.5142998027613412,0.48570019723865876
E01020705,1450,713,737,0.4917241379310345,0.5082758620689655
E01020706,1840,901,939,0.48967391304347824,0.5103260869565217
E01020715,2393,1180,1213,0.4931048892603427,0.5068951107396573
E01020685,1657,803,854,0.48461074230537116,0.5153892576946288
E01020686,1572,792,780,0.5038167938931297,0.4961832061068702
E01020687,1427,688,739,0.4821303433777155,0.5178696566222845
E01020688,1530,708,822,0.4627450980392157,0.5372549019607843
E01020689,1477,719,758,0.4867975626269465,0.5132024373730535
E01020694,1451,706,745,0.48656099241902134,0.5134390075809786
E01020696,1276,622,654,0.48746081504702193,0.512539184952978
E01020697,1576,777,799,0.4930203045685279,0.506979695431472
E01020732,1796,845,951,0.4704899777282851,0.529510022271715
E01020695,1782,898,884,0.5039281705948373,0.49607182940516276
E01020698,1600,789,811,0.493125,0.506875
E01020699,1172,594,578,0.5068259385665529,0.4931740614334471
E01020700,1575,777,798,0.49333333333333335,0.5066666666666667
E01020701,1345,646,699,0.48029739776951674,0.5197026022304833
E01020750,1247,617,630,0.49478748997594224,0.5052125100240578
E01020781,1126,534,592,0.47424511545293074,0.5257548845470693
E01020786,1606,829,777,0.5161892901618929,0.4838107098381071
E01020787,1833,881,952,0.48063284233497,0.51936715766503
E01033163,1978,975,1003,0.4929221435793731,0.5070778564206269
E01033202,1166,576,590,0.4939965694682676,0.5060034305317325
E01020740,1414,711,703,0.5028288543140028,0.4971711456859972
E01020741,1245,665,580,0.5341365461847389,0.46586345381526106
E01020742,1681,825,856,0.4907792980368828,0.5092207019631172
E01020782,1196,567,629,0.47408026755852845,0.5259197324414716
E01020783,1347,650,697,0.4825538233110616,0.5174461766889383
E01020784,1462,732,730,0.5006839945280438,0.4993160054719562
E01020743,1418,673,745,0.47461212976022565,0.5253878702397743
E01020747,1298,584,714,0.44992295839753466,0.5500770416024653
E01020748,1285,619,666,0.48171206225680935,0.5182879377431907
E01020749,1388,640,748,0.4610951008645533,0.5389048991354467
E01020773,1389,680,709,0.4895608351331893,0.5104391648668106
E01020775,1712,771,941,0.4503504672897196,0.5496495327102804
E01020776,1855,893,962,0.4814016172506739,0.5185983827493261
E01033161,1549,802,747,0.5177533892834086,0.48224661071659136
E01033198,1470,757,713,0.5149659863945578,0.4850340136054422
E01033205,1497,764,733,0.5103540414161657,0.48964595858383436
E01033206,1535,765,770,0.498371335504886,0.501628664495114
E01020751,1862,931,931,0.5,0.5
E01020752,1199,614,585,0.51209341117598,0.48790658882402
E01020754,1323,667,656,0.5041572184429327,0.4958427815570673
E01020756,1348,676,672,0.5014836795252225,0.49851632047477745
E01020745,1347,621,726,0.4610244988864143,0.5389755011135857
E01020753,1961,923,1038,0.47067822539520654,0.5293217746047935
E01020757,1145,555,590,0.4847161572052402,0.5152838427947598
E01020758,1441,685,756,0.4753643303261624,0.5246356696738376
E01020759,1115,531,584,0.47623318385650226,0.5237668161434977
E01020765,1713,884,829,0.5160537069468768,0.4839462930531232
E01020760,1634,812,822,0.4969400244798042,0.5030599755201959
E01020761,1291,639,652,0.4949651432997676,0.5050348567002324
E01020762,1434,710,724,0.49511854951185497,0.504881450488145
E01020763,1831,921,910,0.503003823047515,0.496996176952485
E01020764,1370,658,712,0.4802919708029197,0.5197080291970803
E01020766,1452,681,771,0.4690082644628099,0.53099173553719
E01020767,1961,948,1013,0.48342682304946455,0.5165731769505354
E01020768,1591,809,782,0.5084852294154619,0.491514770584538
E01020733,1251,585,666,0.4676258992805755,0.5323741007194245
E01020734,1225,554,671,0.45224489795918366,0.5477551020408163
E01020735,1416,685,731,0.4837570621468927,0.5162429378531074
E01020770,1228,577,651,0.46986970684039087,0.5301302931596091
E01020771,1050,516,534,0.49142857142857144,0.5085714285714286
E01020780,1167,565,602,0.48414738646101113,0.5158526135389888
E01020746,1179,575,604,0.48770144189991516,0.5122985581000848
E01020769,1268,630,638,0.4968454258675079,0.5031545741324921
E01020777,1472,698,774,0.4741847826086957,0.5258152173913043
E01020778,1196,606,590,0.5066889632107023,0.49331103678929766
E01020779,1657,823,834,0.4966807483403742,0.5033192516596259
E01020736,1204,590,614,0.4900332225913621,0.5099667774086378
E01020737,1395,652,743,0.46738351254480287,0.5326164874551972
E01020738,1013,495,518,0.4886475814412636,0.5113524185587365
E01020739,1325,638,687,0.48150943396226414,0.5184905660377358
E01020744,1007,512,495,0.5084409136047666,0.4915590863952334
E01020788,1538,770,768,0.5006501950585176,0.49934980494148246
E01020789,1436,706,730,0.49164345403899723,0.5083565459610028
E01020790,1328,664,664,0.5,0.5
E01020791,1299,652,647,0.5019245573518091,0.4980754426481909
E01020792,1484,723,761,0.4871967654986523,0.5128032345013477
E01020772,2001,995,1006,0.49725137431284355,0.5027486256871564
E01020793,1707,833,874,0.4879906268306971,0.5120093731693028
E01020794,1780,877,903,0.4926966292134832,0.5073033707865169
E01020795,1790,835,955,0.4664804469273743,0.5335195530726257
E01020817,1279,646,633,0.5050820953870211,0.4949179046129789
E01020818,1477,734,743,0.4969532836831415,0.5030467163168585
E01020819,1078,528,550,0.4897959183673469,0.5102040816326531
E01020837,1734,857,877,0.4942329873125721,0.505767012687428
E01020843,1613,805,808,0.4990700557966522,0.5009299442033478
E01020809,1435,691,744,0.4815331010452962,0.5184668989547039
E01020810,1310,637,673,0.4862595419847328,0.5137404580152671
E01020811,1278,611,667,0.4780907668231612,0.5219092331768388
E01020812,1523,747,776,0.49047931713722914,0.5095206828627709
E01020827,1824,900,924,0.4934210526315789,0.506578947368421
E01020806,1437,695,742,0.4836464857341684,0.5163535142658316
E01020807,1323,660,663,0.4988662131519274,0.5011337868480725
E01020820,1516,720,796,0.47493403693931396,0.525065963060686
E01020842,2013,956,1057,0.4749130650769995,0.5250869349230005
E01020797,2501,1238,1263,0.4950019992003199,0.5049980007996802
E01020798,1484,684,800,0.4609164420485175,0.5390835579514824
E01020799,1470,717,753,0.48775510204081635,0.5122448979591837
E01020808,1421,712,709,0.5010555946516537,0.4989444053483462
E01020821,1872,926,946,0.4946581196581197,0.5053418803418803
E01020822,1834,922,912,0.5027262813522355,0.49727371864776443
E01020823,1769,872,897,0.49293386093838326,0.5070661390616167
E01020835,1664,812,852,0.4879807692307692,0.5120192307692307
E01020836,1967,967,1000,0.49161159125571935,0.5083884087442806
E01020803,1975,991,984,0.5017721518987341,0.4982278481012658
E01020805,1981,928,1053,0.4684502776375568,0.5315497223624432
E01033203,2805,1389,1416,0.49518716577540106,0.5048128342245989
E01020796,1275,609,666,0.4776470588235294,0.5223529411764706
E01020828,1651,820,831,0.4966686856450636,0.5033313143549364
E01020829,2443,1221,1222,0.49979533360622186,0.5002046663937781
E01020830,1510,721,789,0.4774834437086093,0.5225165562913907
E01020801,1548,756,792,0.4883720930232558,0.5116279069767442
E01020802,2105,1021,1084,0.4850356294536817,0.5149643705463183
E01020838,1730,885,845,0.5115606936416185,0.4884393063583815
E01020839,1637,789,848,0.48197923029932804,0.518020769700672
E01020840,1580,783,797,0.49556962025316453,0.5044303797468355
E01020841,1763,833,930,0.47249007373794666,0.5275099262620533
E01020813,1245,629,616,0.5052208835341365,0.4947791164658635
E01020814,1465,717,748,0.489419795221843,0.510580204778157
E01020815,1218,597,621,0.49014778325123154,0.5098522167487685
E01020848,1142,550,592,0.4816112084063047,0.5183887915936952
E01020850,1926,984,942,0.5109034267912772,0.48909657320872274
E01020851,1421,700,721,0.49261083743842365,0.5073891625615764
E01020816,1529,732,797,0.4787442773054284,0.5212557226945717
E01020844,1584,788,796,0.49747474747474746,0.5025252525252525
E01020847,1568,739,829,0.47130102040816324,0.5286989795918368
E01020849,1286,611,675,0.4751166407465008,0.5248833592534993
E01020825,1569,762,807,0.48565965583174,0.51434034416826
E01020831,1439,642,797,0.4461431549687283,0.5538568450312717
E01020833,1236,608,628,0.4919093851132686,0.5080906148867314
E01020834,1283,587,696,0.45752143413873736,0.5424785658612626
E01020824,1544,706,838,0.4572538860103627,0.5427461139896373
E01020826,1510,729,781,0.4827814569536424,0.5172185430463576
E01020832,1392,669,723,0.48060344827586204,0.5193965517241379
E01020845,1351,632,719,0.46780162842339007,0.5321983715766099
E01020846,1237,611,626,0.4939369442198868,0.5060630557801131
E01020856,1531,767,764,0.5009797517962117,0.4990202482037884
E01020858,1062,532,530,0.5009416195856874,0.4990583804143126
E01020859,1228,573,655,0.46661237785016285,0.5333876221498371
E01020860,1056,522,534,0.4943181818181818,0.5056818181818182
E01020861,1169,555,614,0.47476475620188197,0.525235243798118
E01020862,2391,1164,1227,0.4868255959849435,0.5131744040150564
E01020864,2068,1059,1009,0.5120889748549323,0.4879110251450677
E01020867,2254,1090,1164,0.4835847382431233,0.5164152617568767
E01020857,1522,744,778,0.4888304862023653,0.5111695137976346
E01020863,1390,699,691,0.5028776978417266,0.49712230215827335
E01020865,1328,652,676,0.49096385542168675,0.5090361445783133
E01020866,1001,500,501,0.4995004995004995,0.5004995004995005
E01020852,1676,823,853,0.49105011933174225,0.5089498806682577
E01020853,1528,697,831,0.456151832460733,0.543848167539267
E01020854,2632,1505,1127,0.5718085106382979,0.42819148936170215
E01020855,1204,560,644,0.46511627906976744,0.5348837209302325
E01020889,1481,732,749,0.49426063470627957,0.5057393652937204
E01020890,1777,902,875,0.5075970737197524,0.4924029262802476
E01020891,1612,805,807,0.4993796526054591,0.500620347394541
E01020905,1530,731,799,0.4777777777777778,0.5222222222222223
E01020906,1663,797,866,0.4792543595911004,0.5207456404088996
E01020876,1738,848,890,0.48791714614499426,0.5120828538550057
E01020878,1721,849,872,0.49331783846600813,0.5066821615339918
E01020887,1883,970,913,0.5151354221986192,0.48486457780138076
E01020892,1104,543,561,0.49184782608695654,0.5081521739130435
E01020894,1251,617,634,0.49320543565147884,0.5067945643485212
E01020898,1531,698,833,0.4559111691704768,0.5440888308295232
E01020877,1562,764,798,0.48911651728553135,0.5108834827144686
E01020879,2146,1037,1109,0.4832246039142591,0.516775396085741
E01020893,1695,819,876,0.4831858407079646,0.5168141592920354
E01020899,1292,651,641,0.5038699690402477,0.49613003095975233
E01020903,1164,589,575,0.5060137457044673,0.49398625429553267
E01020904,1755,860,895,0.49002849002849,0.50997150997151
E01020873,1453,701,752,0.48245010323468684,0.5175498967653132
E01020875,1301,647,654,0.4973097617217525,0.5026902382782475
E01020900,1409,705,704,0.5003548616039745,0.49964513839602553
E01020901,1414,697,717,0.4929278642149929,0.5070721357850071
E01020902,1448,703,745,0.48549723756906077,0.5145027624309392
E01020868,1785,855,930,0.4789915966386555,0.5210084033613446
E01020869,1396,689,707,0.49355300859598855,0.5064469914040115
E01020874,1468,752,716,0.5122615803814714,0.4877384196185286
E01020880,1561,781,780,0.5003203074951954,0.4996796925048046
E01020881,1356,645,711,0.4756637168141593,0.5243362831858407
E01020870,1360,652,708,0.47941176470588237,0.5205882352941177
E01020871,1411,663,748,0.46987951807228917,0.5301204819277109
E01020872,1808,825,983,0.4563053097345133,0.5436946902654868
E01020883,1711,825,886,0.48217416715371125,0.5178258328462887
E01020886,1259,595,664,0.4725972994440032,0.5274027005559968
E01020882,1460,744,716,0.5095890410958904,0.4904109589041096
E01020888,1957,974,983,0.4977005620848237,0.5022994379151763
E01020895,1485,705,780,0.47474747474747475,0.5252525252525253
E01020896,1380,663,717,0.48043478260869565,0.5195652173913043
E01020897,2473,1190,1283,0.48119692680954307,0.5188030731904569
E01020884,1417,637,780,0.44954128440366975,0.5504587155963303
E01020885,1143,558,585,0.4881889763779528,0.5118110236220472
E01020907,1608,758,850,0.47139303482587064,0.5286069651741293
E01020908,1404,664,740,0.47293447293447294,0.5270655270655271
E01020909,1685,780,905,0.4629080118694362,0.5370919881305638
E01011954,2171,1019,1152,0.46936895439889453,0.5306310456011055
E01011969,1373,686,687,0.4996358339402768,0.5003641660597232
E01011970,1156,578,578,0.5,0.5
E01011971,1452,698,754,0.4807162534435262,0.5192837465564738
E01033465,1754,852,902,0.48574686431014824,0.5142531356898518
E01033467,1178,528,650,0.44821731748726656,0.5517826825127334
E01011952,1670,766,904,0.45868263473053894,0.5413173652694611
E01011953,1886,924,962,0.4899257688229056,0.5100742311770944
E01011991,1830,918,912,0.5016393442622951,0.49836065573770494
E01011992,1582,791,791,0.5,0.5
E01011993,1775,889,886,0.5008450704225352,0.49915492957746477
E01011994,1573,782,791,0.4971392244119517,0.5028607755880483
E01011955,1366,677,689,0.4956076134699854,0.5043923865300146
E01011957,1317,666,651,0.5056947608200456,0.49430523917995445
E01032540,999,470,529,0.47047047047047047,0.5295295295295295
E01032541,2171,1022,1149,0.4707508060801474,0.5292491939198526
E01033466,1982,938,1044,0.47325933400605447,0.5267406659939455
E01011973,1320,683,637,0.5174242424242425,0.4825757575757576
E01011974,1687,897,790,0.5317131001778305,0.46828689982216953
E01011975,1324,637,687,0.4811178247734139,0.5188821752265861
E01011976,1026,537,489,0.5233918128654971,0.4766081871345029
E01011965,1649,796,853,0.48271679805942996,0.5172832019405701
E01011966,1367,679,688,0.4967081199707388,0.5032918800292612
E01011983,1716,826,890,0.4813519813519814,0.5186480186480187
E01012002,1378,659,719,0.4782293178519594,0.5217706821480407
E01011951,1391,702,689,0.5046728971962616,0.4953271028037383
E01011964,1489,755,734,0.5070517125587642,0.49294828744123576
E01011967,1497,733,764,0.48964595858383436,0.5103540414161657
E01011999,2191,1097,1094,0.5006846188954815,0.4993153811045185
E01012000,1359,706,653,0.5194996320824136,0.48050036791758644
E01011950,1452,730,722,0.5027548209366391,0.4972451790633609
E01011986,1274,608,666,0.4772370486656201,0.5227629513343799
E01011987,1402,662,740,0.47218259629101283,0.5278174037089871
E01012001,1951,927,1024,0.4751409533572527,0.5248590466427473
E01011949,1942,937,1005,0.4824922760041195,0.5175077239958805
E01011980,1701,832,869,0.48912404467960025,0.5108759553203998
E01011981,1666,772,894,0.46338535414165666,0.5366146458583433
E01011984,1250,590,660,0.472,0.528
E01011985,1169,572,597,0.4893071000855432,0.5106928999144568
E01011988,1914,899,1015,0.4696969696969697,0.5303030303030303
E01011989,1877,881,996,0.4693660095897709,0.5306339904102291
E01011990,1724,824,900,0.4779582366589327,0.5220417633410673
E01011995,1429,695,734,0.48635409377186845,0.5136459062281316
E01011996,1518,756,762,0.4980237154150198,0.5019762845849802
E01011997,2041,986,1055,0.48309652131308184,0.5169034786869182
E01011998,1470,705,765,0.47959183673469385,0.5204081632653061
E01011961,1442,694,748,0.4812760055478502,0.5187239944521498
E01011962,1456,668,788,0.45879120879120877,0.5412087912087912
E01011977,1748,844,904,0.482837528604119,0.517162471395881
E01011978,1557,758,799,0.48683365446371224,0.5131663455362877
E01011979,1547,723,824,0.4673561732385262,0.5326438267614738
E01011959,2061,1006,1055,0.4881125667151868,0.5118874332848132
E01011960,1394,688,706,0.4935437589670014,0.5064562410329986
E01011963,1418,706,712,0.4978843441466855,0.5021156558533145
E01011968,2132,1010,1122,0.47373358348968103,0.5262664165103189
E01011982,1300,639,661,0.49153846153846154,0.5084615384615384
E01012003,1541,725,816,0.47047371836469826,0.5295262816353018
E01012005,2023,1003,1020,0.4957983193277311,0.5042016806722689
E01012068,2369,1321,1048,0.5576192486281131,0.44238075137188687
E01012092,2191,1216,975,0.554997717937015,0.4450022820629849
E01012093,1975,1066,909,0.5397468354430379,0.460253164556962
E01012094,2574,1381,1193,0.5365190365190365,0.46348096348096346
E01033468,2537,1416,1121,0.5581395348837209,0.4418604651162791
E01012058,1625,818,807,0.5033846153846154,0.4966153846153846
E01012059,1497,710,787,0.4742818971275885,0.5257181028724115
E01012060,1683,761,922,0.45216874628639336,0.5478312537136066
E01012061,1463,689,774,0.4709501025290499,0.5290498974709501
E01012036,1534,820,714,0.5345501955671447,0.4654498044328553
E01012037,1540,814,726,0.5285714285714286,0.4714285714285714
E01012038,1506,777,729,0.5159362549800797,0.48406374501992033
E01012039,1510,901,609,0.5966887417218543,0.4033112582781457
E01012040,1466,739,727,0.5040927694406548,0.49590723055934516
E01012041,1028,542,486,0.5272373540856031,0.4727626459143969
E01012074,1550,732,818,0.472258064516129,0.5277419354838709
E01012075,1605,694,911,0.432398753894081,0.567601246105919
E01012076,1551,654,897,0.42166344294003866,0.5783365570599613
E01012077,1363,631,732,0.462949376375642,0.5370506236243581
E01012088,1447,663,784,0.4581893572909468,0.5418106427090532
E01012078,1453,724,729,0.49827942188575364,0.5017205781142464
E01012079,1443,700,743,0.4851004851004851,0.5148995148995149
E01012080,1269,626,643,0.4933018124507486,0.5066981875492513
E01012081,1754,872,882,0.49714937286202965,0.5028506271379704
E01012026,1594,791,803,0.49623588456712675,0.5037641154328732
E01012027,1754,833,921,0.4749144811858609,0.5250855188141391
E01033469,1998,982,1016,0.4914914914914915,0.5085085085085085
E01012015,1501,727,774,0.4843437708194537,0.5156562291805463
E01012016,1698,818,880,0.4817432273262662,0.5182567726737338
E01012017,1573,802,771,0.5098537825810553,0.4901462174189447
E01012089,1549,745,804,0.48095545513234345,0.5190445448676565
E01012090,1546,784,762,0.5071151358344114,0.49288486416558863
E01012091,1748,824,924,0.47139588100686497,0.528604118993135
E01012011,1861,854,1007,0.4588930682428802,0.5411069317571199
E01012012,1795,879,916,0.48969359331476325,0.5103064066852367
E01012013,1307,628,679,0.48048967100229534,0.5195103289977047
E01012014,1552,735,817,0.4735824742268041,0.5264175257731959
E01012053,1686,833,853,0.4940688018979834,0.5059311981020166
E01012054,1760,865,895,0.4914772727272727,0.5085227272727273
E01012055,1941,979,962,0.5043791859866048,0.49562081401339514
E01012056,2304,1175,1129,0.5099826388888888,0.4900173611111111
E01012057,2020,985,1035,0.4876237623762376,0.5123762376237624
E01012082,1578,729,849,0.4619771863117871,0.5380228136882129
E01012083,1555,717,838,0.46109324758842446,0.5389067524115756
E01012084,1650,720,930,0.43636363636363634,0.5636363636363636
E01012085,1471,670,801,0.4554724677090415,0.5445275322909585
E01012018,1676,856,820,0.5107398568019093,0.4892601431980907
E01012019,1296,582,714,0.44907407407407407,0.5509259259259259
E01012020,1577,751,826,0.47622067216233355,0.5237793278376665
E01012021,1383,644,739,0.4656543745480839,0.5343456254519161
E01012007,1485,712,773,0.4794612794612795,0.5205387205387205
E01012008,1421,670,751,0.47149894440534834,0.5285010555946517
E01012009,1757,869,888,0.4945930563460444,0.5054069436539556
E01012010,1364,676,688,0.49560117302052786,0.5043988269794721
E01012046,1730,820,910,0.47398843930635837,0.5260115606936416
E01012047,1610,771,839,0.4788819875776398,0.5211180124223602
E01012048,1734,838,896,0.48327566320645904,0.5167243367935409
E01012049,1414,696,718,0.49222065063649223,0.5077793493635078
E01012050,1478,705,773,0.4769959404600812,0.5230040595399188
E01012051,1364,658,706,0.48240469208211145,0.5175953079178885
E01012052,1327,649,678,0.48907309721175585,0.5109269027882442
E01012022,1518,747,771,0.49209486166007904,0.5079051383399209
E01012023,1372,626,746,0.45626822157434405,0.543731778425656
E01012024,1525,731,794,0.479344262295082,0.520655737704918
E01012025,1297,639,658,0.4926754047802621,0.5073245952197378
E01012065,1662,796,866,0.4789410348977136,0.5210589651022864
E01012066,2041,1024,1017,0.5017148456638902,0.49828515433610976
E01012067,1602,765,837,0.47752808988764045,0.5224719101123596
E01012042,1457,706,751,0.48455730954015097,0.515442690459849
E01012043,1452,712,740,0.4903581267217631,0.509641873278237
E01012044,1574,745,829,0.4733163913595934,0.5266836086404066
E01012045,1471,688,783,0.4677090414683889,0.5322909585316111
E01032552,1647,775,872,0.4705525197328476,0.5294474802671524
E01032553,1243,589,654,0.47385358004827033,0.5261464199517297
E01012030,1528,694,834,0.45418848167539266,0.5458115183246073
E01012031,1559,750,809,0.4810776138550353,0.5189223861449648
E01012032,1735,870,865,0.5014409221902018,0.49855907780979825
E01012033,1303,600,703,0.4604758250191865,0.5395241749808135
E01012034,1501,726,775,0.4836775483011326,0.5163224516988674
E01012035,1341,650,691,0.48471290082028334,0.5152870991797166
E01012062,1477,703,774,0.47596479350033855,0.5240352064996615
E01012063,1413,646,767,0.45718329794762913,0.5428167020523709
E01012064,1838,918,920,0.499455930359086,0.500544069640914
E01012071,1472,734,738,0.4986413043478261,0.501358695652174
E01012073,1424,701,723,0.4922752808988764,0.5077247191011236
E01032593,1970,958,1012,0.4862944162436548,0.5137055837563452
E01027356,1719,833,886,0.48458406050029085,0.5154159394997091
E01027357,1350,641,709,0.4748148148148148,0.5251851851851852
E01027366,1525,726,799,0.4760655737704918,0.5239344262295081
E01027367,1960,1035,925,0.5280612244897959,0.4719387755102041
E01027358,2000,930,1070,0.465,0.535
E01027359,2317,1108,1209,0.478204574881312,0.5217954251186879
E01033715,1037,499,538,0.4811957569913211,0.5188042430086789
E01033717,1412,669,743,0.4737960339943343,0.5262039660056658
E01027361,2109,1048,1061,0.4969179706021811,0.5030820293978189
E01027362,1259,611,648,0.4853057982525814,0.5146942017474185
E01027363,1197,568,629,0.47451963241436923,0.5254803675856308
E01027364,2054,1002,1052,0.4878286270691334,0.5121713729308666
E01027370,1837,887,950,0.48285247686445293,0.5171475231355471
E01027371,1834,905,929,0.49345692475463465,0.5065430752453653
E01027372,2118,1018,1100,0.4806421152030217,0.5193578847969783
E01027365,2193,1076,1117,0.4906520747834017,0.5093479252165982
E01027368,1766,863,903,0.48867497168742924,0.5113250283125708
E01027369,1547,762,785,0.49256625727213965,0.5074337427278603
E01027373,2003,1007,996,0.5027458811782326,0.49725411882176734
E01027376,1741,822,919,0.47214244686961515,0.5278575531303848
E01027377,1672,801,871,0.47906698564593303,0.520933014354067
E01027385,1333,611,722,0.45836459114778694,0.5416354088522131
E01027387,1803,839,964,0.4653355518580144,0.5346644481419855
E01027388,1446,688,758,0.47579529737206083,0.5242047026279392
E01027389,1625,799,826,0.4916923076923077,0.5083076923076923
E01027378,1064,519,545,0.48778195488721804,0.5122180451127819
E01027379,1374,664,710,0.48326055312954874,0.5167394468704513
E01027380,1413,715,698,0.5060155697098372,0.49398443029016276
E01027382,1687,817,870,0.4842916419679905,0.5157083580320095
E01027386,1359,649,710,0.4775570272259014,0.5224429727740986
E01027374,2053,1010,1043,0.4919629810034096,0.5080370189965904
E01027375,1773,883,890,0.49802594472645234,0.5019740552735477
E01027381,1848,932,916,0.5043290043290043,0.49567099567099565
E01027383,1346,655,691,0.4866270430906389,0.513372956909361
E01027384,1447,721,726,0.49827228749136143,0.5017277125086386
E01027390,1983,940,1043,0.47402924861321233,0.5259707513867877
E01027392,1703,797,906,0.4679976512037581,0.532002348796242
E01027393,1539,735,804,0.4775828460038986,0.5224171539961013
E01027416,1558,745,813,0.4781771501925546,0.5218228498074454
E01027424,2060,999,1061,0.4849514563106796,0.5150485436893204
E01027414,1469,753,716,0.5125936010891763,0.4874063989108237
E01027415,1665,781,884,0.4690690690690691,0.5309309309309309
E01027431,1707,835,872,0.48916227299355597,0.510837727006444
E01027441,2011,989,1022,0.4917951268025858,0.5082048731974143
E01027442,1579,806,773,0.5104496516782774,0.4895503483217226
E01027391,1503,700,803,0.4657351962741184,0.5342648037258816
E01027422,1845,915,930,0.4959349593495935,0.5040650406504065
E01027423,1515,748,767,0.49372937293729374,0.5062706270627063
E01027429,1849,852,997,0.4607896160086533,0.5392103839913467
E01027430,1629,784,845,0.4812768569674647,0.5187231430325353
E01027425,2288,1104,1184,0.4825174825174825,0.5174825174825175
E01027426,1542,730,812,0.47341115434500647,0.5265888456549935
E01027427,1657,842,815,0.508147254073627,0.49185274592637296
E01027428,1543,757,786,0.49060272197018795,0.509397278029812
E01027437,1817,906,911,0.49862410566868465,0.5013758943313154
E01027438,1488,734,754,0.4932795698924731,0.5067204301075269
E01027439,1954,959,995,0.4907881269191402,0.5092118730808598
E01027440,1418,701,717,0.49435825105782794,0.5056417489421721
E01027400,1360,665,695,0.4889705882352941,0.5110294117647058
E01027401,1500,757,743,0.5046666666666667,0.49533333333333335
E01027402,1334,657,677,0.49250374812593706,0.507496251874063
E01027403,1186,567,619,0.47807757166947723,0.5219224283305227
E01027398,2301,1090,1211,0.4737070838765754,0.5262929161234245
E01027409,1531,722,809,0.4715871979098628,0.5284128020901372
E01027411,1358,600,758,0.4418262150220913,0.5581737849779087
E01027412,1571,757,814,0.4818586887332909,0.5181413112667091
E01027413,1872,908,964,0.48504273504273504,0.5149572649572649
E01027395,1491,704,787,0.4721663313212609,0.5278336686787392
E01027396,1392,655,737,0.47054597701149425,0.5294540229885057
E01027397,1404,649,755,0.46225071225071224,0.5377492877492878
E01027399,1508,737,771,0.4887267904509284,0.5112732095490716
E01027404,1540,759,781,0.4928571428571429,0.5071428571428571
E01027405,1448,688,760,0.47513812154696133,0.5248618784530387
E01027417,1525,711,814,0.4662295081967213,0.5337704918032787
E01027418,1841,894,947,0.485605649103748,0.5143943508962521
E01027419,1557,754,803,0.4842646114322415,0.5157353885677585
E01027420,1412,665,747,0.4709631728045326,0.5290368271954674
E01027421,1470,691,779,0.47006802721088436,0.5299319727891156
E01027394,1153,578,575,0.5013009540329575,0.4986990459670425
E01027406,1284,627,657,0.4883177570093458,0.5116822429906542
E01027407,1277,634,643,0.4964761158966327,0.5035238841033672
E01027408,1289,615,674,0.47711404189294027,0.5228859581070597
E01027410,1614,777,837,0.48141263940520446,0.5185873605947955
E01027432,1549,785,764,0.5067785668173015,0.4932214331826985
E01027433,1678,826,852,0.4922526817640048,0.5077473182359953
E01027434,1400,701,699,0.5007142857142857,0.4992857142857143
E01027435,1431,699,732,0.48846960167714887,0.5115303983228512
E01027436,1559,773,786,0.49583066067992304,0.504169339320077
E01027443,1483,693,790,0.4672960215778827,0.5327039784221174
E01027444,2468,1760,708,0.713128038897893,0.28687196110210694
E01027445,1617,813,804,0.5027829313543599,0.4972170686456401
E01027446,1367,672,695,0.49158741770299924,0.5084125822970007
E01027451,1858,919,939,0.4946178686759957,0.5053821313240043
E01027474,1884,914,970,0.4851380042462845,0.5148619957537155
E01027475,1415,687,728,0.48551236749116605,0.5144876325088339
E01027457,1590,807,783,0.5075471698113208,0.49245283018867925
E01027462,1881,909,972,0.48325358851674644,0.5167464114832536
E01027463,1709,870,839,0.5090696313633704,0.4909303686366296
E01027447,1777,867,910,0.4879009566685425,0.5120990433314575
E01027448,1939,946,993,0.4878803506962352,0.5121196493037649
E01027450,1645,804,841,0.4887537993920973,0.5112462006079027
E01027473,1754,871,883,0.4965792474344356,0.5034207525655644
E01027452,1429,688,741,0.4814555633310007,0.5185444366689993
E01027453,1427,641,786,0.44919411352487737,0.5508058864751226
E01027461,1341,619,722,0.4615958240119314,0.5384041759880686
E01033718,2084,969,1115,0.46497120921305185,0.5350287907869482
E01027455,1520,769,751,0.5059210526315789,0.49407894736842106
E01027456,1341,673,668,0.5018642803877703,0.4981357196122297
E01027458,1603,765,838,0.47723019338739864,0.5227698066126014
E01027460,1682,828,854,0.49227110582639716,0.5077288941736029
E01027464,1353,630,723,0.4656319290465632,0.5343680709534369
E01027465,1493,713,780,0.477561955793704,0.522438044206296
E01027466,1215,552,663,0.454320987654321,0.5456790123456791
E01033714,2455,1191,1264,0.485132382892057,0.5148676171079429
E01027449,1563,773,790,0.4945617402431222,0.5054382597568778
E01027468,1268,636,632,0.501577287066246,0.49842271293375395
E01027469,1464,743,721,0.5075136612021858,0.4924863387978142
E01027471,1673,831,842,0.4967124925283921,0.5032875074716079
E01027472,1740,929,811,0.5339080459770115,0.46609195402298853
E01027479,2312,1144,1168,0.49480968858131485,0.5051903114186851
E01027480,1219,601,618,0.49302707136997537,0.5069729286300246
E01027503,1762,891,871,0.5056753688989785,0.49432463110102154
E01027511,1105,557,548,0.5040723981900452,0.49592760180995477
E01027484,2270,1117,1153,0.4920704845814978,0.5079295154185022
E01027485,1492,728,764,0.4879356568364611,0.5120643431635389
E01027486,1153,578,575,0.5013009540329575,0.4986990459670425
E01027487,1146,552,594,0.4816753926701571,0.518324607329843
E01027512,1041,544,497,0.5225744476464937,0.47742555235350626
E01027483,1388,673,715,0.48487031700288186,0.5151296829971181
E01027496,1222,580,642,0.4746317512274959,0.5253682487725041
E01027508,1086,517,569,0.47605893186003684,0.5239410681399632
E01027513,1924,926,998,0.4812889812889813,0.5187110187110187
E01027476,2311,1119,1192,0.48420597144093463,0.5157940285590653
E01027489,1605,784,821,0.4884735202492212,0.5115264797507788
E01027490,1840,844,996,0.45869565217391306,0.5413043478260869
E01027491,1608,775,833,0.48196517412935325,0.5180348258706468
E01027492,1873,902,971,0.4815803523758676,0.5184196476241324
E01027493,1622,745,877,0.4593094944512947,0.5406905055487053
E01027494,2238,1055,1183,0.47140303842716713,0.5285969615728329
E01027497,2688,1322,1366,0.49181547619047616,0.5081845238095238
E01027498,2653,1278,1375,0.4817188088955899,0.5182811911044101
E01027499,1487,729,758,0.4902488231338265,0.5097511768661735
E01027500,1689,791,898,0.46832445233866193,0.5316755476613381
E01027501,1093,519,574,0.47483989021043,0.52516010978957
E01027502,1243,603,640,0.48511665325824616,0.5148833467417538
E01027481,1647,769,878,0.46690953248330297,0.533090467516697
E01027482,1519,738,781,0.4858459512837393,0.5141540487162607
E01027504,1991,953,1038,0.4786539427423405,0.5213460572576595
E01027506,1148,568,580,0.49477351916376305,0.5052264808362369
E01027507,1386,691,695,0.49855699855699853,0.5014430014430015
E01027509,1361,647,714,0.47538574577516535,0.5246142542248347
E01027477,1223,615,608,0.5028618152085037,0.4971381847914963
E01027478,1077,518,559,0.4809656453110492,0.5190343546889508
E01027488,2184,1076,1108,0.4926739926739927,0.5073260073260073
E01027495,1080,538,542,0.4981481481481482,0.5018518518518519
E01027505,1408,700,708,0.4971590909090909,0.5028409090909091
E01027510,1164,584,580,0.5017182130584192,0.49828178694158076
E01027541,1792,872,920,0.48660714285714285,0.5133928571428571
E01027542,1811,831,980,0.45886250690226393,0.5411374930977361
E01027543,1344,660,684,0.49107142857142855,0.5089285714285714
E01027544,1361,671,690,0.49301983835415136,0.5069801616458487
E01027528,1279,662,617,0.5175918686473807,0.48240813135261923
E01027529,1153,606,547,0.5255854293148309,0.4744145706851691
E01027539,1725,842,883,0.4881159420289855,0.5118840579710144
E01027545,2049,969,1080,0.47291361639824303,0.527086383601757
E01027546,1734,849,885,0.48961937716262977,0.5103806228373703
E01027533,1709,850,859,0.497366881217086,0.502633118782914
E01027540,1899,896,1003,0.4718272775144813,0.5281727224855187
E01027549,1573,801,772,0.5092180546726002,0.4907819453273999
E01033716,2374,1185,1189,0.4991575400168492,0.5008424599831508
E01027524,1469,691,778,0.4703880190605854,0.5296119809394145
E01027525,1708,834,874,0.4882903981264637,0.5117096018735363
E01027526,1271,612,659,0.4815106215578285,0.5184893784421715
E01027527,1317,614,703,0.466211085801063,0.5337889141989369
E01027536,1462,718,744,0.4911080711354309,0.5088919288645691
E01027532,1890,939,951,0.49682539682539684,0.5031746031746032
E01027537,1377,664,713,0.4822076978939724,0.5177923021060276
E01027538,1800,874,926,0.4855555555555556,0.5144444444444445
E01027530,1442,679,763,0.470873786407767,0.529126213592233
E01027531,1700,836,864,0.49176470588235294,0.508235294117647
E01027534,1909,908,1001,0.47564169722367733,0.5243583027763227
E01027535,1434,668,766,0.46582984658298465,0.5341701534170153
E01027553,1643,786,857,0.47839318320146074,0.5216068167985393
E01027554,1336,658,678,0.49251497005988026,0.5074850299401198
E01027515,1433,692,741,0.4829030006978367,0.5170969993021632
E01027517,1923,943,980,0.4903796151846074,0.5096203848153926
E01027518,1469,706,763,0.48059904697072836,0.5194009530292716
E01027519,1452,694,758,0.47796143250688705,0.522038567493113
E01027550,1288,625,663,0.48524844720496896,0.514751552795031
E01027551,1445,724,721,0.501038062283737,0.49896193771626296
E01027552,1265,640,625,0.5059288537549407,0.49407114624505927
E01027514,1597,746,851,0.46712586098935505,0.532874139010645
E01027516,1264,605,659,0.4786392405063291,0.5213607594936709
E01027520,1512,749,763,0.49537037037037035,0.5046296296296297
E01027521,1708,858,850,0.5023419203747073,0.49765807962529274
E01027522,1285,585,700,0.45525291828793774,0.5447470817120622
E01027523,1152,559,593,0.4852430555555556,0.5147569444444444
E01012100,1603,871,732,0.5433562071116657,0.4566437928883344
E01012101,1511,753,758,0.4983454665784249,0.5016545334215751
E01012102,2212,1081,1131,0.4886980108499096,0.5113019891500904
E01012184,1484,754,730,0.5080862533692723,0.4919137466307278
E01012105,1375,682,693,0.496,0.504
E01012142,1694,821,873,0.4846517119244392,0.5153482880755608
E01012143,1278,607,671,0.4749608763693271,0.525039123630673
E01012144,1387,681,706,0.49098774333093004,0.5090122566690699
E01012106,1369,685,684,0.5003652300949598,0.4996347699050402
E01012107,1404,669,735,0.47649572649572647,0.5235042735042735
E01032560,1069,529,540,0.49485500467726845,0.5051449953227315
E01032561,1538,705,833,0.45838751625487645,0.5416124837451235
E01012176,1432,691,741,0.4825418994413408,0.5174581005586593
E01012177,1486,733,753,0.49327052489905787,0.5067294751009421
E01012178,1424,664,760,0.46629213483146065,0.5337078651685393
E01012179,1482,690,792,0.46558704453441296,0.5344129554655871
E01012180,1792,897,895,0.5005580357142857,0.4994419642857143
E01012185,1465,686,779,0.468259385665529,0.531740614334471
E01012186,1642,804,838,0.48964677222898906,0.510353227771011
E01012127,1042,479,563,0.4596928982725528,0.5403071017274472
E01012128,1119,519,600,0.46380697050938335,0.5361930294906166
E01012129,2185,1048,1137,0.4796338672768879,0.5203661327231122
E01012130,1284,611,673,0.47585669781931467,0.5241433021806854
E01012131,1415,656,759,0.4636042402826855,0.5363957597173145
E01012138,2691,1349,1342,0.5013006317354144,0.49869936826458566
E01012139,1942,970,972,0.49948506694129763,0.5005149330587023
E01012140,1329,630,699,0.47404063205417607,0.5259593679458239
E01012141,1099,547,552,0.49772520473157417,0.5022747952684259
E01012154,1271,611,660,0.48072383949645947,0.5192761605035405
E01012155,1472,695,777,0.47214673913043476,0.5278532608695652
E01012156,1738,835,903,0.48043728423475257,0.5195627157652474
E01012157,1634,779,855,0.47674418604651164,0.5232558139534884
E01012158,1412,672,740,0.47592067988668557,0.5240793201133145
E01012159,1611,855,756,0.5307262569832403,0.4692737430167598
E01012160,1434,660,774,0.4602510460251046,0.5397489539748954
E01012161,1501,685,816,0.4563624250499667,0.5436375749500333
E01012113,1429,643,786,0.44996501049685095,0.5500349895031491
E01012114,1396,678,718,0.48567335243553006,0.5143266475644699
E01012175,1426,688,738,0.48246844319775595,0.517531556802244
E01033471,2263,1054,1209,0.4657534246575342,0.5342465753424658
E01012095,1353,675,678,0.49889135254988914,0.5011086474501109
E01012097,1180,587,593,0.49745762711864405,0.502542372881356
E01012098,1302,629,673,0.48310291858678955,0.5168970814132104
E01012099,1559,778,781,0.4990378447722899,0.50096215522771
E01012108,1462,683,779,0.46716826265389877,0.5328317373461012
E01012109,1396,667,729,0.4777936962750716,0.5222063037249284
E01012110,1393,711,682,0.5104091888011486,0.4895908111988514
E01012111,1288,601,687,0.4666149068322981,0.5333850931677019
E01012171,1435,669,766,0.4662020905923345,0.5337979094076655
E01012172,1383,676,707,0.48879248011569054,0.5112075198843095
E01012162,1464,724,740,0.49453551912568305,0.505464480874317
E01012163,2181,1104,1077,0.5061898211829436,0.4938101788170564
E01012164,1594,763,831,0.47867001254705144,0.5213299874529486
E01012165,2215,1031,1184,0.4654627539503386,0.5345372460496614
E01012096,1606,831,775,0.5174346201743462,0.4825653798256538
E01012136,1426,712,714,0.4992987377279102,0.5007012622720898
E01033473,2145,1026,1119,0.4783216783216783,0.5216783216783217
E01012112,1466,741,725,0.5054570259208732,0.4945429740791269
E01012145,1472,710,762,0.48233695652173914,0.5176630434782609
E01012147,1595,785,810,0.49216300940438873,0.5078369905956113
E01012149,1203,597,606,0.49625935162094764,0.5037406483790524
E01012132,2022,1011,1011,0.5,0.5
E01012134,1447,723,724,0.4996544574982723,0.5003455425017277
E01012137,1364,696,668,0.5102639296187683,0.4897360703812317
E01012181,1686,859,827,0.5094899169632265,0.4905100830367734
E01012117,1420,674,746,0.47464788732394364,0.5253521126760563
E01012118,1358,643,715,0.4734904270986745,0.5265095729013255
E01012119,2129,1022,1107,0.480037576326914,0.519962423673086
E01012121,1354,675,679,0.4985228951255539,0.5014771048744461
E01032548,1566,752,814,0.48020434227330777,0.5197956577266922
E01032549,1664,791,873,0.4753605769230769,0.5246394230769231
E01033472,2528,1245,1283,0.4924841772151899,0.5075158227848101
E01012120,1361,646,715,0.47465099191770754,0.5253490080822925
E01012124,1433,722,711,0.5038381018841591,0.4961618981158409
E01012182,1423,694,729,0.4877020379479972,0.5122979620520028
E01012183,1541,754,787,0.4892926670992862,0.5107073329007138
E01012148,1411,709,702,0.5024805102763997,0.49751948972360027
E01012150,1532,693,839,0.45234986945169714,0.5476501305483029
E01012151,1471,692,779,0.47042828008157717,0.5295717199184229
E01012152,1563,780,783,0.4990403071017274,0.5009596928982726
E01032594,1376,645,731,0.46875,0.53125
E01012146,1249,629,620,0.5036028823058447,0.49639711769415534
E01012167,1478,698,780,0.4722598105548038,0.5277401894451962
E01012168,1920,910,1010,0.4739583333333333,0.5260416666666666
E01012170,1377,645,732,0.4684095860566449,0.5315904139433552
E01012173,1163,567,596,0.48753224419604474,0.5124677558039553
E01012174,1110,515,595,0.46396396396396394,0.536036036036036
E01033470,1773,898,875,0.5064861816130851,0.4935138183869148
E01012242,1519,758,761,0.4990125082290981,0.500987491770902
E01012243,1606,746,860,0.46450809464508097,0.5354919053549191
E01012244,1445,700,745,0.4844290657439446,0.5155709342560554
E01012246,1451,736,715,0.50723638869745,0.49276361130255
E01012296,1367,666,701,0.48719824433065106,0.5128017556693489
E01012297,2644,1296,1348,0.49016641452344933,0.5098335854765507
E01012197,2029,943,1086,0.4647609659931001,0.5352390340069
E01012256,1321,646,675,0.48902346707040123,0.5109765329295988
E01012257,1433,699,734,0.48778785764131194,0.5122121423586881
E01012275,1544,737,807,0.47733160621761656,0.5226683937823834
E01012276,1603,744,859,0.4641297567061759,0.535870243293824
E01012277,1665,792,873,0.4756756756756757,0.5243243243243243
E01012196,1670,804,866,0.481437125748503,0.518562874251497
E01012198,1475,720,755,0.488135593220339,0.511864406779661
E01012214,1654,796,858,0.48125755743651755,0.5187424425634825
E01012215,1307,625,682,0.47819433817903595,0.521805661820964
E01012216,1302,625,677,0.48003072196620583,0.5199692780337941
E01012245,1605,756,849,0.47102803738317756,0.5289719626168224
E01012278,1335,674,661,0.5048689138576778,0.4951310861423221
E01012279,1776,867,909,0.48817567567567566,0.5118243243243243
E01012280,1569,773,796,0.4926704907584449,0.5073295092415552
E01012281,1309,627,682,0.4789915966386555,0.5210084033613446
E01012255,1423,696,727,0.48910751932536894,0.5108924806746311
E01012269,1673,822,851,0.4913329348475792,0.5086670651524208
E01012294,1209,594,615,0.4913151364764268,0.5086848635235732
E01012295,1210,588,622,0.4859504132231405,0.5140495867768595
E01033476,1639,806,833,0.4917632702867602,0.5082367297132397
E01033480,1639,804,835,0.4905430140329469,0.5094569859670531
E01012210,1584,783,801,0.4943181818181818,0.5056818181818182
E01012211,1840,891,949,0.4842391304347826,0.5157608695652174
E01012212,1469,737,732,0.5017018379850239,0.4982981620149762
E01012213,1393,616,777,0.44221105527638194,0.5577889447236181
E01012192,1583,787,796,0.49715729627289956,0.5028427037271005
E01012193,1556,781,775,0.5019280205655527,0.4980719794344473
E01012260,1653,806,847,0.48759830611010285,0.5124016938898972
E01012261,1509,774,735,0.5129224652087475,0.4870775347912525
E01012247,1277,599,678,0.46906812842599843,0.5309318715740016
E01012249,1580,767,813,0.4854430379746835,0.5145569620253164
E01012271,1496,704,792,0.47058823529411764,0.5294117647058824
E01012272,1065,524,541,0.492018779342723,0.507981220657277
E01012273,1582,768,814,0.4854614412136536,0.5145385587863464
E01012274,1341,641,700,0.4780014914243102,0.5219985085756897
E01012248,1428,679,749,0.47549019607843135,0.5245098039215687
E01012250,1461,710,751,0.485968514715948,0.5140314852840521
E01032542,1120,530,590,0.4732142857142857,0.5267857142857143
E01032543,2213,1025,1188,0.4631721644826028,0.5368278355173972
E01032544,2033,973,1060,0.47860304968027545,0.5213969503197246
E01012194,1539,762,777,0.4951267056530214,0.5048732943469786
E01012195,1563,741,822,0.4740882917466411,0.525911708253359
E01012258,2054,1425,629,0.6937682570593963,0.3062317429406037
E01012259,1776,876,900,0.49324324324324326,0.5067567567567568
E01012268,1662,858,804,0.516245487364621,0.48375451263537905
E01012187,1390,697,693,0.5014388489208633,0.4985611510791367
E01012188,1205,596,609,0.4946058091286307,0.5053941908713693
E01012189,1398,676,722,0.48354792560801146,0.5164520743919886
E01012205,1402,672,730,0.4793152639087018,0.5206847360912982
E01012219,1775,878,897,0.49464788732394366,0.5053521126760563
E01012251,1665,827,838,0.4966966966966967,0.5033033033033033
E01012252,1550,719,831,0.4638709677419355,0.5361290322580645
E01012253,1310,641,669,0.48931297709923666,0.5106870229007634
E01012254,1439,726,713,0.5045170257123002,0.4954829742876998
E01012204,1303,609,694,0.4673829623944743,0.5326170376055257
E01012206,1460,679,781,0.46506849315068494,0.5349315068493151
E01012207,1932,958,974,0.49585921325051757,0.5041407867494824
E01012208,1648,799,849,0.4848300970873786,0.5151699029126213
E01012262,2224,1133,1091,0.5094424460431655,0.49055755395683454
E01012264,2384,1198,1186,0.50251677852349,0.4974832214765101
E01012266,2435,1180,1255,0.48459958932238195,0.5154004106776181
E01012267,1672,820,852,0.4904306220095694,0.5095693779904307
E01033477,2518,1421,1097,0.5643367752184273,0.43566322478157266
E01012190,1493,730,763,0.48894842598794375,0.5110515740120563
E01012191,1658,731,927,0.4408926417370326,0.5591073582629674
E01012224,1781,848,933,0.47613700168444695,0.523862998315553
E01012225,1531,727,804,0.47485303723056826,0.5251469627694317
E01012226,1381,676,705,0.4895003620564808,0.5104996379435192
E01012209,1709,827,882,0.483908718548859,0.516091281451141
E01012217,1546,781,765,0.5051746442432082,0.4948253557567917
E01012218,1579,765,814,0.4844838505383154,0.5155161494616846
E01012223,1564,753,811,0.48145780051150894,0.518542199488491
E01012286,1443,690,753,0.4781704781704782,0.5218295218295218
E01012287,2332,1180,1152,0.5060034305317325,0.4939965694682676
E01012288,1473,711,762,0.48268839103869654,0.5173116089613035
E01012289,1283,634,649,0.49415432579890883,0.5058456742010912
E01012238,1545,745,800,0.48220064724919093,0.517799352750809
E01012239,1994,1002,992,0.5025075225677031,0.4974924774322969
E01012240,1786,863,923,0.4832026875699888,0.5167973124300111
E01012241,1489,722,767,0.48488918737407655,0.5151108126259234
E01012290,1759,845,914,0.48038658328595796,0.519613416714042
E01012291,1816,893,923,0.4917400881057269,0.5082599118942731
E01012292,2316,1133,1183,0.4892055267702936,0.5107944732297064
E01012282,1299,616,683,0.47421093148575827,0.5257890685142417
E01012283,1328,633,695,0.4766566265060241,0.5233433734939759
E01012284,1553,702,851,0.45202833226014166,0.5479716677398584
E01012285,1325,641,684,0.48377358490566036,0.5162264150943396
E01012199,1446,701,745,0.4847856154910097,0.5152143845089903
E01012200,2005,971,1034,0.48428927680798006,0.5157107231920199
E01012201,1803,876,927,0.4858569051580699,0.5141430948419301
E01012202,1508,709,799,0.47015915119363394,0.5298408488063661
E01012203,1797,898,899,0.4997217584863662,0.5002782415136339
E01012270,1369,658,711,0.4806428049671293,0.5193571950328707
E01012228,1421,716,705,0.5038705137227305,0.49612948627726955
E01012230,1588,802,786,0.5050377833753149,0.49496221662468515
E01012233,1437,708,729,0.49269311064718163,0.5073068893528184
E01012236,1351,684,667,0.5062916358253146,0.49370836417468544
E01012237,1363,693,670,0.5084372707263389,0.491562729273661
E01012227,1559,748,811,0.47979474021808854,0.5202052597819115
E01012231,2022,992,1030,0.49060336300692386,0.5093966369930761
E01012232,1431,713,718,0.49825296995108315,0.5017470300489169
E01012234,1694,827,867,0.4881936245572609,0.5118063754427391
E01033474,1645,789,856,0.4796352583586626,0.5203647416413374
E01033475,1840,925,915,0.5027173913043478,0.49728260869565216
E01033478,1891,957,934,0.506081438392385,0.493918561607615
E01033479,1803,907,896,0.5030504714364947,0.49694952856350527
E01012235,1361,817,544,0.6002939015429831,0.3997060984570169
E01012298,1393,705,688,0.5061019382627423,0.4938980617372577
E01012299,1481,773,708,0.5219446320054018,0.47805536799459825
E01012300,1516,663,853,0.43733509234828494,0.5626649076517151
E01012301,1368,684,684,0.5,0.5
E01012302,1245,610,635,0.4899598393574297,0.5100401606425703
E01012303,1381,682,699,0.49384503982621286,0.5061549601737871
E01008246,1458,712,746,0.4883401920438957,0.5116598079561042
E01008247,1616,757,859,0.46844059405940597,0.531559405940594
E01008248,1752,888,864,0.5068493150684932,0.4931506849315068
E01008249,1554,739,815,0.47554697554697556,0.5244530244530244
E01008250,1473,704,769,0.47793618465716226,0.5220638153428377
E01008195,2065,1000,1065,0.48426150121065376,0.5157384987893463
E01008197,1486,735,751,0.4946164199192463,0.5053835800807537
E01008198,1431,676,755,0.4723969252271139,0.527603074772886
E01008199,1379,635,744,0.4604786076867295,0.5395213923132705
E01008200,1336,649,687,0.48577844311377244,0.5142215568862275
E01008245,1437,697,740,0.4850382741823243,0.5149617258176757
E01008214,1680,769,911,0.4577380952380952,0.5422619047619047
E01008215,1598,829,769,0.518773466833542,0.4812265331664581
E01008243,1525,720,805,0.4721311475409836,0.5278688524590164
E01008244,2064,1018,1046,0.4932170542635659,0.5067829457364341
E01008178,1710,818,892,0.4783625730994152,0.5216374269005848
E01008180,1519,709,810,0.46675444371296904,0.533245556287031
E01008182,1641,805,836,0.49055453991468617,0.5094454600853139
E01008277,1531,747,784,0.4879163945133899,0.51208360548661
E01008280,1855,884,971,0.4765498652291105,0.5234501347708895
E01008177,1468,669,799,0.45572207084468663,0.5442779291553134
E01008179,1224,593,631,0.48447712418300654,0.5155228758169934
E01008181,1477,703,774,0.47596479350033855,0.5240352064996615
E01008276,1459,688,771,0.4715558601782042,0.5284441398217957
E01008279,1471,718,753,0.48810333106730114,0.5118966689326988
E01008209,2088,1028,1060,0.49233716475095785,0.5076628352490421
E01008210,1399,676,723,0.4832022873481058,0.5167977126518942
E01008258,2320,1177,1143,0.5073275862068966,0.49267241379310345
E01008259,1919,1050,869,0.5471599791558103,0.4528400208441897
E01008167,1668,864,804,0.5179856115107914,0.48201438848920863
E01008169,1646,869,777,0.5279465370595383,0.47205346294046174
E01008170,2008,1029,979,0.5124501992031872,0.48754980079681276
E01008171,1479,908,571,0.6139283299526708,0.3860716700473293
E01008257,1442,689,753,0.4778085991678225,0.5221914008321775
E01008262,1783,903,880,0.5064498037016265,0.49355019629837354
E01008263,1532,732,800,0.47780678851174935,0.5221932114882507
E01008264,1419,707,712,0.49823819591261453,0.5017618040873855
E01008265,1479,732,747,0.4949290060851927,0.5050709939148073
E01008266,1366,661,705,0.4838945827232797,0.5161054172767203
E01008251,1756,906,850,0.5159453302961275,0.48405466970387245
E01008252,1765,884,881,0.5008498583569405,0.4991501416430595
E01008253,1713,875,838,0.5107997664915354,0.4892002335084647
E01008254,1352,679,673,0.5022189349112426,0.4977810650887574
E01008255,1741,858,883,0.4928202182653647,0.5071797817346353
E01008165,1399,695,704,0.496783416726233,0.503216583273767
E01008201,1596,756,840,0.47368421052631576,0.5263157894736842
E01008202,1869,885,984,0.47351524879614765,0.5264847512038523
E01008204,1550,749,801,0.4832258064516129,0.516774193548387
E01008212,1381,698,683,0.5054308472121651,0.4945691527878349
E01008213,1483,707,776,0.47673634524612274,0.5232636547538773
E01008216,1556,757,799,0.4865038560411311,0.5134961439588689
E01008228,1193,565,628,0.47359597652975693,0.5264040234702431
E01008206,1748,851,897,0.4868421052631579,0.5131578947368421
E01008207,1457,720,737,0.49416609471516815,0.5058339052848319
E01008208,1650,791,859,0.4793939393939394,0.5206060606060606
E01008211,1710,834,876,0.48771929824561405,0.512280701754386
E01008283,1311,658,653,0.501906941266209,0.498093058733791
E01008284,1471,742,729,0.504418762746431,0.495581237253569
E01008286,1492,709,783,0.47520107238605896,0.524798927613941
E01008287,2071,1019,1052,0.4920328343795268,0.5079671656204732
E01008231,1590,757,833,0.4761006289308176,0.5238993710691824
E01008240,1514,721,793,0.476221928665786,0.5237780713342141
E01008241,1637,766,871,0.46792913866829566,0.5320708613317043
E01008242,1670,791,879,0.47365269461077847,0.5263473053892216
E01008281,1501,699,802,0.46568954030646237,0.5343104596935376
E01008282,1487,719,768,0.4835238735709482,0.5164761264290518
E01008219,1735,830,905,0.4783861671469741,0.521613832853026
E01008235,1466,709,757,0.48362892223738063,0.5163710777626194
E01008236,1513,714,799,0.47191011235955055,0.5280898876404494
E01008237,1554,762,792,0.49034749034749037,0.5096525096525096
E01008238,1555,765,790,0.4919614147909968,0.5080385852090032
E01008267,1538,764,774,0.4967490247074122,0.5032509752925878
E01008269,1489,715,774,0.4801880456682337,0.5198119543317663
E01008270,1330,651,679,0.48947368421052634,0.5105263157894737
E01008271,1410,701,709,0.4971631205673759,0.5028368794326241
E01008275,1505,728,777,0.48372093023255813,0.5162790697674419
E01008229,1380,678,702,0.49130434782608695,0.508695652173913
E01008230,1399,666,733,0.4760543245175125,0.5239456754824875
E01008232,1388,675,713,0.48631123919308356,0.5136887608069164
E01008233,1374,688,686,0.5007278020378457,0.4992721979621543
E01008285,1439,687,752,0.477414871438499,0.5225851285615011
E01008256,1771,845,926,0.4771315640880858,0.5228684359119141
E01008260,1554,761,793,0.4897039897039897,0.5102960102960103
E01008261,1460,688,772,0.4712328767123288,0.5287671232876713
E01008268,1477,713,764,0.4827352742044685,0.5172647257955315
E01008272,1417,669,748,0.4721242060691602,0.5278757939308398
E01008273,1473,735,738,0.4989816700610998,0.5010183299389002
E01008274,1454,679,775,0.46698762035763414,0.5330123796423659
E01008193,1283,588,695,0.4583008573655495,0.5416991426344505
E01008194,1390,680,710,0.4892086330935252,0.5107913669064749
E01008234,2123,1056,1067,0.49740932642487046,0.5025906735751295
E01008239,1524,746,778,0.489501312335958,0.510498687664042
E01008218,1639,802,837,0.48932275777913364,0.5106772422208664
E01008220,1284,635,649,0.4945482866043614,0.5054517133956387
E01008221,1735,835,900,0.4812680115273775,0.5187319884726225
E01008225,1691,832,859,0.4920165582495565,0.5079834417504435
E01008227,1706,795,911,0.46600234466588514,0.5339976553341149
E01008184,1409,679,730,0.48190205819730303,0.518097941802697
E01008185,1411,660,751,0.4677533664068037,0.5322466335931963
E01008188,1458,696,762,0.4773662551440329,0.522633744855967
E01008278,1424,707,717,0.4964887640449438,0.5035112359550562
E01008189,1381,679,702,0.49167270094134685,0.5083272990586531
E01008190,1295,611,684,0.4718146718146718,0.5281853281853282
E01008191,1484,728,756,0.49056603773584906,0.5094339622641509
E01008192,1433,709,724,0.4947662247034194,0.5052337752965806
E01008217,1563,727,836,0.46513115802943056,0.5348688419705694
E01008183,1478,690,788,0.4668470906630582,0.5331529093369418
E01008186,1965,1000,965,0.5089058524173028,0.4910941475826972
E01008187,1674,805,869,0.480884109916368,0.519115890083632
E01008196,1928,924,1004,0.47925311203319504,0.520746887966805
E01008222,1521,715,806,0.4700854700854701,0.5299145299145299
E01008223,1782,835,947,0.4685746352413019,0.5314253647586981
E01008224,1852,899,953,0.48542116630669546,0.5145788336933045
E01008226,1498,734,764,0.48998664886515353,0.5100133511348465
E01008172,1703,814,889,0.47798003523194366,0.5220199647680563
E01008173,1606,769,837,0.4788293897882939,0.5211706102117061
E01008174,2087,989,1098,0.4738859607091519,0.5261140392908481
E01008175,1475,708,767,0.48,0.52
E01008176,1496,765,731,0.5113636363636364,0.48863636363636365
E01008162,2377,1248,1129,0.5250315523769458,0.4749684476230543
E01008164,1313,684,629,0.5209444021325209,0.47905559786747903
E01008166,1559,946,613,0.6067992302758178,0.39320076972418216
E01008168,2238,1093,1145,0.48838248436103665,0.5116175156389634
E01008163,2000,1018,982,0.509,0.491
E01008203,1779,918,861,0.5160202360876898,0.4839797639123103
E01008205,1549,754,795,0.486765655261459,0.513234344738541
E01008294,1517,731,786,0.4818721160184575,0.5181278839815425
E01008306,1636,803,833,0.4908312958435208,0.5091687041564792
E01008307,1029,455,574,0.4421768707482993,0.5578231292517006
E01008308,1395,686,709,0.4917562724014337,0.5082437275985663
E01008311,1677,850,827,0.5068574836016696,0.49314251639833034
E01008312,1264,598,666,0.47310126582278483,0.5268987341772152
E01008313,1217,606,611,0.4979457682826623,0.5020542317173378
E01008309,1829,884,945,0.4833242208857299,0.5166757791142701
E01008352,1484,728,756,0.49056603773584906,0.5094339622641509
E01008357,1637,797,840,0.4868662186927306,0.5131337813072694
E01008358,1477,676,801,0.45768449559918756,0.5423155044008124
E01033550,2056,1027,1029,0.4995136186770428,0.5004863813229572
E01033551,1754,870,884,0.4960091220068415,0.5039908779931584
E01008336,1366,658,708,0.4816983894582723,0.5183016105417276
E01008337,1445,719,726,0.4975778546712803,0.5024221453287198
E01008338,1259,613,646,0.4868943606036537,0.5131056393963463
E01008339,1457,722,735,0.4955387783115992,0.5044612216884008
E01008340,1488,728,760,0.489247311827957,0.510752688172043
E01008341,1423,672,751,0.47224174279690795,0.5277582572030921
E01008342,1388,669,719,0.4819884726224784,0.5180115273775217
E01008293,1447,747,700,0.5162404975812025,0.4837595024187975
E01008456,1498,707,791,0.4719626168224299,0.5280373831775701
E01008457,1565,749,816,0.47859424920127797,0.5214057507987221
E01008458,1661,788,873,0.4744130042143287,0.5255869957856713
E01008459,1982,925,1057,0.4667003027245207,0.5332996972754793
E01008460,1550,738,812,0.4761290322580645,0.5238709677419355
E01008351,1469,701,768,0.4771953710006807,0.5228046289993192
E01008354,1708,852,856,0.49882903981264637,0.5011709601873536
E01008418,2011,1016,995,0.5052212829438091,0.494778717056191
E01008420,1347,663,684,0.4922048997772829,0.5077951002227171
E01008422,1646,810,836,0.49210206561360875,0.5078979343863913
E01008424,1743,896,847,0.5140562248995983,0.4859437751004016
E01008353,1533,712,821,0.4644487932159165,0.5355512067840835
E01008355,1554,733,821,0.4716859716859717,0.5283140283140283
E01008356,1523,852,671,0.5594221930400525,0.44057780695994747
E01008378,1452,691,761,0.4758953168044077,0.5241046831955923
E01008419,1521,741,780,0.48717948717948717,0.5128205128205128
E01008421,1521,729,792,0.47928994082840237,0.5207100591715976
E01008423,1388,679,709,0.489193083573487,0.510806916426513
E01008317,1529,748,781,0.4892086330935252,0.5107913669064749
E01008319,1870,949,921,0.5074866310160427,0.4925133689839572
E01008320,1462,720,742,0.49247606019151846,0.5075239398084815
E01008321,1756,833,923,0.474373576309795,0.525626423690205
E01008322,1530,787,743,0.5143790849673202,0.48562091503267973
E01008323,1670,796,874,0.47664670658682634,0.5233532934131736
E01008295,1588,737,851,0.4641057934508816,0.5358942065491183
E01008374,1580,781,799,0.49430379746835446,0.5056962025316456
E01008375,1514,746,768,0.49273447820343463,0.5072655217965654
E01008376,1197,588,609,0.49122807017543857,0.5087719298245614
E01008377,2215,1088,1127,0.491196388261851,0.508803611738149
E01008379,1527,759,768,0.49705304518664045,0.5029469548133595
E01008380,1702,878,824,0.5158636897767332,0.48413631022326675
E01008296,1409,659,750,0.46770759403832507,0.5322924059616749
E01008297,1397,696,701,0.49821045096635647,0.5017895490336435
E01008298,1507,734,773,0.4870603848706038,0.5129396151293961
E01008299,1342,648,694,0.4828614008941878,0.5171385991058122
E01008314,1495,741,754,0.4956521739130435,0.5043478260869565
E01008315,1556,745,811,0.4787917737789203,0.5212082262210797
E01008316,1609,815,794,0.5065257924176507,0.4934742075823493
E01008318,1405,697,708,0.49608540925266903,0.5039145907473309
E01008363,1595,767,828,0.4808777429467085,0.5191222570532915
E01008365,1679,856,823,0.509827278141751,0.49017272185824895
E01008366,2081,1072,1009,0.5151369533877943,0.4848630466122057
E01008369,1997,1125,872,0.5633450175262894,0.43665498247371054
E01008371,1365,662,703,0.484981684981685,0.515018315018315
E01008372,1935,1063,872,0.5493540051679586,0.4506459948320413
E01008373,2348,1210,1138,0.5153321976149915,0.4846678023850085
E01008400,1317,614,703,0.466211085801063,0.5337889141989369
E01008401,1514,733,781,0.48414795244385733,0.5158520475561427
E01008402,1476,726,750,0.491869918699187,0.508130081300813
E01008403,1457,705,752,0.4838709677419355,0.5161290322580645
E01008404,1647,790,857,0.47965998785670916,0.5203400121432908
E01008405,1417,698,719,0.49258997882851097,0.507410021171489
E01008443,1433,698,735,0.4870900209351012,0.5129099790648988
E01008324,1350,646,704,0.4785185185185185,0.5214814814814814
E01008325,1420,667,753,0.4697183098591549,0.530281690140845
E01008326,1488,702,786,0.4717741935483871,0.5282258064516129
E01008327,1295,635,660,0.49034749034749037,0.5096525096525096
E01008328,1267,610,657,0.48145224940805054,0.5185477505919495
E01008329,1462,704,758,0.48153214774281805,0.518467852257182
E01008330,1385,618,767,0.44620938628158846,0.5537906137184115
E01008300,1672,802,870,0.4796650717703349,0.5203349282296651
E01008450,1480,640,840,0.43243243243243246,0.5675675675675675
E01008451,1788,822,966,0.4597315436241611,0.540268456375839
E01008452,1428,717,711,0.5021008403361344,0.49789915966386555
E01008367,2192,1191,1001,0.5433394160583942,0.45666058394160586
E01008368,1816,965,851,0.5313876651982379,0.4686123348017621
E01008370,1716,870,846,0.506993006993007,0.493006993006993
E01008409,1710,885,825,0.5175438596491229,0.4824561403508772
E01008411,1777,920,857,0.5177265053460889,0.48227349465391106
E01008303,1977,1023,954,0.5174506828528073,0.48254931714719274
E01008359,1607,862,745,0.536403235843186,0.46359676415681395
E01008360,1668,879,789,0.5269784172661871,0.47302158273381295
E01008361,1593,873,720,0.5480225988700564,0.4519774011299435
E01008362,1795,952,843,0.5303621169916435,0.46963788300835657
E01008364,1696,902,794,0.5318396226415094,0.4681603773584906
E01008343,1547,756,791,0.48868778280542985,0.5113122171945701
E01008344,1602,773,829,0.48252184769038703,0.517478152309613
E01008345,1591,745,846,0.46825895663104966,0.5317410433689503
E01008346,1626,779,847,0.479089790897909,0.5209102091020911
E01008347,1430,681,749,0.4762237762237762,0.5237762237762238
E01008348,1177,536,641,0.45539507221750214,0.5446049277824979
E01008349,1565,818,747,0.5226837060702876,0.4773162939297125
E01008350,1301,615,686,0.4727132974634896,0.5272867025365103
E01008430,1354,652,702,0.4815361890694239,0.518463810930576
E01008431,1353,682,671,0.5040650406504065,0.4959349593495935
E01008433,1383,686,697,0.4960231381055676,0.5039768618944324
E01008434,1477,732,745,0.4955991875423155,0.5044008124576845
E01008435,1474,684,790,0.46404341926729986,0.5359565807327001
E01008436,1489,774,715,0.5198119543317663,0.4801880456682337
E01008381,1376,680,696,0.4941860465116279,0.5058139534883721
E01008382,1339,622,717,0.46452576549663926,0.5354742345033607
E01008383,1494,707,787,0.47322623828647925,0.5267737617135207
E01008384,1399,671,728,0.47962830593280914,0.5203716940671909
E01008385,1398,696,702,0.4978540772532189,0.5021459227467812
E01008386,1364,664,700,0.4868035190615836,0.5131964809384164
E01008387,1364,655,709,0.4802052785923754,0.5197947214076246
E01008396,2991,1647,1344,0.5506519558676028,0.4493480441323972
E01008398,1695,986,709,0.5817109144542773,0.4182890855457227
E01008449,1783,1052,731,0.5900168255748738,0.4099831744251262
E01008453,1669,833,836,0.49910125823846613,0.5008987417615338
E01008455,1646,880,766,0.534629404617254,0.46537059538274606
E01033556,2512,1436,1076,0.571656050955414,0.428343949044586
E01008406,1557,831,726,0.5337186897880539,0.4662813102119461
E01008407,2794,1453,1341,0.5200429491768075,0.47995705082319257
E01008410,1720,878,842,0.5104651162790698,0.48953488372093024
E01008412,1657,878,779,0.5298732649366324,0.47012673506336755
E01008413,1473,812,661,0.551255940257977,0.4487440597420231
E01033548,1117,628,489,0.5622202327663384,0.4377797672336616
E01033553,2608,1353,1255,0.5187883435582822,0.4812116564417178
E01008394,1439,694,745,0.48227936066712995,0.51772063933287
E01008395,1522,749,773,0.4921156373193167,0.5078843626806833
E01008397,1794,1016,778,0.5663322185061316,0.4336677814938685
E01008399,1896,927,969,0.4889240506329114,0.5110759493670886
E01008439,1828,935,893,0.5114879649890591,0.4885120350109409
E01033543,1302,826,476,0.6344086021505376,0.3655913978494624
E01033545,1187,743,444,0.6259477674810446,0.37405223251895536
E01033554,1313,775,538,0.5902513328255903,0.4097486671744098
E01008415,1214,581,633,0.4785831960461285,0.5214168039538715
E01008416,1690,828,862,0.48994082840236686,0.5100591715976331
E01033547,2127,1040,1087,0.4889515749882464,0.5110484250117536
E01008301,1776,936,840,0.527027027027027,0.47297297297297297
E01008302,1642,790,852,0.48112058465286234,0.5188794153471377
E01008304,1900,1010,890,0.531578947368421,0.46842105263157896
E01008305,2176,1030,1146,0.4733455882352941,0.5266544117647058
E01008391,1485,706,779,0.4754208754208754,0.5245791245791246
E01008392,1551,784,767,0.5054803352675693,0.4945196647324307
E01008432,1355,673,682,0.4966789667896679,0.5033210332103321
E01008288,1321,655,666,0.4958364875094625,0.5041635124905375
E01008289,1590,714,876,0.4490566037735849,0.5509433962264151
E01008290,1277,633,644,0.49569303054032887,0.5043069694596711
E01008291,2133,1040,1093,0.4875761837787154,0.5124238162212845
E01008292,1342,664,678,0.4947839046199702,0.5052160953800298
E01008388,1801,870,931,0.4830649639089395,0.5169350360910605
E01008389,1739,783,956,0.4502587694077056,0.5497412305922944
E01008426,1654,765,889,0.4625151148730351,0.5374848851269649
E01008429,1420,645,775,0.45422535211267606,0.545774647887324
E01008331,1882,952,930,0.5058448459086079,0.49415515409139216
E01008332,2271,1208,1063,0.531924262439454,0.468075737560546
E01008333,1851,1041,810,0.5623987034035657,0.4376012965964344
E01008334,2040,1064,976,0.5215686274509804,0.47843137254901963
E01008335,2079,1097,982,0.5276575276575276,0.47234247234247234
E01008437,1219,654,565,0.5365053322395406,0.4634946677604594
E01008438,1648,907,741,0.5503640776699029,0.4496359223300971
E01008390,1792,885,907,0.49386160714285715,0.5061383928571429
E01008425,1795,994,801,0.5537604456824513,0.44623955431754875
E01008427,1172,582,590,0.49658703071672355,0.5034129692832765
E01008428,1295,634,661,0.48957528957528956,0.5104247104247104
E01008441,1649,783,866,0.47483323226197693,0.5251667677380231
E01008442,1374,668,706,0.4861717612809316,0.5138282387190685
E01008444,1545,747,798,0.48349514563106794,0.516504854368932
E01008445,1930,924,1006,0.47875647668393784,0.5212435233160622
E01008446,1417,678,739,0.4784756527875794,0.5215243472124206
E01008447,1317,619,698,0.47000759301442674,0.5299924069855733
E01008448,1482,732,750,0.4939271255060729,0.5060728744939271
E01008547,1384,702,682,0.5072254335260116,0.49277456647398843
E01008548,1297,636,661,0.49036237471087124,0.5096376252891287
E01008549,1486,706,780,0.47510094212651416,0.5248990578734859
E01008551,1458,702,756,0.48148148148148145,0.5185185185185185
E01008478,1565,749,816,0.47859424920127797,0.5214057507987221
E01008480,1555,738,817,0.47459807073954985,0.5254019292604502
E01008504,1528,781,747,0.5111256544502618,0.48887434554973824
E01008578,1396,684,712,0.4899713467048711,0.5100286532951289
E01008583,1464,717,747,0.48975409836065575,0.5102459016393442
E01008520,1373,674,699,0.49089584850691914,0.5091041514930809
E01008523,1317,652,665,0.49506454062262717,0.5049354593773728
E01008546,1477,724,753,0.4901828029790115,0.5098171970209885
E01008550,1622,788,834,0.48581997533908755,0.5141800246609125
E01008577,1365,655,710,0.47985347985347987,0.5201465201465202
E01008579,1497,673,824,0.44956579826319304,0.5504342017368069
E01008580,1389,660,729,0.47516198704103674,0.5248380129589633
E01008581,1367,631,736,0.4615947329919532,0.5384052670080468
E01008582,1349,670,679,0.4966641957005189,0.5033358042994811
E01008517,1593,772,821,0.48462021343377276,0.5153797865662273
E01008519,1361,612,749,0.449669360764144,0.550330639235856
E01008521,1486,669,817,0.45020188425302826,0.5497981157469717
E01008522,1597,771,826,0.482780212899186,0.5172197871008141
E01008584,1544,811,733,0.5252590673575129,0.47474093264248707
E01008585,1615,777,838,0.48111455108359136,0.5188854489164086
E01008587,1390,695,695,0.5,0.5
E01008588,1574,782,792,0.49682337992376113,0.5031766200762389
E01008589,1446,709,737,0.4903181189488243,0.5096818810511756
E01008518,1639,789,850,0.48139109212934716,0.5186089078706528
E01008564,1452,712,740,0.4903581267217631,0.509641873278237
E01008565,2026,950,1076,0.46890424481737414,0.5310957551826259
E01008567,1414,662,752,0.4681753889674682,0.5318246110325319
E01008475,1656,813,843,0.49094202898550726,0.5090579710144928
E01008476,1703,820,883,0.48150322959483266,0.5184967704051674
E01008477,1642,760,882,0.4628501827040195,0.5371498172959805
E01008479,1356,644,712,0.4749262536873156,0.5250737463126843
E01008552,1630,784,846,0.48098159509202454,0.5190184049079755
E01008553,1832,865,967,0.4721615720524017,0.5278384279475983
E01008554,1690,822,868,0.4863905325443787,0.5136094674556213
E01008555,1629,774,855,0.47513812154696133,0.5248618784530387
E01008586,1553,748,805,0.4816484224082421,0.5183515775917579
E01008495,1723,842,881,0.4886825304701103,0.5113174695298898
E01008496,1497,739,758,0.49365397461589844,0.5063460253841016
E01008497,1451,701,750,0.48311509303928324,0.5168849069607168
E01008498,1509,711,798,0.4711729622266402,0.5288270377733598
E01008568,1479,708,771,0.4787018255578093,0.5212981744421906
E01008569,1462,676,786,0.46238030095759236,0.5376196990424077
E01008570,1337,643,694,0.4809274495138369,0.5190725504861631
E01032647,1724,860,864,0.4988399071925754,0.5011600928074246
E01032648,1530,721,809,0.47124183006535947,0.5287581699346405
E01008500,1601,785,816,0.49031855090568394,0.509681449094316
E01008505,1668,828,840,0.49640287769784175,0.5035971223021583
E01008506,1390,653,737,0.4697841726618705,0.5302158273381294
E01008507,1502,741,761,0.4933422103861518,0.5066577896138482
E01008493,1503,722,781,0.4803725881570193,0.5196274118429807
E01008494,1519,698,821,0.45951283739302173,0.5404871626069783
E01008556,1984,934,1050,0.47076612903225806,0.5292338709677419
E01008557,1630,804,826,0.49325153374233127,0.5067484662576687
E01008470,1409,655,754,0.46486870120652946,0.5351312987934705
E01008499,1683,809,874,0.48068924539512775,0.5193107546048723
E01008502,1630,776,854,0.47607361963190187,0.5239263803680981
E01008516,1317,633,684,0.4806378132118451,0.5193621867881549
E01008488,1423,682,741,0.4792691496837667,0.5207308503162333
E01008489,1728,770,958,0.44560185185185186,0.5543981481481481
E01008490,1552,760,792,0.4896907216494845,0.5103092783505154
E01008491,1578,752,826,0.47655259822560203,0.523447401774398
E01008558,1527,712,815,0.46627373935821875,0.5337262606417813
E01008560,1700,832,868,0.4894117647058824,0.5105882352941177
E01008561,1582,773,809,0.488621997471555,0.511378002528445
E01008562,1495,712,783,0.4762541806020067,0.5237458193979934
E01008525,1558,747,811,0.47946084724005134,0.5205391527599487
E01008527,1495,731,764,0.4889632107023411,0.5110367892976588
E01008559,1524,707,817,0.46391076115485563,0.5360892388451444
E01008563,1448,715,733,0.4937845303867403,0.5062154696132597
E01008469,1473,734,739,0.4983027834351663,0.5016972165648337
E01008472,1494,711,783,0.4759036144578313,0.5240963855421686
E01008473,1289,629,660,0.48797517455391776,0.5120248254460822
E01008501,2091,1025,1066,0.49019607843137253,0.5098039215686274
E01008503,1638,779,859,0.47557997557997556,0.5244200244200244
E01008471,1629,769,860,0.47206875383670965,0.5279312461632903
E01008474,1454,707,747,0.4862448418156809,0.5137551581843192
E01008513,2235,1059,1176,0.4738255033557047,0.5261744966442953
E01008514,1807,841,966,0.4654122855561704,0.5345877144438296
E01032649,1095,532,563,0.4858447488584475,0.5141552511415525
E01032650,1038,511,527,0.49229287090558765,0.5077071290944123
E01008486,1420,678,742,0.47746478873239434,0.5225352112676056
E01008487,1429,695,734,0.48635409377186845,0.5136459062281316
E01008526,1464,685,779,0.46789617486338797,0.532103825136612
E01008530,1605,742,863,0.46230529595015574,0.5376947040498442
E01008461,1428,639,789,0.4474789915966387,0.5525210084033614
E01008466,1326,647,679,0.4879336349924585,0.5120663650075414
E01008467,1409,675,734,0.47906316536550747,0.5209368346344926
E01008468,1436,661,775,0.46030640668523676,0.5396935933147632
E01008483,1561,789,772,0.5054452274183215,0.4945547725816784
E01008524,1681,848,833,0.5044616299821535,0.4955383700178465
E01008528,1427,707,720,0.4954449894884373,0.5045550105115627
E01008529,1625,781,844,0.4806153846153846,0.5193846153846153
E01008481,1480,667,813,0.4506756756756757,0.5493243243243243
E01008482,1679,774,905,0.46098868374032165,0.5390113162596784
E01008484,1342,650,692,0.4843517138599106,0.5156482861400894
E01008485,1550,735,815,0.47419354838709676,0.5258064516129032
E01008492,1724,836,888,0.48491879350348027,0.5150812064965197
E01008462,1253,604,649,0.48204309656823624,0.5179569034317638
E01008463,1334,641,693,0.48050974512743627,0.5194902548725637
E01008464,1383,647,736,0.467823571945047,0.532176428054953
E01008465,1427,687,740,0.48142957252978275,0.5185704274702172
E01008531,1439,720,719,0.5003474635163307,0.4996525364836692
E01008532,1526,734,792,0.48099606815203144,0.5190039318479686
E01008534,1372,685,687,0.49927113702623904,0.500728862973761
E01008538,1251,625,626,0.49960031974420466,0.5003996802557954
E01008508,1567,768,799,0.4901084875558392,0.5098915124441609
E01008509,1627,794,833,0.4880147510755993,0.5119852489244008
E01008510,1561,759,802,0.48622677770659833,0.5137732222934016
E01008512,1552,731,821,0.47100515463917525,0.5289948453608248
E01008539,1428,711,717,0.49789915966386555,0.5021008403361344
E01008540,1637,779,858,0.4758704948075748,0.5241295051924252
E01008541,1579,797,782,0.5047498416719443,0.49525015832805575
E01008544,1625,899,726,0.5532307692307692,0.44676923076923075
E01008545,1290,669,621,0.5186046511627908,0.4813953488372093
E01008511,1684,805,879,0.47802850356294535,0.5219714964370546
E01008542,1579,735,844,0.4654844838505383,0.5345155161494617
E01008543,2222,1080,1142,0.48604860486048607,0.5139513951395139
E01008571,1796,861,935,0.47939866369710465,0.5206013363028953
E01008572,1651,890,761,0.5390672319806178,0.4609327680193822
E01008573,1604,814,790,0.5074812967581047,0.4925187032418953
E01008574,1593,762,831,0.4783427495291902,0.5216572504708098
E01008576,2079,1001,1078,0.48148148148148145,0.5185185185185185
E01008533,1489,675,814,0.45332437877770315,0.5466756212222968
E01008535,1473,676,797,0.4589273591310251,0.5410726408689749
E01008536,1433,734,699,0.5122121423586881,0.48778785764131194
E01008537,1310,652,658,0.49770992366412214,0.5022900763358779
E01008575,1333,627,706,0.4703675918979745,0.5296324081020255
E01008595,1562,758,804,0.4852752880921895,0.5147247119078106
E01008596,1485,711,774,0.47878787878787876,0.5212121212121212
E01008597,2354,1212,1142,0.5148683092608326,0.4851316907391674
E01008598,1572,814,758,0.5178117048346056,0.4821882951653944
E01008599,1473,688,785,0.46707399864222676,0.5329260013577732
E01008664,1481,798,683,0.5388251181634031,0.4611748818365969
E01008665,1434,742,692,0.5174337517433751,0.4825662482566248
E01008666,1394,718,676,0.5150645624103299,0.48493543758967
E01008667,1572,802,770,0.510178117048346,0.48982188295165396
E01008668,1515,768,747,0.5069306930693069,0.49306930693069306
E01008673,1199,586,613,0.48874061718098416,0.5112593828190158
E01008675,1423,712,711,0.500351370344343,0.49964862965565704
E01008676,1242,605,637,0.48711755233494364,0.5128824476650563
E01008677,1422,761,661,0.5351617440225035,0.4648382559774965
E01008678,1266,642,624,0.5071090047393365,0.4928909952606635
E01008647,1460,701,759,0.48013698630136986,0.5198630136986301
E01008648,1383,673,710,0.4866232827187274,0.5133767172812725
E01008649,1645,749,896,0.4553191489361702,0.5446808510638298
E01008651,1917,873,1044,0.45539906103286387,0.5446009389671361
E01008679,1303,617,686,0.47352264006139677,0.5264773599386032
E01008680,1425,694,731,0.4870175438596491,0.5129824561403509
E01008682,1242,580,662,0.4669887278582931,0.533011272141707
E01008683,1442,725,717,0.5027739251040222,0.4972260748959778
E01008635,1370,627,743,0.4576642335766423,0.5423357664233577
E01008650,1419,688,731,0.48484848484848486,0.5151515151515151
E01008674,1266,614,652,0.4849921011058452,0.5150078988941548
E01008681,1402,659,743,0.47004279600570614,0.5299572039942939
E01008600,1318,650,668,0.4931714719271624,0.5068285280728376
E01008604,1630,795,835,0.48773006134969327,0.5122699386503068
E01008660,1414,721,693,0.5099009900990099,0.4900990099009901
E01008661,1133,558,575,0.49249779346866723,0.5075022065313327
E01008633,1423,680,743,0.47786366830639493,0.5221363316936051
E01008634,1318,605,713,0.4590288315629742,0.5409711684370258
E01008636,1442,695,747,0.48196948682385576,0.5180305131761442
E01008637,1454,723,731,0.4972489683631362,0.5027510316368639
E01008639,1944,931,1013,0.47890946502057613,0.5210905349794238
E01008652,1103,558,545,0.5058930190389845,0.4941069809610154
E01008653,1273,578,695,0.4540455616653574,0.5459544383346425
E01008654,1234,634,600,0.513776337115073,0.4862236628849271
E01008655,1470,730,740,0.4965986394557823,0.5034013605442177
E01008657,1363,651,712,0.4776228906823184,0.5223771093176816
E01008638,1405,701,704,0.498932384341637,0.501067615658363
E01008640,1976,955,1021,0.4832995951417004,0.5167004048582996
E01008641,1511,758,753,0.5016545334215751,0.4983454665784249
E01008642,1438,681,757,0.47357440890125174,0.5264255910987483
E01008590,1501,736,765,0.49033977348434377,0.5096602265156562
E01008591,1411,702,709,0.49751948972360027,0.5024805102763997
E01008592,1457,721,736,0.4948524365133837,0.5051475634866164
E01008594,1783,848,935,0.47560291643297814,0.5243970835670219
E01008601,1537,696,841,0.4528301886792453,0.5471698113207547
E01008669,1377,661,716,0.48002904865649965,0.5199709513435004
E01008671,1219,645,574,0.5291222313371616,0.47087776866283837
E01008672,1316,661,655,0.5022796352583586,0.49772036474164133
E01008622,1605,762,843,0.4747663551401869,0.525233644859813
E01008625,1470,695,775,0.47278911564625853,0.5272108843537415
E01033074,2119,973,1146,0.4591788579518641,0.5408211420481359
E01008602,1466,708,758,0.4829467939972715,0.5170532060027285
E01008603,1294,670,624,0.517774343122102,0.482225656877898
E01008608,1141,507,634,0.44434706397896584,0.5556529360210342
E01008670,1518,692,826,0.45586297760210803,0.544137022397892
E01008643,1430,684,746,0.4783216783216783,0.5216783216783217
E01008644,1503,739,764,0.4916833000665336,0.5083166999334664
E01008645,1454,696,758,0.4786795048143054,0.5213204951856947
E01008646,1406,652,754,0.46372688477951635,0.5362731152204836
E01008656,1420,661,759,0.46549295774647886,0.5345070422535211
E01008658,1443,674,769,0.4670824670824671,0.532917532917533
E01008593,1262,578,684,0.45800316957210774,0.5419968304278923
E01008605,1163,548,615,0.471195184866724,0.528804815133276
E01008606,1413,685,728,0.4847841472045294,0.5152158527954707
E01008607,1380,618,762,0.44782608695652176,0.5521739130434783
E01008609,1461,669,792,0.45790554414784396,0.5420944558521561
E01008631,1472,698,774,0.4741847826086957,0.5258152173913043
E01008632,1236,573,663,0.46359223300970875,0.5364077669902912
E01008659,1483,720,763,0.4855023600809171,0.5144976399190829
E01008662,1247,597,650,0.4787489975942261,0.5212510024057738
E01008663,1399,661,738,0.47248034310221587,0.5275196568977841
E01008624,1417,673,744,0.47494707127734653,0.5250529287226535
E01008684,1215,574,641,0.47242798353909465,0.5275720164609053
E01008685,1858,896,962,0.4822389666307858,0.5177610333692142
E01008686,1705,803,902,0.47096774193548385,0.5290322580645161
E01008687,1707,807,900,0.4727592267135325,0.5272407732864675
E01008688,1417,647,770,0.4565984474241355,0.5434015525758645
E01008689,1539,739,800,0.4801819363222872,0.5198180636777128
E01008690,1430,704,726,0.49230769230769234,0.5076923076923077
E01008691,1262,636,626,0.5039619651347068,0.4960380348652932
E01008692,1367,659,708,0.4820775420629115,0.5179224579370885
E01008627,1316,645,671,0.49012158054711247,0.5098784194528876
E01008628,1445,674,771,0.46643598615916954,0.5335640138408304
E01008629,1417,695,722,0.49047282992237123,0.5095271700776288
E01008630,1445,672,773,0.46505190311418687,0.5349480968858131
E01008610,1407,667,740,0.47405828002842926,0.5259417199715707
E01008611,1475,731,744,0.49559322033898306,0.504406779661017
E01008612,1468,721,747,0.49114441416893734,0.5088555858310627
E01008613,1549,782,767,0.5048418334409296,0.49515816655907036
E01008616,1570,750,820,0.47770700636942676,0.5222929936305732
E01008618,1274,613,661,0.4811616954474097,0.5188383045525903
E01008619,1566,726,840,0.46360153256704983,0.5363984674329502
E01008621,1419,678,741,0.47780126849894294,0.5221987315010571
E01008614,1636,779,857,0.47616136919315405,0.523838630806846
E01008615,1389,628,761,0.4521238300935925,0.5478761699064075
E01008617,1482,741,741,0.5,0.5
E01008620,1449,669,780,0.4616977225672878,0.5383022774327122
E01008713,1604,814,790,0.5074812967581047,0.4925187032418953
E01008722,1479,694,785,0.46923597025016905,0.530764029749831
E01008724,1206,565,641,0.4684908789386401,0.5315091210613598
E01008726,1499,716,783,0.47765176784523017,0.5223482321547699
E01008723,1406,678,728,0.4822190611664296,0.5177809388335705
E01008725,1407,677,730,0.48116560056858565,0.5188343994314144
E01008727,1539,720,819,0.4678362573099415,0.5321637426900585
E01008728,1453,696,757,0.47900894700619406,0.5209910529938059
E01008792,1328,632,696,0.4759036144578313,0.5240963855421686
E01008698,1466,693,773,0.47271487039563437,0.5272851296043656
E01008837,1292,590,702,0.456656346749226,0.5433436532507739
E01008838,1590,743,847,0.46729559748427674,0.5327044025157233
E01008839,1368,639,729,0.46710526315789475,0.5328947368421053
E01008840,1462,707,755,0.4835841313269494,0.5164158686730507
E01008841,1205,562,643,0.46639004149377594,0.5336099585062241
E01008712,1650,789,861,0.4781818181818182,0.5218181818181818
E01008817,1158,522,636,0.45077720207253885,0.5492227979274611
E01008819,1408,661,747,0.4694602272727273,0.5305397727272727
E01008821,1392,621,771,0.44612068965517243,0.5538793103448276
E01008822,1621,770,851,0.47501542257865514,0.5249845774213449
E01008842,1445,710,735,0.4913494809688581,0.5086505190311419
E01008708,1480,715,765,0.4831081081081081,0.5168918918918919
E01008709,1412,671,741,0.4752124645892351,0.5247875354107648
E01008711,1463,703,760,0.4805194805194805,0.5194805194805194
E01008820,1153,572,581,0.49609713790112747,0.5039028620988725
E01033075,2077,1011,1066,0.4867597496389023,0.5132402503610978
E01008786,1431,683,748,0.4772886093640811,0.522711390635919
E01008787,1632,833,799,0.5104166666666666,0.4895833333333333
E01008788,1510,737,773,0.4880794701986755,0.5119205298013245
E01008789,1396,710,686,0.5085959885386819,0.49140401146131807
E01008790,1522,768,754,0.5045992115637319,0.49540078843626806
E01008791,1786,949,837,0.5313549832026876,0.4686450167973124
E01008855,1486,764,722,0.5141318977119784,0.4858681022880215
E01008856,1385,675,710,0.48736462093862815,0.5126353790613718
E01008876,1523,763,760,0.5009848982271832,0.4990151017728168
E01008877,1457,706,751,0.48455730954015097,0.515442690459849
E01008693,1260,620,640,0.49206349206349204,0.5079365079365079
E01008694,1430,673,757,0.4706293706293706,0.5293706293706294
E01008695,1534,741,793,0.4830508474576271,0.5169491525423728
E01008696,1312,672,640,0.5121951219512195,0.4878048780487805
E01008697,1312,601,711,0.4580792682926829,0.541920731707317
E01008699,1412,664,748,0.4702549575070821,0.5297450424929179
E01008853,1371,641,730,0.4675419401896426,0.5324580598103574
E01008854,1521,783,738,0.514792899408284,0.48520710059171596
E01008857,1390,657,733,0.47266187050359715,0.5273381294964029
E01008858,1368,594,774,0.4342105263157895,0.5657894736842105
E01008859,1382,645,737,0.4667149059334298,0.5332850940665702
E01008860,1394,672,722,0.48206599713055953,0.5179340028694405
E01008878,1578,745,833,0.4721166032953105,0.5278833967046895
E01008873,1299,636,663,0.4896073903002309,0.5103926096997691
E01008874,1803,854,949,0.473655019412091,0.526344980587909
E01008875,1571,767,804,0.48822406110757477,0.5117759388924252
E01008879,1443,707,736,0.48995148995148996,0.51004851004851
E01008880,1159,570,589,0.4918032786885246,0.5081967213114754
E01008701,1829,898,931,0.490978676872608,0.509021323127392
E01008704,1531,749,782,0.4892227302416721,0.5107772697583279
E01008706,1648,837,811,0.5078883495145631,0.49211165048543687
E01008707,1615,797,818,0.4934984520123839,0.5065015479876162
E01008756,1513,710,803,0.46926635822868473,0.5307336417713153
E01008762,1518,686,832,0.4519104084321476,0.5480895915678524
E01008812,1723,770,953,0.4468949506674405,0.5531050493325594
E01033076,1548,750,798,0.4844961240310077,0.5155038759689923
E01008700,1257,616,641,0.4900556881463803,0.5099443118536198
E01008703,2180,1234,946,0.5660550458715596,0.43394495412844036
E01008705,1129,570,559,0.5048715677590788,0.4951284322409212
E01008831,2242,1292,950,0.576271186440678,0.423728813559322
E01008834,1836,1023,813,0.5571895424836601,0.44281045751633985
E01008810,1652,823,829,0.49818401937046003,0.5018159806295399
E01008811,1651,809,842,0.4900060569351908,0.5099939430648092
E01008813,1601,768,833,0.4797001873828857,0.5202998126171143
E01008814,1553,754,799,0.4855119124275596,0.5144880875724405
E01008757,1478,710,768,0.4803788903924222,0.5196211096075778
E01008758,1445,690,755,0.47750865051903113,0.5224913494809689
E01008759,1491,752,739,0.5043594902749833,0.4956405097250168
E01008761,1444,674,770,0.4667590027700831,0.5332409972299169
E01008702,1107,526,581,0.4751580849141825,0.5248419150858176
E01008735,2007,1023,984,0.5097159940209267,0.49028400597907323
E01008736,1232,613,619,0.49756493506493504,0.502435064935065
E01008737,1388,710,678,0.5115273775216138,0.4884726224783862
E01008738,1316,678,638,0.5151975683890577,0.4848024316109423
E01008836,1515,851,664,0.5617161716171617,0.4382838283828383
E01008845,1423,733,690,0.5151089248067463,0.4848910751932537
E01008846,1183,526,657,0.4446322907861369,0.555367709213863
E01008847,1376,667,709,0.48473837209302323,0.5152616279069767
E01008850,1723,845,878,0.4904236796285548,0.5095763203714452
E01008851,1592,755,837,0.4742462311557789,0.5257537688442211
E01008760,1495,731,764,0.4889632107023411,0.5110367892976588
E01008830,1523,797,726,0.5233092580433355,0.4766907419566645
E01008832,1570,743,827,0.4732484076433121,0.5267515923566879
E01008833,1470,725,745,0.4931972789115646,0.5068027210884354
E01008843,1282,648,634,0.5054602184087363,0.49453978159126366
E01008844,1432,686,746,0.4790502793296089,0.520949720670391
E01008848,1343,659,684,0.49069247952345496,0.509307520476545
E01008849,1257,577,680,0.4590294351630867,0.5409705648369133
E01008852,1245,620,625,0.4979919678714859,0.5020080321285141
E01008867,1662,873,789,0.5252707581227437,0.4747292418772563
E01008868,1219,608,611,0.49876948318293685,0.5012305168170632
E01008869,1315,637,678,0.4844106463878327,0.5155893536121673
E01008870,1443,735,708,0.5093555093555093,0.49064449064449067
E01008871,1466,689,777,0.46998635743519784,0.5300136425648022
E01008872,1477,722,755,0.4888287068381855,0.5111712931618145
E01008729,1072,489,583,0.45615671641791045,0.5438432835820896
E01008730,1661,771,890,0.4641782059000602,0.5358217940999398
E01008731,1277,610,667,0.47768206734534063,0.5223179326546593
E01008732,2119,994,1125,0.4690891930155734,0.5309108069844266
E01008733,1641,792,849,0.4826325411334552,0.5173674588665448
E01008734,1414,696,718,0.49222065063649223,0.5077793493635078
E01008740,1454,715,739,0.49174690508940855,0.5082530949105915
E01008781,1554,769,785,0.4948519948519948,0.5051480051480052
E01008782,1459,709,750,0.4859492803289925,0.5140507196710076
E01008783,1410,693,717,0.49148936170212765,0.5085106382978724
E01008784,1584,781,803,0.4930555555555556,0.5069444444444444
E01008785,1439,686,753,0.47671994440583737,0.5232800555941626
E01008835,1568,810,758,0.5165816326530612,0.48341836734693877
E01008823,1407,678,729,0.48187633262260127,0.5181236673773987
E01008824,1507,720,787,0.47777040477770405,0.522229595222296
E01008825,1533,755,778,0.49249836921069795,0.507501630789302
E01008826,1446,673,773,0.4654218533886584,0.5345781466113416
E01008827,1245,587,658,0.4714859437751004,0.5285140562248996
E01008828,1585,732,853,0.4618296529968454,0.5381703470031546
E01008829,1370,668,702,0.48759124087591244,0.5124087591240876
E01008739,1585,756,829,0.4769716088328076,0.5230283911671925
E01008741,1451,720,731,0.4962095106822881,0.503790489317712
E01008779,1446,675,771,0.46680497925311204,0.533195020746888
E01008780,1925,959,966,0.49818181818181817,0.5018181818181818
E01008799,1665,819,846,0.4918918918918919,0.5081081081081081
E01008861,1523,746,777,0.489822718319107,0.5101772816808929
E01008862,1441,717,724,0.49757113115891743,0.5024288688410826
E01008863,1621,801,820,0.49413942011104256,0.5058605798889574
E01008864,1289,642,647,0.49806051202482543,0.5019394879751745
E01008865,1379,664,715,0.4815083393763597,0.5184916606236403
E01008866,1410,664,746,0.47092198581560285,0.5290780141843971
E01008773,1402,653,749,0.4657631954350927,0.5342368045649073
E01008776,1243,554,689,0.4456958970233307,0.5543041029766693
E01008777,1348,619,729,0.45919881305637983,0.5408011869436202
E01008778,1379,629,750,0.45612762871646123,0.5438723712835388
E01008809,1541,721,820,0.46787800129785856,0.5321219987021415
E01008803,1433,681,752,0.47522679692951847,0.5247732030704815
E01008804,1633,778,855,0.4764237599510104,0.5235762400489896
E01008805,1426,690,736,0.4838709677419355,0.5161290322580645
E01033077,1798,865,933,0.4810901001112347,0.5189098998887653
E01008763,1505,709,796,0.47109634551495017,0.5289036544850498
E01008764,1496,720,776,0.48128342245989303,0.5187165775401069
E01008766,2280,1104,1176,0.4842105263157895,0.5157894736842106
E01008768,1437,706,731,0.4913013221990257,0.5086986778009742
E01008769,1717,796,921,0.46359930110658126,0.5364006988934188
E01008772,1366,672,694,0.49194729136163984,0.5080527086383602
E01008774,1304,621,683,0.4762269938650307,0.5237730061349694
E01008775,1407,690,717,0.4904051172707889,0.509594882729211
E01008802,1422,679,743,0.47749648382559773,0.5225035161744023
E01008808,1442,717,725,0.4972260748959778,0.5027739251040222
E01008793,1701,791,910,0.46502057613168724,0.5349794238683128
E01008795,1797,892,905,0.49638286032276013,0.5036171396772399
E01008797,1997,986,1011,0.49374061091637456,0.5062593890836254
E01008800,1436,708,728,0.49303621169916434,0.5069637883008357
E01008801,1597,795,802,0.4978083907326237,0.5021916092673764
E01008765,1531,739,792,0.48269105160026127,0.5173089483997387
E01008767,1492,698,794,0.467828418230563,0.532171581769437
E01008770,1404,685,719,0.4878917378917379,0.5121082621082621
E01008771,1521,747,774,0.4911242603550296,0.5088757396449705
E01008720,1389,682,707,0.49100071994240463,0.5089992800575954
E01008721,1620,799,821,0.49320987654320986,0.5067901234567901
E01008796,1596,770,826,0.4824561403508772,0.5175438596491229
E01032483,1702,841,861,0.49412455934195065,0.5058754406580493
E01032484,1290,637,653,0.4937984496124031,0.506201550387597
E01008750,1906,944,962,0.49527806925498424,0.5047219307450157
E01008751,1038,503,535,0.48458574181117536,0.5154142581888247
E01008752,1634,786,848,0.4810281517747858,0.5189718482252142
E01008753,1213,588,625,0.48474855729596045,0.5152514427040396
E01008755,1338,634,704,0.47384155455904337,0.5261584454409567
E01008714,1284,595,689,0.4633956386292835,0.5366043613707165
E01008715,1303,654,649,0.5019186492709132,0.4980813507290867
E01008716,1345,661,684,0.49144981412639405,0.5085501858736059
E01008717,1635,772,863,0.47217125382263,0.5278287461773701
E01008749,1422,700,722,0.49226441631504925,0.5077355836849508
E01008754,1417,654,763,0.46153846153846156,0.5384615384615384
E01008718,1390,700,690,0.5035971223021583,0.49640287769784175
E01008719,1228,583,645,0.4747557003257329,0.5252442996742671
E01008742,1692,819,873,0.48404255319148937,0.5159574468085106
E01008747,1410,656,754,0.4652482269503546,0.5347517730496454
E01008748,1345,658,687,0.48921933085501856,0.5107806691449814
E01008743,1688,798,890,0.4727488151658768,0.5272511848341233
E01008744,1623,809,814,0.4984596426370918,0.5015403573629081
E01008745,1645,799,846,0.4857142857142857,0.5142857142857142
E01008746,1643,785,858,0.47778454047474134,0.5222154595252587
E01012607,1504,727,777,0.4833776595744681,0.5166223404255319
E01012608,1672,816,856,0.4880382775119617,0.5119617224880383
E01012633,1592,770,822,0.4836683417085427,0.5163316582914573
E01012634,1386,699,687,0.5043290043290043,0.49567099567099565
E01012635,1641,825,816,0.5027422303473492,0.49725776965265084
E01012636,1503,722,781,0.4803725881570193,0.5196274118429807
E01012581,1243,628,615,0.505229283990346,0.49477071600965405
E01012582,1639,808,831,0.49298352654057354,0.5070164734594265
E01012583,1642,803,839,0.4890377588306943,0.5109622411693058
E01012587,1988,988,1000,0.4969818913480885,0.5030181086519114
E01012588,2105,1035,1070,0.4916864608076009,0.5083135391923991
E01012574,1447,729,718,0.5038009675190048,0.4961990324809952
E01012577,1914,953,961,0.49791013584117033,0.5020898641588297
E01012578,1976,979,997,0.49544534412955465,0.5045546558704453
E01012605,1895,942,953,0.49709762532981533,0.5029023746701847
E01012606,1681,856,825,0.5092207019631172,0.4907792980368828
E01012579,1650,812,838,0.4921212121212121,0.5078787878787879
E01012580,2159,1118,1041,0.5178323297823066,0.48216767021769336
E01012642,1742,873,869,0.5011481056257175,0.49885189437428246
E01012645,1992,958,1034,0.48092369477911645,0.5190763052208835
E01012585,1633,799,834,0.48928352725045926,0.5107164727495407
E01012586,1627,866,761,0.5322679778733866,0.4677320221266134
E01012656,1668,872,796,0.5227817745803357,0.47721822541966424
E01012657,2031,1061,970,0.5224027572624323,0.4775972427375677
E01012658,1825,918,907,0.503013698630137,0.496986301369863
E01012629,1145,599,546,0.5231441048034935,0.47685589519650656
E01012631,1292,652,640,0.5046439628482973,0.4953560371517028
E01012643,1635,805,830,0.4923547400611621,0.5076452599388379
E01012644,2539,1325,1214,0.5218589996061441,0.4781410003938559
E01012655,1854,1070,784,0.5771305285868392,0.4228694714131607
E01012571,1474,756,718,0.5128900949796472,0.4871099050203528
E01012572,1552,788,764,0.5077319587628866,0.49226804123711343
E01012573,1800,924,876,0.5133333333333333,0.4866666666666667
E01012575,1284,622,662,0.48442367601246106,0.5155763239875389
E01012630,2271,1172,1099,0.5160722148833113,0.48392778511668866
E01012576,1626,888,738,0.5461254612546126,0.45387453874538747
E01012637,1583,764,819,0.4826279216677195,0.5173720783322805
E01012638,1662,845,817,0.5084235860409145,0.4915764139590854
E01012639,1803,905,898,0.5019412090959512,0.4980587909040488
E01012640,1751,887,864,0.5065676756139349,0.4934323243860651
E01012641,1712,812,900,0.4742990654205608,0.5257009345794392
E01012595,1903,927,976,0.48712559117183396,0.512874408828166
E01012596,1776,865,911,0.48704954954954954,0.5129504504504504
E01012622,1651,836,815,0.5063597819503332,0.49364021804966685
E01012623,1533,775,758,0.5055446836268754,0.49445531637312456
E01012624,1570,799,771,0.5089171974522293,0.4910828025477707
E01012625,1633,821,812,0.5027556644213105,0.4972443355786895
E01012584,1473,739,734,0.5016972165648337,0.4983027834351663
E01012609,1577,779,798,0.4939759036144578,0.5060240963855421
E01012610,1274,622,652,0.48822605965463106,0.5117739403453689
E01012611,1051,516,535,0.49096098953377737,0.5090390104662227
E01012612,1399,675,724,0.48248749106504646,0.5175125089349535
E01012613,1347,675,672,0.5011135857461024,0.49888641425389757
E01012600,1442,715,727,0.4958391123439667,0.5041608876560333
E01012601,1531,747,784,0.4879163945133899,0.51208360548661
E01012602,1601,786,815,0.4909431605246721,0.5090568394753279
E01012603,1580,775,805,0.49050632911392406,0.509493670886076
E01012604,1686,777,909,0.4608540925266904,0.5391459074733096
E01012632,2090,1039,1051,0.4971291866028708,0.5028708133971291
E01012594,1473,697,776,0.47318397827562797,0.526816021724372
E01012618,1465,711,754,0.4853242320819113,0.5146757679180888
E01012619,1400,692,708,0.4942857142857143,0.5057142857142857
E01012620,1388,680,708,0.4899135446685879,0.5100864553314121
E01012621,1490,709,781,0.47583892617449663,0.5241610738255034
E01012593,1775,886,889,0.49915492957746477,0.5008450704225352
E01012597,1767,907,860,0.5132993774759479,0.48670062252405205
E01012598,2992,1511,1481,0.5050133689839572,0.4949866310160428
E01012599,1169,596,573,0.5098374679213002,0.49016253207869975
E01012589,1422,684,738,0.4810126582278481,0.5189873417721519
E01012590,1356,635,721,0.46828908554572274,0.5317109144542773
E01012591,1561,742,819,0.47533632286995514,0.5246636771300448
E01012648,1178,591,587,0.50169779286927,0.49830220713073003
E01012652,1539,755,784,0.49057829759584143,0.5094217024041585
E01012617,1393,675,718,0.48456568557071067,0.5154343144292893
E01012646,1669,815,854,0.48831635710005994,0.5116836428999401
E01012647,1342,652,690,0.4858420268256334,0.5141579731743666
E01012650,1379,686,693,0.49746192893401014,0.5025380710659898
E01012649,1462,712,750,0.48700410396716826,0.5129958960328317
E01012651,1693,824,869,0.48670998227997636,0.5132900177200236
E01012653,1294,644,650,0.49768160741885625,0.5023183925811437
E01012654,1657,860,797,0.5190102595051298,0.48098974049487025
E01012614,1745,878,867,0.5031518624641834,0.49684813753581664
E01012615,1495,730,765,0.4882943143812709,0.5117056856187291
E01012616,1782,895,887,0.5022446689113356,0.49775533108866443
E01012659,1411,683,728,0.48405386250885896,0.515946137491141
E01012660,1170,599,571,0.5119658119658119,0.488034188034188
E01012661,1498,769,729,0.513351134846462,0.48664886515353806
E01012592,1924,950,974,0.49376299376299376,0.5062370062370062
E01012628,1165,591,574,0.5072961373390558,0.4927038626609442
E01032485,1766,874,892,0.49490373725934317,0.5050962627406569
E01032486,1414,675,739,0.47736916548797736,0.5226308345120226
E01012663,1602,765,837,0.47752808988764045,0.5224719101123596
E01012664,1639,739,900,0.45088468578401464,0.5491153142159854
E01012665,1642,773,869,0.4707673568818514,0.5292326431181485
E01012716,1479,715,764,0.4834347532116295,0.5165652467883706
E01012719,1446,668,778,0.46196403872752423,0.5380359612724758
E01012662,1459,643,816,0.4407128169979438,0.5592871830020562
E01012703,1499,714,785,0.47631754503002,0.52368245496998
E01012704,1993,990,1003,0.4967385850476668,0.5032614149523331
E01012706,1645,789,856,0.4796352583586626,0.5203647416413374
E01012717,1660,819,841,0.49337349397590363,0.5066265060240964
E01012666,1458,724,734,0.49657064471879286,0.5034293552812071
E01012667,1563,752,811,0.48112603966730644,0.5188739603326935
E01012668,1570,758,812,0.48280254777070064,0.5171974522292994
E01012669,1784,883,901,0.49495515695067266,0.5050448430493274
E01012718,1621,764,857,0.4713140037014189,0.5286859962985812
E01012690,1727,834,893,0.4829183555298205,0.5170816444701795
E01012691,1868,887,981,0.4748394004282655,0.5251605995717344
E01012692,1720,813,907,0.47267441860465115,0.5273255813953488
E01012705,1624,779,845,0.47967980295566504,0.520320197044335
E01012723,1435,666,769,0.4641114982578397,0.5358885017421603
E01012693,1550,741,809,0.4780645161290323,0.5219354838709678
E01012711,1384,684,700,0.49421965317919075,0.5057803468208093
E01012747,1515,734,781,0.4844884488448845,0.5155115511551155
E01012750,1740,859,881,0.49367816091954025,0.5063218390804598
E01012681,1550,989,561,0.6380645161290323,0.36193548387096774
E01012683,1445,826,619,0.5716262975778547,0.42837370242214534
E01012748,1656,837,819,0.5054347826086957,0.4945652173913043
E01012749,1755,926,829,0.5276353276353276,0.4723646723646724
E01012707,1228,593,635,0.4828990228013029,0.5171009771986971
E01012720,1601,743,858,0.46408494690818236,0.5359150530918176
E01012721,1679,819,860,0.48779035139964266,0.5122096486003573
E01012724,1262,648,614,0.5134706814580031,0.4865293185419968
E01012678,1386,786,600,0.5670995670995671,0.4329004329004329
E01012679,1448,715,733,0.4937845303867403,0.5062154696132597
E01012680,1593,780,813,0.4896421845574388,0.5103578154425612
E01012682,1433,721,712,0.5031402651779484,0.49685973482205165
E01012684,1457,710,747,0.48730267673301303,0.5126973232669869
E01012676,1370,636,734,0.4642335766423358,0.5357664233576642
E01012677,1381,656,725,0.47501810282404056,0.5249818971759594
E01012708,1359,638,721,0.46946284032376745,0.5305371596762325
E01012709,1612,739,873,0.45843672456575685,0.5415632754342432
E01012710,1262,586,676,0.4643423137876387,0.5356576862123613
E01012722,1284,648,636,0.5046728971962616,0.4953271028037383
E01012673,1367,744,623,0.5442574981711777,0.45574250182882226
E01012675,1553,793,760,0.510624597553123,0.489375402446877
E01012735,1322,690,632,0.5219364599092284,0.47806354009077157
E01012736,1382,754,628,0.5455861070911722,0.4544138929088278
E01012737,1457,855,602,0.5868222374742622,0.4131777625257378
E01012670,1248,613,635,0.4911858974358974,0.5088141025641025
E01012733,1027,540,487,0.5258033106134372,0.4741966893865628
E01012734,1430,700,730,0.48951048951048953,0.5104895104895105
E01012738,1272,646,626,0.5078616352201258,0.4921383647798742
E01012739,1383,674,709,0.48734634851771513,0.5126536514822849
E01012742,1142,547,595,0.478984238178634,0.521015761821366
E01012712,1698,831,867,0.48939929328621906,0.5106007067137809
E01012713,1918,916,1002,0.47758081334723673,0.5224191866527633
E01012715,1555,742,813,0.47717041800643084,0.5228295819935691
E01012740,1502,738,764,0.49134487350199735,0.5086551264980027
E01012741,1362,659,703,0.48384728340675476,0.5161527165932452
E01012671,1385,734,651,0.5299638989169675,0.4700361010830325
E01012672,1282,704,578,0.5491419656786272,0.45085803432137284
E01012674,1645,893,752,0.5428571428571428,0.45714285714285713
E01012751,1465,816,649,0.5569965870307167,0.44300341296928325
E01012686,1472,705,767,0.4789402173913043,0.5210597826086957
E01012687,1425,700,725,0.49122807017543857,0.5087719298245614
E01012688,1231,565,666,0.45897644191714054,0.5410235580828595
E01012689,1293,641,652,0.4957463263727765,0.5042536736272235
E01012714,1681,787,894,0.4681737061273052,0.5318262938726949
E01012695,1395,686,709,0.4917562724014337,0.5082437275985663
E01012743,1707,843,864,0.4938488576449912,0.5061511423550088
E01012744,1609,738,871,0.4586699813548788,0.5413300186451212
E01012745,1682,852,830,0.5065398335315101,0.4934601664684899
E01012746,1810,875,935,0.48342541436464087,0.5165745856353591
E01012685,1489,721,768,0.4842175957018133,0.5157824042981867
E01012694,1380,670,710,0.4855072463768116,0.5144927536231884
E01012696,1563,739,824,0.472808701215611,0.527191298784389
E01012697,1377,656,721,0.47639796659404504,0.523602033405955
E01012698,1520,739,781,0.4861842105263158,0.5138157894736842
E01012726,1805,853,952,0.47257617728531853,0.5274238227146815
E01012728,1554,775,779,0.49871299871299873,0.5012870012870013
E01012752,1367,651,716,0.47622531089978054,0.5237746891002194
E01012753,1189,582,607,0.4894869638351556,0.5105130361648444
E01012754,1197,597,600,0.49874686716791977,0.5012531328320802
E01012755,1475,746,729,0.5057627118644068,0.4942372881355932
E01012701,1453,695,758,0.4783207157604955,0.5216792842395045
E01012729,1600,758,842,0.47375,0.52625
E01012730,1640,781,859,0.47621951219512193,0.5237804878048781
E01012731,1602,736,866,0.45942571785268416,0.5405742821473158
E01012732,1688,774,914,0.4585308056872038,0.5414691943127962
E01012699,1725,831,894,0.4817391304347826,0.5182608695652174
E01012700,1825,880,945,0.4821917808219178,0.5178082191780822
E01012702,1454,664,790,0.45667125171939477,0.5433287482806052
E01012725,1468,672,796,0.45776566757493187,0.5422343324250681
E01012727,1610,785,825,0.48757763975155277,0.5124223602484472
E01018393,2047,1028,1019,0.5021983390327308,0.4978016609672692
E01018411,2320,1169,1151,0.5038793103448276,0.4961206896551724
E01018412,1526,744,782,0.4875491480996068,0.5124508519003932
E01018413,1277,622,655,0.48707909162098667,0.5129209083790133
E01018414,1372,684,688,0.49854227405247814,0.5014577259475219
E01018415,1642,745,897,0.45371498172959807,0.546285018270402
E01018416,1314,648,666,0.4931506849315068,0.5068493150684932
E01018424,1696,839,857,0.4946933962264151,0.5053066037735849
E01018425,1625,799,826,0.4916923076923077,0.5083076923076923
E01018426,1602,814,788,0.5081148564294632,0.4918851435705368
E01018427,1325,634,691,0.4784905660377359,0.5215094339622641
E01018419,1361,696,665,0.5113886847905952,0.4886113152094049
E01018420,1902,940,962,0.4942166140904311,0.5057833859095688
E01018421,1342,669,673,0.49850968703427717,0.5014903129657228
E01018422,1286,632,654,0.49144634525660963,0.5085536547433903
E01018423,1456,691,765,0.47458791208791207,0.5254120879120879
E01018395,1603,822,781,0.5127885215221459,0.487211478477854
E01018396,1482,710,772,0.47908232118758437,0.5209176788124157
E01018400,2157,1055,1102,0.4891052387575336,0.5108947612424664
E01018401,1576,804,772,0.5101522842639594,0.48984771573604063
E01018398,1459,695,764,0.47635366689513364,0.5236463331048663
E01018399,1501,745,756,0.49633577614923385,0.5036642238507661
E01018402,1910,964,946,0.5047120418848168,0.4952879581151832
E01018403,1953,967,986,0.49513568868407576,0.5048643113159242
E01018397,1831,881,950,0.4811578372474058,0.5188421627525942
E01018408,1784,878,906,0.492152466367713,0.507847533632287
E01018409,1847,901,946,0.48781808337845156,0.5121819166215484
E01018410,1567,766,801,0.48883216336949586,0.5111678366305041
E01018404,1490,731,759,0.4906040268456376,0.5093959731543625
E01018405,1397,698,699,0.49964209019327127,0.5003579098067287
E01018406,1444,726,718,0.502770083102493,0.49722991689750695
E01018407,1481,699,782,0.47197839297771776,0.5280216070222823
E01018436,1416,679,737,0.4795197740112994,0.5204802259887006
E01018437,1579,749,830,0.4743508549715009,0.525649145028499
E01018438,1414,687,727,0.48585572842998587,0.5141442715700142
E01018439,1339,638,701,0.4764749813293503,0.5235250186706497
E01018440,1780,888,892,0.49887640449438203,0.501123595505618
E01018441,1690,845,845,0.5,0.5
E01018442,1829,886,943,0.48441771459814104,0.5155822854018589
E01018443,1493,760,733,0.5090421969189551,0.49095780308104486
E01018432,1495,759,736,0.5076923076923077,0.49230769230769234
E01018433,1253,590,663,0.47086991221069435,0.5291300877893057
E01018434,1335,639,696,0.4786516853932584,0.5213483146067416
E01018435,1353,661,692,0.4885439763488544,0.5114560236511456
E01018394,2053,1031,1022,0.5021919142717973,0.4978080857282026
E01018417,1629,793,836,0.4868017188459177,0.5131982811540823
E01018418,1510,749,761,0.4960264900662252,0.5039735099337749
E01018428,1399,692,707,0.49463902787705505,0.505360972122945
E01018429,1492,733,759,0.4912868632707775,0.5087131367292225
E01018430,1388,694,694,0.5,0.5
E01018431,1163,594,569,0.5107480653482374,0.4892519346517627
E01018387,1684,807,877,0.47921615201900236,0.5207838479809976
E01018388,1568,773,795,0.492984693877551,0.5070153061224489
E01018389,1607,741,866,0.4611076540136901,0.5388923459863099
E01018390,1666,815,851,0.4891956782713085,0.5108043217286915
E01018386,1418,715,703,0.504231311706629,0.49576868829337095
E01018391,1933,931,1002,0.4816347646145887,0.5183652353854112
E01018392,1899,936,963,0.4928909952606635,0.5071090047393365
E01018472,1386,685,701,0.49422799422799424,0.5057720057720058
E01018473,1671,873,798,0.5224416517055656,0.47755834829443444
E01018474,1870,947,923,0.5064171122994653,0.49358288770053477
E01018475,1873,974,899,0.5200213561131874,0.4799786438868126
E01018463,1482,721,761,0.4865047233468286,0.5134952766531714
E01018476,1428,648,780,0.453781512605042,0.5462184873949579
E01018477,1533,744,789,0.48532289628180036,0.5146771037181996
E01018478,1467,717,750,0.4887525562372188,0.5112474437627812
E01018479,1603,797,806,0.49719276356830944,0.5028072364316906
E01018459,1410,660,750,0.46808510638297873,0.5319148936170213
E01018460,1400,675,725,0.48214285714285715,0.5178571428571429
E01018461,1401,684,717,0.48822269807280516,0.5117773019271948
E01018466,2304,1154,1150,0.5008680555555556,0.4991319444444444
E01018467,2192,1134,1058,0.5173357664233577,0.48266423357664234
E01018482,1401,689,712,0.4917915774446824,0.5082084225553176
E01018483,1370,683,687,0.4985401459854015,0.5014598540145986
E01018484,2402,1114,1288,0.46378018318068276,0.5362198168193172
E01018485,1540,773,767,0.5019480519480519,0.4980519480519481
E01018499,1544,764,780,0.4948186528497409,0.5051813471502591
E01018500,1254,621,633,0.49521531100478466,0.5047846889952153
E01018501,1579,771,808,0.4882837238758708,0.5117162761241292
E01018502,2059,1000,1059,0.48567265662943176,0.5143273433705683
E01018462,1473,727,746,0.49355057705363203,0.506449422946368
E01018464,1390,712,678,0.5122302158273381,0.48776978417266187
E01018496,1687,842,845,0.4991108476585655,0.5008891523414345
E01018497,1174,588,586,0.5008517887563884,0.4991482112436116
E01018498,1570,737,833,0.4694267515923567,0.5305732484076433
E01018465,2843,1421,1422,0.4998241294407316,0.5001758705592684
E01018468,1623,790,833,0.4867529266789895,0.5132470733210105
E01018469,1621,766,855,0.47254780999383095,0.527452190006169
E01018470,1482,715,767,0.4824561403508772,0.5175438596491229
E01018471,1493,727,766,0.4869390488948426,0.5130609511051574
E01018486,1474,792,682,0.5373134328358209,0.4626865671641791
E01018487,1650,832,818,0.5042424242424243,0.49575757575757573
E01018488,1518,771,747,0.5079051383399209,0.49209486166007904
E01018489,1366,726,640,0.5314787701317716,0.4685212298682284
E01018510,1616,806,810,0.49876237623762376,0.5012376237623762
E01018511,1445,693,752,0.4795847750865052,0.5204152249134948
E01018512,1690,791,899,0.4680473372781065,0.5319526627218935
E01018513,1623,817,806,0.503388786198398,0.49661121380160195
E01018445,1927,962,965,0.49922158796056043,0.5007784120394395
E01018446,1336,654,682,0.48952095808383234,0.5104790419161677
E01018447,1739,901,838,0.5181138585393904,0.48188614146060954
E01018448,1735,882,853,0.5083573487031701,0.49164265129683
E01018490,1448,699,749,0.48273480662983426,0.5172651933701657
E01018491,1428,699,729,0.4894957983193277,0.5105042016806722
E01018492,1066,524,542,0.4915572232645403,0.5084427767354597
E01018505,1086,546,540,0.5027624309392266,0.4972375690607735
E01018506,1421,709,712,0.4989444053483462,0.5010555946516537
E01018507,1404,716,688,0.50997150997151,0.49002849002849
E01018451,1324,605,719,0.4569486404833837,0.5430513595166163
E01018454,1522,766,756,0.5032851511169514,0.4967148488830486
E01018455,1325,635,690,0.47924528301886793,0.5207547169811321
E01018456,1294,593,701,0.45826893353941267,0.5417310664605873
E01018457,1433,699,734,0.48778785764131194,0.5122121423586881
E01018444,2157,1072,1085,0.49698655540101994,0.5030134445989801
E01018480,2172,1090,1082,0.501841620626151,0.498158379373849
E01018515,2325,1173,1152,0.5045161290322581,0.49548387096774194
E01018516,1460,733,727,0.5020547945205479,0.49794520547945204
E01033375,1342,660,682,0.4918032786885246,0.5081967213114754
E01033376,1178,589,589,0.5,0.5
E01033378,1401,701,700,0.5003568879371877,0.49964311206281226
E01018493,1236,595,641,0.4813915857605178,0.5186084142394822
E01018494,1345,670,675,0.49814126394052044,0.5018587360594795
E01018495,1241,619,622,0.49879129734085415,0.5012087026591459
E01018508,1180,581,599,0.4923728813559322,0.5076271186440678
E01018509,1102,497,605,0.45099818511796735,0.5490018148820327
E01018452,1139,551,588,0.48375768217734855,0.5162423178226514
E01018503,1630,767,863,0.4705521472392638,0.5294478527607362
E01018504,1765,845,920,0.47875354107648727,0.5212464589235127
E01033372,1259,605,654,0.4805401111993646,0.5194598888006354
E01033373,1273,627,646,0.4925373134328358,0.5074626865671642
E01018449,1725,843,882,0.48869565217391303,0.5113043478260869
E01018450,2221,1084,1137,0.4880684376407024,0.5119315623592976
E01018458,2136,1038,1098,0.4859550561797753,0.5140449438202247
E01018481,1985,1018,967,0.5128463476070529,0.4871536523929471
E01018514,1976,982,994,0.49696356275303644,0.5030364372469636
E01018585,1382,672,710,0.48625180897250364,0.5137481910274964
E01018586,1536,771,765,0.501953125,0.498046875
E01018587,1526,737,789,0.4829619921363041,0.5170380078636959
E01018661,1244,625,619,0.502411575562701,0.49758842443729906
E01018657,1104,531,573,0.48097826086956524,0.5190217391304348
E01018662,1190,571,619,0.47983193277310926,0.5201680672268908
E01018663,1529,720,809,0.4708960104643558,0.5291039895356442
E01018664,1462,727,735,0.49726402188782487,0.5027359781121751
E01018665,1117,533,584,0.477170993733214,0.5228290062667861
E01018655,1514,718,796,0.47424042272126815,0.5257595772787318
E01018656,1551,727,824,0.4687298517085751,0.5312701482914249
E01018658,1296,654,642,0.5046296296296297,0.49537037037037035
E01018659,1248,618,630,0.4951923076923077,0.5048076923076923
E01018660,1005,498,507,0.4955223880597015,0.5044776119402985
E01018582,1753,876,877,0.4997147746719909,0.5002852253280091
E01018592,1714,828,886,0.4830805134189031,0.5169194865810969
E01018593,1674,834,840,0.4982078853046595,0.5017921146953405
E01018594,1662,830,832,0.4993983152827918,0.5006016847172082
E01018595,1520,744,776,0.48947368421052634,0.5105263157894737
E01018596,1918,927,991,0.48331595411887385,0.5166840458811262
E01018583,1822,915,907,0.5021953896816685,0.4978046103183315
E01018584,1885,950,935,0.5039787798408488,0.4960212201591512
E01018612,1206,593,613,0.4917081260364842,0.5082918739635157
E01018613,1483,723,760,0.4875252865812542,0.5124747134187457
E01018600,1609,791,818,0.4916096954630205,0.5083903045369795
E01018601,1717,787,930,0.45835760046592894,0.541642399534071
E01018602,1710,859,851,0.5023391812865498,0.4976608187134503
E01018652,1569,767,802,0.4888463989802422,0.5111536010197578
E01018598,1581,796,785,0.5034788108791903,0.4965211891208096
E01018599,1145,552,593,0.4820960698689956,0.5179039301310043
E01018648,2172,1070,1102,0.49263351749539597,0.507366482504604
E01018649,1362,656,706,0.48164464023494863,0.5183553597650514
E01018650,1688,802,886,0.47511848341232227,0.5248815165876777
E01018651,1582,621,961,0.3925410872313527,0.6074589127686473
E01018654,2277,1143,1134,0.5019762845849802,0.4980237154150198
E01018588,1543,749,794,0.4854180168502916,0.5145819831497084
E01018589,1608,800,808,0.4975124378109453,0.5024875621890548
E01018590,1840,912,928,0.4956521739130435,0.5043478260869565
E01018653,1999,952,1047,0.4762381190595298,0.5237618809404703
E01018605,1137,545,592,0.4793315743183817,0.5206684256816183
E01018609,1688,795,893,0.4709715639810427,0.5290284360189573
E01018610,1910,906,1004,0.4743455497382199,0.5256544502617801
E01018611,1683,842,841,0.5002970885323826,0.49970291146761736
E01018666,1783,880,903,0.49355019629837354,0.5064498037016265
E01018667,1615,749,866,0.46377708978328175,0.5362229102167183
E01018668,1730,791,939,0.4572254335260116,0.5427745664739885
E01018603,1280,629,651,0.49140625,0.50859375
E01018604,1340,622,718,0.46417910447761196,0.5358208955223881
E01018606,1472,681,791,0.4626358695652174,0.5373641304347826
E01018607,1299,643,656,0.49499615088529636,0.5050038491147036
E01018608,1382,694,688,0.5021707670043415,0.49782923299565845
E01018572,1797,812,985,0.4518642181413467,0.5481357818586533
E01018573,1544,766,778,0.4961139896373057,0.5038860103626943
E01018574,1935,931,1004,0.4811369509043928,0.5188630490956072
E01018580,1531,751,780,0.49052906596995427,0.5094709340300457
E01018581,1219,593,626,0.4864643150123052,0.5135356849876949
E01018575,1101,553,548,0.5022706630336058,0.4977293369663942
E01018576,1748,863,885,0.4937070938215103,0.5062929061784897
E01018577,2435,1196,1239,0.49117043121149895,0.508829568788501
E01018578,1214,595,619,0.4901153212520593,0.5098846787479407
E01018579,1095,534,561,0.4876712328767123,0.5123287671232877
E01018641,1280,641,639,0.50078125,0.49921875
E01018642,1382,655,727,0.47395079594790157,0.5260492040520984
E01018643,1925,972,953,0.5049350649350649,0.49506493506493504
E01018644,1374,693,681,0.5043668122270742,0.49563318777292575
E01018614,1899,928,971,0.4886782517114271,0.5113217482885729
E01018618,1467,710,757,0.4839809134287662,0.5160190865712339
E01018619,1426,691,735,0.4845722300140252,0.5154277699859747
E01018620,1432,702,730,0.49022346368715086,0.5097765363128491
E01018621,1320,618,702,0.4681818181818182,0.5318181818181819
E01018626,2149,1049,1100,0.4881340158213122,0.5118659841786878
E01018628,1590,786,804,0.49433962264150944,0.5056603773584906
E01018629,1858,880,978,0.4736275565123789,0.5263724434876211
E01018630,1280,613,667,0.47890625,0.52109375
E01018631,1380,721,659,0.5224637681159421,0.47753623188405797
E01018615,1178,604,574,0.5127334465195246,0.4872665534804754
E01018616,1320,638,682,0.48333333333333334,0.5166666666666667
E01018617,1437,708,729,0.49269311064718163,0.5073068893528184
E01018632,1584,789,795,0.4981060606060606,0.5018939393939394
E01018633,1501,719,782,0.47901399067288475,0.5209860093271153
E01018622,1325,640,685,0.4830188679245283,0.5169811320754717
E01018623,1489,738,751,0.4956346541302888,0.5043653458697113
E01018624,1824,960,864,0.5263157894736842,0.47368421052631576
E01018625,1425,654,771,0.4589473684210526,0.5410526315789473
E01018627,1579,818,761,0.5180493983533883,0.4819506016466118
E01018635,1225,606,619,0.4946938775510204,0.5053061224489795
E01018636,1421,682,739,0.47994370161857847,0.5200562983814215
E01018634,1874,924,950,0.49306296691568835,0.5069370330843116
E01018645,1797,852,945,0.4741235392320534,0.5258764607679466
E01018646,1781,847,934,0.4755755193711398,0.5244244806288602
E01018647,1544,758,786,0.49093264248704666,0.5090673575129534
E01018591,2339,1138,1201,0.48653270628473705,0.5134672937152629
E01018597,2373,1180,1193,0.4972608512431521,0.5027391487568479
E01018669,2588,1261,1327,0.48724884080370945,0.5127511591962906
E01018670,2357,1159,1198,0.4917267713194739,0.508273228680526
E01018637,1823,839,984,0.46023038946791006,0.5397696105320899
E01018638,1585,753,832,0.4750788643533123,0.5249211356466877
E01018639,1401,688,713,0.49107780157030695,0.5089221984296931
E01018640,1311,653,658,0.498093058733791,0.501906941266209
E01018308,1902,992,910,0.5215562565720294,0.4784437434279706
E01018336,1233,602,631,0.4882400648824006,0.5117599351175993
E01018337,1331,661,670,0.4966190833959429,0.5033809166040571
E01018338,1790,874,916,0.488268156424581,0.511731843575419
E01018358,1272,600,672,0.4716981132075472,0.5283018867924528
E01018359,1081,542,539,0.5013876040703052,0.49861239592969475
E01018360,2096,1005,1091,0.4794847328244275,0.5205152671755725
E01018366,1515,752,763,0.49636963696369635,0.5036303630363036
E01018367,1984,973,1011,0.4904233870967742,0.5095766129032258
E01018364,1565,745,820,0.476038338658147,0.5239616613418531
E01018365,1860,876,984,0.47096774193548385,0.5290322580645161
E01018378,1230,577,653,0.4691056910569106,0.5308943089430894
E01018379,1347,639,708,0.47438752783964366,0.5256124721603563
E01018380,1176,565,611,0.4804421768707483,0.5195578231292517
E01018362,1516,711,805,0.46899736147757254,0.5310026385224275
E01018363,1048,510,538,0.4866412213740458,0.5133587786259542
E01018374,1894,913,981,0.4820485744456177,0.5179514255543822
E01018375,1802,881,921,0.48890122086570476,0.5110987791342952
E01018376,1640,759,881,0.4628048780487805,0.5371951219512195
E01018377,1647,833,814,0.5057680631451124,0.4942319368548877
E01018309,1648,778,870,0.4720873786407767,0.5279126213592233
E01018310,1531,711,820,0.4644023514043109,0.5355976485956891
E01018311,1388,671,717,0.4834293948126801,0.5165706051873199
E01018312,1493,717,776,0.48024112525117213,0.5197588747488279
E01018313,1357,658,699,0.4848931466470155,0.5151068533529846
E01018314,1644,768,876,0.46715328467153283,0.5328467153284672
E01018315,1125,551,574,0.48977777777777776,0.5102222222222222
E01018316,1431,696,735,0.4863731656184486,0.5136268343815513
E01018317,1482,748,734,0.50472334682861,0.49527665317139
E01018349,1618,781,837,0.4826946847960445,0.5173053152039555
E01018350,1927,934,993,0.4846912298910223,0.5153087701089777
E01018368,1377,645,732,0.4684095860566449,0.5315904139433552
E01018370,1351,665,686,0.49222797927461137,0.5077720207253886
E01018345,1317,625,692,0.4745634016704632,0.5254365983295368
E01018346,1370,673,697,0.4912408759124088,0.5087591240875913
E01018347,1355,685,670,0.5055350553505535,0.4944649446494465
E01018383,1531,752,779,0.49118223383409537,0.5088177661659047
E01018384,1446,691,755,0.4778699861687414,0.5221300138312587
E01018327,1998,1037,961,0.519019019019019,0.48098098098098097
E01018343,1645,790,855,0.48024316109422494,0.5197568389057751
E01018361,1471,750,721,0.5098572399728076,0.49014276002719237
E01032930,1852,1014,838,0.5475161987041036,0.4524838012958963
E01032931,1085,588,497,0.5419354838709678,0.45806451612903226
E01018326,2012,1046,966,0.5198807157057654,0.4801192842942346
E01018328,1867,789,1078,0.4226031065881093,0.5773968934118907
E01018329,2137,1006,1131,0.47075339260645765,0.5292466073935423
E01018330,1243,547,696,0.44006436041834274,0.5599356395816573
E01018331,1650,750,900,0.45454545454545453,0.5454545454545454
E01018319,2109,1023,1086,0.4850640113798009,0.5149359886201992
E01018344,1936,953,983,0.4922520661157025,0.5077479338842975
E01018381,1196,591,605,0.49414715719063546,0.5058528428093646
E01018382,1532,745,787,0.48629242819843344,0.5137075718015666
E01018323,1383,627,756,0.45336225596529284,0.5466377440347071
E01018324,1317,653,664,0.49582384206529995,0.5041761579347
E01018325,1467,718,749,0.4894342194955692,0.5105657805044308
E01018385,2028,980,1048,0.4832347140039448,0.5167652859960552
E01018320,1455,688,767,0.47285223367697593,0.5271477663230241
E01018321,1200,584,616,0.4866666666666667,0.5133333333333333
E01018322,1172,570,602,0.4863481228668942,0.5136518771331058
E01018348,2115,1042,1073,0.49267139479905436,0.5073286052009456
E01018332,1063,544,519,0.5117591721542804,0.48824082784571965
E01018333,1503,708,795,0.47105788423153694,0.5289421157684631
E01018334,1511,731,780,0.48378557246856385,0.5162144275314361
E01018340,1428,687,741,0.4810924369747899,0.5189075630252101
E01018341,1108,524,584,0.4729241877256318,0.5270758122743683
E01018342,1568,718,850,0.45790816326530615,0.5420918367346939
E01018351,1448,743,705,0.513121546961326,0.48687845303867405
E01018352,1790,881,909,0.4921787709497207,0.5078212290502794
E01018353,1575,770,805,0.4888888888888889,0.5111111111111111
E01018354,1606,763,843,0.475093399750934,0.524906600249066
E01018335,2115,1049,1066,0.49598108747044917,0.5040189125295508
E01018369,1678,794,884,0.4731823599523242,0.5268176400476758
E01018371,1807,859,948,0.47537354731599335,0.5246264526840066
E01018372,1896,950,946,0.5010548523206751,0.4989451476793249
E01018339,2018,977,1041,0.48414271555996036,0.5158572844400396
E01018355,1210,532,678,0.4396694214876033,0.5603305785123966
E01018356,1474,747,727,0.5067842605156038,0.4932157394843962
E01018357,1291,631,660,0.48876839659178933,0.5112316034082107
E01018373,1980,984,996,0.49696969696969695,0.503030303030303
E01018534,2521,1217,1304,0.4827449424831416,0.5172550575168584
E01018535,1524,736,788,0.48293963254593175,0.5170603674540682
E01018536,1647,787,860,0.47783849423193686,0.5221615057680632
E01018537,1944,901,1043,0.463477366255144,0.536522633744856
E01018518,1507,734,773,0.4870603848706038,0.5129396151293961
E01018569,1283,645,638,0.5027279812938426,0.49727201870615745
E01018570,1200,588,612,0.49,0.51
E01018571,1342,625,717,0.46572280178837555,0.5342771982116244
E01018546,1479,704,775,0.4759972954699121,0.5240027045300879
E01018547,1384,675,709,0.4877167630057804,0.5122832369942196
E01018548,1577,758,819,0.4806594800253646,0.5193405199746354
E01018549,1412,715,697,0.5063739376770539,0.4936260623229462
E01018532,1855,884,971,0.4765498652291105,0.5234501347708895
E01018533,1506,756,750,0.50199203187251,0.49800796812749004
E01018544,1491,711,780,0.4768611670020121,0.5231388329979879
E01018545,1920,918,1002,0.478125,0.521875
E01018519,1416,695,721,0.490819209039548,0.509180790960452
E01018520,1035,491,544,0.47439613526570046,0.5256038647342995
E01018525,1329,577,752,0.43416102332580886,0.5658389766741911
E01018563,2101,1060,1041,0.504521656354117,0.4954783436458829
E01018564,2247,1106,1141,0.49221183800623053,0.5077881619937694
E01018523,1347,680,667,0.5048255382331106,0.4951744617668894
E01018524,1413,655,758,0.46355272469922154,0.5364472753007785
E01018541,1385,674,711,0.4866425992779783,0.5133574007220216
E01018542,1317,586,731,0.44495064540622625,0.5550493545937737
E01018543,1319,597,722,0.45261561789234267,0.5473843821076573
E01018528,1176,582,594,0.49489795918367346,0.5051020408163265
E01018529,1507,745,762,0.49435965494359657,0.5056403450564034
E01018530,1517,772,745,0.5088991430454846,0.4911008569545155
E01018531,1566,750,816,0.4789272030651341,0.5210727969348659
E01018560,1169,576,593,0.49272882805816937,0.5072711719418306
E01018561,1236,630,606,0.5097087378640777,0.49029126213592233
E01018562,1454,727,727,0.5,0.5
E01018522,1382,677,705,0.48986975397973953,0.5101302460202605
E01018538,1199,564,635,0.47039199332777315,0.5296080066722268
E01018539,1088,504,584,0.4632352941176471,0.5367647058823529
E01018540,1444,720,724,0.4986149584487535,0.5013850415512465
E01018521,1213,598,615,0.49299258037922505,0.5070074196207749
E01018550,1074,508,566,0.4729981378026071,0.527001862197393
E01018551,1504,777,727,0.5166223404255319,0.4833776595744681
E01018552,1554,761,793,0.4897039897039897,0.5102960102960103
E01018553,1510,727,783,0.4814569536423841,0.5185430463576159
E01018556,1435,684,751,0.47665505226480837,0.5233449477351917
E01018557,1455,662,793,0.4549828178694158,0.5450171821305841
E01018558,1293,647,646,0.5003866976024749,0.49961330239752516
E01018559,1168,600,568,0.5136986301369864,0.4863013698630137
E01018565,1568,756,812,0.48214285714285715,0.5178571428571429
E01018566,1332,641,691,0.48123123123123124,0.5187687687687688
E01018567,1424,709,715,0.4978932584269663,0.5021067415730337
E01018568,1567,780,787,0.4977664326738992,0.5022335673261008
E01018526,1624,778,846,0.479064039408867,0.520935960591133
E01018527,1727,858,869,0.4968152866242038,0.5031847133757962
E01018554,2347,1175,1172,0.5006391137622497,0.4993608862377503
E01018555,1172,609,563,0.5196245733788396,0.4803754266211604
E01018685,1216,570,646,0.46875,0.53125
E01018686,1414,664,750,0.4695898161244696,0.5304101838755304
E01018687,1365,652,713,0.4776556776556777,0.5223443223443224
E01018688,1560,747,813,0.47884615384615387,0.5211538461538462
E01018689,1450,683,767,0.4710344827586207,0.5289655172413793
E01018690,2072,1019,1053,0.4917953667953668,0.5082046332046332
E01018675,2092,1072,1020,0.5124282982791587,0.4875717017208413
E01018708,2121,1092,1029,0.5148514851485149,0.48514851485148514
E01018721,2201,1100,1101,0.49977283053157656,0.5002271694684235
E01018671,1258,631,627,0.5015898251192369,0.4984101748807631
E01018672,1606,766,840,0.47696139476961397,0.523038605230386
E01018673,1192,564,628,0.47315436241610737,0.5268456375838926
E01018674,1558,741,817,0.47560975609756095,0.524390243902439
E01018684,2255,1116,1139,0.49490022172949,0.50509977827051
E01018695,1684,802,882,0.47624703087885983,0.5237529691211401
E01018696,1473,739,734,0.5016972165648337,0.4983027834351663
E01018697,1815,870,945,0.4793388429752066,0.5206611570247934
E01018698,1987,965,1022,0.4856567689984902,0.5143432310015098
E01018704,1184,603,581,0.5092905405405406,0.4907094594594595
E01018705,1530,777,753,0.5078431372549019,0.492156862745098
E01018706,1398,693,705,0.4957081545064378,0.5042918454935622
E01018718,1633,819,814,0.5015309246785058,0.4984690753214942
E01018722,2264,1111,1153,0.4907243816254417,0.5092756183745583
E01018713,2713,1319,1394,0.48617766310357535,0.5138223368964246
E01018714,1828,902,926,0.4934354485776805,0.5065645514223195
E01018715,1729,868,861,0.5020242914979757,0.4979757085020243
E01018726,1503,746,757,0.4963406520292748,0.5036593479707252
E01018727,1652,776,876,0.46973365617433416,0.5302663438256658
E01018728,1563,761,802,0.4868841970569418,0.5131158029430583
E01018729,1673,818,855,0.48894202032277345,0.5110579796772265
E01018709,1492,756,736,0.5067024128686327,0.4932975871313673
E01018710,1487,693,794,0.4660390047074647,0.5339609952925353
E01018711,1526,754,772,0.4941022280471822,0.5058977719528178
E01018712,1564,819,745,0.5236572890025576,0.47634271099744246
E01018699,1629,798,831,0.48987108655616945,0.5101289134438306
E01018701,1462,726,736,0.49658002735978113,0.5034199726402189
E01018716,1544,803,741,0.5200777202072538,0.4799222797927461
E01018717,1763,855,908,0.48496880317640384,0.5150311968235961
E01018719,1550,769,781,0.49612903225806454,0.5038709677419355
E01018720,1565,760,805,0.48562300319488816,0.5143769968051118
E01018691,1582,757,825,0.47850821744627053,0.5214917825537294
E01018693,1589,758,831,0.4770295783511643,0.5229704216488358
E01018694,1584,770,814,0.4861111111111111,0.5138888888888888
E01018700,2041,1032,1009,0.5056344928956394,0.4943655071043606
E01018702,1286,608,678,0.4727838258164852,0.5272161741835147
E01018703,1811,899,912,0.496410822749862,0.5035891772501381
E01018676,1451,709,742,0.48862853204686424,0.5113714679531358
E01018677,1430,692,738,0.48391608391608393,0.5160839160839161
E01018678,1314,637,677,0.484779299847793,0.515220700152207
E01018679,1727,826,901,0.47828604516502604,0.521713954834974
E01018692,1975,1014,961,0.5134177215189873,0.48658227848101265
E01018680,1622,833,789,0.5135635018495684,0.48643649815043155
E01018681,1451,727,724,0.5010337698139214,0.49896623018607855
E01018682,1075,524,551,0.4874418604651163,0.5125581395348837
E01018683,1498,717,781,0.4786381842456609,0.5213618157543392
E01018733,1475,712,763,0.48271186440677966,0.5172881355932203
E01018734,1273,618,655,0.48546739984289083,0.5145326001571092
E01018748,1390,641,749,0.4611510791366906,0.5388489208633094
E01018749,2509,1240,1269,0.49422080510163413,0.5057791948983659
E01018736,1629,803,826,0.49294045426642114,0.5070595457335789
E01018737,1338,659,679,0.49252615844544095,0.507473841554559
E01018743,1463,713,750,0.48735475051264526,0.5126452494873548
E01018744,1707,834,873,0.48857644991212656,0.5114235500878734
E01018732,1425,656,769,0.46035087719298246,0.5396491228070175
E01018745,1556,781,775,0.5019280205655527,0.4980719794344473
E01018746,1632,802,830,0.49142156862745096,0.508578431372549
E01018747,1511,748,763,0.49503639973527463,0.5049636002647253
E01018730,1463,699,764,0.47778537252221465,0.5222146274777854
E01018738,1474,670,804,0.45454545454545453,0.5454545454545454
E01018739,1443,659,784,0.4566874566874567,0.5433125433125433
E01018741,1263,641,622,0.5075217735550277,0.4924782264449723
E01018731,1600,765,835,0.478125,0.521875
E01018735,1301,621,680,0.47732513451191394,0.5226748654880861
E01018740,1537,719,818,0.4677944046844502,0.5322055953155498
E01018742,1492,769,723,0.5154155495978552,0.48458445040214476
E01018707,1731,856,875,0.49451184286539573,0.5054881571346043
E01018723,1124,543,581,0.4830960854092527,0.5169039145907474
E01018724,1490,725,765,0.4865771812080537,0.5134228187919463
E01018725,1310,656,654,0.500763358778626,0.49923664122137407
E01012392,2350,1141,1209,0.485531914893617,0.514468085106383
E01012393,2028,1000,1028,0.4930966469428008,0.5069033530571992
E01012395,1445,711,734,0.49204152249134947,0.5079584775086505
E01012411,1314,668,646,0.5083713850837138,0.4916286149162861
E01012374,2733,1364,1369,0.4990852542993048,0.5009147457006952
E01012375,1583,800,783,0.505369551484523,0.49463044851547694
E01012376,2593,1334,1259,0.5144620131122252,0.4855379868877748
E01012421,1339,672,667,0.5018670649738611,0.4981329350261389
E01012423,1418,705,713,0.49717912552891397,0.502820874471086
E01012368,1938,915,1023,0.47213622291021673,0.5278637770897833
E01012410,1265,628,637,0.4964426877470356,0.5035573122529644
E01012412,1449,746,703,0.5148378191856453,0.48516218081435475
E01012413,1485,717,768,0.48282828282828283,0.5171717171717172
E01012414,1232,615,617,0.4991883116883117,0.5008116883116883
E01012377,1794,918,876,0.5117056856187291,0.4882943143812709
E01012390,1597,749,848,0.46900438321853477,0.5309956167814652
E01012419,1143,519,624,0.4540682414698163,0.5459317585301837
E01012420,1481,710,771,0.47940580688723833,0.5205941931127617
E01012422,1480,683,797,0.4614864864864865,0.5385135135135135
E01012369,1517,752,765,0.4957152274225445,0.5042847725774555
E01012394,1485,682,803,0.45925925925925926,0.5407407407407407
E01012425,1613,770,843,0.4773713577185369,0.5226286422814631
E01012426,1345,646,699,0.48029739776951674,0.5197026022304833
E01012427,1765,845,920,0.47875354107648727,0.5212464589235127
E01012378,1498,722,776,0.4819759679572764,0.5180240320427236
E01012379,1481,714,767,0.48210668467251855,0.5178933153274814
E01012380,1391,644,747,0.4629762760603882,0.5370237239396118
E01012388,1814,872,942,0.4807056229327453,0.5192943770672547
E01012442,1621,720,901,0.44417026526835285,0.5558297347316471
E01012367,1591,778,813,0.48900062853551224,0.5109993714644877
E01012370,1743,847,896,0.4859437751004016,0.5140562248995983
E01012424,1877,927,950,0.4938732019179542,0.5061267980820459
E01012441,2301,1137,1164,0.4941329856584094,0.5058670143415906
E01012389,1785,861,924,0.4823529411764706,0.5176470588235295
E01012391,2130,1035,1095,0.4859154929577465,0.5140845070422535
E01012401,1841,906,935,0.49212384573601303,0.5078761542639869
E01012443,1597,775,822,0.4852849092047589,0.514715090795241
E01012385,1441,719,722,0.4989590562109646,0.5010409437890354
E01012386,1945,973,972,0.5002570694087404,0.4997429305912596
E01012387,1115,543,572,0.48699551569506727,0.5130044843049327
E01012434,1577,773,804,0.4901712111604312,0.5098287888395688
E01012435,2114,1081,1033,0.511352885525071,0.48864711447492903
E01012381,1351,716,635,0.5299777942264989,0.4700222057735011
E01012382,1497,724,773,0.48363393453573816,0.5163660654642619
E01012384,1588,787,801,0.49559193954659947,0.5044080604534005
E01012444,1139,550,589,0.4828797190517998,0.5171202809482002
E01012445,1276,641,635,0.5023510971786834,0.49764890282131663
E01012398,1239,607,632,0.48991121872477805,0.510088781275222
E01012400,1240,568,672,0.45806451612903226,0.5419354838709678
E01012402,1586,738,848,0.46532156368221944,0.5346784363177806
E01012404,1403,688,715,0.4903777619387028,0.5096222380612973
E01012405,1992,983,1009,0.4934738955823293,0.5065261044176707
E01012416,1792,881,911,0.4916294642857143,0.5083705357142857
E01012417,1294,641,653,0.4953632148377125,0.5046367851622875
E01012428,2200,1086,1114,0.49363636363636365,0.5063636363636363
E01012429,1387,673,714,0.4852198990627253,0.5147801009372747
E01012430,1755,889,866,0.5065527065527066,0.49344729344729343
E01012431,2064,1077,987,0.5218023255813954,0.47819767441860467
E01012383,1702,833,869,0.4894242068155112,0.5105757931844889
E01012396,1531,769,762,0.5022860875244938,0.4977139124755062
E01012397,1505,709,796,0.47109634551495017,0.5289036544850498
E01012399,1408,682,726,0.484375,0.515625
E01012403,1624,790,834,0.48645320197044334,0.5135467980295566
E01012408,2046,964,1082,0.47116324535679377,0.5288367546432062
E01012432,1409,687,722,0.48757984386089426,0.5124201561391057
E01012433,1620,770,850,0.47530864197530864,0.5246913580246914
E01012436,1334,631,703,0.47301349325337333,0.5269865067466267
E01012438,1189,554,635,0.4659377628259041,0.5340622371740958
E01012440,1373,685,688,0.4989075018208303,0.5010924981791697
E01012406,1596,777,819,0.4868421052631579,0.5131578947368421
E01012407,1594,766,828,0.48055207026348806,0.5194479297365119
E01012409,1434,699,735,0.4874476987447699,0.5125523012552301
E01012437,1354,634,720,0.46824224519940916,0.5317577548005908
E01012439,1522,692,830,0.45466491458607095,0.545335085413929
E01012371,1244,595,649,0.4782958199356913,0.5217041800643086
E01012372,1139,570,569,0.5004389815627743,0.4995610184372256
E01012373,1290,644,646,0.4992248062015504,0.5007751937984496
E01012415,1399,691,708,0.49392423159399573,0.5060757684060043
E01012418,1376,660,716,0.4796511627906977,0.5203488372093024
E01012471,2289,1660,629,0.7252075141983398,0.2747924858016601
E01012472,1823,858,965,0.4706527701590784,0.5293472298409215
E01012476,1544,757,787,0.49028497409326427,0.5097150259067358
E01012477,1559,767,792,0.4919820397690827,0.5080179602309173
E01012473,1558,730,828,0.4685494223363286,0.5314505776636713
E01012474,1427,636,791,0.4456902592852137,0.5543097407147862
E01012475,1490,742,748,0.49798657718120803,0.5020134228187919
E01012554,1960,972,988,0.4959183673469388,0.5040816326530613
E01012467,1224,607,617,0.4959150326797386,0.5040849673202614
E01012468,2435,1196,1239,0.49117043121149895,0.508829568788501
E01012469,1546,746,800,0.48253557567917205,0.517464424320828
E01012470,1143,546,597,0.4776902887139108,0.5223097112860893
E01012460,1420,698,722,0.4915492957746479,0.5084507042253521
E01012462,1289,644,645,0.49961210240496506,0.5003878975950349
E01012463,1128,573,555,0.5079787234042553,0.4920212765957447
E01012464,1399,702,697,0.5017869907076483,0.4982130092923517
E01012459,1361,678,683,0.4981631153563556,0.5018368846436444
E01012461,1308,649,659,0.49617737003058104,0.503822629969419
E01012465,1289,648,641,0.5027152831652444,0.4972847168347556
E01012466,1507,752,755,0.49900464499004643,0.5009953550099535
E01012526,1700,828,872,0.48705882352941177,0.5129411764705882
E01012534,1520,722,798,0.475,0.525
E01012535,1655,794,861,0.4797583081570997,0.5202416918429003
E01012537,1496,707,789,0.47259358288770054,0.5274064171122995
E01012539,1549,753,796,0.48612007746933505,0.513879922530665
E01012538,1427,695,732,0.48703573931324456,0.5129642606867554
E01012540,1366,670,696,0.4904831625183016,0.5095168374816984
E01012541,1303,616,687,0.4727551803530315,0.5272448196469686
E01012542,1356,670,686,0.4941002949852507,0.5058997050147492
E01012543,1647,803,844,0.48755312689738917,0.5124468731026108
E01012544,1404,686,718,0.4886039886039886,0.5113960113960114
E01012521,1571,742,829,0.47231063017186503,0.527689369828135
E01012522,1359,673,686,0.4952170713760118,0.5047829286239882
E01012533,1445,697,748,0.4823529411764706,0.5176470588235295
E01012536,1436,719,717,0.5006963788300836,0.49930362116991645
E01012545,1592,769,823,0.48304020100502515,0.5169597989949749
E01012546,1598,789,809,0.4937421777221527,0.5062578222778473
E01012561,1589,771,818,0.4852108244178729,0.5147891755821271
E01012562,1726,877,849,0.5081112398609502,0.4918887601390498
E01012567,1875,957,918,0.5104,0.4896
E01012568,2500,1248,1252,0.4992,0.5008
E01012563,1729,855,874,0.4945054945054945,0.5054945054945055
E01012564,1402,706,696,0.5035663338088445,0.4964336661911555
E01012565,2494,1206,1288,0.483560545308741,0.5164394546912591
E01012566,2156,1066,1090,0.49443413729128016,0.5055658627087198
E01012569,1925,982,943,0.5101298701298701,0.48987012987012984
E01012570,1204,593,611,0.4925249169435216,0.5074750830564784
E01012481,1594,777,817,0.4874529485570891,0.5125470514429109
E01012482,1601,766,835,0.47845096814490945,0.5215490318550906
E01012520,1506,769,737,0.5106241699867198,0.4893758300132802
E01012523,1442,717,725,0.4972260748959778,0.5027739251040222
E01012524,1523,752,771,0.4937623112278398,0.5062376887721602
E01012525,1517,755,762,0.4976928147659855,0.5023071852340145
E01012478,1446,705,741,0.487551867219917,0.5124481327800829
E01012547,1716,835,881,0.4865967365967366,0.5134032634032634
E01012548,1793,892,901,0.4974902398215282,0.5025097601784718
E01012549,1393,669,724,0.48025843503230436,0.5197415649676956
E01012550,1583,779,804,0.4921036007580543,0.5078963992419456
E01012453,1715,858,857,0.5002915451895044,0.49970845481049564
E01012454,2034,1047,987,0.5147492625368731,0.48525073746312686
E01012455,1934,941,993,0.48655635987590484,0.5134436401240952
E01012457,1662,825,837,0.4963898916967509,0.5036101083032491
E01012551,1560,780,780,0.5,0.5
E01012552,1357,644,713,0.4745762711864407,0.5254237288135594
E01012553,1354,692,662,0.5110782865583456,0.48892171344165436
E01012555,1402,695,707,0.4957203994293866,0.5042796005706134
E01012556,1483,742,741,0.5003371544167229,0.4996628455832771
E01012491,1422,705,717,0.4957805907172996,0.5042194092827004
E01012492,1444,718,726,0.49722991689750695,0.502770083102493
E01012493,1819,878,941,0.48268279274326553,0.5173172072567345
E01012494,1654,822,832,0.4969770253929867,0.5030229746070133
E01012500,1354,661,693,0.4881831610044313,0.5118168389955687
E01012495,1713,882,831,0.5148861646234676,0.4851138353765324
E01012496,1400,674,726,0.48142857142857143,0.5185714285714286
E01012497,1271,593,678,0.46656176239181746,0.5334382376081825
E01012498,1523,729,794,0.47866053841103084,0.5213394615889692
E01012499,1908,946,962,0.49580712788259956,0.5041928721174004
E01012501,1419,708,711,0.4989429175475687,0.5010570824524313
E01012479,1618,829,789,0.5123609394313968,0.48763906056860323
E01012480,1960,1040,920,0.5306122448979592,0.46938775510204084
E01012510,1751,923,828,0.5271273557966876,0.4728726442033124
E01012511,1670,827,843,0.49520958083832334,0.5047904191616767
E01033299,2010,1006,1004,0.5004975124378109,0.49950248756218907
E01033303,1165,593,572,0.5090128755364807,0.49098712446351933
E01012458,2367,1204,1163,0.5086607520067596,0.4913392479932404
E01012483,1621,792,829,0.48858729179518817,0.5114127082048119
E01012509,1791,875,916,0.4885538805136795,0.5114461194863205
E01012512,1558,769,789,0.49358151476251605,0.506418485237484
E01033300,1082,649,433,0.5998151571164511,0.400184842883549
E01033302,1545,811,734,0.5249190938511327,0.47508090614886733
E01012527,1491,722,769,0.4842387659289068,0.5157612340710932
E01012528,1241,576,665,0.46414182111200647,0.5358581788879936
E01012529,1426,684,742,0.4796633941093969,0.520336605890603
E01012530,1442,698,744,0.4840499306518724,0.5159500693481276
E01012531,1513,703,810,0.4646397884996695,0.5353602115003304
E01012532,1430,675,755,0.47202797202797203,0.527972027972028
E01012504,1785,908,877,0.5086834733893557,0.49131652661064423
E01012505,1400,701,699,0.5007142857142857,0.4992857142857143
E01012506,1544,768,776,0.49740932642487046,0.5025906735751295
E01012507,1845,942,903,0.510569105691057,0.4894308943089431
E01012508,1560,770,790,0.4935897435897436,0.5064102564102564
E01012513,1980,959,1021,0.48434343434343435,0.5156565656565657
E01012514,1864,887,977,0.47585836909871243,0.5241416309012875
E01012515,1471,712,759,0.4840244731475187,0.5159755268524813
E01012516,1342,656,686,0.488822652757079,0.511177347242921
E01012517,2216,1092,1124,0.4927797833935018,0.5072202166064982
E01012518,2003,995,1008,0.49675486769845234,0.5032451323015477
E01012519,1474,730,744,0.49525101763907736,0.5047489823609227
E01012485,1568,765,803,0.48788265306122447,0.5121173469387755
E01012486,1483,730,753,0.49224544841537426,0.5077545515846258
E01012487,1537,743,794,0.483409238776838,0.516590761223162
E01012489,1898,901,997,0.4747102212855637,0.5252897787144363
E01012490,1466,705,761,0.48090040927694405,0.5190995907230559
E01012450,1403,658,745,0.4689950106913756,0.5310049893086244
E01012451,1558,752,806,0.48267008985879334,0.5173299101412067
E01012557,1574,777,797,0.4936467598475222,0.5063532401524777
E01012558,1787,906,881,0.5069949636261891,0.4930050363738109
E01012559,1554,766,788,0.4929214929214929,0.5070785070785071
E01012560,1476,709,767,0.4803523035230352,0.5196476964769647
E01012448,1579,916,663,0.5801139962001267,0.41988600379987334
E01012488,1735,849,886,0.4893371757925072,0.5106628242074928
E01012502,1633,811,822,0.4966319657072872,0.5033680342927128
E01012503,1451,717,734,0.4941419710544452,0.5058580289455548
E01012446,1429,713,716,0.4989503149055283,0.5010496850944717
E01012447,1494,733,761,0.49062918340026773,0.5093708165997323
E01012449,1403,674,729,0.4803991446899501,0.5196008553100498
E01012452,1770,868,902,0.4903954802259887,0.5096045197740113
E01019126,1703,796,907,0.4674104521432766,0.5325895478567234
E01019127,1565,743,822,0.4747603833865815,0.5252396166134186
E01019132,1803,908,895,0.5036051026067665,0.4963948973932335
E01019134,1523,718,805,0.4714379514116875,0.5285620485883126
E01019135,1593,761,832,0.47771500313873194,0.5222849968612681
E01019136,1620,794,826,0.4901234567901235,0.5098765432098765
E01019137,1095,512,583,0.46757990867579907,0.5324200913242009
E01019083,1832,926,906,0.5054585152838428,0.4945414847161572
E01019107,1608,813,795,0.5055970149253731,0.4944029850746269
E01019130,1683,838,845,0.4979203802733215,0.5020796197266786
E01019131,1940,980,960,0.5051546391752577,0.4948453608247423
E01019081,1884,942,942,0.5,0.5
E01019082,1496,721,775,0.481951871657754,0.518048128342246
E01019102,1728,858,870,0.4965277777777778,0.5034722222222222
E01019128,1631,833,798,0.5107296137339056,0.4892703862660944
E01019133,1546,774,772,0.500646830530401,0.49935316946959896
E01019093,1561,779,782,0.49903907751441384,0.5009609224855862
E01019094,1703,829,874,0.4867880211391662,0.5132119788608338
E01019096,2274,1141,1133,0.5017590149516271,0.4982409850483729
E01019114,1472,703,769,0.47758152173913043,0.5224184782608695
E01019115,1609,826,783,0.5133623368551895,0.48663766314481044
E01019095,1536,738,798,0.48046875,0.51953125
E01019097,1803,863,940,0.4786466999445369,0.5213533000554631
E01019098,1644,793,851,0.48236009732360097,0.517639902676399
E01019099,1707,859,848,0.5032220269478618,0.4967779730521383
E01019084,1508,740,768,0.4907161803713528,0.5092838196286472
E01019085,1550,774,776,0.4993548387096774,0.5006451612903225
E01019086,1120,557,563,0.4973214285714286,0.5026785714285714
E01019088,1714,816,898,0.47607934655775963,0.5239206534422404
E01019091,1858,917,941,0.49354144241119485,0.5064585575888052
E01019078,1546,781,765,0.5051746442432082,0.4948253557567917
E01019079,1469,710,759,0.4833219877467665,0.5166780122532335
E01019080,1809,870,939,0.48092868988391374,0.5190713101160862
E01019087,1625,788,837,0.4849230769230769,0.5150769230769231
E01019090,1572,796,776,0.5063613231552163,0.49363867684478374
E01019116,1252,643,609,0.5135782747603834,0.48642172523961663
E01019118,1369,722,647,0.5273922571219869,0.47260774287801316
E01019122,1415,716,699,0.5060070671378092,0.4939929328621908
E01019123,1577,771,806,0.4889029803424223,0.5110970196575777
E01019124,2083,1020,1063,0.4896783485357657,0.5103216514642342
E01019125,1536,751,785,0.4889322916666667,0.5110677083333334
E01019111,1537,765,772,0.4977228366948601,0.5022771633051398
E01019112,1693,844,849,0.4985233313644418,0.5014766686355582
E01019113,1749,804,945,0.45969125214408235,0.5403087478559176
E01019120,1783,891,892,0.4997195737521032,0.5002804262478968
E01019121,1989,1023,966,0.5143288084464555,0.4856711915535445
E01019108,1487,678,809,0.45595158036314726,0.5440484196368527
E01019109,1818,881,937,0.4845984598459846,0.5154015401540154
E01019110,1673,777,896,0.46443514644351463,0.5355648535564853
E01019117,1309,662,647,0.5057295645530939,0.494270435446906
E01019119,1509,730,779,0.48376408217362493,0.5162359178263751
E01019089,1594,764,830,0.479297365119197,0.520702634880803
E01019100,1660,802,858,0.4831325301204819,0.516867469879518
E01019101,1507,743,764,0.4930325149303251,0.5069674850696748
E01019129,1694,841,853,0.4964580873671783,0.5035419126328218
E01019092,1615,812,803,0.5027863777089784,0.4972136222910217
E01019103,1291,607,684,0.4701781564678544,0.5298218435321457
E01019104,1357,653,704,0.4812085482682388,0.5187914517317612
E01019105,1127,568,559,0.5039929015084295,0.49600709849157054
E01019106,1468,706,762,0.48092643051771117,0.5190735694822888
E01019144,1458,731,727,0.5013717421124828,0.49862825788751713
E01019145,2004,992,1012,0.49500998003992014,0.5049900199600799
E01019146,1370,689,681,0.502919708029197,0.49708029197080295
E01019147,1575,773,802,0.4907936507936508,0.5092063492063492
E01019148,1404,701,703,0.49928774928774927,0.5007122507122507
E01019149,1505,748,757,0.49700996677740866,0.5029900332225914
E01019150,1539,760,779,0.49382716049382713,0.5061728395061729
E01019151,1487,718,769,0.4828513786146604,0.5171486213853396
E01019152,1216,597,619,0.4909539473684211,0.509046052631579
E01019153,1074,528,546,0.49162011173184356,0.5083798882681564
E01019154,1253,605,648,0.4828411811652035,0.5171588188347965
E01019155,1379,638,741,0.4626540971718637,0.5373459028281363
E01019162,1472,727,745,0.4938858695652174,0.5061141304347826
E01019163,1315,667,648,0.5072243346007604,0.49277566539923956
E01019156,1423,727,696,0.5108924806746311,0.48910751932536894
E01019159,1052,531,521,0.5047528517110266,0.49524714828897337
E01019164,1451,708,743,0.4879393521709166,0.5120606478290833
E01019165,1408,734,674,0.5213068181818182,0.4786931818181818
E01019166,1371,682,689,0.4974471188913202,0.5025528811086798
E01019167,1483,704,779,0.47471341874578554,0.5252865812542145
E01019168,1395,687,708,0.4924731182795699,0.5075268817204301
E01019169,1349,662,687,0.4907338769458858,0.5092661230541141
E01019170,1282,630,652,0.4914196567862715,0.5085803432137286
E01019171,1320,677,643,0.5128787878787879,0.4871212121212121
E01019161,1752,849,903,0.4845890410958904,0.5154109589041096
E01019176,1704,838,866,0.49178403755868544,0.5082159624413145
E01019177,1400,699,701,0.4992857142857143,0.5007142857142857
E01019178,1509,741,768,0.49105367793240556,0.5089463220675944
E01019179,1229,605,624,0.49227013832384053,0.5077298616761595
E01019140,1051,516,535,0.49096098953377737,0.5090390104662227
E01019160,1380,665,715,0.48188405797101447,0.5181159420289855
E01019172,1383,690,693,0.49891540130151846,0.5010845986984815
E01019173,1320,662,658,0.5015151515151515,0.4984848484848485
E01019174,1163,570,593,0.4901117798796217,0.5098882201203784
E01019175,1436,706,730,0.49164345403899723,0.5083565459610028
E01019141,1228,631,597,0.5138436482084691,0.48615635179153094
E01019142,1431,695,736,0.4856743535988819,0.5143256464011181
E01019143,1612,812,800,0.5037220843672456,0.49627791563275436
E01019157,1444,734,710,0.5083102493074793,0.4916897506925208
E01019158,1193,579,614,0.4853310980720872,0.5146689019279128
E01019180,1859,893,966,0.48036578805809577,0.5196342119419043
E01019182,1383,666,717,0.48156182212581344,0.5184381778741866
E01019184,1335,671,664,0.5026217228464419,0.49737827715355803
E01033160,2102,1026,1076,0.48810656517602286,0.5118934348239772
E01019138,1262,639,623,0.506339144215531,0.4936608557844691
E01019139,1354,753,601,0.5561299852289513,0.44387001477104876
E01019185,1410,709,701,0.5028368794326241,0.4971631205673759
E01019186,1280,609,671,0.47578125,0.52421875
E01019187,1282,611,671,0.4765990639625585,0.5234009360374415
E01019226,1159,579,580,0.4995685936151855,0.5004314063848145
E01019227,1411,710,701,0.5031892274982283,0.4968107725017718
E01019228,1553,805,748,0.5183515775917579,0.4816484224082421
E01019229,1933,967,966,0.5002586652871185,0.4997413347128815
E01019200,1551,773,778,0.498388136686009,0.501611863313991
E01019201,1430,658,772,0.46013986013986014,0.5398601398601398
E01019202,1646,797,849,0.4842041312272175,0.5157958687727825
E01019225,2002,1011,991,0.504995004995005,0.495004995004995
E01019188,1488,724,764,0.48655913978494625,0.5134408602150538
E01019189,1545,779,766,0.5042071197411003,0.49579288025889967
E01019190,1565,768,797,0.4907348242811502,0.5092651757188499
E01019191,1551,739,812,0.4764667956157318,0.5235332043842682
E01019244,1460,682,778,0.4671232876712329,0.5328767123287671
E01019196,1793,868,925,0.4841048522030117,0.5158951477969883
E01019238,1311,619,692,0.47215865751334857,0.5278413424866514
E01019240,1768,911,857,0.5152714932126696,0.4847285067873303
E01019241,1612,790,822,0.49007444168734493,0.5099255583126551
E01019243,1533,704,829,0.4592302674494455,0.5407697325505545
E01019251,1740,826,914,0.4747126436781609,0.5252873563218391
E01019192,1456,706,750,0.4848901098901099,0.5151098901098901
E01019195,1426,664,762,0.46563814866760167,0.5343618513323983
E01019203,2117,1041,1076,0.49173358526216343,0.5082664147378365
E01019254,1356,670,686,0.4941002949852507,0.5058997050147492
E01019255,1366,675,691,0.49414348462664714,0.5058565153733529
E01019204,1276,689,587,0.5399686520376176,0.46003134796238243
E01019206,1470,817,653,0.5557823129251701,0.44421768707482995
E01019234,1547,747,800,0.48287007110536523,0.5171299288946348
E01019235,1487,717,770,0.4821788836583726,0.5178211163416274
E01019237,1485,705,780,0.47474747474747475,0.5252525252525253
E01019242,1329,609,720,0.4582392776523702,0.5417607223476298
E01019219,2157,1054,1103,0.48864163189615206,0.5113583681038479
E01019224,2064,1024,1040,0.49612403100775193,0.5038759689922481
E01019239,1560,751,809,0.4814102564102564,0.5185897435897436
E01019249,1439,691,748,0.48019457956914524,0.5198054204308548
E01019250,1362,660,702,0.4845814977973568,0.5154185022026432
E01019205,1714,815,899,0.47549591598599766,0.5245040840140023
E01019207,1394,682,712,0.48923959827833574,0.5107604017216643
E01019215,1500,750,750,0.5,0.5
E01019218,1575,744,831,0.4723809523809524,0.5276190476190477
E01019233,1332,648,684,0.4864864864864865,0.5135135135135135
E01019193,1516,704,812,0.46437994722955145,0.5356200527704486
E01019194,2093,1026,1067,0.49020544672718586,0.5097945532728141
E01019230,1542,737,805,0.4779507133592737,0.5220492866407264
E01019231,1472,740,732,0.5027173913043478,0.49728260869565216
E01019232,1479,723,756,0.48884381338742394,0.5111561866125761
E01019252,1392,661,731,0.47485632183908044,0.5251436781609196
E01019209,1444,734,710,0.5083102493074793,0.4916897506925208
E01019211,1781,907,874,0.5092644581695677,0.49073554183043233
E01019216,1583,760,823,0.4801010739102969,0.5198989260897031
E01019217,1725,874,851,0.5066666666666667,0.49333333333333335
E01019220,1558,788,770,0.5057766367137355,0.4942233632862644
E01019236,1607,783,824,0.48724331051649034,0.5127566894835096
E01019197,1989,924,1065,0.4645550527903469,0.5354449472096531
E01019198,1350,665,685,0.4925925925925926,0.5074074074074074
E01019199,1062,493,569,0.4642184557438795,0.5357815442561206
E01019221,1964,943,1021,0.480142566191446,0.519857433808554
E01019222,1655,778,877,0.4700906344410876,0.5299093655589124
E01019245,1561,769,792,0.4926329276105061,0.507367072389494
E01019208,1526,735,791,0.481651376146789,0.518348623853211
E01019210,1467,694,773,0.4730743012951602,0.5269256987048399
E01019246,1267,621,646,0.49013417521704816,0.5098658247829518
E01019247,1508,731,777,0.48474801061007955,0.5152519893899205
E01019248,1140,534,606,0.46842105263157896,0.531578947368421
E01019212,1533,750,783,0.4892367906066536,0.5107632093933464
E01019213,2737,1374,1363,0.5020094994519547,0.4979905005480453
E01019214,1781,850,931,0.4772599663110612,0.5227400336889388
E01019223,1536,749,787,0.4876302083333333,0.5123697916666666
E01019253,1793,862,931,0.4807585052983826,0.5192414947016174
E01019268,1130,548,582,0.4849557522123894,0.5150442477876106
E01019269,1566,761,805,0.4859514687100894,0.5140485312899106
E01019270,1362,670,692,0.4919236417033774,0.5080763582966226
E01019297,1448,709,739,0.48964088397790057,0.5103591160220995
E01019260,1507,763,744,0.5063039150630392,0.4936960849369608
E01019280,1561,850,711,0.5445227418321589,0.4554772581678411
E01019281,1237,614,623,0.4963621665319321,0.5036378334680679
E01019282,1307,672,635,0.5141545524100994,0.48584544758990056
E01019261,1756,895,861,0.5096810933940774,0.49031890660592253
E01019262,1746,868,878,0.49713631156930127,0.5028636884306987
E01019284,1255,586,669,0.46693227091633466,0.5330677290836653
E01019285,1571,767,804,0.48822406110757477,0.5117759388924252
E01019286,1319,638,681,0.4836997725549659,0.5163002274450341
E01019287,1208,611,597,0.5057947019867549,0.49420529801324503
E01019288,1477,765,712,0.5179417738659445,0.4820582261340555
E01019256,1500,742,758,0.49466666666666664,0.5053333333333333
E01019263,1138,584,554,0.5131810193321616,0.4868189806678383
E01019264,1701,853,848,0.5014697236919459,0.4985302763080541
E01019265,1281,667,614,0.5206869633099142,0.47931303669008585
E01019266,1471,748,723,0.5084976206662135,0.49150237933378654
E01019267,1345,633,712,0.4706319702602231,0.5293680297397769
E01019276,1025,533,492,0.52,0.48
E01019277,1212,603,609,0.4975247524752475,0.5024752475247525
E01019278,1346,664,682,0.4933135215453195,0.5066864784546805
E01019291,1317,659,658,0.5003796507213364,0.4996203492786636
E01019292,1120,551,569,0.4919642857142857,0.5080357142857143
E01019294,1446,691,755,0.4778699861687414,0.5221300138312587
E01019295,1567,747,820,0.4767070835992342,0.5232929164007658
E01019296,1485,729,756,0.4909090909090909,0.509090909090909
E01019301,1438,724,714,0.5034770514603616,0.4965229485396384
E01019302,1025,515,510,0.5024390243902439,0.4975609756097561
E01019271,1363,661,702,0.48495964783565665,0.5150403521643434
E01019272,1485,709,776,0.47744107744107744,0.5225589225589226
E01019273,1608,825,783,0.5130597014925373,0.4869402985074627
E01019274,1542,779,763,0.5051880674448768,0.49481193255512324
E01019275,2196,1093,1103,0.4977231329690346,0.5022768670309654
E01019257,1498,744,754,0.49666221628838453,0.5033377837116155
E01019258,1526,785,741,0.5144167758846658,0.4855832241153342
E01019279,1396,734,662,0.5257879656160458,0.47421203438395415
E01019300,1801,936,865,0.5197112715158245,0.4802887284841755
E01019303,1523,752,771,0.4937623112278398,0.5062376887721602
E01019304,1300,668,632,0.5138461538461538,0.48615384615384616
E01019259,1300,642,658,0.4938461538461538,0.5061538461538462
E01019283,1849,1182,667,0.6392644672796106,0.3607355327203894
E01019289,1386,664,722,0.4790764790764791,0.5209235209235209
E01019290,1095,546,549,0.4986301369863014,0.5013698630136987
E01019293,1369,679,690,0.4959824689554419,0.504017531044558
E01019298,1514,761,753,0.5026420079260238,0.49735799207397624
E01019299,1985,956,1029,0.48161209068010075,0.5183879093198992
E01019305,2088,1013,1075,0.48515325670498083,0.5148467432950191
E01019314,1273,644,629,0.5058915946582875,0.49410840534171246
E01019320,1471,756,715,0.5139360978925901,0.4860639021074099
E01019321,1562,788,774,0.5044814340588989,0.49551856594110116
E01019315,1699,843,856,0.4961742201294879,0.503825779870512
E01019316,1494,775,719,0.5187416331994645,0.48125836680053546
E01019322,1388,683,705,0.4920749279538905,0.5079250720461095
E01019338,1497,759,738,0.5070140280561122,0.49298597194388777
E01019327,1342,633,709,0.47168405365126675,0.5283159463487332
E01019332,1398,635,763,0.4542203147353362,0.5457796852646638
E01019333,1134,569,565,0.5017636684303352,0.4982363315696649
E01019335,1522,787,735,0.5170827858081471,0.48291721419185285
E01019336,1723,860,863,0.4991294254207777,0.5008705745792222
E01019312,1447,700,747,0.4837595024187975,0.5162404975812025
E01019326,1540,736,804,0.4779220779220779,0.522077922077922
E01019328,1342,631,711,0.470193740685544,0.529806259314456
E01019329,1140,560,580,0.49122807017543857,0.5087719298245614
E01019330,1455,693,762,0.4762886597938144,0.5237113402061856
E01019331,1529,779,750,0.5094833224329627,0.49051667756703726
E01019334,1362,662,700,0.48604992657856094,0.5139500734214391
E01019308,1432,719,713,0.5020949720670391,0.4979050279329609
E01019311,1438,691,747,0.480528511821975,0.519471488178025
E01019313,1374,685,689,0.4985443959243086,0.5014556040756915
E01019339,1422,725,697,0.5098452883263009,0.490154711673699
E01019306,1293,620,673,0.4795050270688322,0.5204949729311679
E01019307,1755,856,899,0.4877492877492878,0.5122507122507123
E01019310,1396,712,684,0.5100286532951289,0.4899713467048711
E01019319,1563,791,772,0.5060780550223928,0.49392194497760716
E01019323,1202,600,602,0.49916805324459235,0.5008319467554077
E01019324,1300,652,648,0.5015384615384615,0.49846153846153846
E01019337,1394,711,683,0.5100430416068866,0.4899569583931133
E01019309,2293,1155,1138,0.5037069341474052,0.49629306585259486
E01019317,1319,660,659,0.5003790750568613,0.49962092494313876
E01019318,1261,606,655,0.48057097541633625,0.5194290245836638
E01019325,1364,666,698,0.48826979472140764,0.5117302052785924
E01019340,1352,678,674,0.5014792899408284,0.4985207100591716
E01019374,1533,746,787,0.4866275277234181,0.5133724722765819
E01019375,1445,722,723,0.4996539792387543,0.5003460207612457
E01019376,1442,733,709,0.5083217753120666,0.49167822468793343
E01019395,2074,948,1126,0.4570877531340405,0.5429122468659595
E01019387,2116,1033,1083,0.4881852551984877,0.5118147448015122
E01019396,2061,1022,1039,0.49587578845220764,0.5041242115477923
E01019397,1975,993,982,0.5027848101265823,0.49721518987341773
E01019398,1192,585,607,0.49077181208053694,0.5092281879194631
E01019399,1057,505,552,0.47776726584673607,0.522232734153264
E01019346,1915,943,972,0.49242819843342034,0.5075718015665797
E01019359,2056,984,1072,0.4785992217898833,0.5214007782101168
E01019365,2201,1113,1088,0.5056792367105861,0.4943207632894139
E01019370,2219,1049,1170,0.47273546642631814,0.5272645335736819
E01019360,2083,1047,1036,0.5026404224675948,0.4973595775324052
E01019363,1926,959,967,0.4979231568016615,0.5020768431983386
E01019364,1935,947,988,0.48940568475452195,0.510594315245478
E01019371,2203,1058,1145,0.4802541988197912,0.5197458011802089
E01019358,1832,862,970,0.4705240174672489,0.5294759825327511
E01019362,1966,940,1026,0.47812817904374366,0.5218718209562564
E01019366,1882,927,955,0.49256110520722635,0.5074388947927736
E01019394,2313,1181,1132,0.5105923043666234,0.48940769563337655
E01019361,1850,885,965,0.4783783783783784,0.5216216216216216
E01019367,2468,1220,1248,0.49432739059967584,0.5056726094003241
E01019368,2110,1023,1087,0.4848341232227488,0.5151658767772512
E01019369,1855,862,993,0.4646900269541779,0.5353099730458221
E01019356,1435,706,729,0.49198606271777,0.50801393728223
E01019381,2114,1068,1046,0.5052034058656575,0.49479659413434246
E01019386,1727,870,857,0.5037637521713955,0.49623624782860454
E01019344,1031,514,517,0.498545101842871,0.501454898157129
E01019345,1174,577,597,0.49148211243611584,0.5085178875638842
E01019350,1617,802,815,0.49598021026592454,0.5040197897340755
E01019351,1753,892,861,0.5088419851682829,0.49115801483171706
E01019372,1057,478,579,0.4522232734153264,0.5477767265846736
E01019373,1447,650,797,0.44920525224602625,0.5507947477539737
E01019384,2601,1395,1206,0.5363321799307958,0.46366782006920415
E01019385,1140,541,599,0.4745614035087719,0.525438596491228
E01019348,1227,612,615,0.49877750611246946,0.5012224938875306
E01019352,2235,1083,1152,0.48456375838926175,0.5154362416107383
E01019377,1748,845,903,0.4834096109839817,0.5165903890160183
E01019383,1975,945,1030,0.47848101265822784,0.5215189873417722
E01019341,1531,730,801,0.4768125408229915,0.5231874591770085
E01019342,1063,491,572,0.4619002822201317,0.5380997177798683
E01019343,1524,730,794,0.479002624671916,0.520997375328084
E01019347,1756,853,903,0.4857630979498861,0.5142369020501139
E01019382,2199,1066,1133,0.4847658026375625,0.5152341973624375
E01019388,1924,919,1005,0.47765072765072764,0.5223492723492723
E01019389,2268,1108,1160,0.48853615520282184,0.5114638447971781
E01019390,1997,972,1025,0.4867300951427141,0.513269904857286
E01019392,1833,897,936,0.48936170212765956,0.5106382978723404
E01019349,1831,869,962,0.474604041507373,0.525395958492627
E01019353,1496,700,796,0.4679144385026738,0.5320855614973262
E01019354,1320,601,719,0.4553030303030303,0.5446969696969697
E01019355,1298,605,693,0.4661016949152542,0.5338983050847458
E01019357,1869,925,944,0.49491706795077584,0.5050829320492242
E01019378,1601,769,832,0.4803247970018738,0.5196752029981262
E01019379,1428,683,745,0.47829131652661067,0.5217086834733894
E01019380,1074,546,528,0.5083798882681564,0.49162011173184356
E01019391,1717,845,872,0.49213744903902157,0.5078625509609784
E01019393,1939,948,991,0.4889118102114492,0.5110881897885508
E01004768,1601,805,796,0.5028107432854466,0.4971892567145534
E01004803,1635,816,819,0.4990825688073395,0.5009174311926605
E01004804,1452,727,725,0.5006887052341598,0.49931129476584024
E01004807,1451,725,726,0.4996554100620262,0.5003445899379738
E01004808,1643,809,834,0.4923919659160073,0.5076080340839927
E01004788,1392,661,731,0.47485632183908044,0.5251436781609196
E01004790,1432,701,731,0.4895251396648045,0.5104748603351955
E01004805,1633,804,829,0.4923453766074709,0.5076546233925291
E01004806,1515,739,776,0.4877887788778878,0.5122112211221123
E01004810,1597,769,828,0.4815278647463995,0.5184721352536005
E01004769,1534,750,784,0.48891786179921776,0.5110821382007823
E01004770,1465,703,762,0.47986348122866895,0.520136518771331
E01004771,1641,813,828,0.4954296160877514,0.5045703839122486
E01004773,1962,1018,944,0.5188583078491336,0.48114169215086644
E01004809,1763,820,943,0.46511627906976744,0.5348837209302325
E01004777,1601,755,846,0.47158026233604,0.52841973766396
E01004881,1437,650,787,0.4523312456506611,0.5476687543493389
E01004888,1322,675,647,0.510590015128593,0.48940998487140697
E01004889,1433,667,766,0.46545708304256805,0.534542916957432
E01004890,1402,669,733,0.47717546362339514,0.5228245363766049
E01004766,1592,795,797,0.4993718592964824,0.5006281407035176
E01004767,1678,815,863,0.4856972586412396,0.5143027413587604
E01004772,1731,821,910,0.47429231658001153,0.5257076834199884
E01004774,1675,809,866,0.4829850746268657,0.5170149253731343
E01004824,1731,896,835,0.5176198729058348,0.4823801270941652
E01004784,1261,628,633,0.4980174464710547,0.5019825535289453
E01004785,1423,680,743,0.47786366830639493,0.5221363316936051
E01004786,1453,687,766,0.4728148657949071,0.5271851342050929
E01004789,1406,686,720,0.4879089615931721,0.5120910384068279
E01004791,1234,570,664,0.4619124797406807,0.5380875202593193
E01004792,1465,711,754,0.4853242320819113,0.5146757679180888
E01004779,1557,769,788,0.4938985228002569,0.5061014771997431
E01004781,1816,897,919,0.493942731277533,0.5060572687224669
E01004882,1362,672,690,0.4933920704845815,0.5066079295154186
E01004883,1431,718,713,0.5017470300489169,0.49825296995108315
E01004884,1470,734,736,0.4993197278911565,0.5006802721088436
E01004864,1550,758,792,0.4890322580645161,0.5109677419354839
E01004867,1517,784,733,0.5168094924192486,0.4831905075807515
E01004921,1561,753,808,0.4823830877642537,0.5176169122357464
E01004924,1538,764,774,0.4967490247074122,0.5032509752925878
E01004925,1516,721,795,0.47559366754617416,0.5244063324538258
E01004778,1186,600,586,0.5059021922428331,0.49409780775716694
E01004780,1987,981,1006,0.4937091092098641,0.5062908907901359
E01004782,1118,524,594,0.46869409660107336,0.5313059033989267
E01004783,1490,749,741,0.5026845637583892,0.49731543624161073
E01004802,1809,882,927,0.48756218905472637,0.5124378109452736
E01004926,1302,570,732,0.4377880184331797,0.5622119815668203
E01004927,2056,1001,1055,0.48686770428015563,0.5131322957198443
E01004929,1975,978,997,0.4951898734177215,0.5048101265822785
E01004820,1601,808,793,0.504684572142411,0.49531542785758903
E01004825,1641,864,777,0.526508226691042,0.473491773308958
E01004826,1586,773,813,0.48738965952080704,0.512610340479193
E01004865,1345,646,699,0.48029739776951674,0.5197026022304833
E01004866,1741,851,890,0.488799540493969,0.511200459506031
E01004840,1652,823,829,0.49818401937046003,0.5018159806295399
E01004841,1720,844,876,0.4906976744186046,0.5093023255813953
E01004842,1702,806,896,0.4735605170387779,0.5264394829612221
E01004919,1505,745,760,0.4950166112956811,0.5049833887043189
E01004920,1584,734,850,0.4633838383838384,0.5366161616161617
E01004787,1608,780,828,0.48507462686567165,0.5149253731343284
E01004793,1617,770,847,0.47619047619047616,0.5238095238095238
E01004794,1775,840,935,0.4732394366197183,0.5267605633802817
E01004795,1498,751,747,0.5013351134846462,0.4986648865153538
E01004797,1371,634,737,0.462436177972283,0.537563822027717
E01004775,1512,756,756,0.5,0.5
E01004885,1366,669,697,0.48975109809663253,0.5102489019033675
E01004886,1383,671,712,0.485177151120752,0.514822848879248
E01004887,1415,695,720,0.4911660777385159,0.508833922261484
E01004868,1679,836,843,0.49791542584871945,0.5020845741512805
E01004869,1674,822,852,0.4910394265232975,0.5089605734767025
E01004870,1889,1029,860,0.5447326627845421,0.4552673372154579
E01004871,1629,857,772,0.5260896255371393,0.47391037446286066
E01004922,1742,866,876,0.4971297359357061,0.5028702640642939
E01004822,1679,822,857,0.48957712924359736,0.5104228707564026
E01004823,1732,865,867,0.49942263279445726,0.5005773672055427
E01004848,1693,923,770,0.5451860602480804,0.4548139397519197
E01033217,1037,565,472,0.5448408871745419,0.45515911282545807
E01033220,1294,728,566,0.5625965996908809,0.437403400309119
E01004818,1589,837,752,0.5267463813719321,0.473253618628068
E01004819,1513,777,736,0.5135492399206874,0.48645076007931265
E01004928,1408,683,725,0.4850852272727273,0.5149147727272727
E01004930,1517,736,781,0.4851680949241925,0.5148319050758076
E01004931,1584,767,817,0.4842171717171717,0.5157828282828283
E01004932,1534,755,779,0.4921773142112125,0.5078226857887875
E01004834,1614,870,744,0.5390334572490706,0.46096654275092935
E01004838,1672,817,855,0.48863636363636365,0.5113636363636364
E01004843,1517,715,802,0.4713249835201055,0.5286750164798946
E01004845,1714,852,862,0.4970828471411902,0.5029171528588098
E01004923,1584,814,770,0.5138888888888888,0.4861111111111111
E01004796,1494,741,753,0.4959839357429719,0.5040160642570282
E01004798,1652,790,862,0.4782082324455206,0.5217917675544794
E01004799,1317,649,668,0.49278663629460895,0.507213363705391
E01004800,1303,644,659,0.49424405218726014,0.5057559478127398
E01004801,1635,756,879,0.46238532110091746,0.5376146788990825
E01004917,2044,978,1066,0.47847358121330724,0.5215264187866928
E01004835,1488,768,720,0.5161290322580645,0.4838709677419355
E01004836,1491,712,779,0.47753185781354796,0.5224681421864521
E01004837,1632,813,819,0.49816176470588236,0.5018382352941176
E01004844,1581,781,800,0.4939911448450348,0.5060088551549652
E01004897,1085,554,531,0.5105990783410138,0.4894009216589862
E01004827,1615,820,795,0.5077399380804953,0.49226006191950467
E01004849,1731,878,853,0.5072212593876372,0.4927787406123628
E01004850,1743,956,787,0.5484796328169822,0.4515203671830178
E01004851,1552,790,762,0.509020618556701,0.49097938144329895
E01004853,1599,831,768,0.5196998123827392,0.4803001876172608
E01004811,1557,773,784,0.4964675658317277,0.5035324341682723
E01004812,1848,958,890,0.5183982683982684,0.4816017316017316
E01004813,1392,701,691,0.5035919540229885,0.4964080459770115
E01004815,1578,801,777,0.5076045627376425,0.4923954372623574
E01004817,1562,823,739,0.5268886043533931,0.4731113956466069
E01004828,1800,910,890,0.5055555555555555,0.49444444444444446
E01004829,1371,693,678,0.5054704595185996,0.49452954048140046
E01004832,1532,761,771,0.49673629242819844,0.5032637075718016
E01004854,1531,783,748,0.511430437622469,0.488569562377531
E01004878,1475,774,701,0.5247457627118645,0.4752542372881356
E01004911,1566,780,786,0.49808429118773945,0.5019157088122606
E01004912,1448,700,748,0.48342541436464087,0.5165745856353591
E01004913,1960,982,978,0.5010204081632653,0.4989795918367347
E01004914,1194,576,618,0.4824120603015075,0.5175879396984925
E01004915,1340,675,665,0.503731343283582,0.4962686567164179
E01004916,1460,671,789,0.45958904109589044,0.5404109589041096
E01004918,1303,664,639,0.5095932463545664,0.4904067536454336
E01004846,1272,630,642,0.49528301886792453,0.5047169811320755
E01004847,2004,959,1045,0.4785429141716567,0.5214570858283433
E01004852,1612,808,804,0.5012406947890818,0.4987593052109181
E01004877,1792,899,893,0.5016741071428571,0.49832589285714285
E01004879,1460,683,777,0.4678082191780822,0.5321917808219178
E01004830,1551,761,790,0.49065119277885233,0.5093488072211476
E01004831,1630,814,816,0.49938650306748467,0.5006134969325153
E01004833,1530,736,794,0.48104575163398694,0.5189542483660131
E01004839,1978,960,1018,0.48533872598584427,0.5146612740141557
E01004814,1456,732,724,0.5027472527472527,0.49725274725274726
E01004855,1483,709,774,0.47808496291301417,0.5219150370869858
E01004856,1422,732,690,0.5147679324894515,0.48523206751054854
E01004857,1506,742,764,0.49269588313413015,0.5073041168658698
E01004891,1594,783,811,0.49121706398996234,0.5087829360100377
E01004893,1532,780,752,0.5091383812010444,0.4908616187989556
E01004894,1840,904,936,0.49130434782608695,0.508695652173913
E01004901,1812,919,893,0.5071743929359823,0.4928256070640177
E01033218,1581,784,797,0.4958886780518659,0.5041113219481341
E01033219,1496,755,741,0.5046791443850267,0.49532085561497324
E01004816,1588,776,812,0.48866498740554154,0.5113350125944585
E01004872,1560,754,806,0.48333333333333334,0.5166666666666667
E01004873,1762,854,908,0.48467650397275824,0.5153234960272418
E01004875,1590,778,812,0.48930817610062893,0.5106918238993711
E01004880,1333,669,664,0.5018754688672168,0.4981245311327832
E01004892,1531,720,811,0.47028086218158066,0.5297191378184193
E01004896,1360,664,696,0.48823529411764705,0.5117647058823529
E01004899,1539,757,782,0.4918778427550357,0.5081221572449642
E01004900,1599,784,815,0.4903064415259537,0.5096935584740463
E01004776,1802,890,912,0.4938956714761376,0.5061043285238623
E01004895,1325,621,704,0.46867924528301885,0.5313207547169811
E01004936,2029,1004,1025,0.4948250369640217,0.5051749630359783
E01004938,1493,734,759,0.4916275954454119,0.5083724045545881
E01004939,1519,760,759,0.500329163923634,0.49967083607636603
E01004858,1600,802,798,0.50125,0.49875
E01004859,1463,664,799,0.4538619275461381,0.5461380724538619
E01004860,1487,713,774,0.47948890383322124,0.5205110961667787
E01004902,1679,835,844,0.4973198332340679,0.5026801667659321
E01004906,1684,847,837,0.5029691211401425,0.4970308788598575
E01004861,1663,806,857,0.4846662657847264,0.5153337342152736
E01004862,1374,655,719,0.47671033478893743,0.5232896652110626
E01004863,1536,748,788,0.4869791666666667,0.5130208333333334
E01004874,1804,879,925,0.48725055432372505,0.5127494456762749
E01004876,1866,910,956,0.48767416934619506,0.5123258306538049
E01004903,1470,713,757,0.4850340136054422,0.5149659863945578
E01004904,1623,810,813,0.49907578558225507,0.5009242144177449
E01004905,1601,785,816,0.49031855090568394,0.509681449094316
E01004907,1301,616,685,0.4734819369715603,0.5265180630284396
E01004908,1347,649,698,0.48181143281366,0.51818856718634
E01004909,1411,682,729,0.4833451452870305,0.5166548547129696
E01004910,2096,1040,1056,0.4961832061068702,0.5038167938931297
E01004933,1329,673,656,0.5063957863054929,0.49360421369450713
E01004934,1518,762,756,0.5019762845849802,0.4980237154150198
E01004935,1770,839,931,0.47401129943502823,0.5259887005649717
E01004937,1524,758,766,0.4973753280839895,0.5026246719160105
E01004940,1463,708,755,0.4839371155160629,0.5160628844839371
E01005014,1462,735,727,0.5027359781121751,0.49726402188782487
E01005015,1523,710,813,0.4661851608667104,0.5338148391332895
E01005016,1517,745,772,0.4911008569545155,0.5088991430454846
E01005017,1733,859,874,0.4956722446624351,0.5043277553375649
E01005018,1503,733,770,0.48769128409846974,0.5123087159015303
E01005021,1229,728,501,0.5923515052888527,0.4076484947111473
E01005019,1502,709,793,0.47203728362183756,0.5279627163781625
E01005023,1309,605,704,0.46218487394957986,0.5378151260504201
E01005046,1435,695,740,0.4843205574912892,0.5156794425087108
E01005048,1687,821,866,0.4866627148784825,0.5133372851215174
E01005020,1465,731,734,0.49897610921501706,0.5010238907849829
E01005022,1597,796,801,0.49843456480901693,0.5015654351909831
E01005047,1475,702,773,0.4759322033898305,0.5240677966101694
E01005049,1695,843,852,0.49734513274336284,0.5026548672566372
E01005051,1574,739,835,0.46950444726810675,0.5304955527318933
E01004976,1547,738,809,0.4770523594053006,0.5229476405946994
E01004977,1721,816,905,0.47414294015107494,0.5258570598489251
E01004978,1688,843,845,0.4994075829383886,0.5005924170616114
E01004981,1455,698,757,0.47972508591065294,0.5202749140893471
E01004982,1449,727,722,0.5017253278122843,0.49827467218771565
E01004961,1545,735,810,0.47572815533980584,0.5242718446601942
E01004965,1227,605,622,0.4930725346373268,0.5069274653626732
E01004966,1777,845,932,0.47552054023635343,0.5244794597636466
E01004967,1284,634,650,0.4937694704049844,0.5062305295950156
E01004963,1472,721,751,0.4898097826086957,0.5101902173913043
E01004968,1576,771,805,0.48921319796954316,0.5107868020304569
E01005050,2041,1003,1038,0.49142577168054874,0.5085742283194512
E01005052,1464,730,734,0.49863387978142076,0.5013661202185792
E01005053,1530,759,771,0.49607843137254903,0.503921568627451
E01004954,1464,713,751,0.4870218579234973,0.5129781420765027
E01004955,1348,683,665,0.5066765578635015,0.49332344213649854
E01004956,1534,766,768,0.49934810951760106,0.500651890482399
E01004957,1748,831,917,0.4754004576659039,0.5245995423340961
E01004960,1514,742,772,0.4900924702774108,0.5099075297225891
E01004958,1400,738,662,0.5271428571428571,0.47285714285714286
E01004959,1658,816,842,0.49215922798552475,0.5078407720144753
E01004979,1544,808,736,0.5233160621761658,0.47668393782383417
E01004980,1286,650,636,0.505443234836703,0.49455676516329705
E01005024,1447,709,738,0.48997926744989634,0.5100207325501037
E01005026,1629,815,814,0.5003069367710252,0.49969306322897483
E01004947,1420,686,734,0.4830985915492958,0.5169014084507042
E01004948,1864,922,942,0.4946351931330472,0.5053648068669528
E01004962,1670,828,842,0.49580838323353293,0.5041916167664671
E01004964,1833,894,939,0.4877250409165303,0.5122749590834698
E01004949,1470,730,740,0.4965986394557823,0.5034013605442177
E01004950,1510,726,784,0.48079470198675495,0.519205298013245
E01004951,1579,761,818,0.4819506016466118,0.5180493983533883
E01004952,1379,674,705,0.4887599709934735,0.5112400290065264
E01004953,1492,711,781,0.4765415549597855,0.5234584450402144
E01005025,1489,759,730,0.5097380792478173,0.49026192075218267
E01005027,1771,908,863,0.51270468661773,0.4872953133822699
E01005028,1863,938,925,0.5034889962426194,0.49651100375738055
E01005029,1851,887,964,0.4792004321988115,0.5207995678011885
E01005000,1555,772,783,0.4964630225080386,0.5035369774919615
E01005001,1339,661,678,0.4936519790888723,0.5063480209111277
E01005005,1404,674,730,0.48005698005698005,0.51994301994302
E01005006,1519,728,791,0.4792626728110599,0.5207373271889401
E01005030,1590,786,804,0.49433962264150944,0.5056603773584906
E01005054,1498,728,770,0.48598130841121495,0.514018691588785
E01005059,1707,840,867,0.492091388400703,0.507908611599297
E01005060,1669,806,863,0.4829239065308568,0.5170760934691432
E01004997,1556,763,793,0.4903598971722365,0.5096401028277635
E01004998,1464,700,764,0.4781420765027322,0.5218579234972678
E01004999,1480,738,742,0.49864864864864866,0.5013513513513513
E01005002,1590,755,835,0.4748427672955975,0.5251572327044025
E01005003,1462,727,735,0.49726402188782487,0.5027359781121751
E01004991,1414,704,710,0.49787835926449786,0.5021216407355021
E01004992,1481,728,753,0.49155975692099935,0.5084402430790007
E01004993,1411,657,754,0.46562721474131824,0.5343727852586818
E01004994,1307,652,655,0.49885233358837033,0.5011476664116297
E01004990,1517,767,750,0.5056031641397495,0.4943968358602505
E01004996,1444,703,741,0.4868421052631579,0.5131578947368421
E01005004,1458,718,740,0.4924554183813443,0.5075445816186557
E01005008,1866,911,955,0.4882100750267953,0.5117899249732047
E01005009,1481,729,752,0.4922349763673194,0.5077650236326806
E01004945,1558,751,807,0.4820282413350449,0.517971758664955
E01005055,1493,739,754,0.49497655726724715,0.5050234427327528
E01005056,1256,634,622,0.5047770700636943,0.49522292993630573
E01005057,1560,752,808,0.48205128205128206,0.517948717948718
E01005058,1333,665,668,0.4988747186796699,0.5011252813203301
E01004995,1543,751,792,0.4867141931302657,0.5132858068697342
E01005010,1621,769,852,0.4743985194324491,0.5256014805675508
E01005012,1711,845,866,0.4938632378725891,0.5061367621274109
E01005013,2378,1183,1195,0.49747687132043733,0.5025231286795626
E01004984,1367,645,722,0.4718361375274323,0.5281638624725676
E01004985,1439,712,727,0.4947880472550382,0.5052119527449618
E01004989,1457,726,731,0.4982841455044612,0.5017158544955388
E01005007,1470,661,809,0.4496598639455782,0.5503401360544218
E01005011,1385,681,704,0.49169675090252707,0.5083032490974729
E01004983,1291,628,663,0.48644461657629745,0.5135553834237025
E01004986,1638,768,870,0.46886446886446886,0.5311355311355311
E01004987,1201,559,642,0.46544546211490423,0.5345545378850958
E01004988,1438,665,773,0.4624478442280946,0.5375521557719054
E01004941,1783,844,939,0.4733595064498037,0.5266404935501963
E01004942,1521,704,817,0.462853385930309,0.537146614069691
E01004943,1631,803,828,0.49233599019006746,0.5076640098099325
E01004944,1615,786,829,0.486687306501548,0.513312693498452
E01004946,1624,743,881,0.45751231527093594,0.5424876847290641
E01004969,1472,765,707,0.5197010869565217,0.48029891304347827
E01004970,1572,770,802,0.48982188295165396,0.510178117048346
E01004971,1519,776,743,0.510862409479921,0.489137590520079
E01005034,1457,695,762,0.4770075497597804,0.5229924502402197
E01004972,1485,709,776,0.47744107744107744,0.5225589225589226
E01004973,1525,762,763,0.499672131147541,0.5003278688524591
E01004975,1521,717,804,0.4714003944773176,0.5285996055226825
E01005039,1486,714,772,0.48048452220726784,0.5195154777927322
E01005045,1599,784,815,0.4903064415259537,0.5096935584740463
E01004974,1427,718,709,0.5031534688156972,0.4968465311843027
E01005033,1528,767,761,0.5019633507853403,0.4980366492146597
E01005036,1816,938,878,0.5165198237885462,0.4834801762114537
E01005037,1422,712,710,0.5007032348804501,0.49929676511954996
E01005031,1463,693,770,0.47368421052631576,0.5263157894736842
E01005032,1256,539,717,0.429140127388535,0.570859872611465
E01005035,1402,675,727,0.4814550641940086,0.5185449358059915
E01005038,1347,654,693,0.48552338530066813,0.5144766146993318
E01005040,1812,918,894,0.5066225165562914,0.49337748344370863
E01005041,1614,799,815,0.4950433705080545,0.5049566294919455
E01005042,1902,920,982,0.48370136698212407,0.5162986330178759
E01005043,1872,896,976,0.47863247863247865,0.5213675213675214
E01005044,1793,935,858,0.5214723926380368,0.4785276073619632
E01005098,1522,712,810,0.46780551905387646,0.5321944809461235
E01005099,1819,811,1008,0.44584936778449696,0.554150632215503
E01005100,1588,722,866,0.45465994962216627,0.5453400503778337
E01005102,1358,647,711,0.47643593519882177,0.5235640648011782
E01005103,1640,771,869,0.47012195121951217,0.5298780487804878
E01005101,1704,792,912,0.4647887323943662,0.5352112676056338
E01005135,1621,772,849,0.47624922887106724,0.5237507711289328
E01005136,1506,709,797,0.4707835325365206,0.5292164674634794
E01005138,1755,879,876,0.5008547008547009,0.49914529914529915
E01005140,2804,1394,1410,0.4971469329529244,0.5028530670470756
E01005139,1726,847,879,0.4907300115874855,0.5092699884125145
E01005141,1738,832,906,0.47871116225546606,0.5212888377445339
E01005251,1594,760,834,0.4767879548306148,0.5232120451693852
E01005252,1834,862,972,0.47001090512540894,0.529989094874591
E01033685,1561,781,780,0.5003203074951954,0.4996796925048046
E01033687,1417,749,668,0.5285815102328864,0.47141848976711365
E01005104,1789,892,897,0.4986025712688653,0.5013974287311347
E01005160,1769,892,877,0.50423968343697,0.49576031656302993
E01005161,1554,750,804,0.4826254826254826,0.5173745173745173
E01005162,1710,856,854,0.5005847953216375,0.4994152046783626
E01005163,1651,857,794,0.5190793458509994,0.4809206541490006
E01005247,1454,690,764,0.47455295735900965,0.5254470426409904
E01005248,1369,633,736,0.46238130021913804,0.537618699780862
E01005249,1846,930,916,0.5037919826652221,0.4962080173347779
E01005250,1781,805,976,0.4519932622122403,0.5480067377877597
E01005253,1585,755,830,0.47634069400630913,0.5236593059936908
E01005254,1598,796,802,0.4981226533166458,0.5018773466833542
E01005164,1571,876,695,0.5576066199872692,0.44239338001273076
E01005205,1987,960,1027,0.48314041268243585,0.5168595873175642
E01005206,1693,886,807,0.5233313644418193,0.47666863555818073
E01005207,1915,951,964,0.4966057441253264,0.5033942558746737
E01005223,1234,620,614,0.5024311183144247,0.49756888168557534
E01005224,1819,897,922,0.4931280923584387,0.5068719076415613
E01005225,1847,924,923,0.5002707092582567,0.4997292907417434
E01005226,1599,761,838,0.47592245153220764,0.5240775484677924
E01005229,1539,745,794,0.48408057179987,0.5159194282001299
E01005145,2711,1452,1259,0.5355957211361121,0.46440427886388785
E01005146,2361,1162,1199,0.4921643371452774,0.5078356628547226
E01005149,1743,914,829,0.5243832472748136,0.47561675272518644
E01005165,2109,1108,1001,0.5253674727358938,0.4746325272641062
E01005166,1862,957,905,0.5139634801288937,0.48603651987110635
E01005167,1985,1025,960,0.5163727959697733,0.4836272040302267
E01005202,1778,852,926,0.47919010123734535,0.5208098987626547
E01005203,1905,997,908,0.5233595800524934,0.47664041994750656
E01005227,1685,834,851,0.49495548961424335,0.5050445103857567
E01005228,1691,819,872,0.48432879952690716,0.5156712004730929
E01033678,1574,794,780,0.5044472681067345,0.49555273189326554
E01033679,1409,739,670,0.524485450674237,0.4755145493257629
E01005256,1995,993,1002,0.49774436090225566,0.5022556390977444
E01005257,1798,846,952,0.47052280311457173,0.5294771968854283
E01005258,1707,844,863,0.4944346807264206,0.5055653192735794
E01005259,1602,739,863,0.4612983770287141,0.5387016229712859
E01005260,1499,754,745,0.5030020013342228,0.4969979986657772
E01005093,1724,826,898,0.4791183294663573,0.5208816705336426
E01005094,1463,689,774,0.4709501025290499,0.5290498974709501
E01005097,1731,804,927,0.464471403812825,0.5355285961871751
E01005255,1609,826,783,0.5133623368551895,0.48663766314481044
E01005261,1642,761,881,0.46345919610231423,0.5365408038976858
E01005129,1461,760,701,0.5201916495550992,0.4798083504449008
E01005132,1480,706,774,0.47702702702702704,0.522972972972973
E01005133,1275,685,590,0.5372549019607843,0.4627450980392157
E01033663,1183,735,448,0.621301775147929,0.378698224852071
E01033684,1203,721,482,0.5993349958437241,0.400665004156276
E01033688,1505,740,765,0.49169435215946844,0.5083056478405316
E01005092,1629,810,819,0.4972375690607735,0.5027624309392266
E01005105,1960,1000,960,0.5102040816326531,0.4897959183673469
E01005106,1877,931,946,0.4960042621204049,0.5039957378795951
E01005107,1803,911,892,0.5052689961175818,0.4947310038824182
E01033668,1136,582,554,0.5123239436619719,0.4876760563380282
E01033669,1397,692,705,0.49534717251252686,0.5046528274874732
E01005108,2630,1259,1371,0.4787072243346008,0.5212927756653992
E01005189,1691,819,872,0.48432879952690716,0.5156712004730929
E01005190,2017,1014,1003,0.5027268220128904,0.49727317798710957
E01033666,2664,1323,1341,0.4966216216216216,0.5033783783783784
E01005061,1648,853,795,0.5175970873786407,0.4824029126213592
E01005062,2893,1449,1444,0.5008641548565503,0.4991358451434497
E01005063,1486,740,746,0.4979811574697174,0.5020188425302826
E01005065,2231,1178,1053,0.528014343343792,0.47198565665620795
E01005066,1700,952,748,0.56,0.44
E01005208,2338,1252,1086,0.5355004277159966,0.4644995722840034
E01005209,2699,1353,1346,0.50129677658392,0.49870322341608003
E01005210,3244,1572,1672,0.4845869297163995,0.5154130702836005
E01005214,2279,1303,976,0.571741992101799,0.42825800789820095
E01005067,1362,678,684,0.4977973568281938,0.5022026431718062
E01005186,2376,1177,1199,0.49537037037037035,0.5046296296296297
E01005232,1867,966,901,0.5174076057846813,0.4825923942153187
E01005235,1760,857,903,0.4869318181818182,0.5130681818181818
E01005239,1762,874,888,0.4960272417707151,0.5039727582292849
E01005187,1926,968,958,0.5025960539979232,0.4974039460020768
E01005188,1714,840,874,0.49008168028004667,0.5099183197199533
E01005191,1657,842,815,0.508147254073627,0.49185274592637296
E01005192,1584,814,770,0.5138888888888888,0.4861111111111111
E01005193,1798,892,906,0.4961067853170189,0.5038932146829811
E01005230,2069,1127,942,0.5447075882068633,0.4552924117931368
E01005231,2626,1303,1323,0.4961919268849962,0.5038080731150039
E01005236,2061,1126,935,0.5463367297428433,0.45366327025715675
E01005237,1994,1091,903,0.5471414242728184,0.4528585757271815
E01033652,1618,805,813,0.49752781211372066,0.5024721878862793
E01033657,1557,773,784,0.4964675658317277,0.5035324341682723
E01005195,1986,924,1062,0.4652567975830816,0.5347432024169184
E01005196,2376,1152,1224,0.48484848484848486,0.5151515151515151
E01005197,1566,828,738,0.5287356321839081,0.47126436781609193
E01005198,1570,771,799,0.4910828025477707,0.5089171974522293
E01005201,2016,1021,995,0.5064484126984127,0.4935515873015873
E01005240,2655,1334,1321,0.5024482109227872,0.4975517890772128
E01005243,2463,1146,1317,0.46528623629719856,0.5347137637028014
E01005245,2410,1181,1229,0.4900414937759336,0.5099585062240664
E01005246,2139,938,1201,0.4385226741467976,0.5614773258532024
E01005241,2428,1243,1185,0.5119439868204283,0.48805601317957165
E01005242,2603,1370,1233,0.5263157894736842,0.47368421052631576
E01005244,2938,1557,1381,0.5299523485364194,0.4700476514635807
E01005285,1299,675,624,0.5196304849884527,0.48036951501154734
E01005288,1728,1007,721,0.5827546296296297,0.41724537037037035
E01005280,1919,966,953,0.5033871808233454,0.4966128191766545
E01005281,2239,1062,1177,0.4743188923626619,0.5256811076373381
E01005284,3436,1642,1794,0.4778812572759022,0.5221187427240978
E01005286,2170,1219,951,0.5617511520737327,0.4382488479262673
E01005287,2131,1097,1034,0.5147817925856405,0.48521820741435945
E01005194,2589,1397,1192,0.5395905755117806,0.46040942448821937
E01005199,2273,1151,1122,0.506379234491861,0.49362076550813905
E01005200,1831,919,912,0.5019115237575096,0.4980884762424904
E01005233,2403,1272,1131,0.529338327091136,0.4706616729088639
E01005234,2046,1054,992,0.5151515151515151,0.48484848484848486
E01005238,2109,1073,1036,0.5087719298245614,0.49122807017543857
E01005297,2449,1223,1226,0.4993875051041241,0.5006124948958759
E01005298,1835,922,913,0.5024523160762943,0.49754768392370574
E01005302,1846,985,861,0.5335861321776815,0.46641386782231853
E01033680,1211,686,525,0.5664739884393064,0.43352601156069365
E01033686,1265,671,594,0.5304347826086957,0.46956521739130436
E01005150,1870,1047,823,0.5598930481283423,0.44010695187165777
E01005151,1485,747,738,0.503030303030303,0.49696969696969695
E01005152,1453,721,732,0.49621472814865797,0.503785271851342
E01005159,1585,780,805,0.4921135646687697,0.5078864353312302
E01005296,1704,866,838,0.5082159624413145,0.49178403755868544
E01005299,1591,785,806,0.49340037712130735,0.5065996228786926
E01005178,1968,1002,966,0.5091463414634146,0.49085365853658536
E01005179,2235,1138,1097,0.50917225950783,0.49082774049217004
E01005180,1847,899,948,0.48673524634542503,0.513264753654575
E01005181,2140,1066,1074,0.4981308411214953,0.5018691588785047
E01005182,1610,760,850,0.4720496894409938,0.5279503105590062
E01005183,1779,827,952,0.46486790331646993,0.5351320966835301
E01005219,2073,1112,961,0.5364206464061746,0.46357935359382535
E01005220,1849,943,906,0.5100054083288263,0.4899945916711736
E01005221,2248,1199,1049,0.5333629893238434,0.4666370106761566
E01005222,2102,1029,1073,0.4895337773549001,0.5104662226450999
E01005184,2121,1017,1104,0.4794908062234795,0.5205091937765205
E01005185,4024,1957,2067,0.48633200795228626,0.5136679920477137
E01005271,2101,1072,1029,0.5102332222751071,0.4897667777248929
E01005282,1852,941,911,0.5080993520518359,0.4919006479481641
E01005283,1481,745,736,0.5030384875084403,0.49696151249155973
E01005154,1581,760,821,0.48070841239721696,0.519291587602783
E01005156,1496,729,767,0.4872994652406417,0.5127005347593583
E01005158,1511,725,786,0.4798146922567836,0.5201853077432164
E01005300,1561,737,824,0.47213324791800126,0.5278667520819987
E01005301,1601,788,813,0.49219237976264835,0.5078076202373517
E01005118,1507,712,795,0.47246184472461844,0.5275381552753815
E01005120,1849,890,959,0.48134126554894535,0.5186587344510546
E01005215,2004,998,1006,0.49800399201596807,0.501996007984032
E01005216,1526,738,788,0.4836173001310616,0.5163826998689384
E01005217,1905,923,982,0.48451443569553804,0.5154855643044619
E01005218,1683,887,796,0.5270350564468211,0.47296494355317886
E01005270,1747,840,907,0.48082427017744706,0.519175729822553
E01005272,1802,813,989,0.451165371809101,0.548834628190899
E01005273,1558,815,743,0.5231065468549422,0.47689345314505777
E01005278,1839,892,947,0.4850462207721588,0.5149537792278412
E01005279,2036,999,1037,0.4906679764243615,0.5093320235756386
E01005305,1795,974,821,0.5426183844011142,0.4573816155988858
E01005309,2297,1107,1190,0.48193295602960384,0.5180670439703962
E01005310,1860,842,1018,0.45268817204301076,0.5473118279569893
E01005311,1769,903,866,0.5104578858111928,0.4895421141888072
E01005312,1811,923,888,0.5096631695196024,0.49033683048039756
E01005082,1548,720,828,0.46511627906976744,0.5348837209302325
E01005153,1663,781,882,0.4696331930246542,0.5303668069753458
E01005155,1411,676,735,0.47909284195605956,0.5209071580439405
E01005157,1591,749,842,0.47077309868007544,0.5292269013199246
E01005274,1766,877,889,0.49660249150622876,0.5033975084937712
E01005275,1695,879,816,0.5185840707964602,0.4814159292035398
E01005276,1602,816,786,0.5093632958801498,0.49063670411985016
E01005277,1729,919,810,0.5315211104684789,0.4684788895315211
E01005076,1483,767,716,0.5171948752528658,0.48280512474713416
E01005081,1770,824,946,0.4655367231638418,0.5344632768361582
E01005083,1710,910,800,0.5321637426900585,0.4678362573099415
E01033670,1252,632,620,0.5047923322683706,0.4952076677316294
E01033671,1709,887,822,0.5190169689877121,0.4809830310122879
E01005125,1596,771,825,0.4830827067669173,0.5169172932330827
E01005304,1810,983,827,0.5430939226519337,0.4569060773480663
E01005306,1546,792,754,0.5122897800776197,0.48771021992238034
E01005307,1971,1044,927,0.5296803652968036,0.4703196347031963
E01005308,1697,833,864,0.4908662345315262,0.5091337654684738
E01005119,1531,727,804,0.47485303723056826,0.5251469627694317
E01005121,1594,745,849,0.46737766624843163,0.5326223337515684
E01005122,1681,787,894,0.4681737061273052,0.5318262938726949
E01005123,1701,809,892,0.4756025867136978,0.5243974132863022
E01005124,1734,781,953,0.45040369088811993,0.5495963091118801
E01005077,1558,730,828,0.4685494223363286,0.5314505776636713
E01005078,1453,745,708,0.5127322780454233,0.48726772195457674
E01005079,1565,748,817,0.4779552715654952,0.5220447284345048
E01005084,2018,973,1045,0.4821605550049554,0.5178394449950446
E01005172,1600,787,813,0.491875,0.508125
E01005173,1547,790,757,0.5106658047834518,0.48933419521654814
E01005174,1570,753,817,0.47961783439490446,0.5203821656050955
E01005175,1605,801,804,0.49906542056074765,0.5009345794392523
E01005176,1806,903,903,0.5,0.5
E01005177,1339,629,710,0.4697535474234503,0.5302464525765497
E01005115,1874,935,939,0.4989327641408751,0.5010672358591248
E01005262,1841,897,944,0.4872351982618142,0.5127648017381857
E01005264,1535,720,815,0.46905537459283386,0.5309446254071661
E01005265,1684,813,871,0.4827790973871734,0.5172209026128266
E01005266,1957,940,1017,0.4803270311701584,0.5196729688298416
E01005126,2034,1004,1030,0.4936086529006883,0.5063913470993117
E01005168,1388,679,709,0.489193083573487,0.510806916426513
E01005169,1367,662,705,0.4842721287490856,0.5157278712509145
E01005170,1531,761,770,0.4970607446113651,0.5029392553886349
E01005171,1697,854,843,0.5032410135533294,0.4967589864466706
E01005263,1633,843,790,0.5162278015921616,0.48377219840783836
E01005267,1551,760,791,0.49000644745325594,0.5099935525467441
E01005268,2018,979,1039,0.48513379583746286,0.5148662041625371
E01005269,1484,715,769,0.48180592991913745,0.5181940700808625
E01005069,1447,696,751,0.4809951624049758,0.5190048375950241
E01005111,1405,644,761,0.4583629893238434,0.5416370106761565
E01005113,1573,797,776,0.5066751430387794,0.4933248569612206
E01005114,1768,845,923,0.47794117647058826,0.5220588235294118
E01005116,1964,924,1040,0.47046843177189407,0.5295315682281059
E01005071,1592,771,821,0.4842964824120603,0.5157035175879398
E01005072,1703,837,866,0.4914856136230182,0.5085143863769818
E01005073,1492,754,738,0.5053619302949062,0.49463806970509383
E01005112,1660,807,853,0.48614457831325303,0.513855421686747
E01005117,2059,1041,1018,0.5055852355512385,0.49441476444876153
E01005085,1567,751,816,0.47925973197192084,0.5207402680280792
E01005086,1811,885,926,0.48868028713418,0.51131971286582
E01005089,1920,891,1029,0.4640625,0.5359375
E01005289,1450,710,740,0.4896551724137931,0.5103448275862069
E01005295,2459,1213,1246,0.49328995526636843,0.5067100447336316
E01005087,2083,970,1113,0.4656745079212674,0.5343254920787326
E01005088,1708,768,940,0.4496487119437939,0.550351288056206
E01005090,1597,746,851,0.46712586098935505,0.532874139010645
E01005091,2159,1037,1122,0.48031496062992124,0.5196850393700787
E01005291,1454,676,778,0.4649243466299862,0.5350756533700137
E01005068,1578,745,833,0.4721166032953105,0.5278833967046895
E01005070,1682,808,874,0.4803804994054697,0.5196195005945303
E01005074,1522,736,786,0.4835742444152431,0.5164257555847569
E01005075,1390,647,743,0.4654676258992806,0.5345323741007194
E01005319,2131,1010,1121,0.47395588925387144,0.5260441107461286
E01005290,1544,763,781,0.49417098445595853,0.5058290155440415
E01005292,1479,692,787,0.4678837052062204,0.5321162947937795
E01005293,1229,592,637,0.4816924328722539,0.5183075671277462
E01005294,1496,739,757,0.4939839572192513,0.5060160427807486
E01005317,1647,804,843,0.48816029143898,0.51183970856102
E01005313,1496,717,779,0.47927807486631013,0.5207219251336899
E01005314,1575,747,828,0.4742857142857143,0.5257142857142857
E01005315,1503,720,783,0.47904191616766467,0.5209580838323353
E01005316,1606,796,810,0.49564134495641343,0.5043586550435866
E01005318,1874,889,985,0.4743863393810032,0.5256136606189968
E01005130,1481,779,702,0.5259959486833221,0.47400405131667794
E01033651,1152,657,495,0.5703125,0.4296875
E01033658,1303,712,591,0.5464313123561013,0.4535686876438987
E01033664,1119,602,517,0.5379803395889187,0.46201966041108133
E01033667,1006,589,417,0.5854870775347912,0.41451292246520877
E01005128,1710,898,812,0.5251461988304094,0.47485380116959064
E01033653,1670,964,706,0.577245508982036,0.4227544910179641
E01033654,2956,1502,1454,0.5081190798376184,0.4918809201623816
E01033659,1336,782,554,0.5853293413173652,0.41467065868263475
E01033661,1155,710,445,0.6147186147186147,0.3852813852813853
E01005143,2602,1368,1234,0.5257494235203689,0.47425057647963104
E01033655,1197,683,514,0.570593149540518,0.429406850459482
E01033665,1212,704,508,0.5808580858085809,0.41914191419141916
E01033676,1668,824,844,0.4940047961630695,0.5059952038369304
E01005212,2110,1074,1036,0.5090047393364929,0.4909952606635071
E01033656,3490,1873,1617,0.5366762177650429,0.463323782234957
E01033662,1335,828,507,0.6202247191011236,0.3797752808988764
E01005142,1912,948,964,0.49581589958158995,0.50418410041841
E01005147,2538,1236,1302,0.48699763593380613,0.5130023640661938
E01033674,2206,1535,671,0.6958295557570263,0.3041704442429737
E01033675,2064,993,1071,0.4811046511627907,0.5188953488372093
E01005213,2189,1192,997,0.544540886249429,0.455459113750571
E01033660,1168,679,489,0.5813356164383562,0.4186643835616438
E01033672,1291,690,601,0.5344694035631293,0.46553059643687067
E01033673,1101,658,443,0.59763851044505,0.40236148955495005
E01033677,1170,694,476,0.5931623931623932,0.40683760683760684
E01033681,1373,796,577,0.5797523670793882,0.4202476329206118
E01033682,1261,741,520,0.5876288659793815,0.41237113402061853
E01033683,1259,756,503,0.6004765687053217,0.3995234312946783
E01005357,1424,698,726,0.4901685393258427,0.5098314606741573
E01005358,1643,762,881,0.46378575776019476,0.5362142422398052
E01005359,1594,791,803,0.49623588456712675,0.5037641154328732
E01005360,1402,669,733,0.47717546362339514,0.5228245363766049
E01005441,1592,756,836,0.4748743718592965,0.5251256281407035
E01005442,1408,681,727,0.4836647727272727,0.5163352272727273
E01005444,1504,702,802,0.46675531914893614,0.5332446808510638
E01005445,1537,742,795,0.4827586206896552,0.5172413793103449
E01005361,1696,824,872,0.4858490566037736,0.5141509433962265
E01005443,1396,680,716,0.4871060171919771,0.5128939828080229
E01005446,1393,680,713,0.4881550610193826,0.5118449389806173
E01005447,1630,762,868,0.46748466257668714,0.5325153374233129
E01005390,1515,734,781,0.4844884488448845,0.5155115511551155
E01005394,1540,741,799,0.4811688311688312,0.5188311688311689
E01005395,1439,711,728,0.49409312022237667,0.5059068797776234
E01005396,1482,733,749,0.49460188933873145,0.5053981106612686
E01005355,1511,737,774,0.4877564526803441,0.5122435473196558
E01005356,1335,638,697,0.4779026217228464,0.5220973782771535
E01005399,1589,796,793,0.500943989930774,0.49905601006922595
E01005403,1679,852,827,0.5074449076831448,0.4925550923168553
E01005410,1550,784,766,0.5058064516129033,0.4941935483870968
E01005411,1548,736,812,0.4754521963824289,0.524547803617571
E01005414,1295,669,626,0.5166023166023166,0.4833976833976834
E01005415,1148,548,600,0.47735191637630664,0.5226480836236934
E01005452,1372,678,694,0.49416909620991256,0.5058309037900874
E01005453,1320,643,677,0.4871212121212121,0.5128787878787879
E01032558,1447,667,780,0.4609536973047685,0.5390463026952315
E01032559,2800,1376,1424,0.49142857142857144,0.5085714285714286
E01005391,1593,806,787,0.5059635907093534,0.49403640929064657
E01005392,1481,706,775,0.47670492910195816,0.5232950708980418
E01005393,1271,607,664,0.4775767112509835,0.5224232887490166
E01005401,1652,804,848,0.48668280871670705,0.513317191283293
E01005397,1459,709,750,0.4859492803289925,0.5140507196710076
E01005398,1548,724,824,0.46770025839793283,0.5322997416020672
E01005400,1503,741,762,0.4930139720558882,0.5069860279441117
E01005402,1533,737,796,0.48075668623613826,0.5192433137638617
E01005335,1289,630,659,0.4887509697439876,0.5112490302560124
E01005337,1963,978,985,0.49821701477330615,0.5017829852266938
E01005339,1463,738,725,0.504442925495557,0.4955570745044429
E01005340,1435,673,762,0.4689895470383275,0.5310104529616725
E01005421,1709,801,908,0.4686951433586893,0.5313048566413107
E01005422,1503,691,812,0.4597471723220226,0.5402528276779773
E01032920,1870,962,908,0.5144385026737968,0.4855614973262032
E01005448,1472,733,739,0.49796195652173914,0.5020380434782609
E01005449,1218,573,645,0.47044334975369456,0.5295566502463054
E01005454,1449,712,737,0.4913733609385783,0.5086266390614217
E01005455,1586,822,764,0.5182849936948297,0.4817150063051702
E01005456,1589,780,809,0.4908747640025173,0.5091252359974827
E01005407,1706,866,840,0.5076201641266119,0.492379835873388
E01005412,1690,853,837,0.5047337278106508,0.4952662721893491
E01005416,1385,695,690,0.5018050541516246,0.4981949458483754
E01005417,1463,698,765,0.47710184552289814,0.5228981544771019
E01005348,1654,814,840,0.4921402660217654,0.5078597339782346
E01005350,2011,1091,920,0.5425161611138737,0.4574838388861263
E01005432,1499,737,762,0.4916611074049366,0.5083388925950634
E01005433,1515,700,815,0.46204620462046203,0.5379537953795379
E01005329,1526,774,752,0.5072083879423329,0.4927916120576671
E01005330,1562,778,784,0.4980793854033291,0.5019206145966709
E01005333,1274,655,619,0.5141287284144427,0.4858712715855573
E01005336,1576,787,789,0.4993654822335025,0.5006345177664975
E01005349,2424,1205,1219,0.4971122112211221,0.5028877887788779
E01005351,1986,976,1010,0.4914400805639476,0.5085599194360524
E01005352,1449,734,715,0.5065562456866805,0.49344375431331955
E01005353,1913,1014,899,0.5300575013068479,0.46994249869315213
E01005354,1764,885,879,0.5017006802721088,0.49829931972789115
E01005327,1932,917,1015,0.4746376811594203,0.5253623188405797
E01005328,1369,703,666,0.5135135135135135,0.4864864864864865
E01005331,1544,775,769,0.5019430051813472,0.49805699481865284
E01005334,1514,749,765,0.4947159841479524,0.5052840158520475
E01005338,1791,848,943,0.4734785036292574,0.5265214963707426
E01005387,1431,714,717,0.4989517819706499,0.5010482180293501
E01005388,1354,640,714,0.4726735598227474,0.5273264401772526
E01005389,1661,818,843,0.49247441300421435,0.5075255869957856
E01005418,1510,752,758,0.49801324503311256,0.5019867549668874
E01005428,1736,892,844,0.5138248847926268,0.4861751152073733
E01005431,1720,829,891,0.4819767441860465,0.5180232558139535
E01005450,1670,811,859,0.48562874251497007,0.51437125748503
E01005451,1336,670,666,0.5014970059880239,0.49850299401197606
E01005408,1771,878,893,0.4957651044607566,0.5042348955392434
E01005409,1658,804,854,0.48492159227985526,0.5150784077201448
E01032922,2477,1205,1272,0.48647557529269275,0.5135244247073072
E01005406,1414,702,712,0.49646393210749645,0.5035360678925035
E01005413,1665,815,850,0.4894894894894895,0.5105105105105106
E01005419,1502,706,796,0.47003994673768307,0.5299600532623169
E01005420,1678,782,896,0.466030989272944,0.533969010727056
E01005321,1609,815,794,0.5065257924176507,0.4934742075823493
E01005326,3008,1448,1560,0.48138297872340424,0.5186170212765957
E01005427,2021,989,1032,0.48936170212765956,0.5106382978723404
E01005429,1818,915,903,0.5033003300330033,0.4966996699669967
E01005430,2394,1180,1214,0.4928989139515455,0.5071010860484545
E01005320,1913,956,957,0.4997386304234187,0.5002613695765813
E01005434,1340,739,601,0.5514925373134328,0.44850746268656716
E01005437,1908,950,958,0.4979035639412998,0.5020964360587002
E01005459,1358,636,722,0.4683357879234168,0.5316642120765832
E01005383,1968,942,1026,0.47865853658536583,0.5213414634146342
E01005386,1388,656,732,0.47262247838616717,0.5273775216138329
E01032556,1439,724,715,0.5031271716469771,0.49687282835302293
E01032557,1654,759,895,0.4588875453446191,0.5411124546553809
E01005342,1336,642,694,0.4805389221556886,0.5194610778443114
E01005343,1393,660,733,0.4737975592246949,0.5262024407753051
E01005344,1499,709,790,0.47298198799199465,0.5270180120080054
E01005381,1511,729,782,0.4824619457313038,0.5175380542686963
E01005332,2295,1093,1202,0.47625272331154683,0.5237472766884531
E01005341,1459,747,712,0.5119945167923236,0.4880054832076765
E01005345,1506,760,746,0.5046480743691899,0.4953519256308101
E01005346,1433,705,728,0.4919748778785764,0.5080251221214236
E01005347,1345,679,666,0.5048327137546469,0.49516728624535317
E01005322,1267,598,669,0.47198105761641673,0.5280189423835833
E01005323,1397,705,692,0.5046528274874732,0.49534717251252686
E01005324,1469,668,801,0.4547311095983662,0.5452688904016337
E01005325,1001,473,528,0.4725274725274725,0.5274725274725275
E01005438,2331,1188,1143,0.5096525096525096,0.49034749034749037
E01005377,1327,629,698,0.4740015071590053,0.5259984928409948
E01005379,1272,547,725,0.4300314465408805,0.5699685534591195
E01005380,1509,707,802,0.4685222001325381,0.5314777998674619
E01005382,1453,718,735,0.4941500344115623,0.5058499655884378
E01005439,1519,737,782,0.48518762343647137,0.5148123765635286
E01005362,1462,715,747,0.4890560875512996,0.5109439124487004
E01005364,1674,817,857,0.48805256869773,0.51194743130227
E01005368,1542,731,811,0.47405966277561606,0.5259403372243839
E01005376,1288,604,684,0.468944099378882,0.531055900621118
E01005378,1494,733,761,0.49062918340026773,0.5093708165997323
E01005363,1539,757,782,0.4918778427550357,0.5081221572449642
E01005369,1494,698,796,0.46720214190093706,0.5327978580990629
E01005370,1437,692,745,0.4815588030619346,0.5184411969380655
E01005371,1331,652,679,0.4898572501878287,0.5101427498121713
E01005365,1456,729,727,0.5006868131868132,0.4993131868131868
E01005366,1514,686,828,0.45310435931307796,0.5468956406869221
E01005367,1474,716,758,0.48575305291723203,0.514246947082768
E01005440,1334,638,696,0.4782608695652174,0.5217391304347826
E01005372,1191,578,613,0.48530646515533166,0.5146935348446684
E01005373,1201,581,620,0.48376353039134057,0.5162364696086594
E01005374,1443,701,742,0.4857934857934858,0.5142065142065142
E01005375,1469,718,751,0.48876786929884275,0.5112321307011573
E01005435,1913,981,932,0.512807109252483,0.487192890747517
E01005436,1699,807,892,0.4749852854620365,0.5250147145379636
E01005460,2356,1163,1193,0.4936332767402377,0.5063667232597623
E01005461,2385,1177,1208,0.49350104821802937,0.5064989517819707
E01005462,1856,948,908,0.5107758620689655,0.4892241379310345
E01005463,1122,582,540,0.5187165775401069,0.48128342245989303
E01032921,2578,1359,1219,0.5271528316524438,0.47284716834755625
E01005518,1425,722,703,0.5066666666666667,0.49333333333333335
E01005520,1758,850,908,0.48350398179749715,0.5164960182025028
E01005522,1344,631,713,0.4694940476190476,0.5305059523809523
E01005523,1936,956,980,0.493801652892562,0.506198347107438
E01005519,1558,790,768,0.5070603337612324,0.49293966623876767
E01005594,1455,713,742,0.49003436426116836,0.5099656357388316
E01005597,1600,771,829,0.481875,0.518125
E01005598,1562,769,793,0.49231754161331626,0.5076824583866837
E01005516,1413,674,739,0.4769992922859165,0.5230007077140835
E01005517,1506,718,788,0.4767596281540505,0.5232403718459495
E01005521,1427,676,751,0.47372109320252276,0.5262789067974772
E01005596,1925,970,955,0.5038961038961038,0.4961038961038961
E01005578,1444,720,724,0.4986149584487535,0.5013850415512465
E01005579,1674,818,856,0.4886499402628435,0.5113500597371565
E01005586,1523,747,776,0.49047931713722914,0.5095206828627709
E01005593,1546,733,813,0.4741267787839586,0.5258732212160414
E01005595,1420,679,741,0.478169014084507,0.5218309859154929
E01005489,1189,572,617,0.48107653490328006,0.5189234650967199
E01005490,1513,925,588,0.6113681427627231,0.38863185723727695
E01005491,1469,711,758,0.48400272294077606,0.5159972770592239
E01005493,1608,774,834,0.48134328358208955,0.5186567164179104
E01005494,1750,830,920,0.4742857142857143,0.5257142857142857
E01005495,1660,762,898,0.45903614457831327,0.5409638554216868
E01005488,1593,788,805,0.49466415568110483,0.5053358443188951
E01005492,1557,760,797,0.4881181759794477,0.5118818240205524
E01005499,1483,741,742,0.4996628455832771,0.5003371544167229
E01005571,1565,766,799,0.4894568690095847,0.5105431309904154
E01005570,1275,608,667,0.4768627450980392,0.5231372549019608
E01005572,1647,808,839,0.49058894960534305,0.509411050394657
E01005573,1502,746,756,0.4966711051930759,0.5033288948069241
E01005574,1677,845,832,0.5038759689922481,0.49612403100775193
E01005587,1467,709,758,0.4832992501704158,0.5167007498295841
E01005588,1377,627,750,0.4553376906318083,0.5446623093681917
E01005580,1580,771,809,0.4879746835443038,0.5120253164556962
E01005581,1588,793,795,0.4993702770780856,0.5006297229219143
E01005583,1689,844,845,0.4997039668442866,0.5002960331557135
E01005585,1419,733,686,0.5165609584214236,0.4834390415785765
E01033258,2981,1527,1454,0.5122442133512244,0.48775578664877556
E01005496,1354,673,681,0.49704579025110784,0.5029542097488922
E01005589,1522,749,773,0.4921156373193167,0.5078843626806833
E01005590,1652,806,846,0.48789346246973364,0.5121065375302664
E01005591,1426,641,785,0.44950911640953717,0.5504908835904628
E01005592,1610,763,847,0.47391304347826085,0.5260869565217391
E01005472,1547,744,803,0.48093083387201035,0.5190691661279897
E01005473,1513,753,760,0.4976867151354924,0.5023132848645075
E01005482,2056,1203,853,0.5851167315175098,0.4148832684824903
E01005483,1882,1006,876,0.5345377258235919,0.46546227417640806
E01005484,2119,1122,997,0.5294950448324681,0.4705049551675319
E01005486,1606,787,819,0.4900373599003736,0.5099626400996264
E01005487,1717,838,879,0.48806057076295867,0.5119394292370414
E01005474,1290,618,672,0.4790697674418605,0.5209302325581395
E01005575,1636,799,837,0.4883863080684597,0.5116136919315404
E01005576,1517,762,755,0.5023071852340145,0.4976928147659855
E01005577,1482,715,767,0.4824561403508772,0.5175438596491229
E01005469,1804,881,923,0.4883592017738359,0.511640798226164
E01005563,1811,898,913,0.4958586416344561,0.5041413583655439
E01005565,1564,768,796,0.49104859335038364,0.5089514066496164
E01005566,2148,989,1159,0.46042830540037244,0.5395716945996276
E01005568,1674,855,819,0.510752688172043,0.489247311827957
E01005569,1635,808,827,0.4941896024464832,0.5058103975535169
E01005556,1539,777,762,0.5048732943469786,0.4951267056530214
E01005559,1586,780,806,0.4918032786885246,0.5081967213114754
E01005560,1551,746,805,0.4809800128949065,0.5190199871050934
E01005567,1459,711,748,0.4873200822481151,0.5126799177518848
E01005555,1366,695,671,0.5087847730600292,0.4912152269399707
E01005557,1212,584,628,0.48184818481848185,0.5181518151815182
E01005558,1644,809,835,0.49209245742092456,0.5079075425790754
E01005561,1362,652,710,0.4787077826725404,0.5212922173274597
E01005562,1525,738,787,0.4839344262295082,0.5160655737704918
E01005470,1772,890,882,0.5022573363431151,0.49774266365688485
E01005471,1606,772,834,0.4806973848069738,0.5193026151930261
E01005475,1665,837,828,0.5027027027027027,0.4972972972972973
E01005485,2151,1094,1057,0.5086006508600651,0.49139934913993494
E01005564,1938,965,973,0.4979360165118679,0.5020639834881321
E01005464,1752,856,896,0.4885844748858447,0.5114155251141552
E01005465,1716,835,881,0.4865967365967366,0.5134032634032634
E01005466,2313,1146,1167,0.49546044098573283,0.5045395590142672
E01005467,1722,789,933,0.45818815331010454,0.5418118466898955
E01005468,1544,757,787,0.49028497409326427,0.5097150259067358
E01005476,1637,824,813,0.5033598045204642,0.49664019547953575
E01005477,1676,802,874,0.4785202863961814,0.5214797136038186
E01005478,1591,750,841,0.4714016341923319,0.5285983658076682
E01005479,1761,840,921,0.47700170357751276,0.5229982964224872
E01005480,1624,755,869,0.4649014778325123,0.5350985221674877
E01005481,1727,785,942,0.45454545454545453,0.5454545454545454
E01005497,1577,760,817,0.4819277108433735,0.5180722891566265
E01005501,1567,775,792,0.49457562220804085,0.5054243777919591
E01005502,1534,733,801,0.47783572359843546,0.5221642764015645
E01005504,1508,720,788,0.47745358090185674,0.5225464190981433
E01005505,1707,798,909,0.46748681898066785,0.5325131810193322
E01005509,1790,936,854,0.5229050279329609,0.4770949720670391
E01005510,1148,560,588,0.4878048780487805,0.5121951219512195
E01005511,1246,619,627,0.4967897271268058,0.5032102728731942
E01005512,1545,788,757,0.510032362459547,0.4899676375404531
E01005513,1336,615,721,0.46032934131736525,0.5396706586826348
E01005514,1510,739,771,0.48940397350993375,0.5105960264900662
E01005515,1705,766,939,0.449266862170088,0.5507331378299121
E01005498,1464,704,760,0.4808743169398907,0.5191256830601093
E01005500,1608,765,843,0.47574626865671643,0.5242537313432836
E01005503,1310,669,641,0.5106870229007634,0.48931297709923666
E01005506,1592,786,806,0.4937185929648241,0.5062814070351759
E01005507,1574,734,840,0.4663278271918678,0.5336721728081322
E01005508,1866,914,952,0.48981779206859594,0.5101822079314041
E01005524,1489,723,766,0.4855607790463398,0.5144392209536601
E01005525,1602,800,802,0.4993757802746567,0.5006242197253433
E01005526,1584,773,811,0.4880050505050505,0.5119949494949495
E01005528,1499,730,769,0.48699132755170116,0.5130086724482988
E01005536,1603,753,850,0.4697442295695571,0.5302557704304429
E01005543,1321,628,693,0.4753974261922786,0.5246025738077215
E01005527,1498,708,790,0.472630173564753,0.527369826435247
E01005529,1610,744,866,0.462111801242236,0.537888198757764
E01005551,1726,804,922,0.46581691772885286,0.5341830822711472
E01005552,1990,946,1044,0.47537688442211057,0.5246231155778894
E01005553,1831,874,957,0.4773347897323867,0.5226652102676134
E01005554,1343,659,684,0.49069247952345496,0.509307520476545
E01005534,1493,743,750,0.49765572672471536,0.5023442732752846
E01005535,1580,805,775,0.509493670886076,0.49050632911392406
E01005537,1363,714,649,0.5238444607483492,0.4761555392516508
E01005538,1509,710,799,0.47051027170311466,0.5294897282968853
E01005540,1334,654,680,0.49025487256371814,0.5097451274362819
E01005541,1621,801,820,0.49413942011104256,0.5058605798889574
E01005542,1326,638,688,0.48114630467571645,0.5188536953242836
E01005533,1640,800,840,0.4878048780487805,0.5121951219512195
E01005539,1354,693,661,0.5118168389955687,0.4881831610044313
E01005546,1237,596,641,0.48181083265966046,0.5181891673403395
E01005547,1450,708,742,0.4882758620689655,0.5117241379310344
E01005548,1284,656,628,0.5109034267912772,0.48909657320872274
E01005530,1437,688,749,0.47877522616562285,0.5212247738343772
E01005531,1165,560,605,0.48068669527896996,0.51931330472103
E01005532,1435,669,766,0.4662020905923345,0.5337979094076655
E01005544,1470,713,757,0.4850340136054422,0.5149659863945578
E01005545,1227,594,633,0.4841075794621027,0.5158924205378973
E01005549,1562,746,816,0.47759282970550576,0.5224071702944942
E01005550,1420,687,733,0.4838028169014085,0.5161971830985915
E01005659,1444,715,729,0.4951523545706371,0.5048476454293629
E01005660,1470,701,769,0.47687074829931975,0.5231292517006803
E01005663,1376,681,695,0.4949127906976744,0.5050872093023255
E01005664,1487,696,791,0.46805648957632817,0.5319435104236718
E01005665,1470,682,788,0.4639455782312925,0.5360544217687074
E01005703,1544,789,755,0.5110103626943006,0.4889896373056995
E01005704,1405,688,717,0.4896797153024911,0.5103202846975089
E01005706,1494,686,808,0.45917001338688085,0.5408299866131191
E01005708,1491,722,769,0.4842387659289068,0.5157612340710932
E01005702,2127,1027,1100,0.4828396803008933,0.5171603196991067
E01005705,1868,892,976,0.47751605995717344,0.5224839400428265
E01005707,1718,865,853,0.5034924330616997,0.49650756693830034
E01005661,1789,868,921,0.48518725544997204,0.5148127445500279
E01005662,1519,704,815,0.46346280447662935,0.5365371955233706
E01005709,1391,661,730,0.47519769949676494,0.5248023005032351
E01005710,1509,708,801,0.4691848906560636,0.5308151093439364
E01005670,1663,785,878,0.4720384846662658,0.5279615153337343
E01005672,1369,652,717,0.4762600438276114,0.5237399561723886
E01005676,1276,620,656,0.48589341692789967,0.5141065830721003
E01005677,1540,750,790,0.487012987012987,0.512987012987013
E01005686,1439,713,726,0.4954829742876998,0.5045170257123002
E01005688,1591,807,784,0.507228158390949,0.4927718416090509
E01005691,1472,748,724,0.5081521739130435,0.49184782608695654
E01005692,1306,640,666,0.4900459418070444,0.5099540581929556
E01005711,1505,751,754,0.49900332225913624,0.5009966777408638
E01005712,1620,794,826,0.4901234567901235,0.5098765432098765
E01005713,1415,653,762,0.4614840989399293,0.5385159010600706
E01005714,1438,681,757,0.47357440890125174,0.5264255910987483
E01005715,1652,822,830,0.4975786924939467,0.5024213075060533
E01005718,1680,849,831,0.5053571428571428,0.49464285714285716
E01005673,1437,711,726,0.49478079331941544,0.5052192066805845
E01005675,2564,1720,844,0.6708268330733229,0.3291731669266771
E01005678,1519,741,778,0.4878209348255431,0.5121790651744569
E01005679,1594,769,825,0.48243412797992474,0.5175658720200753
E01005687,1752,860,892,0.4908675799086758,0.5091324200913242
E01005689,1438,679,759,0.4721835883171071,0.527816411682893
E01005690,1555,757,798,0.4868167202572347,0.5131832797427652
E01005693,1402,659,743,0.47004279600570614,0.5299572039942939
E01005646,1577,770,807,0.48826886493341787,0.5117311350665821
E01005649,1717,856,861,0.49854397204426326,0.5014560279557367
E01005650,1582,839,743,0.5303413400758533,0.4696586599241466
E01005651,2121,1010,1111,0.47619047619047616,0.5238095238095238
E01005647,1621,739,882,0.45589142504626773,0.5441085749537322
E01005648,1817,924,893,0.5085305448541552,0.4914694551458448
E01005652,1398,660,738,0.4721030042918455,0.5278969957081545
E01005653,1518,696,822,0.45849802371541504,0.541501976284585
E01005671,1503,736,767,0.48968729208250167,0.5103127079174984
E01005674,1446,694,752,0.47994467496542187,0.5200553250345782
E01005694,1741,836,905,0.48018380241240666,0.5198161975875933
E01005696,1521,734,787,0.482577251808021,0.517422748191979
E01005698,1657,799,858,0.4821967410983706,0.5178032589016295
E01005700,1538,746,792,0.4850455136540962,0.5149544863459038
E01005716,1770,893,877,0.5045197740112994,0.49548022598870056
E01005717,1568,778,790,0.4961734693877551,0.5038265306122449
E01005734,1357,644,713,0.4745762711864407,0.5254237288135594
E01005735,1393,701,692,0.5032304379038047,0.49676956209619527
E01005736,1420,711,709,0.5007042253521127,0.4992957746478873
E01005737,1507,746,761,0.49502322495023227,0.5049767750497678
E01005739,1531,736,795,0.480731548007838,0.519268451992162
E01005695,1578,783,795,0.49619771863117873,0.5038022813688213
E01005697,1563,766,797,0.49008317338451696,0.5099168266154831
E01005738,1766,876,890,0.4960362400906002,0.5039637599093998
E01005740,1556,755,801,0.4852185089974293,0.5147814910025706
E01005741,1642,785,857,0.47807551766138856,0.5219244823386114
E01005742,1587,759,828,0.4782608695652174,0.5217391304347826
E01005625,1329,626,703,0.4710308502633559,0.5289691497366441
E01005627,1178,569,609,0.4830220713073005,0.5169779286926995
E01005699,1494,734,760,0.49129852744310576,0.5087014725568942
E01005701,1593,777,816,0.487758945386064,0.512241054613936
E01005609,1787,874,913,0.4890878567431449,0.5109121432568551
E01005611,1942,992,950,0.5108135942327497,0.48918640576725025
E01005612,2038,1043,995,0.5117762512266928,0.48822374877330715
E01005613,2280,1211,1069,0.531140350877193,0.46885964912280703
E01005614,1940,957,983,0.493298969072165,0.506701030927835
E01005615,1958,998,960,0.5097037793667007,0.4902962206332993
E01005624,1669,791,878,0.47393648891551826,0.5260635110844817
E01005680,1425,735,690,0.5157894736842106,0.4842105263157895
E01005683,1600,741,859,0.463125,0.536875
E01032919,3668,1949,1719,0.5313522355507089,0.4686477644492912
E01005622,1452,684,768,0.47107438016528924,0.5289256198347108
E01005623,1261,635,626,0.5035685963521015,0.4964314036478985
E01005626,1311,640,671,0.4881769641495042,0.5118230358504958
E01005628,1616,835,781,0.5167079207920792,0.4832920792079208
E01005725,1378,648,730,0.4702467343976778,0.5297532656023222
E01005726,1500,714,786,0.476,0.524
E01005727,1337,664,673,0.49663425579655945,0.5033657442034405
E01005728,1353,663,690,0.49002217294900224,0.5099778270509978
E01005733,1370,657,713,0.47956204379562045,0.5204379562043796
E01005631,1509,842,667,0.5579854208084825,0.44201457919151754
E01005632,2112,1043,1069,0.49384469696969696,0.506155303030303
E01005633,1393,679,714,0.48743718592964824,0.5125628140703518
E01005634,1472,722,750,0.4904891304347826,0.5095108695652174
E01005635,1577,788,789,0.49968294229549776,0.5003170577045022
E01005636,1553,771,782,0.49645846748229233,0.5035415325177076
E01005637,1314,646,668,0.4916286149162861,0.5083713850837138
E01005629,1311,637,674,0.4858886346300534,0.5141113653699466
E01005630,1495,699,796,0.46755852842809364,0.5324414715719064
E01005719,1741,878,863,0.5043078690407812,0.4956921309592188
E01005720,2384,1177,1207,0.4937080536912752,0.5062919463087249
E01005722,1778,845,933,0.4752530933633296,0.5247469066366705
E01005723,1469,685,784,0.46630360789652825,0.5336963921034718
E01005724,1479,715,764,0.4834347532116295,0.5165652467883706
E01005610,1261,622,639,0.49325931800158607,0.5067406819984139
E01032684,1809,1012,797,0.5594250967385296,0.4405749032614704
E01032687,1285,740,545,0.5758754863813229,0.42412451361867703
E01032906,1243,764,479,0.6146419951729686,0.38535800482703136
E01032907,1185,678,507,0.5721518987341773,0.4278481012658228
E01032909,1325,732,593,0.5524528301886793,0.44754716981132076
E01032911,1154,619,535,0.5363951473136915,0.46360485268630847
E01033330,1396,837,559,0.5995702005730659,0.4004297994269341
E01005654,1420,727,693,0.5119718309859155,0.4880281690140845
E01005656,1497,735,762,0.4909819639278557,0.5090180360721442
E01005657,1446,751,695,0.5193637621023514,0.4806362378976487
E01005721,1436,775,661,0.5396935933147632,0.46030640668523676
E01005655,1368,717,651,0.5241228070175439,0.4758771929824561
E01005658,1415,662,753,0.4678445229681979,0.5321554770318021
E01005681,1580,839,741,0.5310126582278482,0.4689873417721519
E01005682,1515,904,611,0.5966996699669967,0.4033003300330033
E01005729,1308,690,618,0.5275229357798165,0.4724770642201835
E01005730,1646,798,848,0.4848116646415553,0.5151883353584447
E01005731,1594,774,820,0.48557089084065247,0.5144291091593476
E01005732,1142,557,585,0.48774080560420313,0.5122591943957968
E01005599,1610,847,763,0.5260869565217391,0.47391304347826085
E01005600,1467,732,735,0.49897750511247446,0.5010224948875256
E01005601,1574,766,808,0.4866581956797967,0.5133418043202033
E01005602,1352,671,681,0.496301775147929,0.503698224852071
E01005603,1580,767,813,0.4854430379746835,0.5145569620253164
E01005604,1523,726,797,0.4766907419566645,0.5233092580433355
E01005605,1383,700,683,0.5061460592913956,0.4938539407086045
E01005638,1558,765,793,0.4910141206675225,0.5089858793324775
E01005667,1828,889,939,0.4863238512035011,0.5136761487964989
E01032685,1494,859,635,0.5749665327978581,0.4250334672021419
E01032686,1396,826,570,0.5916905444126075,0.40830945558739257
E01032912,1481,755,726,0.5097906819716408,0.4902093180283592
E01032914,1602,895,707,0.5586766541822722,0.44132334581772786
E01032915,1547,751,796,0.4854557207498384,0.5145442792501616
E01032917,1056,626,430,0.5928030303030303,0.4071969696969697
E01005639,1566,736,830,0.46998722860791825,0.5300127713920817
E01005640,1456,703,753,0.48282967032967034,0.5171703296703297
E01005641,1423,686,737,0.4820801124385102,0.5179198875614898
E01005642,1227,602,625,0.4906275468622657,0.5093724531377343
E01005643,1404,666,738,0.47435897435897434,0.5256410256410257
E01005644,1583,790,793,0.4990524320909665,0.5009475679090335
E01005645,1445,716,729,0.4955017301038062,0.5044982698961937
E01005616,1461,710,751,0.485968514715948,0.5140314852840521
E01005617,1536,735,801,0.478515625,0.521484375
E01005618,1485,680,805,0.45791245791245794,0.5420875420875421
E01005619,1298,654,644,0.5038520801232665,0.49614791987673346
E01005620,2531,1277,1254,0.5045436586329514,0.4954563413670486
E01005621,1652,837,815,0.5066585956416465,0.4933414043583535
E01005886,1496,717,779,0.47927807486631013,0.5207219251336899
E01005888,1522,707,815,0.4645203679369251,0.5354796320630749
E01005889,1472,680,792,0.46195652173913043,0.5380434782608695
E01005891,1293,634,659,0.4903325599381284,0.5096674400618716
E01005894,1405,689,716,0.4903914590747331,0.5096085409252669
E01005887,1498,703,795,0.46929238985313754,0.5307076101468625
E01005890,1478,706,772,0.4776725304465494,0.5223274695534507
E01005893,1697,864,833,0.5091337654684738,0.4908662345315262
E01005896,1666,852,814,0.5114045618247299,0.4885954381752701
E01005919,1602,728,874,0.4544319600499376,0.5455680399500624
E01005862,1561,773,788,0.4951953875720692,0.5048046124279308
E01005892,1311,661,650,0.5041952707856598,0.4958047292143402
E01005895,1150,535,615,0.4652173913043478,0.5347826086956522
E01005920,1562,769,793,0.49231754161331626,0.5076824583866837
E01005921,1392,652,740,0.46839080459770116,0.5316091954022989
E01005922,1406,669,737,0.47581792318634425,0.5241820768136558
E01005753,1671,756,915,0.4524236983842011,0.547576301615799
E01005754,1791,931,860,0.519821328866555,0.480178671133445
E01005755,1635,802,833,0.490519877675841,0.5094801223241591
E01005756,1589,789,800,0.49653870358716173,0.5034612964128382
E01005745,1433,726,707,0.5066294487090021,0.4933705512909979
E01005746,1418,706,712,0.4978843441466855,0.5021156558533145
E01005747,1454,727,727,0.5,0.5
E01005748,1536,774,762,0.50390625,0.49609375
E01005863,1744,871,873,0.4994266055045872,0.5005733944954128
E01005864,1481,748,733,0.5050641458474004,0.4949358541525996
E01005866,1713,915,798,0.5341506129597198,0.4658493870402802
E01005869,1508,715,793,0.47413793103448276,0.5258620689655172
E01005914,1426,731,695,0.5126227208976157,0.48737727910238426
E01005915,1489,740,749,0.49697783747481533,0.5030221625251847
E01005916,1565,787,778,0.5028753993610223,0.4971246006389776
E01005917,1619,798,821,0.4928968499073502,0.5071031500926498
E01005859,1459,728,731,0.498971898560658,0.5010281014393421
E01005865,1471,733,738,0.4983004758667573,0.5016995241332427
E01005867,1458,698,760,0.4787379972565158,0.5212620027434842
E01005868,1498,745,753,0.49732977303070763,0.5026702269692924
E01005743,1353,667,686,0.49297856614929786,0.5070214338507022
E01005744,1438,687,751,0.47774687065368565,0.5222531293463143
E01005749,1647,807,840,0.4899817850637523,0.5100182149362478
E01005750,1697,820,877,0.48320565704183854,0.5167943429581615
E01005751,1314,661,653,0.5030441400304414,0.4969558599695586
E01005897,1495,739,756,0.494314381270903,0.505685618729097
E01005898,1603,770,833,0.48034934497816595,0.519650655021834
E01005900,1549,751,798,0.48482892188508714,0.5151710781149128
E01005903,1438,716,722,0.49791376912378305,0.502086230876217
E01005904,1462,713,749,0.48768809849521205,0.512311901504788
E01005853,1570,754,816,0.4802547770700637,0.5197452229299363
E01005856,1619,795,824,0.49104385423100677,0.5089561457689932
E01005860,1488,692,796,0.4650537634408602,0.5349462365591398
E01005861,1548,738,810,0.47674418604651164,0.5232558139534884
E01005752,1477,734,743,0.4969532836831415,0.5030467163168585
E01005899,1616,752,864,0.46534653465346537,0.5346534653465347
E01005901,1398,695,703,0.4971387696709585,0.5028612303290415
E01005902,1618,767,851,0.47404202719406674,0.5259579728059333
E01005905,1436,701,735,0.4881615598885794,0.5118384401114207
E01005852,1552,747,805,0.48131443298969073,0.5186855670103093
E01005854,1626,789,837,0.48523985239852396,0.514760147601476
E01005855,1504,769,735,0.5113031914893617,0.4886968085106383
E01005857,1549,767,782,0.49515816655907036,0.5048418334409296
E01005858,1575,752,823,0.4774603174603175,0.5225396825396825
E01005757,1607,818,789,0.5090230242688238,0.4909769757311761
E01005758,1851,1008,843,0.5445705024311183,0.4554294975688817
E01005766,1452,760,692,0.5234159779614325,0.4765840220385675
E01005918,1511,861,650,0.5698213103904699,0.4301786896095301
E01005870,1399,694,705,0.4960686204431737,0.5039313795568263
E01005871,1337,654,683,0.48915482423335827,0.5108451757666418
E01005873,1489,729,760,0.4895903290799194,0.5104096709200806
E01005875,1559,756,803,0.48492623476587554,0.5150737652341244
E01005764,1642,796,846,0.48477466504263095,0.5152253349573691
E01005816,1600,763,837,0.476875,0.523125
E01005817,1345,654,691,0.4862453531598513,0.5137546468401487
E01005822,1507,798,709,0.5295288652952886,0.47047113470471136
E01005880,1488,718,770,0.4825268817204301,0.5174731182795699
E01005881,1278,634,644,0.49608763693270735,0.5039123630672926
E01005883,1536,767,769,0.4993489583333333,0.5006510416666666
E01005908,1494,722,772,0.48326639892904955,0.5167336010709505
E01005765,1393,657,736,0.47164393395549176,0.5283560660445082
E01005818,1422,672,750,0.47257383966244726,0.5274261603375527
E01005819,1547,786,761,0.5080801551389786,0.4919198448610213
E01005820,1455,672,783,0.4618556701030928,0.5381443298969072
E01005821,1489,736,753,0.49429147078576224,0.5057085292142377
E01005823,1632,811,821,0.49693627450980393,0.5030637254901961
E01005825,1516,759,757,0.5006596306068601,0.49934036939313986
E01005872,1712,843,869,0.49240654205607476,0.5075934579439252
E01005874,1672,874,798,0.5227272727272727,0.4772727272727273
E01005876,1481,746,735,0.5037137069547603,0.4962862930452397
E01005877,1402,686,716,0.4893009985734665,0.5106990014265336
E01005878,1435,675,760,0.47038327526132406,0.5296167247386759
E01005879,1308,621,687,0.47477064220183485,0.5252293577981652
E01005882,1380,660,720,0.4782608695652174,0.5217391304347826
E01005884,1494,712,782,0.47657295850066933,0.5234270414993306
E01005885,1386,630,756,0.45454545454545453,0.5454545454545454
E01005832,1472,744,728,0.5054347826086957,0.4945652173913043
E01005833,1046,507,539,0.4847036328871893,0.5152963671128107
E01005835,1397,695,702,0.49749463135289906,0.5025053686471009
E01005837,1588,772,816,0.48614609571788414,0.5138539042821159
E01005843,1510,768,742,0.5086092715231788,0.4913907284768212
E01005769,1335,603,732,0.451685393258427,0.5483146067415731
E01005778,1469,706,763,0.48059904697072836,0.5194009530292716
E01005779,1419,684,735,0.4820295983086681,0.5179704016913319
E01005780,1466,720,746,0.49113233287858116,0.5088676671214188
E01005781,1533,724,809,0.47227658186562294,0.5277234181343771
E01005759,1679,845,834,0.5032757593805837,0.49672424061941634
E01005760,1857,928,929,0.49973074851911686,0.5002692514808832
E01005797,1370,684,686,0.4992700729927007,0.5007299270072992
E01005800,1627,776,851,0.47695144437615244,0.5230485556238476
E01005804,1201,549,652,0.4571190674437968,0.5428809325562032
E01005824,1474,734,740,0.49796472184531887,0.5020352781546812
E01005826,1450,658,792,0.45379310344827584,0.5462068965517242
E01005827,1406,695,711,0.49431009957325744,0.5056899004267426
E01005828,1288,624,664,0.484472049689441,0.515527950310559
E01005829,1283,608,675,0.47388932190179267,0.5261106780982073
E01005768,1632,782,850,0.4791666666666667,0.5208333333333334
E01005770,1429,682,747,0.47725682295311406,0.5227431770468859
E01005771,1383,662,721,0.4786695589298626,0.5213304410701374
E01005775,1566,738,828,0.47126436781609193,0.5287356321839081
E01005761,1404,736,668,0.5242165242165242,0.4757834757834758
E01005762,1588,736,852,0.4634760705289673,0.5365239294710328
E01005763,1696,828,868,0.4882075471698113,0.5117924528301887
E01005799,1804,885,919,0.49057649667405767,0.5094235033259423
E01005798,1587,761,826,0.47952110901071204,0.520478890989288
E01005801,1497,755,742,0.5043420173680695,0.4956579826319305
E01005802,1535,778,757,0.5068403908794789,0.49315960912052115
E01005803,1488,730,758,0.4905913978494624,0.5094086021505376
E01005830,1476,718,758,0.48644986449864497,0.513550135501355
E01005831,1546,754,792,0.48771021992238034,0.5122897800776197
E01005767,1492,729,763,0.4886058981233244,0.5113941018766756
E01005772,1466,726,740,0.495225102319236,0.504774897680764
E01005773,1523,708,815,0.4648719632304662,0.5351280367695338
E01005774,1400,671,729,0.47928571428571426,0.5207142857142857
E01005776,1571,775,796,0.49331635900700194,0.5066836409929981
E01005909,1552,748,804,0.48195876288659795,0.5180412371134021
E01005910,1533,711,822,0.4637964774951076,0.5362035225048923
E01005911,1353,635,718,0.4693274205469327,0.5306725794530672
E01005912,1366,691,675,0.5058565153733529,0.49414348462664714
E01005782,1218,574,644,0.47126436781609193,0.5287356321839081
E01005783,1541,727,814,0.4717715768981181,0.5282284231018819
E01005784,1427,693,734,0.48563419761737914,0.5143658023826209
E01005785,1535,768,767,0.5003257328990228,0.4996742671009772
E01005786,1589,809,780,0.5091252359974827,0.4908747640025173
E01005834,1505,734,771,0.4877076411960133,0.5122923588039867
E01005836,1837,894,943,0.48666303756124113,0.5133369624387588
E01005838,1707,811,896,0.47510251903925016,0.5248974809607498
E01005840,1532,749,783,0.48890339425587465,0.5110966057441253
E01005927,1352,654,698,0.48372781065088755,0.5162721893491125
E01005928,1572,756,816,0.48091603053435117,0.5190839694656488
E01005929,1376,679,697,0.4934593023255814,0.5065406976744186
E01005930,1560,753,807,0.4826923076923077,0.5173076923076924
E01005806,1215,581,634,0.47818930041152263,0.5218106995884774
E01005813,1441,699,742,0.4850798056904927,0.5149201943095073
E01005814,1329,664,665,0.4996237772761475,0.5003762227238525
E01005815,1470,700,770,0.47619047619047616,0.5238095238095238
E01005777,1486,701,785,0.4717362045760431,0.528263795423957
E01005787,1299,664,635,0.5111624326404927,0.4888375673595073
E01005788,1528,735,793,0.48102094240837695,0.518979057591623
E01005790,1223,588,635,0.4807849550286182,0.5192150449713818
E01005805,1573,749,824,0.4761602034329307,0.5238397965670692
E01005807,1576,776,800,0.49238578680203043,0.5076142131979695
E01005839,1316,663,653,0.5037993920972644,0.49620060790273557
E01005841,1538,737,801,0.47919375812743825,0.5208062418725617
E01005844,1490,714,776,0.4791946308724832,0.5208053691275167
E01005845,1621,796,825,0.4910549043800123,0.5089450956199877
E01005849,1571,779,792,0.4958625079567155,0.5041374920432845
E01005851,1524,755,769,0.4954068241469816,0.5045931758530183
E01005808,1366,663,703,0.48535871156661786,0.5146412884333821
E01005809,1263,631,632,0.4996041171813143,0.5003958828186856
E01005810,1573,735,838,0.4672600127145582,0.5327399872854418
E01005811,1402,687,715,0.4900142653352354,0.5099857346647646
E01005812,1289,627,662,0.4864235841737781,0.5135764158262219
E01005842,1620,806,814,0.49753086419753084,0.5024691358024691
E01005906,1462,690,772,0.4719562243502052,0.5280437756497948
E01005907,1293,632,661,0.48878576952822894,0.5112142304717711
E01005913,1441,703,738,0.4878556557945871,0.5121443442054129
E01005789,1560,771,789,0.49423076923076925,0.5057692307692307
E01005791,1543,744,799,0.48217757615035645,0.5178224238496435
E01005793,1423,673,750,0.4729444834855938,0.5270555165144062
E01005795,1292,631,661,0.48839009287925694,0.5116099071207431
E01005796,1260,621,639,0.4928571428571429,0.5071428571428571
E01005846,1659,837,822,0.5045207956600362,0.49547920433996384
E01005847,1553,765,788,0.49259497746297487,0.5074050225370251
E01005848,1839,899,940,0.488852637302882,0.511147362697118
E01005850,1759,852,907,0.48436611711199545,0.5156338828880046
E01005792,1464,721,743,0.4924863387978142,0.5075136612021858
E01005794,1241,597,644,0.48106365834004833,0.5189363416599516
E01005923,1549,756,793,0.4880568108457069,0.511943189154293
E01005931,1445,681,764,0.471280276816609,0.528719723183391
E01005924,1343,646,697,0.4810126582278481,0.5189873417721519
E01005925,1418,655,763,0.4619181946403385,0.5380818053596615
E01005926,1265,621,644,0.4909090909090909,0.509090909090909
E01005932,1385,677,708,0.4888086642599278,0.5111913357400723
E01006053,1864,907,957,0.486587982832618,0.5134120171673819
E01006054,1623,776,847,0.47812692544670365,0.5218730745532963
E01006055,1387,670,717,0.4830569574621485,0.5169430425378515
E01006057,1533,741,792,0.48336594911937375,0.5166340508806262
E01006058,1911,976,935,0.510727367870225,0.489272632129775
E01006059,1413,689,724,0.4876150035385704,0.5123849964614295
E01005938,1638,825,813,0.5036630036630036,0.49633699633699635
E01005939,1305,633,672,0.4850574712643678,0.5149425287356322
E01005940,1494,737,757,0.4933065595716198,0.5066934404283802
E01005955,1710,849,861,0.4964912280701754,0.5035087719298246
E01006056,1190,586,604,0.492436974789916,0.507563025210084
E01006061,2383,1172,1211,0.49181703734788085,0.5081829626521192
E01006062,2114,1047,1067,0.49526963103122046,0.5047303689687795
E01006063,1463,723,740,0.49419002050580996,0.50580997949419
E01005936,1487,751,736,0.5050437121721587,0.4949562878278413
E01005937,1516,722,794,0.4762532981530343,0.5237467018469657
E01005945,1974,936,1038,0.47416413373860183,0.5258358662613982
E01005946,1653,824,829,0.4984875983061101,0.5015124016938899
E01005947,1581,788,793,0.49841872232764073,0.5015812776723593
E01005954,1499,726,773,0.48432288192128087,0.5156771180787192
E01005956,1422,681,741,0.47890295358649787,0.5210970464135021
E01005957,1459,739,720,0.5065113091158328,0.49348869088416725
E01005958,1456,693,763,0.47596153846153844,0.5240384615384616
E01005959,1705,818,887,0.4797653958944281,0.5202346041055719
E01005933,1467,721,746,0.49147920927062033,0.5085207907293797
E01005934,1479,708,771,0.4787018255578093,0.5212981744421906
E01005935,1475,695,780,0.4711864406779661,0.5288135593220339
E01005949,1557,759,798,0.48747591522157996,0.51252408477842
E01005960,1637,816,821,0.4984728161270617,0.5015271838729383
E01005941,1650,883,767,0.5351515151515152,0.46484848484848484
E01005942,1649,817,832,0.4954517889630079,0.5045482110369921
E01005943,1793,890,903,0.4963747908533185,0.5036252091466815
E01005944,1467,763,704,0.520109066121336,0.47989093387866394
E01006060,1396,718,678,0.5143266475644699,0.48567335243553006
E01006064,1578,784,794,0.4968314321926489,0.5031685678073511
E01006065,1357,627,730,0.46204863669859986,0.5379513633014001
E01006066,1403,677,726,0.48253741981468284,0.5174625801853172
E01006067,1842,928,914,0.503800217155266,0.496199782844734
E01006068,1594,787,807,0.49372647427854455,0.5062735257214555
E01006069,1667,769,898,0.46130773845230955,0.5386922615476905
E01006073,1752,822,930,0.4691780821917808,0.5308219178082192
E01005993,1411,681,730,0.48263642806520196,0.517363571934798
E01005995,1421,696,725,0.4897959183673469,0.5102040816326531
E01005996,1939,947,992,0.4883960804538422,0.5116039195461578
E01005997,1459,717,742,0.4914324880054832,0.5085675119945168
E01006000,1543,759,784,0.49189889825016203,0.508101101749838
E01005994,1449,689,760,0.47550034506556244,0.5244996549344375
E01005999,1857,901,956,0.485191168551427,0.5148088314485729
E01006002,1368,638,730,0.46637426900584794,0.533625730994152
E01006004,1544,746,798,0.483160621761658,0.5168393782383419
E01006005,1351,626,725,0.463360473723168,0.536639526276832
E01006007,1508,735,773,0.4874005305039788,0.5125994694960212
E01005998,1703,834,869,0.4897240164415737,0.5102759835584263
E01006001,1559,771,788,0.49454778704297625,0.5054522129570237
E01006003,1450,715,735,0.49310344827586206,0.506896551724138
E01006006,1472,727,745,0.4938858695652174,0.5061141304347826
E01005948,1769,993,776,0.5613340870548332,0.43866591294516677
E01005950,1923,926,997,0.48153926157046284,0.5184607384295372
E01005951,1585,766,819,0.4832807570977918,0.5167192429022082
E01005952,2163,1247,916,0.5765141007859454,0.42348589921405455
E01005953,2043,1005,1038,0.4919236417033774,0.5080763582966226
E01005961,1423,692,731,0.4862965565706254,0.5137034434293746
E01005962,1457,706,751,0.48455730954015097,0.515442690459849
E01005968,1446,693,753,0.47925311203319504,0.520746887966805
E01005969,1381,679,702,0.49167270094134685,0.5083272990586531
E01006022,1619,825,794,0.509573810994441,0.490426189005559
E01006023,1545,822,723,0.5320388349514563,0.4679611650485437
E01006070,1437,706,731,0.4913013221990257,0.5086986778009742
E01006071,1586,814,772,0.5132408575031526,0.48675914249684743
E01006072,1685,848,837,0.5032640949554896,0.4967359050445104
E01006009,1364,673,691,0.4934017595307918,0.5065982404692082
E01006017,1416,727,689,0.5134180790960452,0.4865819209039548
E01006018,1366,675,691,0.49414348462664714,0.5058565153733529
E01006021,1365,657,708,0.48131868131868133,0.5186813186813187
E01006008,1455,715,740,0.49140893470790376,0.5085910652920962
E01006010,1381,655,726,0.47429398986241855,0.5257060101375814
E01006012,1839,893,946,0.4855899945622621,0.5144100054377378
E01006015,1419,695,724,0.4897815362931642,0.5102184637068358
E01006016,1754,926,828,0.5279361459521095,0.47206385404789053
E01006011,1634,808,826,0.4944920440636475,0.5055079559363526
E01006013,1281,624,657,0.48711943793911006,0.5128805620608899
E01006014,1302,633,669,0.4861751152073733,0.5138248847926268
E01006019,1509,763,746,0.5056328694499669,0.4943671305500331
E01006020,1563,748,815,0.47856685860524634,0.5214331413947537
E01005963,1222,597,625,0.4885433715220949,0.5114566284779051
E01005964,1538,730,808,0.47464239271781533,0.5253576072821846
E01005965,1430,695,735,0.486013986013986,0.513986013986014
E01005966,1355,682,673,0.5033210332103321,0.4966789667896679
E01005967,1381,693,688,0.501810282404055,0.498189717595945
E01006031,1496,715,781,0.47794117647058826,0.5220588235294118
E01006032,1330,650,680,0.48872180451127817,0.5112781954887218
E01006033,1360,691,669,0.5080882352941176,0.4919117647058823
E01006034,2143,1047,1096,0.48856742883807747,0.5114325711619225
E01006035,1976,999,977,0.5055668016194332,0.4944331983805668
E01006036,1953,970,983,0.49667178699436765,0.5033282130056324
E01005970,1464,747,717,0.5102459016393442,0.48975409836065575
E01005972,1680,822,858,0.48928571428571427,0.5107142857142857
E01005974,1563,763,800,0.48816378758797185,0.5118362124120281
E01005975,1562,738,824,0.47247119078104993,0.5275288092189501
E01006024,1809,898,911,0.49640685461580986,0.5035931453841902
E01006026,1569,762,807,0.48565965583174,0.51434034416826
E01006037,1498,727,771,0.48531375166889185,0.5146862483311081
E01006038,1638,777,861,0.47435897435897434,0.5256410256410257
E01006047,1341,657,684,0.4899328859060403,0.5100671140939598
E01006048,1498,726,772,0.48464619492656874,0.5153538050734312
E01006049,1537,766,771,0.4983734547820429,0.501626545217957
E01006051,1645,817,828,0.4966565349544073,0.5033434650455927
E01005985,1533,736,797,0.4801043705153294,0.5198956294846706
E01005987,1547,738,809,0.4770523594053006,0.5229476405946994
E01005988,1601,773,828,0.48282323547782635,0.5171767645221736
E01005990,1344,662,682,0.49255952380952384,0.5074404761904762
E01005991,1466,720,746,0.49113233287858116,0.5088676671214188
E01005971,1406,703,703,0.5,0.5
E01005986,1246,594,652,0.4767255216693419,0.5232744783306581
E01005989,1220,576,644,0.4721311475409836,0.5278688524590164
E01005992,1317,608,709,0.4616552771450266,0.5383447228549735
E01005973,1426,714,712,0.5007012622720898,0.4992987377279102
E01005976,1523,723,800,0.4747209455022981,0.525279054497702
E01005977,1497,706,791,0.47160988643954577,0.5283901135604543
E01005978,1377,660,717,0.4793028322440087,0.5206971677559913
E01006025,1418,661,757,0.46614950634696756,0.5338504936530324
E01006027,1409,700,709,0.49680624556423,0.5031937544357701
E01006050,1707,824,883,0.48271821909783247,0.5172817809021676
E01006052,1537,768,769,0.4996746909564086,0.5003253090435914
E01006028,1762,872,890,0.4948921679909194,0.5051078320090806
E01006029,1837,882,955,0.48013064779531844,0.5198693522046816
E01006030,1836,904,932,0.4923747276688453,0.5076252723311547
E01006039,1406,672,734,0.4779516358463727,0.5220483641536273
E01006040,1699,859,840,0.505591524426133,0.49440847557386697
E01006041,1597,803,794,0.5028177833437696,0.4971822166562304
E01005979,1612,791,821,0.49069478908188585,0.5093052109181141
E01005980,1485,698,787,0.47003367003367,0.52996632996633
E01005981,1529,682,847,0.4460431654676259,0.5539568345323741
E01005982,1347,644,703,0.47809948032665184,0.5219005196733482
E01005983,1616,783,833,0.484529702970297,0.5154702970297029
E01005984,1517,787,730,0.5187870797626896,0.4812129202373105
E01006042,1638,784,854,0.47863247863247865,0.5213675213675214
E01006043,1466,686,780,0.4679399727148704,0.5320600272851296
E01006044,1383,676,707,0.48879248011569054,0.5112075198843095
E01006045,1264,614,650,0.48575949367088606,0.5142405063291139
E01006046,1481,709,772,0.4787305874409183,0.5212694125590817
E01006109,1448,856,592,0.5911602209944752,0.4088397790055249
E01006110,1775,826,949,0.46535211267605636,0.5346478873239436
E01006111,1720,818,902,0.4755813953488372,0.5244186046511627
E01006112,1713,839,874,0.4897840046701693,0.5102159953298308
E01006185,1968,1015,953,0.5157520325203252,0.4842479674796748
E01006188,1553,781,772,0.5028976175144881,0.4971023824855119
E01006116,1350,650,700,0.48148148148148145,0.5185185185185185
E01006117,1672,826,846,0.49401913875598086,0.5059808612440191
E01006118,1453,689,764,0.4741913282863042,0.5258086717136958
E01006119,1608,785,823,0.48818407960199006,0.5118159203980099
E01006121,1549,739,810,0.47708198837959975,0.5229180116204003
E01006141,1604,820,784,0.5112219451371571,0.48877805486284287
E01006186,1903,970,933,0.509721492380452,0.4902785076195481
E01006187,2535,1268,1267,0.5001972386587771,0.49980276134122287
E01006189,2235,1110,1125,0.4966442953020134,0.5033557046979866
E01006113,1524,750,774,0.4921259842519685,0.5078740157480315
E01006114,1662,809,853,0.48676293622142,0.51323706377858
E01006115,1584,765,819,0.48295454545454547,0.5170454545454546
E01006145,1797,873,924,0.48580968280467446,0.5141903171953256
E01006146,1894,930,964,0.4910242872228089,0.5089757127771911
E01006122,1553,760,793,0.489375402446877,0.510624597553123
E01006123,1695,814,881,0.48023598820059,0.51976401179941
E01006124,1473,721,752,0.4894772572980312,0.5105227427019687
E01006128,1767,893,874,0.5053763440860215,0.4946236559139785
E01006131,1566,786,780,0.5019157088122606,0.49808429118773945
E01006155,1606,793,813,0.4937733499377335,0.5062266500622665
E01006157,1557,757,800,0.4861913937058446,0.5138086062941555
E01006159,1804,824,980,0.4567627494456763,0.5432372505543237
E01006182,1532,699,833,0.456266318537859,0.543733681462141
E01006183,1650,824,826,0.4993939393939394,0.5006060606060606
E01006125,1484,723,761,0.4871967654986523,0.5128032345013477
E01006126,1665,787,878,0.47267267267267266,0.5273273273273273
E01006127,1616,797,819,0.4931930693069307,0.5068069306930693
E01006130,1777,879,898,0.4946539110861002,0.5053460889138999
E01006132,1566,755,811,0.4821200510855683,0.5178799489144317
E01006156,1593,739,854,0.46390458254865036,0.5360954174513497
E01006158,1648,811,837,0.49211165048543687,0.5078883495145631
E01006179,1732,901,831,0.5202078521939953,0.4797921478060046
E01006184,1676,810,866,0.48329355608591884,0.5167064439140812
E01006198,1554,721,833,0.46396396396396394,0.536036036036036
E01006199,1570,745,825,0.4745222929936306,0.5254777070063694
E01006200,1445,667,778,0.4615916955017301,0.5384083044982699
E01006201,1495,754,741,0.5043478260869565,0.4956521739130435
E01006202,1358,707,651,0.520618556701031,0.4793814432989691
E01006120,1430,698,732,0.4881118881118881,0.5118881118881119
E01006129,1367,637,730,0.46598390636430137,0.5340160936356986
E01006133,1454,700,754,0.4814305364511692,0.5185694635488308
E01006197,1530,738,792,0.4823529411764706,0.5176470588235295
E01006203,1415,685,730,0.4840989399293286,0.5159010600706714
E01006142,1659,804,855,0.484629294755877,0.515370705244123
E01006143,1659,839,820,0.5057263411693791,0.49427365883062085
E01006144,1444,707,737,0.48961218836565096,0.510387811634349
E01006180,1838,915,923,0.49782372143634385,0.5021762785636561
E01006181,1666,831,835,0.49879951980792314,0.5012004801920769
E01006147,1415,723,692,0.5109540636042402,0.4890459363957597
E01006149,1485,721,764,0.4855218855218855,0.5144781144781144
E01006150,1542,772,770,0.5006485084306096,0.4993514915693904
E01006154,1501,766,735,0.5103264490339774,0.48967355096602266
E01006165,1918,930,988,0.4848800834202294,0.5151199165797706
E01006166,1567,770,797,0.4913848117421825,0.5086151882578175
E01006169,1634,800,834,0.48959608323133413,0.5104039167686658
E01006170,1550,744,806,0.48,0.52
E01006171,1796,862,934,0.4799554565701559,0.5200445434298441
E01006098,1289,634,655,0.4918541505042669,0.5081458494957332
E01006099,1352,678,674,0.5014792899408284,0.4985207100591716
E01006164,1650,810,840,0.4909090909090909,0.509090909090909
E01006174,1738,877,861,0.5046029919447641,0.4953970080552359
E01006178,1821,914,907,0.5019220208676551,0.49807797913234486
E01006097,1768,895,873,0.5062217194570136,0.49377828054298645
E01006160,1753,887,866,0.5059897318881916,0.4940102681118083
E01006161,1958,969,989,0.49489274770173647,0.5051072522982636
E01006162,1615,801,814,0.49597523219814244,0.5040247678018576
E01006163,1788,890,898,0.49776286353467564,0.5022371364653244
E01006148,1632,806,826,0.49387254901960786,0.5061274509803921
E01006151,1508,749,759,0.496684350132626,0.503315649867374
E01006152,1636,795,841,0.48594132029339854,0.5140586797066015
E01006153,1568,741,827,0.4725765306122449,0.5274234693877551
E01006172,1530,743,787,0.48562091503267973,0.5143790849673202
E01006104,1689,832,857,0.492599171107164,0.507400828892836
E01006105,1933,929,1004,0.48060010346611487,0.5193998965338852
E01006106,1485,687,798,0.4626262626262626,0.5373737373737374
E01006107,1618,765,853,0.47280593325092707,0.5271940667490729
E01006108,1670,763,907,0.4568862275449102,0.5431137724550898
E01006102,1368,635,733,0.4641812865497076,0.5358187134502924
E01006173,1516,737,779,0.4861477572559367,0.5138522427440633
E01006175,1613,750,863,0.4649721016738996,0.5350278983261004
E01006176,1789,884,905,0.4941307993292342,0.5058692006707658
E01006177,1645,798,847,0.4851063829787234,0.5148936170212766
E01006091,2287,1133,1154,0.4954088325317009,0.5045911674682991
E01006092,1355,632,723,0.4664206642066421,0.5335793357933579
E01006095,1629,827,802,0.5076734192756293,0.4923265807243708
E01006167,1633,782,851,0.4788732394366197,0.5211267605633803
E01006168,1919,893,1026,0.46534653465346537,0.5346534653465347
E01006090,1964,1015,949,0.5168024439918534,0.4831975560081466
E01006094,1486,719,767,0.4838492597577389,0.5161507402422612
E01006096,1532,749,783,0.48890339425587465,0.5110966057441253
E01006100,1517,766,751,0.5049439683586026,0.4950560316413975
E01006103,1618,818,800,0.5055624227441285,0.49443757725587145
E01006101,1522,773,749,0.5078843626806833,0.4921156373193167
E01006190,1693,831,862,0.4908446544595393,0.5091553455404607
E01006195,1771,888,883,0.5014116318464145,0.49858836815358554
E01006196,1784,903,881,0.5061659192825112,0.4938340807174888
E01006210,1656,850,806,0.5132850241545893,0.4867149758454106
E01006204,1610,750,860,0.4658385093167702,0.5341614906832298
E01006206,1884,895,989,0.4750530785562633,0.5249469214437368
E01006207,1617,780,837,0.48237476808905383,0.5176252319109462
E01006208,1627,758,869,0.4658881376767056,0.5341118623232944
E01006211,1530,732,798,0.47843137254901963,0.5215686274509804
E01006093,1596,786,810,0.4924812030075188,0.5075187969924813
E01006191,1658,800,858,0.4825090470446321,0.517490952955368
E01006192,1534,735,799,0.4791395045632334,0.5208604954367666
E01006205,1388,697,691,0.5021613832853026,0.4978386167146974
E01006209,1577,777,800,0.49270767279644895,0.507292327203551
E01006078,1851,937,914,0.5062128579146408,0.4937871420853593
E01006080,1808,885,923,0.4894911504424779,0.5105088495575221
E01006089,1497,763,734,0.509686038744155,0.49031396125584503
E01006193,1519,757,762,0.49835418038183016,0.5016458196181699
E01006194,2333,1162,1171,0.4980711530218603,0.5019288469781398
E01006074,1574,733,841,0.4656925031766201,0.53430749682338
E01006075,1940,960,980,0.4948453608247423,0.5051546391752577
E01006076,1623,782,841,0.4818237831176833,0.5181762168823167
E01006079,1995,1017,978,0.5097744360902255,0.49022556390977445
E01006087,1513,754,759,0.4983476536682089,0.5016523463317911
E01006083,1397,687,710,0.4917680744452398,0.5082319255547602
E01006084,1708,838,870,0.49063231850117095,0.509367681498829
E01006088,1575,771,804,0.4895238095238095,0.5104761904761905
E01006139,1717,830,887,0.483401281304601,0.516598718695399
E01006140,1685,828,857,0.4913946587537092,0.5086053412462908
E01006077,1591,812,779,0.5103708359522313,0.4896291640477687
E01006081,1391,689,702,0.4953271028037383,0.5046728971962616
E01006082,1607,780,827,0.48537647790914745,0.5146235220908525
E01006085,1574,719,855,0.4567979669631512,0.5432020330368488
E01006086,1668,802,866,0.48081534772182255,0.5191846522781774
E01006134,1527,755,772,0.49443352979698757,0.5055664702030125
E01006135,1636,764,872,0.4669926650366748,0.5330073349633252
E01006136,1551,732,819,0.47195357833655704,0.528046421663443
E01006137,1433,693,740,0.48360083740404747,0.5163991625959525
E01006138,1747,823,924,0.47109330280480827,0.5289066971951918
E01006315,1237,608,629,0.49151172190784154,0.5084882780921585
E01006316,1486,743,743,0.5,0.5
E01006317,1523,745,778,0.4891661195009849,0.5108338804990151
E01006319,1439,706,733,0.4906184850590688,0.5093815149409312
E01006229,1527,746,781,0.4885396201702685,0.5114603798297315
E01006230,1417,696,721,0.4911785462244178,0.5088214537755822
E01006233,1497,737,760,0.4923179692718771,0.5076820307281229
E01006237,1576,791,785,0.5019035532994924,0.4980964467005076
E01006238,1530,727,803,0.47516339869281043,0.5248366013071896
E01006259,1321,666,655,0.5041635124905375,0.4958364875094625
E01006312,1481,738,743,0.49831195138419987,0.5016880486158002
E01006313,1067,528,539,0.4948453608247423,0.5051546391752577
E01006314,1679,814,865,0.48481238832638474,0.5151876116736153
E01006318,1446,729,717,0.504149377593361,0.495850622406639
E01006320,1378,702,676,0.5094339622641509,0.49056603773584906
E01006321,1710,858,852,0.5017543859649123,0.4982456140350877
E01006231,1477,738,739,0.4996614759647935,0.5003385240352065
E01006232,1855,874,981,0.47115902964959566,0.5288409703504043
E01006234,1230,621,609,0.5048780487804878,0.4951219512195122
E01006235,1524,746,778,0.489501312335958,0.510498687664042
E01006253,1544,747,797,0.4838082901554404,0.5161917098445595
E01006254,1657,782,875,0.471937235968618,0.528062764031382
E01006255,1505,744,761,0.4943521594684385,0.5056478405315614
E01006256,1439,747,692,0.5191104933981932,0.4808895066018068
E01006260,1530,735,795,0.4803921568627451,0.5196078431372549
E01006370,1598,878,720,0.5494367959949937,0.45056320400500627
E01006372,1675,795,880,0.4746268656716418,0.5253731343283582
E01006373,1503,745,758,0.49567531603459747,0.5043246839654025
E01006374,1549,747,802,0.48224661071659136,0.5177533892834086
E01006390,1539,762,777,0.4951267056530214,0.5048732943469786
E01006236,1480,734,746,0.49594594594594593,0.504054054054054
E01006388,1691,856,835,0.5062093435836783,0.4937906564163217
E01006389,1400,687,713,0.4907142857142857,0.5092857142857142
E01006391,1587,799,788,0.5034656584751103,0.49653434152488973
E01006257,1307,655,652,0.5011476664116297,0.49885233358837033
E01006258,1684,812,872,0.4821852731591449,0.517814726840855
E01006369,1696,900,796,0.5306603773584906,0.4693396226415094
E01006371,1543,782,761,0.5068049254698639,0.4931950745301361
E01006375,1602,813,789,0.5074906367041199,0.49250936329588013
E01006306,1546,827,719,0.5349288486416559,0.4650711513583441
E01006307,1432,736,696,0.5139664804469274,0.4860335195530726
E01006386,1534,824,710,0.5371577574967406,0.46284224250325945
E01006387,1319,650,669,0.4927975739196361,0.5072024260803639
E01006392,1499,766,733,0.5110073382254836,0.48899266177451634
E01006350,1823,902,921,0.4947888096544158,0.5052111903455841
E01006351,2092,1015,1077,0.48518164435946465,0.5148183556405354
E01006357,1727,810,917,0.46902142443543715,0.5309785755645628
E01006360,1675,834,841,0.49791044776119403,0.502089552238806
E01006361,1616,825,791,0.510519801980198,0.48948019801980197
E01006356,1472,735,737,0.499320652173913,0.5006793478260869
E01006396,1472,713,759,0.484375,0.515625
E01006397,1135,560,575,0.4933920704845815,0.5066079295154186
E01006398,1086,547,539,0.503683241252302,0.496316758747698
E01006399,1538,766,772,0.4980494148244473,0.5019505851755527
E01006305,1783,874,909,0.4901850813236119,0.5098149186763881
E01006308,1640,796,844,0.4853658536585366,0.5146341463414634
E01006309,1602,839,763,0.5237203495630461,0.4762796504369538
E01006310,1513,764,749,0.5049570389953735,0.4950429610046266
E01006311,1593,783,810,0.4915254237288136,0.5084745762711864
E01006269,1605,810,795,0.5046728971962616,0.4953271028037383
E01006271,1785,880,905,0.49299719887955185,0.5070028011204482
E01006272,1653,816,837,0.49364791288566245,0.5063520871143375
E01006273,1533,723,810,0.47162426614481406,0.5283757338551859
E01006276,2274,1129,1145,0.49648197009674583,0.5035180299032542
E01006353,1543,794,749,0.5145819831497084,0.4854180168502916
E01006354,1584,805,779,0.5082070707070707,0.4917929292929293
E01006355,1531,746,785,0.48726322664924887,0.5127367733507512
E01006358,1750,868,882,0.496,0.504
E01006359,1514,752,762,0.4966974900924703,0.5033025099075297
E01006349,1762,886,876,0.5028376844494892,0.49716231555051077
E01006352,1666,843,823,0.5060024009603842,0.4939975990396158
E01006404,1660,811,849,0.48855421686746986,0.5114457831325301
E01006405,1381,651,730,0.4713975380159305,0.5286024619840695
E01006411,1630,848,782,0.5202453987730061,0.47975460122699387
E01006270,1495,740,755,0.49498327759197325,0.5050167224080268
E01006274,1511,719,792,0.4758438120450033,0.5241561879549967
E01006275,1529,744,785,0.486592544146501,0.513407455853499
E01006277,1802,905,897,0.5022197558268591,0.49778024417314093
E01006286,1509,753,756,0.4990059642147117,0.5009940357852882
E01006239,1965,1023,942,0.5206106870229008,0.47938931297709925
E01006240,1601,793,808,0.49531542785758903,0.504684572142411
E01006241,2001,1016,985,0.5077461269365318,0.49225387306346824
E01006287,1217,590,627,0.4847986852917009,0.5152013147082991
E01006289,1746,902,844,0.5166093928980527,0.4833906071019473
E01006362,1782,899,883,0.5044893378226711,0.49551066217732886
E01006363,1542,741,801,0.4805447470817121,0.519455252918288
E01006364,1811,856,955,0.4726670347874103,0.5273329652125898
E01006365,2206,1070,1136,0.485040797824116,0.514959202175884
E01006366,1681,867,814,0.5157644259369423,0.4842355740630577
E01006367,1577,777,800,0.49270767279644895,0.507292327203551
E01006368,1641,789,852,0.48080438756855576,0.5191956124314442
E01006278,1574,757,817,0.4809402795425667,0.5190597204574333
E01006279,1593,781,812,0.49026993094789706,0.5097300690521029
E01006280,1428,688,740,0.48179271708683474,0.5182072829131653
E01006281,1764,889,875,0.503968253968254,0.49603174603174605
E01006285,1838,906,932,0.4929270946681175,0.5070729053318824
E01006406,1460,721,739,0.49383561643835616,0.5061643835616438
E01006407,1507,755,752,0.5009953550099535,0.49900464499004643
E01006408,1544,764,780,0.4948186528497409,0.5051813471502591
E01006409,1388,679,709,0.489193083573487,0.510806916426513
E01006410,1403,717,686,0.5110477548111191,0.488952245188881
E01006393,1490,760,730,0.5100671140939598,0.4899328859060403
E01006394,1561,755,806,0.4836643177450352,0.5163356822549647
E01006395,2502,1263,1239,0.5047961630695443,0.4952038369304556
E01006400,1345,642,703,0.47732342007434947,0.5226765799256505
E01006401,1463,718,745,0.49077238550922764,0.5092276144907724
E01006402,1198,597,601,0.498330550918197,0.501669449081803
E01006403,1705,859,846,0.5038123167155425,0.4961876832844575
E01006290,1375,686,689,0.4989090909090909,0.5010909090909091
E01006291,1470,740,730,0.5034013605442177,0.4965986394557823
E01006292,1568,761,807,0.48533163265306123,0.5146683673469388
E01006293,1579,791,788,0.5009499683343889,0.4990500316656111
E01006242,1643,816,827,0.4966524650030432,0.5033475349969568
E01006243,2045,1044,1001,0.5105134474327628,0.48948655256723717
E01006244,1564,769,795,0.49168797953964194,0.5083120204603581
E01006245,2417,1222,1195,0.5055854364915184,0.49441456350848156
E01006213,1627,815,812,0.5009219422249539,0.4990780577750461
E01006215,1675,842,833,0.5026865671641791,0.4973134328358209
E01006217,2334,1146,1188,0.4910025706940874,0.5089974293059126
E01006218,2055,1027,1028,0.4997566909975669,0.5002433090024331
E01006219,1297,637,660,0.49113338473400153,0.5088666152659984
E01006288,1803,864,939,0.47920133111480867,0.5207986688851913
E01006294,1963,973,990,0.4956698930208864,0.5043301069791136
E01006295,1593,810,783,0.5084745762711864,0.4915254237288136
E01006377,1624,787,837,0.48460591133004927,0.5153940886699507
E01006378,1334,679,655,0.5089955022488756,0.4910044977511244
E01006212,1395,713,682,0.5111111111111111,0.4888888888888889
E01006214,1375,672,703,0.48872727272727273,0.5112727272727273
E01006216,2191,1111,1080,0.507074395253309,0.492925604746691
E01006322,1539,782,757,0.5081221572449642,0.4918778427550357
E01006329,1290,765,525,0.5930232558139535,0.4069767441860465
E01006282,1701,860,841,0.5055849500293945,0.49441504997060554
E01006283,1535,788,747,0.5133550488599349,0.4866449511400652
E01006284,1520,764,756,0.5026315789473684,0.49736842105263157
E01006336,1630,765,865,0.46932515337423314,0.5306748466257669
E01006337,1507,731,776,0.48506967485069674,0.5149303251493033
E01006376,1642,835,807,0.5085261875761267,0.49147381242387334
E01006381,1920,985,935,0.5130208333333334,0.4869791666666667
E01006382,1410,719,691,0.5099290780141844,0.4900709219858156
E01006383,1660,834,826,0.5024096385542168,0.4975903614457831
E01006384,1394,711,683,0.5100430416068866,0.4899569583931133
E01006250,1532,773,759,0.5045691906005222,0.4954308093994778
E01006251,1462,727,735,0.49726402188782487,0.5027359781121751
E01006379,1551,756,795,0.4874274661508704,0.5125725338491296
E01006380,1655,781,874,0.4719033232628399,0.5280966767371601
E01006385,1489,728,761,0.4889187374076561,0.5110812625923439
E01006328,1432,754,678,0.526536312849162,0.473463687150838
E01006333,1810,892,918,0.49281767955801103,0.507182320441989
E01006334,1716,861,855,0.5017482517482518,0.4982517482517482
E01006338,1588,795,793,0.5006297229219143,0.4993702770780856
E01006248,1564,831,733,0.5313299232736572,0.4686700767263427
E01006249,1578,776,802,0.4917617237008872,0.5082382762991128
E01006330,1629,811,818,0.4978514426028238,0.5021485573971762
E01006331,1596,796,800,0.49874686716791977,0.5012531328320802
E01006332,2077,1024,1053,0.4930187770823303,0.5069812229176697
E01006262,1531,780,751,0.5094709340300457,0.49052906596995427
E01006263,1547,777,770,0.502262443438914,0.497737556561086
E01006266,1392,685,707,0.4920977011494253,0.5079022988505747
E01006267,1637,803,834,0.4905314599877825,0.5094685400122174
E01006268,1762,877,885,0.4977298524404086,0.5022701475595914
E01006323,1502,739,763,0.49201065246338216,0.5079893475366178
E01006324,1325,653,672,0.4928301886792453,0.5071698113207547
E01006325,1608,811,797,0.5043532338308457,0.4956467661691542
E01006326,1439,725,714,0.5038220986796387,0.4961779013203614
E01006327,1482,718,764,0.4844804318488529,0.5155195681511471
E01006246,1566,788,778,0.5031928480204342,0.49680715197956576
E01006247,1330,651,679,0.48947368421052634,0.5105263157894737
E01006252,1464,698,766,0.476775956284153,0.523224043715847
E01006297,1631,757,874,0.46413243408951566,0.5358675659104843
E01006335,1672,829,843,0.4958133971291866,0.5041866028708134
E01006220,1845,900,945,0.4878048780487805,0.5121951219512195
E01006221,1645,819,826,0.4978723404255319,0.502127659574468
E01006222,1577,786,791,0.4984147114774889,0.501585288522511
E01006224,1577,805,772,0.5104629042485732,0.4895370957514268
E01006226,1754,904,850,0.5153933865450399,0.4846066134549601
E01006223,1610,812,798,0.5043478260869565,0.4956521739130435
E01006225,1514,736,778,0.4861294583883752,0.5138705416116248
E01006261,1536,733,803,0.4772135416666667,0.5227864583333334
E01006264,1356,685,671,0.5051622418879056,0.4948377581120944
E01006265,1432,700,732,0.4888268156424581,0.5111731843575419
E01006296,1533,736,797,0.4801043705153294,0.5198956294846706
E01006298,1405,665,740,0.47330960854092524,0.5266903914590747
E01006299,1888,951,937,0.503707627118644,0.4962923728813559
E01006300,1347,659,688,0.4892353377876763,0.5107646622123236
E01006301,1362,651,711,0.4779735682819383,0.5220264317180616
E01006227,1554,757,797,0.4871299871299871,0.5128700128700129
E01006228,1731,896,835,0.5176198729058348,0.4823801270941652
E01006342,1567,778,789,0.4964901084875558,0.5035098915124442
E01006344,1487,695,792,0.4673839946200404,0.5326160053799597
E01006346,2134,1076,1058,0.5042174320524836,0.4957825679475164
E01006339,1370,662,708,0.4832116788321168,0.5167883211678832
E01006340,1457,721,736,0.4948524365133837,0.5051475634866164
E01006343,1758,860,898,0.4891922639362912,0.5108077360637088
E01006345,1583,766,817,0.4838913455464308,0.5161086544535691
E01006348,1607,793,814,0.49346608587429996,0.5065339141257
E01006302,1603,814,789,0.5077978789769183,0.4922021210230817
E01006303,1394,695,699,0.49856527977044474,0.5014347202295553
E01006304,1481,725,756,0.48953409858203917,0.5104659014179609
E01006341,1644,820,824,0.49878345498783455,0.5012165450121655
E01006347,1580,760,820,0.4810126582278481,0.5189873417721519
E01024859,1529,751,778,0.49117069980379335,0.5088293001962066
E01024861,1309,628,681,0.479755538579068,0.5202444614209321
E01024862,1573,782,791,0.4971392244119517,0.5028607755880483
E01024891,1617,757,860,0.4681508967223253,0.5318491032776747
E01024892,1428,658,770,0.46078431372549017,0.5392156862745098
E01024894,1376,670,706,0.48691860465116277,0.5130813953488372
E01024893,1483,722,761,0.4868509777478085,0.5131490222521915
E01024896,1326,644,682,0.4856711915535445,0.5143288084464555
E01024897,1426,690,736,0.4838709677419355,0.5161290322580645
E01024898,1562,783,779,0.501280409731114,0.49871959026888607
E01024856,1613,819,794,0.5077495350278983,0.4922504649721017
E01024875,1405,744,661,0.5295373665480427,0.47046263345195727
E01024876,1367,702,665,0.5135332845647403,0.4864667154352597
E01024877,1574,849,725,0.5393900889453621,0.4606099110546379
E01024878,1609,822,787,0.5108763206960846,0.4891236793039155
E01024895,1377,727,650,0.5279593318809005,0.4720406681190995
E01024883,1506,698,808,0.4634794156706507,0.5365205843293492
E01024884,1585,747,838,0.47129337539432176,0.5287066246056782
E01024885,1665,844,821,0.5069069069069069,0.49309309309309307
E01024886,1392,706,686,0.507183908045977,0.492816091954023
E01024889,1289,637,652,0.49418153607447635,0.5058184639255237
E01024890,1470,710,760,0.48299319727891155,0.5170068027210885
E01024879,1318,624,694,0.47344461305007585,0.5265553869499241
E01024880,1435,695,740,0.4843205574912892,0.5156794425087108
E01024912,1397,675,722,0.4831782390837509,0.5168217609162491
E01024913,1372,696,676,0.5072886297376094,0.49271137026239065
E01024914,1484,736,748,0.49595687331536387,0.5040431266846361
E01024881,1425,713,712,0.5003508771929824,0.49964912280701756
E01024882,1473,701,772,0.47589952477936187,0.5241004752206382
E01024902,1523,725,798,0.47603414313854236,0.5239658568614577
E01024911,1760,880,880,0.5,0.5
E01024855,1428,683,745,0.47829131652661067,0.5217086834733894
E01024857,1522,724,798,0.4756898817345598,0.5243101182654402
E01024858,1338,671,667,0.5014947683109118,0.49850523168908817
E01024864,1587,777,810,0.4896030245746692,0.5103969754253308
E01024863,1471,721,750,0.49014276002719237,0.5098572399728076
E01024865,1434,720,714,0.502092050209205,0.497907949790795
E01024866,1761,842,919,0.478137421919364,0.521862578080636
E01024867,1420,681,739,0.4795774647887324,0.5204225352112676
E01024860,1243,632,611,0.5084473049074819,0.4915526950925181
E01024868,1221,612,609,0.5012285012285013,0.4987714987714988
E01024869,1414,698,716,0.49363507779349364,0.5063649222065064
E01024870,1146,558,588,0.4869109947643979,0.5130890052356021
E01024872,1357,633,724,0.4664701547531319,0.5335298452468681
E01024899,1644,798,846,0.4854014598540146,0.5145985401459854
E01024900,1603,778,825,0.48533998752339363,0.5146600124766063
E01024907,1227,612,615,0.49877750611246946,0.5012224938875306
E01024908,1039,499,540,0.480269489894129,0.519730510105871
E01024909,1538,806,732,0.5240572171651495,0.4759427828348505
E01024874,1052,526,526,0.5,0.5
E01024887,1500,747,753,0.498,0.502
E01024888,1670,841,829,0.5035928143712575,0.49640718562874253
E01024901,1815,878,937,0.4837465564738292,0.5162534435261708
E01024871,1333,653,680,0.4898724681170293,0.5101275318829708
E01024873,1380,677,703,0.4905797101449275,0.5094202898550725
E01024903,1260,600,660,0.47619047619047616,0.5238095238095238
E01024904,1746,817,929,0.4679266895761741,0.5320733104238259
E01024905,1246,618,628,0.4959871589085072,0.5040128410914928
E01024906,1530,764,766,0.4993464052287582,0.5006535947712418
E01024910,1466,693,773,0.47271487039563437,0.5272851296043656
E01024951,1205,606,599,0.5029045643153527,0.4970954356846473
E01024952,1300,663,637,0.51,0.49
E01024953,1396,698,698,0.5,0.5
E01024954,1399,702,697,0.5017869907076483,0.4982130092923517
E01024921,2123,1015,1108,0.4780970325011776,0.5219029674988224
E01024978,1341,671,670,0.5003728560775541,0.49962714392244595
E01024979,1382,665,717,0.48118668596237335,0.5188133140376266
E01024980,1388,675,713,0.48631123919308356,0.5136887608069164
E01024946,1241,596,645,0.4802578565672844,0.5197421434327155
E01024947,1348,688,660,0.5103857566765578,0.4896142433234421
E01024955,1475,749,726,0.5077966101694915,0.4922033898305085
E01024956,1444,701,743,0.48545706371191133,0.5145429362880887
E01024957,1441,692,749,0.48022206800832756,0.5197779319916724
E01024958,1371,684,687,0.4989059080962801,0.5010940919037199
E01024948,1456,739,717,0.507554945054945,0.49244505494505497
E01024949,2295,1128,1167,0.4915032679738562,0.5084967320261438
E01024950,1357,694,663,0.5114222549742078,0.4885777450257922
E01024977,2239,1098,1141,0.4903974988834301,0.5096025011165699
E01024967,1302,634,668,0.4869431643625192,0.5130568356374808
E01024968,1891,936,955,0.4949762030671602,0.5050237969328397
E01024969,1364,631,733,0.4626099706744868,0.5373900293255132
E01024970,1370,697,673,0.5087591240875913,0.4912408759124088
E01024971,1296,619,677,0.47762345679012347,0.5223765432098766
E01024972,1264,629,635,0.497626582278481,0.502373417721519
E01024929,1345,665,680,0.4944237918215613,0.5055762081784386
E01024930,1438,733,705,0.5097357440890126,0.4902642559109875
E01024931,1487,705,782,0.4741089441829186,0.5258910558170814
E01024932,1025,512,513,0.4995121951219512,0.5004878048780488
E01024933,1356,663,693,0.4889380530973451,0.5110619469026548
E01024937,1488,722,766,0.4852150537634409,0.5147849462365591
E01024964,1462,721,741,0.49316005471956226,0.5068399452804377
E01024974,1547,758,789,0.48998060762766643,0.5100193923723335
E01024975,3156,2497,659,0.791191381495564,0.208808618504436
E01024976,1555,755,800,0.4855305466237942,0.5144694533762058
E01024919,2572,1269,1303,0.49339035769828926,0.5066096423017107
E01024920,1939,960,979,0.4951005673027334,0.5048994326972667
E01024934,1509,716,793,0.47448641484426773,0.5255135851557323
E01024935,1418,672,746,0.47390691114245415,0.5260930888575458
E01024925,1708,814,894,0.4765807962529274,0.5234192037470726
E01024926,1921,926,995,0.48204060385216035,0.5179593961478397
E01024927,1667,804,863,0.4823035392921416,0.5176964607078585
E01024928,1527,735,792,0.481335952848723,0.518664047151277
E01024936,1546,798,748,0.5161707632600259,0.48382923673997413
E01024938,1624,827,797,0.5092364532019704,0.4907635467980296
E01024939,1744,857,887,0.4913990825688073,0.5086009174311926
E01024940,1699,904,795,0.5320776927604474,0.4679223072395527
E01024941,1568,783,785,0.49936224489795916,0.5006377551020408
E01024923,1234,628,606,0.5089141004862237,0.49108589951377635
E01024924,1412,725,687,0.5134560906515581,0.48654390934844194
E01024963,1515,733,782,0.48382838283828383,0.5161716171617162
E01024965,1400,691,709,0.49357142857142855,0.5064285714285715
E01024966,1588,783,805,0.49307304785894207,0.506926952141058
E01024942,1629,795,834,0.4880294659300184,0.5119705340699816
E01024943,2293,1108,1185,0.48320976886175315,0.5167902311382468
E01024944,1786,870,916,0.48712206047032475,0.5128779395296752
E01024945,2889,1425,1464,0.4932502596053998,0.5067497403946002
E01024922,1450,698,752,0.48137931034482756,0.5186206896551724
E01024959,1740,865,875,0.49712643678160917,0.5028735632183908
E01024960,1623,799,824,0.492298213185459,0.5077017868145409
E01024961,1602,785,817,0.49001248439450684,0.5099875156054932
E01024962,1544,752,792,0.48704663212435234,0.5129533678756477
E01024915,2181,1061,1120,0.4864740944520862,0.5135259055479138
E01024916,1673,831,842,0.4967124925283921,0.5032875074716079
E01024917,1723,861,862,0.4997098084735926,0.5002901915264074
E01024918,1749,845,904,0.48313321898227557,0.5168667810177244
E01024973,2135,1047,1088,0.49039812646370023,0.5096018735362998
E01024993,1479,707,772,0.47802569303583503,0.521974306964165
E01025026,1328,667,661,0.5022590361445783,0.4977409638554217
E01025027,1778,871,907,0.4898762654668167,0.5101237345331834
E01025028,1368,660,708,0.4824561403508772,0.5175438596491229
E01025031,1205,603,602,0.5004149377593361,0.4995850622406639
E01025007,1288,636,652,0.4937888198757764,0.5062111801242236
E01025008,1151,564,587,0.4900086880973067,0.5099913119026933
E01025009,1451,708,743,0.4879393521709166,0.5120606478290833
E01025011,1471,694,777,0.47178789938817134,0.5282121006118287
E01025012,1975,955,1020,0.4835443037974684,0.5164556962025316
E01025013,1609,755,854,0.4692355500310752,0.5307644499689248
E01025019,1373,655,718,0.4770575382374363,0.5229424617625638
E01024998,1799,822,977,0.45692051139521955,0.5430794886047804
E01025010,1833,1169,664,0.6377523186033824,0.36224768139661756
E01025014,1683,856,827,0.5086155674390969,0.49138443256090314
E01025015,1544,752,792,0.48704663212435234,0.5129533678756477
E01025004,1326,632,694,0.4766214177978884,0.5233785822021116
E01025006,1313,651,662,0.49581111957349583,0.5041888804265042
E01025023,1332,634,698,0.47597597597597596,0.524024024024024
E01025024,1312,619,693,0.4717987804878049,0.5282012195121951
E01025025,1533,742,791,0.4840182648401826,0.5159817351598174
E01025001,1560,701,859,0.4493589743589744,0.5506410256410257
E01025002,1465,695,770,0.47440273037542663,0.5255972696245734
E01025005,1434,677,757,0.4721059972105997,0.5278940027894002
E01025016,2366,1147,1219,0.48478444632290785,0.5152155536770922
E01025018,1232,586,646,0.47564935064935066,0.5243506493506493
E01024984,1438,692,746,0.4812239221140473,0.5187760778859527
E01024985,1391,676,715,0.48598130841121495,0.514018691588785
E01024986,1530,790,740,0.5163398692810458,0.48366013071895425
E01024987,1273,665,608,0.5223880597014925,0.47761194029850745
E01024988,1598,804,794,0.5031289111389237,0.49687108886107634
E01024989,1491,731,760,0.4902749832327297,0.5097250167672703
E01024996,1234,611,623,0.49513776337115073,0.5048622366288493
E01024997,1424,686,738,0.48174157303370785,0.5182584269662921
E01024999,1514,724,790,0.47820343461030385,0.5217965653896962
E01025000,1282,628,654,0.48985959438377535,0.5101404056162246
E01025029,1949,969,980,0.49717804002052335,0.5028219599794767
E01025030,1647,793,854,0.48148148148148145,0.5185185185185185
E01024981,1332,656,676,0.4924924924924925,0.5075075075075075
E01024982,1379,650,729,0.4713560551124003,0.5286439448875997
E01024983,1459,703,756,0.4818368745716244,0.5181631254283756
E01024994,1587,766,821,0.48267170762444866,0.5173282923755513
E01024995,1419,668,751,0.47075405214940097,0.529245947850599
E01025003,1638,785,853,0.47924297924297926,0.5207570207570208
E01025017,1418,619,799,0.43653032440056416,0.5634696755994358
E01024990,1586,745,841,0.4697351828499369,0.530264817150063
E01024991,1014,454,560,0.4477317554240631,0.5522682445759369
E01024992,1346,606,740,0.45022288261515603,0.549777117384844
E01025020,1293,615,678,0.4756380510440835,0.5243619489559165
E01025021,1436,711,725,0.49512534818941506,0.504874651810585
E01025022,1871,876,995,0.4681988241582042,0.5318011758417959
E01025060,1466,720,746,0.49113233287858116,0.5088676671214188
E01025061,1449,681,768,0.4699792960662526,0.5300207039337475
E01025062,1571,787,784,0.5009548058561426,0.4990451941438574
E01025063,1506,761,745,0.5053120849933599,0.4946879150066401
E01025064,1579,770,809,0.4876504116529449,0.5123495883470551
E01025065,1637,826,811,0.5045815516188149,0.4954184483811851
E01025066,1592,779,813,0.48932160804020103,0.510678391959799
E01025032,1455,690,765,0.4742268041237113,0.5257731958762887
E01025033,2299,1147,1152,0.4989125706829056,0.5010874293170944
E01025034,1683,861,822,0.5115864527629234,0.48841354723707664
E01025048,1583,792,791,0.5003158559696779,0.4996841440303222
E01025049,1612,784,828,0.48635235732009924,0.5136476426799007
E01025050,1530,742,788,0.4849673202614379,0.515032679738562
E01025053,1552,748,804,0.48195876288659795,0.5180412371134021
E01025070,1162,583,579,0.5017211703958692,0.49827882960413084
E01025071,1381,685,696,0.4960173787110789,0.503982621288921
E01025072,1381,693,688,0.501810282404055,0.498189717595945
E01025073,1289,639,650,0.495733126454616,0.504266873545384
E01025074,1412,696,716,0.49291784702549574,0.5070821529745042
E01025051,1384,709,675,0.5122832369942196,0.4877167630057804
E01025052,1482,729,753,0.49190283400809715,0.5080971659919028
E01025057,1591,780,811,0.49025769956002513,0.5097423004399748
E01025058,1381,625,756,0.4525706010137581,0.5474293989862419
E01025059,1480,665,815,0.44932432432432434,0.5506756756756757
E01025067,1525,785,740,0.5147540983606558,0.4852459016393443
E01025068,1512,754,758,0.49867724867724866,0.5013227513227513
E01025069,1481,754,727,0.5091154625253207,0.49088453747467925
E01025044,1236,595,641,0.4813915857605178,0.5186084142394822
E01025045,1281,595,686,0.4644808743169399,0.5355191256830601
E01025046,1230,615,615,0.5,0.5
E01025081,1651,825,826,0.4996971532404603,0.5003028467595396
E01025041,1708,861,847,0.5040983606557377,0.4959016393442623
E01025042,2197,1096,1101,0.4988620846609012,0.5011379153390988
E01025082,1715,836,879,0.48746355685131193,0.5125364431486881
E01025083,2003,946,1057,0.47229156265601596,0.527708437343984
E01025084,1634,835,799,0.511015911872705,0.488984088127295
E01033231,2869,1422,1447,0.4956430812129662,0.5043569187870338
E01025055,1506,768,738,0.5099601593625498,0.4900398406374502
E01025075,1677,836,841,0.49850924269528923,0.5014907573047108
E01025076,1367,646,721,0.4725676664228237,0.5274323335771763
E01025077,1372,657,715,0.47886297376093295,0.5211370262390671
E01025078,1528,789,739,0.5163612565445026,0.4836387434554974
E01025035,1483,764,719,0.5151719487525287,0.48482805124747136
E01025036,1505,804,701,0.53421926910299,0.46578073089700994
E01025037,1436,690,746,0.4805013927576602,0.5194986072423399
E01025038,1358,653,705,0.4808541973490427,0.5191458026509573
E01025039,1212,618,594,0.5099009900990099,0.4900990099009901
E01025040,1472,745,727,0.5061141304347826,0.4938858695652174
E01025054,1714,867,847,0.5058343057176196,0.4941656942823804
E01025056,1341,674,667,0.5026099925428784,0.49739000745712153
E01025079,1666,854,812,0.5126050420168067,0.48739495798319327
E01025080,1598,801,797,0.5012515644555695,0.49874843554443055
E01025088,1121,559,562,0.49866190900981266,0.5013380909901873
E01025096,1598,778,820,0.48685857321652065,0.5131414267834794
E01025097,1488,733,755,0.49260752688172044,0.5073924731182796
E01025098,1353,637,716,0.4708056171470806,0.5291943828529194
E01025148,2035,976,1059,0.4796068796068796,0.5203931203931204
E01025168,1094,525,569,0.47989031078610606,0.520109689213894
E01025169,1266,583,683,0.46050552922590837,0.5394944707740916
E01025130,2123,1027,1096,0.4837494112105511,0.5162505887894488
E01025132,1488,765,723,0.5141129032258065,0.48588709677419356
E01025166,1180,563,617,0.47711864406779664,0.5228813559322034
E01025167,1218,636,582,0.5221674876847291,0.47783251231527096
E01025089,1395,657,738,0.47096774193548385,0.5290322580645161
E01025090,1739,848,891,0.48763657274295574,0.5123634272570443
E01025158,1433,666,767,0.4647592463363573,0.5352407536636427
E01025159,1431,667,764,0.4661076170510133,0.5338923829489868
E01025160,1255,605,650,0.4820717131474104,0.5179282868525896
E01025085,1392,657,735,0.47198275862068967,0.5280172413793104
E01025086,1370,617,753,0.45036496350364963,0.5496350364963504
E01025087,1305,545,760,0.41762452107279696,0.5823754789272031
E01025161,1123,512,611,0.45592163846838824,0.5440783615316117
E01025108,1232,596,636,0.4837662337662338,0.5162337662337663
E01025109,1045,488,557,0.46698564593301434,0.5330143540669856
E01025131,1533,748,785,0.48793215916503585,0.5120678408349641
E01025133,1421,681,740,0.4792399718508093,0.5207600281491908
E01025112,1654,800,854,0.4836759371221282,0.5163240628778718
E01025136,1565,730,835,0.46645367412140576,0.5335463258785943
E01025138,1463,713,750,0.48735475051264526,0.5126452494873548
E01025139,1636,860,776,0.5256723716381418,0.4743276283618582
E01025140,1495,731,764,0.4889632107023411,0.5110367892976588
E01025111,1807,857,950,0.4742667404537908,0.5257332595462092
E01025113,1519,747,772,0.49177090190915074,0.5082290980908493
E01025118,1115,537,578,0.48161434977578477,0.5183856502242152
E01025119,1348,644,704,0.47774480712166173,0.5222551928783383
E01025110,1419,739,680,0.5207892882311487,0.4792107117688513
E01025116,1401,668,733,0.476802284082798,0.523197715917202
E01025117,1406,757,649,0.5384068278805121,0.4615931721194879
E01025120,1405,690,715,0.49110320284697506,0.5088967971530249
E01025170,1679,780,899,0.4645622394282311,0.535437760571769
E01025171,1710,797,913,0.46608187134502926,0.5339181286549708
E01025172,1536,708,828,0.4609375,0.5390625
E01025173,1640,769,871,0.4689024390243902,0.5310975609756098
E01025149,2134,1052,1082,0.492970946579194,0.507029053420806
E01025150,1485,686,799,0.46195286195286195,0.538047138047138
E01025151,1538,757,781,0.49219765929778936,0.5078023407022106
E01025152,1511,726,785,0.4804765056254136,0.5195234943745863
E01025154,1339,630,709,0.4705003734129948,0.5294996265870052
E01025091,1473,712,761,0.48336727766463,0.5166327223353699
E01025092,1212,548,664,0.4521452145214521,0.5478547854785478
E01025095,1461,857,604,0.5865845311430528,0.4134154688569473
E01025126,1923,955,968,0.4966198647945918,0.5033801352054083
E01025093,1705,820,885,0.4809384164222874,0.5190615835777126
E01025094,1418,772,646,0.5444287729196051,0.45557122708039494
E01025099,1497,794,703,0.5303941215764864,0.4696058784235137
E01033071,1207,648,559,0.5368682684341343,0.4631317315658658
E01033073,1719,857,862,0.4985456660849331,0.5014543339150669
E01025125,1356,576,780,0.4247787610619469,0.5752212389380531
E01025128,1314,643,671,0.4893455098934551,0.510654490106545
E01025129,1244,596,648,0.4790996784565916,0.5209003215434084
E01025147,1453,713,740,0.4907088781830695,0.5092911218169305
E01025114,1507,726,781,0.48175182481751827,0.5182481751824818
E01025115,1570,745,825,0.4745222929936306,0.5254777070063694
E01025121,1725,837,888,0.4852173913043478,0.5147826086956522
E01025122,1716,822,894,0.479020979020979,0.5209790209790209
E01025123,2313,1132,1181,0.48940769563337655,0.5105923043666234
E01025124,1510,732,778,0.4847682119205298,0.5152317880794702
E01033072,2414,1188,1226,0.49212924606462305,0.507870753935377
E01025100,1542,762,780,0.49416342412451364,0.5058365758754864
E01025101,1413,694,719,0.49115357395612175,0.5088464260438783
E01025102,1461,661,800,0.45242984257357977,0.5475701574264202
E01025103,1337,655,682,0.48990276738967836,0.5100972326103216
E01025144,2045,844,1201,0.41271393643031784,0.5872860635696822
E01025146,2041,994,1047,0.487016168544831,0.512983831455169
E01025127,1376,667,709,0.48473837209302323,0.5152616279069767
E01025141,1443,700,743,0.4851004851004851,0.5148995148995149
E01025143,1448,675,773,0.4661602209944751,0.5338397790055248
E01025145,1472,655,817,0.44497282608695654,0.5550271739130435
E01025105,6137,2972,3165,0.4842757047417305,0.5157242952582695
E01025106,2458,1170,1288,0.4759967453213995,0.5240032546786005
E01025107,1643,837,806,0.5094339622641509,0.49056603773584906
E01025142,1452,694,758,0.47796143250688705,0.522038567493113
E01025137,1464,717,747,0.48975409836065575,0.5102459016393442
E01025153,1245,623,622,0.5004016064257029,0.4995983935742972
E01025155,1258,625,633,0.4968203497615262,0.5031796502384738
E01025156,1175,550,625,0.46808510638297873,0.5319148936170213
E01025157,1153,530,623,0.45967042497831745,0.5403295750216826
E01025162,1348,625,723,0.46364985163204747,0.5363501483679525
E01025163,1384,662,722,0.47832369942196534,0.5216763005780347
E01025164,1400,651,749,0.465,0.535
E01025165,1500,758,742,0.5053333333333333,0.49466666666666664
E01025191,1254,619,635,0.49362041467304624,0.5063795853269537
E01025192,1438,723,715,0.5027816411682893,0.4972183588317107
E01025193,1358,650,708,0.4786450662739323,0.5213549337260678
E01025194,1395,687,708,0.4924731182795699,0.5075268817204301
E01025195,1210,604,606,0.4991735537190083,0.5008264462809917
E01025196,1599,832,767,0.5203252032520326,0.4796747967479675
E01025197,1341,662,679,0.4936614466815809,0.506338553318419
E01025198,1401,670,731,0.4782298358315489,0.5217701641684511
E01025199,1678,828,850,0.4934445768772348,0.5065554231227652
E01025200,1524,747,777,0.49015748031496065,0.5098425196850394
E01025201,1599,782,817,0.4890556597873671,0.5109443402126329
E01025202,1382,682,700,0.4934876989869754,0.5065123010130246
E01025205,1381,677,704,0.49022447501810285,0.5097755249818972
E01025206,1173,555,618,0.4731457800511509,0.5268542199488491
E01025207,1265,627,638,0.4956521739130435,0.5043478260869565
E01025208,1270,604,666,0.4755905511811024,0.5244094488188976
E01025220,1594,750,844,0.47051442910915936,0.5294855708908407
E01025221,1351,655,696,0.4848260547742413,0.5151739452257587
E01025222,1468,709,759,0.4829700272479564,0.5170299727520435
E01025223,1414,691,723,0.4886845827439887,0.5113154172560113
E01025178,1815,877,938,0.4831955922865014,0.5168044077134987
E01025179,1570,764,806,0.48662420382165605,0.513375796178344
E01025180,1877,926,951,0.4933404368673415,0.5066595631326585
E01025203,1683,850,833,0.5050505050505051,0.494949494949495
E01025226,1579,814,765,0.5155161494616846,0.4844838505383154
E01025227,2011,995,1016,0.494778717056191,0.5052212829438091
E01025228,1590,789,801,0.4962264150943396,0.5037735849056604
E01025174,1461,703,758,0.4811772758384668,0.5188227241615332
E01025175,1580,781,799,0.49430379746835446,0.5056962025316456
E01025176,2002,952,1050,0.4755244755244755,0.5244755244755245
E01025177,1800,879,921,0.48833333333333334,0.5116666666666667
E01025204,1642,800,842,0.48721071863581,0.51278928136419
E01025211,1459,716,743,0.49074708704592185,0.5092529129540782
E01025181,1565,717,848,0.45814696485623,0.5418530351437699
E01025182,1630,821,809,0.503680981595092,0.496319018404908
E01025183,1646,817,829,0.49635479951397327,0.5036452004860267
E01025184,1648,818,830,0.4963592233009709,0.5036407766990292
E01025188,2013,1001,1012,0.4972677595628415,0.5027322404371585
E01025189,1679,823,856,0.49017272185824895,0.509827278141751
E01025210,1803,888,915,0.4925124792013311,0.5074875207986689
E01025217,1536,768,768,0.5,0.5
E01025218,1261,642,619,0.5091197462331483,0.4908802537668517
E01025219,1160,589,571,0.5077586206896552,0.49224137931034484
E01025224,2165,1071,1094,0.49468822170900695,0.505311778290993
E01025225,1683,810,873,0.48128342245989303,0.5187165775401069
E01025229,2222,1108,1114,0.49864986498649866,0.5013501350135013
E01025230,1632,825,807,0.5055147058823529,0.4944852941176471
E01025187,1424,692,732,0.4859550561797753,0.5140449438202247
E01025190,1689,809,880,0.4789816459443458,0.5210183540556542
E01025209,1686,826,860,0.48991696322657174,0.5100830367734283
E01025216,2117,1017,1100,0.48039678790741613,0.5196032120925839
E01025185,1929,954,975,0.49455676516329705,0.505443234836703
E01025186,1509,797,712,0.5281643472498343,0.47183565275016565
E01025212,1402,691,711,0.492867332382311,0.507132667617689
E01025213,1122,557,565,0.4964349376114082,0.5035650623885918
E01025214,1379,677,702,0.4909354604786077,0.5090645395213923
E01025215,1388,694,694,0.5,0.5
E01025278,2543,1259,1284,0.49508454581203304,0.504915454187967
E01025279,1945,948,997,0.48740359897172236,0.5125964010282776
E01025282,1398,674,724,0.4821173104434907,0.5178826895565093
E01025257,1346,671,675,0.4985141158989599,0.5014858841010401
E01025277,1722,840,882,0.4878048780487805,0.5121951219512195
E01025280,1804,884,920,0.49002217294900224,0.5099778270509978
E01025281,1500,726,774,0.484,0.516
E01025256,1503,698,805,0.4644045242847638,0.5355954757152362
E01025258,1490,718,772,0.4818791946308725,0.5181208053691275
E01025259,2065,1002,1063,0.48523002421307504,0.514769975786925
E01025299,1441,699,742,0.4850798056904927,0.5149201943095073
E01025301,1128,556,572,0.4929078014184397,0.5070921985815603
E01025302,1238,602,636,0.4862681744749596,0.5137318255250404
E01025253,1773,891,882,0.5025380710659898,0.49746192893401014
E01025254,1216,593,623,0.4876644736842105,0.5123355263157895
E01025255,1597,803,794,0.5028177833437696,0.4971822166562304
E01025300,1133,538,595,0.4748455428067079,0.5251544571932921
E01025303,1339,652,687,0.48693054518297235,0.5130694548170276
E01025260,1490,723,767,0.48523489932885905,0.5147651006711409
E01025262,1510,753,757,0.4986754966887417,0.5013245033112583
E01025263,1500,692,808,0.4613333333333333,0.5386666666666666
E01025264,1451,709,742,0.48862853204686424,0.5113714679531358
E01025239,1393,659,734,0.47307968413496054,0.5269203158650395
E01025241,1605,783,822,0.48785046728971965,0.5121495327102804
E01025242,1612,774,838,0.4801488833746898,0.5198511166253101
E01025243,1966,1016,950,0.5167853509664293,0.4832146490335707
E01025251,1494,731,763,0.4892904953145917,0.5107095046854083
E01025234,1461,720,741,0.4928131416837782,0.5071868583162218
E01025235,1647,812,835,0.4930176077717061,0.5069823922282939
E01025237,1488,716,772,0.48118279569892475,0.5188172043010753
E01025238,1562,726,836,0.4647887323943662,0.5352112676056338
E01025245,2663,1286,1377,0.482914006759294,0.5170859932407059
E01025252,1423,675,748,0.47434996486296555,0.5256500351370345
E01025233,1406,688,718,0.48933143669985774,0.5106685633001422
E01025240,1591,781,810,0.4908862350722816,0.5091137649277184
E01025261,1418,679,739,0.4788434414668547,0.5211565585331452
E01025266,1262,620,642,0.49128367670364503,0.508716323296355
E01025309,1160,586,574,0.5051724137931034,0.49482758620689654
E01025236,1455,689,766,0.4735395189003436,0.5264604810996564
E01025283,1685,825,860,0.4896142433234421,0.5103857566765578
E01025284,1761,880,881,0.4997160704145372,0.5002839295854627
E01025285,1428,726,702,0.5084033613445378,0.49159663865546216
E01025286,1706,861,845,0.5046893317702228,0.49531066822977726
E01025287,1968,997,971,0.5066056910569106,0.49339430894308944
E01025270,1593,809,784,0.5078468298807282,0.4921531701192718
E01025272,1585,799,786,0.5041009463722398,0.49589905362776027
E01025273,1420,720,700,0.5070422535211268,0.49295774647887325
E01025288,1599,862,737,0.5390869293308318,0.46091307066916826
E01025246,1750,911,839,0.5205714285714286,0.4794285714285714
E01025274,1907,1015,892,0.5322496067121133,0.46775039328788676
E01025275,1609,768,841,0.47731510254816656,0.5226848974518334
E01025294,1827,947,880,0.518336070060208,0.481663929939792
E01025276,1695,862,833,0.5085545722713865,0.49144542772861355
E01025308,1717,819,898,0.47699475829935933,0.5230052417006407
E01025310,1516,752,764,0.49604221635883905,0.503957783641161
E01025311,1346,626,720,0.4650817236255572,0.5349182763744428
E01025312,1641,852,789,0.5191956124314442,0.48080438756855576
E01025313,1948,970,978,0.49794661190965095,0.502053388090349
E01025314,2670,1290,1380,0.48314606741573035,0.5168539325842697
E01025231,1448,680,768,0.4696132596685083,0.5303867403314917
E01025232,1605,857,748,0.5339563862928349,0.4660436137071651
E01025265,1490,739,751,0.4959731543624161,0.5040268456375839
E01025267,1446,702,744,0.4854771784232365,0.5145228215767634
E01025268,1664,841,823,0.5054086538461539,0.49459134615384615
E01025269,1638,787,851,0.4804639804639805,0.5195360195360196
E01025271,1559,754,805,0.4836433611289288,0.5163566388710712
E01025295,2559,1644,915,0.6424384525205158,0.35756154747948415
E01025296,1950,974,976,0.49948717948717947,0.5005128205128205
E01025297,2057,1037,1020,0.5041322314049587,0.49586776859504134
E01025298,1621,805,816,0.49660703269586676,0.5033929673041333
E01025244,1690,879,811,0.5201183431952663,0.4798816568047337
E01025292,3172,1603,1569,0.505359394703657,0.494640605296343
E01025293,2030,1055,975,0.5197044334975369,0.4802955665024631
E01025247,1728,892,836,0.5162037037037037,0.4837962962962963
E01025248,1328,623,705,0.4691265060240964,0.5308734939759037
E01025249,1016,512,504,0.5039370078740157,0.49606299212598426
E01025250,1712,866,846,0.5058411214953271,0.4941588785046729
E01025304,1845,922,923,0.4997289972899729,0.5002710027100271
E01025305,1641,816,825,0.49725776965265084,0.5027422303473492
E01025289,1680,883,797,0.5255952380952381,0.4744047619047619
E01025290,1707,911,796,0.533684827182191,0.46631517281780904
E01025291,1365,694,671,0.5084249084249084,0.49157509157509155
E01025306,1795,1041,754,0.5799442896935934,0.4200557103064067
E01033223,1235,717,518,0.5805668016194332,0.4194331983805668
E01033224,1029,582,447,0.565597667638484,0.43440233236151604
E01033226,1083,605,478,0.5586334256694367,0.44136657433056325
E01025315,1737,905,832,0.5210132412204951,0.4789867587795049
E01025320,1325,661,664,0.49886792452830186,0.5011320754716981
E01025331,1405,713,692,0.507473309608541,0.4925266903914591
E01025348,1517,740,777,0.4878048780487805,0.5121951219512195
E01025349,1416,693,723,0.4894067796610169,0.510593220338983
E01025334,1559,747,812,0.47915330339961515,0.5208466966003849
E01025344,1397,638,759,0.4566929133858268,0.5433070866141733
E01025345,1449,731,718,0.5044858523119393,0.49551414768806074
E01025346,1502,745,757,0.4960053262316911,0.503994673768309
E01025347,1633,813,820,0.49785670545009186,0.5021432945499081
E01025329,1431,709,722,0.4954577218728162,0.5045422781271838
E01025330,1342,647,695,0.4821162444113264,0.5178837555886736
E01025335,1377,637,740,0.4625998547567175,0.5374001452432825
E01025338,1592,812,780,0.5100502512562815,0.4899497487437186
E01025339,1483,711,772,0.4794335805799056,0.5205664194200944
E01025322,1356,682,674,0.5029498525073747,0.4970501474926254
E01025326,1477,691,786,0.46784021665538256,0.5321597833446174
E01025327,1320,630,690,0.4772727272727273,0.5227272727272727
E01025342,1598,811,787,0.5075093867334167,0.4924906132665832
E01025321,1316,628,688,0.47720364741641336,0.5227963525835866
E01025340,1402,677,725,0.48288159771754635,0.5171184022824536
E01025341,1171,568,603,0.4850555081127242,0.5149444918872759
E01025343,1422,703,719,0.49437412095639943,0.5056258790436006
E01025354,1316,637,679,0.48404255319148937,0.5159574468085106
E01025316,1480,713,767,0.4817567567567568,0.5182432432432432
E01025317,1163,567,596,0.48753224419604474,0.5124677558039553
E01025325,1518,729,789,0.48023715415019763,0.5197628458498024
E01025328,1231,577,654,0.4687246141348497,0.5312753858651503
E01025318,1060,518,542,0.48867924528301887,0.5113207547169811
E01025319,2094,1038,1056,0.49570200573065903,0.504297994269341
E01025333,1212,591,621,0.4876237623762376,0.5123762376237624
E01025350,1289,615,674,0.47711404189294027,0.5228859581070597
E01025351,2606,1325,1281,0.5084420567920184,0.4915579432079816
E01025323,1132,557,575,0.4920494699646643,0.5079505300353356
E01025324,1501,713,788,0.475016655562958,0.524983344437042
E01025332,1049,524,525,0.49952335557673977,0.5004766444232602
E01025336,1121,540,581,0.4817127564674398,0.5182872435325602
E01025337,1551,752,799,0.48484848484848486,0.5151515151515151
E01025352,1492,769,723,0.5154155495978552,0.48458445040214476
E01025353,1090,516,574,0.47339449541284406,0.5266055045871559
E01025355,2248,1097,1151,0.48798932384341637,0.5120106761565836
E01025361,2062,980,1082,0.475266731328807,0.524733268671193
E01025362,1971,978,993,0.4961948249619482,0.5038051750380518
E01025393,1430,709,721,0.4958041958041958,0.5041958041958042
E01025363,1363,632,731,0.46368305209097577,0.5363169479090242
E01025364,1310,648,662,0.4946564885496183,0.5053435114503817
E01025366,1557,765,792,0.4913294797687861,0.5086705202312138
E01025395,1565,777,788,0.4964856230031949,0.5035143769968051
E01025396,1375,667,708,0.4850909090909091,0.5149090909090909
E01025397,1688,855,833,0.5065165876777251,0.4934834123222749
E01025398,1406,697,709,0.4957325746799431,0.5042674253200569
E01025367,1776,888,888,0.5,0.5
E01025368,1596,785,811,0.4918546365914787,0.5081453634085213
E01025369,1230,584,646,0.47479674796747967,0.5252032520325203
E01025381,1473,701,772,0.47589952477936187,0.5241004752206382
E01025382,1722,862,860,0.5005807200929152,0.4994192799070848
E01025383,2310,1166,1144,0.5047619047619047,0.49523809523809526
E01025356,1508,752,756,0.4986737400530504,0.5013262599469496
E01025373,1561,763,798,0.48878923766816146,0.5112107623318386
E01025385,1250,591,659,0.4728,0.5272
E01025387,1320,673,647,0.5098484848484849,0.49015151515151517
E01033281,2612,1307,1305,0.5003828483920367,0.4996171516079633
E01025377,1413,709,704,0.5017692852087756,0.4982307147912243
E01025378,1500,756,744,0.504,0.496
E01025379,1406,628,778,0.4466571834992888,0.5533428165007113
E01025380,1486,726,760,0.48855989232839836,0.5114401076716016
E01025357,1320,640,680,0.48484848484848486,0.5151515151515151
E01025358,2200,1059,1141,0.4813636363636364,0.5186363636363637
E01025365,1496,709,787,0.47393048128342247,0.5260695187165776
E01025384,1247,600,647,0.48115477145148355,0.5188452285485164
E01025359,1634,824,810,0.5042839657282742,0.49571603427172584
E01025360,1952,968,984,0.4959016393442623,0.5040983606557377
E01025375,1672,831,841,0.49700956937799046,0.5029904306220095
E01025376,2242,1085,1157,0.483942908117752,0.516057091882248
E01025370,1203,608,595,0.5054031587697423,0.4945968412302577
E01025371,1400,677,723,0.4835714285714286,0.5164285714285715
E01025374,1477,739,738,0.5003385240352065,0.4996614759647935
E01025388,1465,737,728,0.5030716723549488,0.4969283276450512
E01025389,1232,585,647,0.47483766233766234,0.5251623376623377
E01025390,1092,517,575,0.4734432234432234,0.5265567765567766
E01025391,1491,724,767,0.48558014755197854,0.5144198524480215
E01025392,1203,617,586,0.512884455527847,0.48711554447215294
E01025394,1518,751,767,0.49472990777338605,0.505270092226614
E01025424,1261,606,655,0.48057097541633625,0.5194290245836638
E01025425,1357,675,682,0.4974207811348563,0.5025792188651437
E01025426,1245,610,635,0.4899598393574297,0.5100401606425703
E01025466,1491,726,765,0.4869215291750503,0.5130784708249497
E01025413,1801,862,939,0.47862298722931707,0.5213770127706829
E01025414,1571,788,783,0.501591343093571,0.49840865690642905
E01025456,1206,585,621,0.48507462686567165,0.5149253731343284
E01025458,1476,725,751,0.4911924119241192,0.5088075880758808
E01025408,1447,695,752,0.48030407740152037,0.5196959225984796
E01025409,1322,643,679,0.4863842662632375,0.5136157337367625
E01025410,1394,678,716,0.48637015781922527,0.5136298421807748
E01025467,2013,953,1060,0.4734227521112767,0.5265772478887233
E01025403,2021,1009,1012,0.49925779317169716,0.5007422068283028
E01025457,1397,691,706,0.49463135289906945,0.5053686471009305
E01025463,1377,668,709,0.4851125635439361,0.5148874364560639
E01025464,1297,653,644,0.5034695451040864,0.49653045489591363
E01025465,1118,554,564,0.49552772808586765,0.5044722719141324
E01025411,2054,996,1058,0.48490749756572543,0.5150925024342746
E01025448,1608,806,802,0.5012437810945274,0.4987562189054726
E01025449,1002,493,509,0.49201596806387227,0.5079840319361277
E01025450,1036,492,544,0.4749034749034749,0.525096525096525
E01025412,1478,729,749,0.493234100135318,0.506765899864682
E01025427,1438,728,710,0.5062586926286509,0.4937413073713491
E01025428,1554,730,824,0.4697554697554698,0.5302445302445302
E01025429,1347,630,717,0.46770601336302897,0.532293986636971
E01025404,1209,599,610,0.49545078577336643,0.5045492142266336
E01025405,1211,582,629,0.4805945499587118,0.5194054500412882
E01025406,1223,596,627,0.4873262469337694,0.5126737530662305
E01025407,1950,928,1022,0.4758974358974359,0.5241025641025641
E01025399,1579,737,842,0.4667511082963901,0.5332488917036099
E01025400,1845,865,980,0.46883468834688347,0.5311653116531165
E01025401,1472,733,739,0.49796195652173914,0.5020380434782609
E01025402,1435,710,725,0.49477351916376305,0.5052264808362369
E01025442,1075,544,531,0.5060465116279069,0.493953488372093
E01025443,1371,661,710,0.48212983223924144,0.5178701677607586
E01025444,1316,644,672,0.48936170212765956,0.5106382978723404
E01025461,1941,973,968,0.5012879958784132,0.49871200412158684
E01025462,1729,881,848,0.5095430884904569,0.49045691150954307
E01025439,1388,647,741,0.4661383285302594,0.5338616714697406
E01025453,1665,818,847,0.4912912912912913,0.5087087087087087
E01025454,1279,645,634,0.5043002345582487,0.49569976544175137
E01025455,1458,706,752,0.4842249657064472,0.5157750342935528
E01025436,2277,1137,1140,0.4993412384716733,0.5006587615283268
E01025437,1790,903,887,0.5044692737430168,0.49553072625698324
E01025438,1319,651,668,0.4935557240333586,0.5064442759666414
E01025440,1412,687,725,0.48654390934844194,0.5134560906515581
E01025441,1408,664,744,0.4715909090909091,0.5284090909090909
E01025417,1424,679,745,0.4768258426966292,0.5231741573033708
E01025418,1399,675,724,0.48248749106504646,0.5175125089349535
E01025419,1598,766,832,0.4793491864831039,0.5206508135168961
E01025420,2756,1413,1343,0.512699564586357,0.487300435413643
E01025421,2307,1153,1154,0.49978326831382747,0.5002167316861725
E01025422,1340,634,706,0.47313432835820896,0.5268656716417911
E01025431,1744,871,873,0.4994266055045872,0.5005733944954128
E01025433,1820,893,927,0.49065934065934064,0.5093406593406593
E01025416,1549,771,778,0.4977404777275662,0.5022595222724339
E01025451,1976,975,1001,0.4934210526315789,0.506578947368421
E01025452,1703,854,849,0.5014679976512038,0.49853200234879624
E01025415,2051,1023,1028,0.49878108239882984,0.5012189176011702
E01025423,1353,646,707,0.47745750184774577,0.5225424981522543
E01025435,1517,730,787,0.4812129202373105,0.5187870797626896
E01025446,1517,724,793,0.4772577455504285,0.5227422544495716
E01025430,1996,975,1021,0.48847695390781565,0.5115230460921844
E01025434,1962,975,987,0.4969418960244648,0.5030581039755352
E01032928,1929,952,977,0.49351995852773456,0.5064800414722654
E01032929,1084,515,569,0.47509225092250923,0.5249077490774908
E01025445,1443,700,743,0.4851004851004851,0.5148995148995149
E01025447,1196,542,654,0.4531772575250836,0.5468227424749164
E01025459,1678,838,840,0.499404052443385,0.5005959475566151
E01025460,2052,1004,1048,0.48927875243664715,0.5107212475633528
E01025496,1204,611,593,0.5074750830564784,0.4925249169435216
E01025497,1548,751,797,0.4851421188630491,0.5148578811369509
E01025498,1289,622,667,0.48254460822342904,0.517455391776571
E01025530,1437,729,708,0.5073068893528184,0.49269311064718163
E01025532,1534,785,749,0.5117340286831812,0.48826597131681876
E01025533,1571,766,805,0.4875875238701464,0.5124124761298536
E01025507,1525,759,766,0.4977049180327869,0.5022950819672131
E01025508,1423,710,713,0.4989458889669712,0.5010541110330288
E01025509,1198,574,624,0.4791318864774624,0.5208681135225376
E01025513,2049,1028,1021,0.5017081503172279,0.49829184968277207
E01025531,1110,548,562,0.4936936936936937,0.5063063063063064
E01025474,1126,555,571,0.4928952042628774,0.5071047957371225
E01025495,2057,999,1058,0.48565872630043755,0.5143412736995625
E01025514,2263,1132,1131,0.5002209456473707,0.49977905435262926
E01025515,1602,813,789,0.5074906367041199,0.49250936329588013
E01025483,2208,1077,1131,0.48777173913043476,0.5122282608695652
E01025484,1964,967,997,0.4923625254582485,0.5076374745417516
E01025485,1700,836,864,0.49176470588235294,0.508235294117647
E01025486,1664,822,842,0.49399038461538464,0.5060096153846154
E01025487,1646,806,840,0.4896719319562576,0.5103280680437424
E01025510,1365,648,717,0.4747252747252747,0.5252747252747253
E01025511,1147,546,601,0.47602441150828245,0.5239755884917175
E01025512,1272,607,665,0.4772012578616352,0.5227987421383647
E01025538,1531,744,787,0.48595689092096667,0.5140431090790333
E01025539,1355,640,715,0.47232472324723246,0.5276752767527675
E01025499,1359,650,709,0.4782928623988227,0.5217071376011774
E01025501,1113,520,593,0.46720575022461813,0.5327942497753818
E01025502,1620,772,848,0.4765432098765432,0.5234567901234568
E01025516,1502,728,774,0.48468708388814913,0.5153129161118508
E01025517,1538,768,770,0.49934980494148246,0.5006501950585176
E01025519,1249,611,638,0.489191353082466,0.510808646917534
E01025488,1961,896,1065,0.45690973992860784,0.5430902600713922
E01025489,1337,639,698,0.4779356768885565,0.5220643231114436
E01025490,1804,784,1020,0.43458980044345896,0.565410199556541
E01025500,1425,675,750,0.47368421052631576,0.5263157894736842
E01025518,1434,668,766,0.46582984658298465,0.5341701534170153
E01025479,1988,968,1020,0.4869215291750503,0.5130784708249497
E01025491,1618,782,836,0.48331273176761436,0.5166872682323856
E01025506,1970,975,995,0.4949238578680203,0.5050761421319797
E01025468,1714,840,874,0.49008168028004667,0.5099183197199533
E01025469,1567,758,809,0.4837268666241225,0.5162731333758774
E01025470,1502,750,752,0.4993342210386152,0.5006657789613849
E01025522,1144,563,581,0.49213286713286714,0.5078671328671329
E01025471,1527,738,789,0.48330058939096265,0.5166994106090373
E01025480,1443,657,786,0.4553014553014553,0.5446985446985447
E01025481,1451,714,737,0.49207443142660234,0.5079255685733977
E01025482,1456,710,746,0.4876373626373626,0.5123626373626373
E01025520,1230,608,622,0.4943089430894309,0.5056910569105691
E01025521,1687,818,869,0.4848844101956135,0.5151155898043864
E01025523,1653,808,845,0.48880822746521474,0.5111917725347852
E01025524,1484,746,738,0.5026954177897575,0.4973045822102426
E01025525,1625,793,832,0.488,0.512
E01025526,1696,813,883,0.4793632075471698,0.5206367924528302
E01025472,1424,696,728,0.4887640449438202,0.5112359550561798
E01025473,1454,689,765,0.47386519944979366,0.5261348005502063
E01025475,1467,729,738,0.49693251533742333,0.5030674846625767
E01025476,1318,617,701,0.468133535660091,0.5318664643399089
E01025477,1214,582,632,0.4794069192751236,0.5205930807248764
E01025478,1191,585,606,0.491183879093199,0.5088161209068011
E01025492,1286,619,667,0.4813374805598756,0.5186625194401244
E01025527,1390,682,708,0.4906474820143885,0.5093525179856115
E01025528,1767,915,852,0.5178268251273345,0.48217317487266553
E01025529,1823,916,907,0.5024684585847504,0.4975315414152496
E01025493,1635,799,836,0.4886850152905199,0.5113149847094801
E01025494,1546,765,781,0.4948253557567917,0.5051746442432082
E01025503,1369,651,718,0.47552958363769177,0.5244704163623083
E01025504,1115,512,603,0.4591928251121076,0.5408071748878924
E01025505,1425,696,729,0.4884210526315789,0.511578947368421
E01025534,1750,845,905,0.4828571428571429,0.5171428571428571
E01025535,1417,709,708,0.5003528581510233,0.49964714184897674
E01025536,1524,712,812,0.4671916010498688,0.5328083989501312
E01025537,1484,733,751,0.4939353099730458,0.5060646900269542
E01025540,1201,561,640,0.46711074104912575,0.5328892589508742
E01025573,1389,686,703,0.49388048956083513,0.5061195104391649
E01025574,1533,712,821,0.4644487932159165,0.5355512067840835
E01025581,1391,686,705,0.4931703810208483,0.5068296189791517
E01025582,1255,648,607,0.5163346613545817,0.48366533864541833
E01025583,1289,647,642,0.5019394879751745,0.49806051202482543
E01025584,1483,808,675,0.5448415374241402,0.45515846257585973
E01025605,1432,676,756,0.4720670391061452,0.5279329608938548
E01025606,1258,598,660,0.4753577106518283,0.5246422893481717
E01025607,1573,776,797,0.4933248569612206,0.5066751430387794
E01025608,1643,782,861,0.4759586122945831,0.524041387705417
E01025590,1576,748,828,0.4746192893401015,0.5253807106598984
E01025591,1552,751,801,0.4838917525773196,0.5161082474226805
E01025592,1494,700,794,0.4685408299866131,0.5314591700133868
E01025593,1759,883,876,0.5019897669130188,0.4980102330869812
E01025563,1134,549,585,0.48412698412698413,0.5158730158730159
E01025564,1610,779,831,0.48385093167701865,0.5161490683229814
E01025565,1486,733,753,0.49327052489905787,0.5067294751009421
E01025586,1568,765,803,0.48788265306122447,0.5121173469387755
E01025587,1510,732,778,0.4847682119205298,0.5152317880794702
E01025588,1372,644,728,0.46938775510204084,0.5306122448979592
E01025589,1241,618,623,0.49798549556809024,0.5020145044319098
E01025557,1551,734,817,0.4732430689877498,0.5267569310122502
E01025575,1089,504,585,0.4628099173553719,0.5371900826446281
E01025578,1533,731,802,0.47684279191128504,0.5231572080887149
E01025579,1394,672,722,0.48206599713055953,0.5179340028694405
E01025580,1296,648,648,0.5,0.5
E01025547,1934,1025,909,0.5299896587383661,0.47001034126163393
E01025549,2148,1048,1100,0.48789571694599626,0.5121042830540037
E01025609,2035,1010,1025,0.4963144963144963,0.5036855036855037
E01025548,1522,739,783,0.4855453350854139,0.514454664914586
E01025553,2594,1283,1311,0.4946029298380879,0.5053970701619122
E01025558,1707,802,905,0.46983011130638547,0.5301698886936145
E01025559,1834,885,949,0.4825517993456925,0.5174482006543075
E01025560,1311,620,691,0.47292143401983217,0.5270785659801678
E01025554,1514,720,794,0.47556142668428003,0.52443857331572
E01025556,1516,716,800,0.47229551451187335,0.5277044854881267
E01025570,1262,626,636,0.4960380348652932,0.5039619651347068
E01025571,1413,725,688,0.5130927105449399,0.4869072894550602
E01025572,1350,652,698,0.482962962962963,0.5170370370370371
E01025604,1504,721,783,0.47938829787234044,0.5206117021276596
E01025561,1471,727,744,0.49422161794697483,0.5057783820530252
E01025562,2110,1014,1096,0.48056872037914694,0.5194312796208531
E01025585,2293,1156,1137,0.5041430440470999,0.49585695595290014
E01025542,1678,800,878,0.4767580452920143,0.5232419547079857
E01025555,1359,662,697,0.48712288447387786,0.5128771155261221
E01025601,1395,647,748,0.4637992831541219,0.5362007168458781
E01025602,1550,764,786,0.49290322580645163,0.5070967741935484
E01025603,1502,711,791,0.4733688415446072,0.5266311584553928
E01025541,1695,820,875,0.4837758112094395,0.5162241887905604
E01025543,1763,830,933,0.4707884288145207,0.5292115711854793
E01025544,1540,743,797,0.4824675324675325,0.5175324675324675
E01025576,2327,1097,1230,0.47142243231628705,0.5285775676837129
E01025577,1432,695,737,0.48533519553072624,0.5146648044692738
E01025550,1486,732,754,0.49259757738896365,0.5074024226110363
E01025552,1283,631,652,0.49181605611847234,0.5081839438815277
E01025594,1517,693,824,0.45682267633487145,0.5431773236651285
E01025595,1442,696,746,0.4826629680998613,0.5173370319001387
E01025596,2057,1020,1037,0.49586776859504134,0.5041322314049587
E01025597,1096,512,584,0.46715328467153283,0.5328467153284672
E01025545,1878,875,1003,0.46592119275825344,0.5340788072417465
E01025546,1485,684,801,0.46060606060606063,0.5393939393939394
E01025551,1292,627,665,0.4852941176470588,0.5147058823529411
E01025567,1520,704,816,0.4631578947368421,0.5368421052631579
E01025598,1452,711,741,0.4896694214876033,0.5103305785123967
E01025566,1986,966,1020,0.486404833836858,0.513595166163142
E01025568,1717,822,895,0.47874199184624344,0.5212580081537566
E01025569,1846,873,973,0.47291440953412783,0.5270855904658721
E01025599,991,484,507,0.4883955600403633,0.5116044399596368
E01025600,1531,747,784,0.4879163945133899,0.51208360548661
E01006448,1677,714,963,0.4257602862254025,0.5742397137745975
E01006492,1358,658,700,0.4845360824742268,0.5154639175257731
E01006493,1115,479,636,0.4295964125560538,0.5704035874439461
E01006494,1429,583,846,0.4079776067179846,0.5920223932820154
E01006495,1872,893,979,0.47702991452991456,0.5229700854700855
E01006454,1222,595,627,0.4869067103109656,0.5130932896890343
E01006456,1595,814,781,0.5103448275862069,0.4896551724137931
E01006457,1188,557,631,0.46885521885521886,0.5311447811447811
E01006458,1413,654,759,0.46284501061571126,0.5371549893842887
E01006490,2757,1296,1461,0.470076169749728,0.529923830250272
E01006491,1970,967,1003,0.49086294416243653,0.5091370558375634
E01006415,2101,1008,1093,0.4797715373631604,0.5202284626368396
E01006417,1310,680,630,0.5190839694656488,0.48091603053435117
E01006436,1466,703,763,0.4795361527967258,0.5204638472032742
E01006437,1369,635,734,0.46384222059897734,0.5361577794010226
E01006447,1357,654,703,0.4819454679439941,0.5180545320560059
E01006455,1694,740,954,0.43683589138134593,0.5631641086186541
E01006506,1351,672,679,0.49740932642487046,0.5025906735751295
E01006507,1428,659,769,0.46148459383753504,0.538515406162465
E01006508,1394,668,726,0.47919655667144906,0.5208034433285509
E01006509,1640,761,879,0.46402439024390246,0.5359756097560976
E01006510,1199,578,621,0.48206839032527105,0.517931609674729
E01006416,1451,651,800,0.44865609924190214,0.5513439007580979
E01006418,1357,637,720,0.4694178334561533,0.5305821665438467
E01006434,1521,696,825,0.45759368836291914,0.5424063116370809
E01006435,1556,730,826,0.4691516709511568,0.5308483290488432
E01006438,1200,580,620,0.48333333333333334,0.5166666666666667
E01006439,1613,798,815,0.49473031618102914,0.5052696838189709
E01006446,1364,629,735,0.46114369501466274,0.5388563049853372
E01006412,1457,669,788,0.4591626630061771,0.540837336993823
E01006413,1419,729,690,0.5137420718816068,0.48625792811839325
E01006414,1366,628,738,0.45973645680819913,0.5402635431918009
E01006441,2402,1168,1234,0.48626144879267275,0.5137385512073273
E01006460,1576,742,834,0.47081218274111675,0.5291878172588832
E01006461,1590,763,827,0.479874213836478,0.520125786163522
E01006463,1868,947,921,0.5069593147751607,0.4930406852248394
E01006464,1617,807,810,0.49907235621521334,0.5009276437847866
E01006466,1549,714,835,0.460942543576501,0.539057456423499
E01006453,1223,557,666,0.455437448896157,0.544562551103843
E01006467,1275,572,703,0.44862745098039214,0.5513725490196079
E01006470,1375,655,720,0.4763636363636364,0.5236363636363637
E01033228,1907,869,1038,0.4556895647614054,0.5443104352385947
E01006459,1612,785,827,0.4869727047146402,0.5130272952853598
E01006462,1514,736,778,0.4861294583883752,0.5138705416116248
E01006496,1377,647,730,0.4698620188816267,0.5301379811183733
E01006498,1574,782,792,0.49682337992376113,0.5031766200762389
E01006499,1591,755,836,0.47454431175361406,0.5254556882463859
E01006440,1454,676,778,0.4649243466299862,0.5350756533700137
E01006442,1272,625,647,0.4913522012578616,0.5086477987421384
E01006443,1395,660,735,0.4731182795698925,0.5268817204301075
E01006444,1383,626,757,0.45263919016630516,0.5473608098336948
E01006445,1329,602,727,0.4529721595184349,0.547027840481565
E01006465,1686,828,858,0.49110320284697506,0.5088967971530249
E01006482,1530,688,842,0.4496732026143791,0.550326797385621
E01006483,1341,647,694,0.482475764354959,0.517524235645041
E01006484,1376,649,727,0.47165697674418605,0.528343023255814
E01006449,1504,714,790,0.4747340425531915,0.5252659574468085
E01006450,1422,656,766,0.4613220815752461,0.5386779184247539
E01006451,1481,702,779,0.47400405131667794,0.5259959486833221
E01006452,1528,720,808,0.4712041884816754,0.5287958115183246
E01006497,1073,502,571,0.4678471575023299,0.53215284249767
E01006500,1109,523,586,0.4715960324616772,0.5284039675383229
E01006501,1431,711,720,0.4968553459119497,0.5031446540880503
E01006504,1376,678,698,0.49273255813953487,0.5072674418604651
E01006505,1750,832,918,0.4754285714285714,0.5245714285714286
E01006472,1565,753,812,0.48115015974440895,0.518849840255591
E01006485,1544,755,789,0.4889896373056995,0.5110103626943006
E01006486,1172,569,603,0.4854948805460751,0.514505119453925
E01006487,1529,719,810,0.4702419882275997,0.5297580117724002
E01006488,1753,825,928,0.47062179121505987,0.5293782087849401
E01006489,1434,691,743,0.4818688981868898,0.5181311018131102
E01006477,1386,651,735,0.4696969696969697,0.5303030303030303
E01006478,1361,632,729,0.46436443791329907,0.5356355620867009
E01006479,1395,651,744,0.4666666666666667,0.5333333333333333
E01006480,1369,635,734,0.46384222059897734,0.5361577794010226
E01006481,1346,630,716,0.46805349182763745,0.5319465081723626
E01006471,1487,683,804,0.4593140551445864,0.5406859448554135
E01006473,1248,585,663,0.46875,0.53125
E01006474,1483,680,803,0.45853000674308836,0.5414699932569117
E01006475,1526,721,805,0.4724770642201835,0.5275229357798165
E01006476,1428,708,720,0.4957983193277311,0.5042016806722689
E01006420,2066,997,1069,0.4825750242013553,0.5174249757986448
E01006424,2070,1009,1061,0.48743961352657006,0.5125603864734299
E01006502,1739,856,883,0.49223691776883266,0.5077630822311673
E01006503,1243,613,630,0.49316170555108607,0.5068382944489139
E01006421,1210,589,621,0.48677685950413224,0.5132231404958678
E01006425,1362,661,701,0.4853157121879589,0.5146842878120411
E01006430,1332,607,725,0.45570570570570573,0.5442942942942943
E01006433,1439,686,753,0.47671994440583737,0.5232800555941626
E01006419,1492,729,763,0.4886058981233244,0.5113941018766756
E01006422,1269,624,645,0.491725768321513,0.508274231678487
E01006423,1426,725,701,0.5084151472650772,0.49158485273492286
E01006427,1450,689,761,0.47517241379310343,0.5248275862068965
E01006426,1230,592,638,0.4813008130081301,0.5186991869918699
E01006428,1511,748,763,0.49503639973527463,0.5049636002647253
E01006429,1131,515,616,0.45534924845269675,0.5446507515473032
E01006431,1672,811,861,0.48504784688995217,0.5149521531100478
E01006432,1526,737,789,0.4829619921363041,0.5170380078636959
E01006651,1642,800,842,0.48721071863581,0.51278928136419
E01006653,1520,733,787,0.48223684210526313,0.5177631578947368
E01006655,1758,836,922,0.47554038680318544,0.5244596131968146
E01006658,1300,604,696,0.4646153846153846,0.5353846153846153
E01006660,1433,682,751,0.47592463363572923,0.5240753663642708
E01006652,1505,752,753,0.49966777408637875,0.5003322259136213
E01006656,1493,734,759,0.4916275954454119,0.5083724045545881
E01006657,1211,576,635,0.4756399669694467,0.5243600330305532
E01006780,1465,705,760,0.4812286689419795,0.5187713310580204
E01006783,1548,759,789,0.4903100775193798,0.5096899224806202
E01006781,1470,708,762,0.4816326530612245,0.5183673469387755
E01006782,1560,777,783,0.4980769230769231,0.5019230769230769
E01006784,1347,685,662,0.5085374907201188,0.4914625092798812
E01006785,1769,875,894,0.4946297343131713,0.5053702656868287
E01006786,1820,937,883,0.5148351648351648,0.48516483516483516
E01006661,1663,751,912,0.4515935057125676,0.5484064942874324
E01006662,1775,780,995,0.4394366197183099,0.5605633802816902
E01006663,1153,561,592,0.4865568083261058,0.5134431916738942
E01006664,1795,847,948,0.471866295264624,0.528133704735376
E01006669,1470,722,748,0.49115646258503404,0.508843537414966
E01006654,1513,713,800,0.4712491738268341,0.5287508261731659
E01006659,1765,1241,524,0.7031161473087819,0.29688385269121814
E01006734,1412,667,745,0.4723796033994334,0.5276203966005666
E01006735,1309,612,697,0.4675324675324675,0.5324675324675324
E01006736,1460,683,777,0.4678082191780822,0.5321917808219178
E01006737,1435,664,771,0.4627177700348432,0.5372822299651568
E01006787,2330,1673,657,0.7180257510729614,0.28197424892703865
E01006788,1825,902,923,0.49424657534246574,0.5057534246575343
E01006790,1587,747,840,0.4706994328922495,0.5293005671077504
E01006791,1674,884,790,0.5280764635603346,0.47192353643966545
E01006665,1555,768,787,0.49389067524115754,0.5061093247588424
E01006666,1504,723,781,0.480718085106383,0.519281914893617
E01006667,1453,700,753,0.4817618719889883,0.5182381280110117
E01006668,1534,726,808,0.47327249022164275,0.5267275097783573
E01006670,1526,728,798,0.47706422018348627,0.5229357798165137
E01006607,1531,718,813,0.4689745264532985,0.5310254735467015
E01006612,1495,728,767,0.48695652173913045,0.5130434782608696
E01006729,1400,641,759,0.45785714285714285,0.5421428571428571
E01032510,1809,879,930,0.4859038142620232,0.5140961857379768
E01032511,1378,676,702,0.49056603773584906,0.5094339622641509
E01006608,1215,604,611,0.497119341563786,0.502880658436214
E01006609,1283,609,674,0.47466874512860485,0.5253312548713952
E01006610,1397,647,750,0.46313528990694347,0.5368647100930566
E01006613,1360,655,705,0.48161764705882354,0.5183823529411765
E01006705,1409,724,685,0.5138396025550035,0.48616039744499645
E01006598,1361,617,744,0.4533431300514328,0.5466568699485672
E01006599,1121,489,632,0.4362176628010705,0.5637823371989296
E01006672,1955,911,1044,0.4659846547314578,0.5340153452685422
E01033759,1147,532,615,0.4638186573670445,0.5361813426329556
E01006600,1407,638,769,0.4534470504619758,0.5465529495380241
E01006603,1410,671,739,0.47588652482269506,0.524113475177305
E01006730,1326,618,708,0.4660633484162896,0.5339366515837104
E01006731,1196,554,642,0.46321070234113715,0.5367892976588629
E01006732,1643,676,967,0.411442483262325,0.588557516737675
E01006611,1291,646,645,0.5003872966692486,0.49961270333075136
E01006614,1322,635,687,0.4803328290468986,0.5196671709531013
E01006615,1302,611,691,0.46927803379416283,0.5307219662058372
E01006698,1716,826,890,0.4813519813519814,0.5186480186480187
E01006700,1438,705,733,0.4902642559109875,0.5097357440890126
E01006623,1462,724,738,0.4952120383036936,0.5047879616963065
E01006624,1556,756,800,0.48586118251928023,0.5141388174807198
E01006627,1378,654,724,0.4746008708272859,0.525399129172714
E01006671,1355,634,721,0.46789667896678966,0.5321033210332103
E01006699,1594,817,777,0.5125470514429109,0.4874529485570891
E01006701,1380,693,687,0.5021739130434782,0.49782608695652175
E01006702,1618,783,835,0.48393077873918416,0.5160692212608158
E01006703,1561,835,726,0.5349135169762973,0.46508648302370276
E01006778,2205,1094,1111,0.4961451247165533,0.5038548752834467
E01006541,1593,786,807,0.4934086629001883,0.5065913370998116
E01006543,1247,598,649,0.47955092221331197,0.520449077786688
E01006544,1658,742,916,0.44752714113389624,0.5524728588661038
E01006616,1428,696,732,0.48739495798319327,0.5126050420168067
E01006762,1692,789,903,0.46631205673758863,0.5336879432624113
E01006604,1367,642,725,0.46964155084125825,0.5303584491587418
E01006605,1531,740,791,0.48334421946440237,0.5166557805355977
E01006618,1639,765,874,0.46674801708358754,0.5332519829164124
E01006625,1416,675,741,0.4766949152542373,0.5233050847457628
E01006626,1448,676,772,0.46685082872928174,0.5331491712707183
E01006637,1596,701,895,0.4392230576441103,0.5607769423558897
E01006638,1219,532,687,0.4364232977850697,0.5635767022149303
E01006639,1509,687,822,0.4552683896620278,0.5447316103379721
E01006644,2040,987,1053,0.4838235294117647,0.5161764705882353
E01006645,1424,671,753,0.47120786516853935,0.5287921348314607
E01006542,1397,698,699,0.49964209019327127,0.5003579098067287
E01006558,1357,670,687,0.4937361827560796,0.5062638172439204
E01006562,1514,709,805,0.46829590488771466,0.5317040951122853
E01033747,1043,484,559,0.46404602109300097,0.535953978906999
E01006545,1512,708,804,0.46825396825396826,0.5317460317460317
E01006546,1319,666,653,0.5049279757391963,0.49507202426080366
E01006547,1490,769,721,0.5161073825503356,0.48389261744966444
E01006548,1675,825,850,0.4925373134328358,0.5074626865671642
E01006766,1266,614,652,0.4849921011058452,0.5150078988941548
E01006767,1787,898,889,0.502518186905428,0.4974818130945719
E01006606,1521,729,792,0.47928994082840237,0.5207100591715976
E01006761,1644,864,780,0.5255474452554745,0.4744525547445255
E01006763,1471,737,734,0.5010197144799456,0.4989802855200544
E01006764,1522,771,751,0.5065703022339028,0.49342969776609724
E01006765,1468,693,775,0.4720708446866485,0.5279291553133515
E01006768,1359,741,618,0.5452538631346578,0.45474613686534215
E01006617,1421,667,754,0.46938775510204084,0.5306122448979592
E01006619,1599,753,846,0.4709193245778612,0.5290806754221389
E01006620,1417,670,747,0.4728299223712068,0.5271700776287932
E01006621,1468,717,751,0.4884196185286104,0.5115803814713896
E01006622,1519,751,768,0.49440421329822254,0.5055957867017775
E01006640,1880,886,994,0.47127659574468084,0.5287234042553192
E01006776,1677,813,864,0.4847942754919499,0.5152057245080501
E01006779,1968,893,1075,0.453760162601626,0.546239837398374
E01033764,2202,1130,1072,0.5131698455949137,0.4868301544050863
E01006560,1860,965,895,0.5188172043010753,0.48118279569892475
E01006564,1721,837,884,0.4863451481696688,0.5136548518303312
E01006646,1899,993,906,0.5229067930489731,0.47709320695102686
E01006648,2175,1148,1027,0.527816091954023,0.472183908045977
E01006540,1509,776,733,0.5142478462557986,0.48575215374420144
E01006563,1744,857,887,0.4913990825688073,0.5086009174311926
E01006647,1422,652,770,0.45850914205344584,0.5414908579465542
E01006693,1511,783,728,0.5181998676373263,0.4818001323626737
E01006572,1207,528,679,0.4374482187241094,0.5625517812758907
E01006574,1388,661,727,0.4762247838616715,0.5237752161383286
E01006641,1740,816,924,0.4689655172413793,0.5310344827586206
E01006642,1290,572,718,0.4434108527131783,0.5565891472868217
E01006643,1822,831,991,0.45609220636663006,0.5439077936333699
E01006567,1655,862,793,0.5208459214501511,0.4791540785498489
E01006568,1617,745,872,0.46072974644403214,0.5392702535559678
E01006570,1479,722,757,0.48816768086544965,0.5118323191345504
E01006571,1470,689,781,0.46870748299319726,0.5312925170068027
E01006711,1538,761,777,0.49479843953185954,0.5052015604681405
E01006717,1436,719,717,0.5006963788300836,0.49930362116991645
E01006718,1587,796,791,0.5015752993068683,0.4984247006931317
E01006719,1535,744,791,0.48469055374592834,0.5153094462540717
E01032508,1723,837,886,0.485780615206036,0.514219384793964
E01032509,1434,671,763,0.4679218967921897,0.5320781032078103
E01006690,1492,782,710,0.5241286863270778,0.47587131367292224
E01006692,2180,1102,1078,0.5055045871559632,0.4944954128440367
E01006695,1821,1045,776,0.5738605161998902,0.42613948380010985
E01006759,1095,571,524,0.5214611872146119,0.4785388127853881
E01006760,1611,999,612,0.6201117318435754,0.37988826815642457
E01006565,1549,705,844,0.4551323434473854,0.5448676565526146
E01006569,1429,672,757,0.470258922323303,0.529741077676697
E01006573,1501,715,786,0.4763491005996003,0.5236508994003998
E01006712,1339,615,724,0.4592979835698282,0.5407020164301718
E01006713,1377,645,732,0.4684095860566449,0.5315904139433552
E01006691,1503,787,716,0.5236194278110445,0.4763805721889554
E01006694,1864,949,915,0.5091201716738197,0.49087982832618027
E01006696,1744,856,888,0.4908256880733945,0.5091743119266054
E01006697,1845,958,887,0.5192411924119241,0.4807588075880759
E01006746,1513,735,778,0.48578982154659617,0.5142101784534039
E01006512,1880,1070,810,0.5691489361702128,0.4308510638297872
E01006747,3552,1636,1916,0.4605855855855856,0.5394144144144144
E01006748,1936,1034,902,0.5340909090909091,0.4659090909090909
E01006751,2572,1229,1343,0.47783825816485226,0.5221617418351477
E01033763,1527,823,704,0.5389652914210871,0.4610347085789129
E01006566,1506,730,776,0.4847277556440903,0.5152722443559097
E01006585,1354,654,700,0.48301329394387,0.51698670605613
E01006586,1899,935,964,0.49236440231700895,0.507635597682991
E01006587,1624,828,796,0.5098522167487685,0.49014778325123154
E01006716,1589,773,816,0.48646947765890497,0.513530522341095
E01006575,1294,607,687,0.46908809891808345,0.5309119010819165
E01006576,1693,803,890,0.47430596574128764,0.5256940342587123
E01006577,1503,727,776,0.48369926813040587,0.5163007318695941
E01006579,1643,796,847,0.4844796104686549,0.515520389531345
E01006584,1393,689,704,0.4946159368269921,0.5053840631730079
E01006720,2108,1074,1034,0.5094876660341556,0.4905123339658444
E01006725,1537,786,751,0.5113858165256994,0.4886141834743006
E01006726,1565,758,807,0.48434504792332267,0.5156549520766773
E01006727,1441,749,692,0.5197779319916724,0.48022206800832756
E01006728,1623,785,838,0.4836722119531731,0.5163277880468269
E01006752,1012,545,467,0.5385375494071146,0.4614624505928854
E01006578,1380,657,723,0.47608695652173916,0.5239130434782608
E01006580,1335,650,685,0.4868913857677903,0.5131086142322098
E01006581,1559,738,821,0.4733803720333547,0.5266196279666453
E01006773,1379,694,685,0.5032632342277013,0.49673676577229875
E01006774,1445,699,746,0.48373702422145326,0.5162629757785467
E01006514,2108,1177,931,0.5583491461100569,0.4416508538899431
E01006515,1208,595,613,0.4925496688741722,0.5074503311258278
E01006673,1937,1009,928,0.5209086215797625,0.47909137842023747
E01033757,1025,593,432,0.5785365853658536,0.4214634146341463
E01033768,1223,744,479,0.6083401471790678,0.39165985282093213
E01006550,1595,776,819,0.4865203761755486,0.5134796238244514
E01006557,2054,1024,1030,0.498539435248296,0.501460564751704
E01006721,1655,805,850,0.486404833836858,0.513595166163142
E01006722,1793,937,856,0.5225878416062465,0.4774121583937535
E01006723,1875,966,909,0.5152,0.4848
E01006724,1790,910,880,0.5083798882681564,0.49162011173184356
E01006552,2029,1101,928,0.5426318383440119,0.45736816165598815
E01006556,2011,1087,924,0.5405271009448036,0.4594728990551964
E01006674,1885,953,932,0.5055702917771884,0.4944297082228117
E01006679,2232,1104,1128,0.4946236559139785,0.5053763440860215
E01006709,1438,739,699,0.5139082058414465,0.4860917941585535
E01006769,1270,630,640,0.49606299212598426,0.5039370078740157
E01006770,1002,459,543,0.45808383233532934,0.5419161676646707
E01006771,1425,630,795,0.4421052631578947,0.5578947368421052
E01006772,1091,520,571,0.4766269477543538,0.5233730522456462
E01006775,1319,593,726,0.4495830174374526,0.5504169825625473
E01006582,1642,799,843,0.4866017052375152,0.5133982947624848
E01006589,1518,728,790,0.4795783926218709,0.5204216073781291
E01006591,1633,806,827,0.4935701163502756,0.5064298836497244
E01006592,1565,721,844,0.460702875399361,0.5392971246006389
E01006597,1667,772,895,0.4631073785242951,0.5368926214757048
E01006553,1880,919,961,0.4888297872340426,0.5111702127659574
E01006588,1569,769,800,0.49012109623964306,0.5098789037603569
E01006590,1642,858,784,0.5225334957369062,0.4774665042630938
E01006593,1541,758,783,0.4918883841661259,0.5081116158338741
E01033749,1153,609,544,0.5281873373807459,0.47181266261925414
E01033766,1075,558,517,0.5190697674418605,0.48093023255813955
E01006520,1706,937,769,0.5492379835873388,0.45076201641266117
E01006549,1662,998,664,0.6004813477737665,0.39951865222623345
E01006675,1824,1054,770,0.5778508771929824,0.42214912280701755
E01006677,1040,451,589,0.43365384615384617,0.5663461538461538
E01006518,1696,843,853,0.4970518867924528,0.5029481132075472
E01006630,1338,609,729,0.4551569506726457,0.5448430493273543
E01006632,1842,928,914,0.503800217155266,0.496199782844734
E01006676,1753,861,892,0.49115801483171706,0.5088419851682829
E01006678,2127,1122,1005,0.5275035260930888,0.47249647390691113
E01006706,1346,623,723,0.46285289747399705,0.537147102526003
E01006707,1323,598,725,0.4520030234315949,0.5479969765684052
E01006708,1805,837,968,0.46371191135734074,0.5362880886426593
E01006710,1496,683,813,0.4565508021390374,0.5434491978609626
E01006792,1368,668,700,0.48830409356725146,0.5116959064327485
E01006794,1593,764,829,0.4795982423101067,0.5204017576898933
E01006800,1401,707,694,0.5046395431834404,0.4953604568165596
E01006801,1355,639,716,0.47158671586715867,0.5284132841328413
E01006532,1557,783,774,0.5028901734104047,0.49710982658959535
E01006539,1437,711,726,0.49478079331941544,0.5052192066805845
E01006583,1758,742,1016,0.42207053469852107,0.5779294653014789
E01006594,1410,667,743,0.47304964539007094,0.5269503546099291
E01006796,1591,789,802,0.49591451917033313,0.5040854808296669
E01006522,1731,995,736,0.5748122472559214,0.42518775274407855
E01006524,2431,1121,1310,0.4611271081859317,0.5388728918140683
E01006526,1404,677,727,0.4821937321937322,0.5178062678062678
E01006529,1304,640,664,0.49079754601226994,0.50920245398773
E01006551,1581,794,787,0.502213788741303,0.49778621125869704
E01006554,1692,871,821,0.514775413711584,0.4852245862884161
E01006525,1209,601,608,0.49710504549214224,0.5028949545078577
E01006595,1745,805,940,0.46131805157593125,0.5386819484240688
E01006596,1451,706,745,0.48656099241902134,0.5134390075809786
E01006689,1651,793,858,0.48031496062992124,0.5196850393700787
E01006633,1432,696,736,0.4860335195530726,0.5139664804469274
E01032505,1317,623,694,0.4730447987851177,0.5269552012148823
E01032506,1403,736,667,0.5245901639344263,0.47540983606557374
E01032507,1539,735,804,0.4775828460038986,0.5224171539961013
E01033748,1277,705,572,0.5520751761942052,0.44792482380579485
E01033767,1067,511,556,0.47891283973758203,0.521087160262418
E01006793,1494,726,768,0.4859437751004016,0.5140562248995983
E01006795,1407,687,720,0.488272921108742,0.511727078891258
E01006797,1499,730,769,0.48699132755170116,0.5130086724482988
E01006798,1410,685,725,0.4858156028368794,0.5141843971631206
E01006799,1821,880,941,0.48325096101043385,0.5167490389895661
E01006521,1660,836,824,0.5036144578313253,0.4963855421686747
E01006523,1508,751,757,0.4980106100795756,0.5019893899204244
E01006528,1461,755,706,0.5167693360711841,0.48323066392881586
E01006628,1874,871,1003,0.4647812166488794,0.5352187833511206
E01006629,1255,595,660,0.47410358565737054,0.5258964143426295
E01006527,1454,683,771,0.46973865199449794,0.5302613480055021
E01006680,1569,784,785,0.4996813256851498,0.5003186743148502
E01006682,1310,643,667,0.4908396946564885,0.5091603053435114
E01006683,1510,718,792,0.47549668874172185,0.5245033112582781
E01006686,1433,696,737,0.4856943475226797,0.5143056524773203
E01006534,1542,753,789,0.4883268482490272,0.5116731517509727
E01006535,1639,766,873,0.4673581452104942,0.5326418547895058
E01006536,1848,874,974,0.47294372294372294,0.5270562770562771
E01006681,1585,789,796,0.49779179810725555,0.5022082018927445
E01006530,1431,674,757,0.47099930118798045,0.5290006988120196
E01006531,1458,686,772,0.47050754458161864,0.5294924554183813
E01006533,1408,680,728,0.48295454545454547,0.5170454545454546
E01006537,2257,1093,1164,0.48427115640230395,0.5157288435976961
E01006538,1318,639,679,0.48482549317147194,0.5151745068285281
E01006519,1286,628,658,0.48833592534992226,0.5116640746500778
E01006684,2138,1048,1090,0.490177736202058,0.509822263797942
E01006685,1484,689,795,0.4642857142857143,0.5357142857142857
E01006687,1952,1031,921,0.5281762295081968,0.4718237704918033
E01006688,1524,744,780,0.4881889763779528,0.5118110236220472
E01006740,1280,679,601,0.53046875,0.46953125
E01006742,1394,693,701,0.4971305595408895,0.5028694404591105
E01006744,1482,720,762,0.48582995951417,0.5141700404858299
E01006745,1879,958,921,0.5098456625864821,0.4901543374135178
E01006738,1501,669,832,0.4457028647568288,0.5542971352431713
E01006739,1769,840,929,0.47484454494064443,0.5251554550593556
E01006741,1815,877,938,0.4831955922865014,0.5168044077134987
E01006743,2175,1066,1109,0.4901149425287356,0.5098850574712643
E01006753,1557,716,841,0.4598587026332691,0.5401412973667309
E01006754,1627,778,849,0.478180700676091,0.521819299323909
E01006755,1587,721,866,0.4543163201008192,0.5456836798991809
E01006756,1820,835,985,0.45879120879120877,0.5412087912087912
E01006757,1491,695,796,0.466130114017438,0.533869885982562
E01006758,1527,701,826,0.4590700720366732,0.5409299279633268
E01006513,2941,1461,1480,0.4967698061883713,0.5032301938116287
E01033758,1730,883,847,0.5104046242774567,0.48959537572254336
E01033760,2115,1042,1073,0.49267139479905436,0.5073286052009456
E01033761,1372,843,529,0.6144314868804664,0.38556851311953355
E01033762,1791,943,848,0.5265214963707426,0.4734785036292574
E01033750,1448,895,553,0.6180939226519337,0.3819060773480663
E01033754,1452,784,668,0.5399449035812672,0.46005509641873277
E01033756,1185,737,448,0.6219409282700422,0.3780590717299578
E01033765,1351,656,695,0.4855662472242783,0.5144337527757217
E01033751,1873,1044,829,0.5573945541911373,0.4426054458088628
E01033752,1196,740,456,0.6187290969899666,0.38127090301003347
E01033753,1051,690,361,0.6565176022835395,0.3434823977164605
E01033755,1082,643,439,0.5942698706099815,0.40573012939001846
E01006946,1397,649,748,0.4645669291338583,0.5354330708661418
E01007028,1355,660,695,0.4870848708487085,0.5129151291512916
E01007029,1248,548,700,0.4391025641025641,0.5608974358974359
E01007030,1539,716,823,0.46523716699155293,0.5347628330084471
E01007036,1212,579,633,0.4777227722772277,0.5222772277227723
E01006947,1427,680,747,0.47652417659425367,0.5234758234057463
E01007031,1446,675,771,0.46680497925311204,0.533195020746888
E01007032,1324,611,713,0.46148036253776437,0.5385196374622356
E01007033,1491,693,798,0.4647887323943662,0.5352112676056338
E01007035,1454,672,782,0.4621733149931224,0.5378266850068776
E01006944,1672,734,938,0.43899521531100477,0.5610047846889952
E01006948,1315,585,730,0.4448669201520912,0.5551330798479087
E01006949,1456,675,781,0.4635989010989011,0.5364010989010989
E01006951,1489,686,803,0.46071188717259903,0.539288112827401
E01007034,1356,616,740,0.45427728613569324,0.5457227138643068
E01006945,1605,756,849,0.47102803738317756,0.5289719626168224
E01006950,1516,748,768,0.49340369393139843,0.5065963060686016
E01006968,1772,867,905,0.48927765237020315,0.5107223476297968
E01006969,1467,748,719,0.5098841172460804,0.49011588275391954
E01033094,988,502,486,0.5080971659919028,0.49190283400809715
E01033097,1050,527,523,0.5019047619047619,0.4980952380952381
E01007055,1484,725,759,0.488544474393531,0.511455525606469
E01007056,1616,791,825,0.48948019801980197,0.510519801980198
E01007057,1528,726,802,0.47513089005235604,0.524869109947644
E01007062,1434,707,727,0.4930264993026499,0.50697350069735
E01007063,1580,750,830,0.47468354430379744,0.5253164556962026
E01007058,1437,744,693,0.5177453027139874,0.4822546972860125
E01007059,1516,736,780,0.48548812664907653,0.5145118733509235
E01007060,1475,721,754,0.4888135593220339,0.5111864406779661
E01007061,1494,750,744,0.5020080321285141,0.4979919678714859
E01007064,1288,628,660,0.48757763975155277,0.5124223602484472
E01006934,1529,741,788,0.48463047743623283,0.5153695225637671
E01006970,1630,802,828,0.4920245398773006,0.5079754601226993
E01006994,1620,790,830,0.4876543209876543,0.5123456790123457
E01006996,1615,830,785,0.5139318885448917,0.48606811145510836
E01006998,1664,808,856,0.4855769230769231,0.5144230769230769
E01006995,1334,646,688,0.48425787106446777,0.5157421289355323
E01006997,1511,729,782,0.4824619457313038,0.5175380542686963
E01006999,1621,773,848,0.4768661320172733,0.5231338679827268
E01007000,1290,617,673,0.4782945736434108,0.5217054263565891
E01007001,1618,768,850,0.4746600741656366,0.5253399258343634
E01007002,1330,639,691,0.48045112781954885,0.5195488721804511
E01006928,1466,722,744,0.4924965893587995,0.5075034106412005
E01006935,1694,823,871,0.4858323494687131,0.5141676505312869
E01006971,1597,766,831,0.4796493425172198,0.5203506574827802
E01006972,1625,693,932,0.42646153846153845,0.5735384615384616
E01006973,1616,720,896,0.44554455445544555,0.5544554455445545
E01006974,1588,739,849,0.46536523929471035,0.5346347607052897
E01006929,1552,756,796,0.48711340206185566,0.5128865979381443
E01006930,1460,699,761,0.47876712328767124,0.5212328767123288
E01006931,1533,700,833,0.45662100456621,0.54337899543379
E01006932,1505,727,778,0.4830564784053156,0.5169435215946844
E01006933,1450,706,744,0.4868965517241379,0.5131034482758621
E01006920,1624,761,863,0.4685960591133005,0.5314039408866995
E01006924,1458,669,789,0.4588477366255144,0.5411522633744856
E01006925,1532,729,803,0.4758485639686684,0.5241514360313316
E01006927,1677,812,865,0.4841979725700656,0.5158020274299344
E01006921,1305,611,694,0.4681992337164751,0.5318007662835249
E01006922,1419,695,724,0.4897815362931642,0.5102184637068358
E01006923,1472,692,780,0.4701086956521739,0.529891304347826
E01006926,1615,789,826,0.4885448916408669,0.5114551083591331
E01006985,1457,690,767,0.4735758407687028,0.5264241592312972
E01006986,1281,614,667,0.47931303669008585,0.5206869633099142
E01006987,1253,608,645,0.4852354349561053,0.5147645650438947
E01006989,1337,641,696,0.47943156320119673,0.5205684367988033
E01006990,1236,604,632,0.4886731391585761,0.511326860841424
E01006988,1372,614,758,0.44752186588921283,0.5524781341107872
E01007079,1586,774,812,0.4880201765447667,0.5119798234552333
E01007080,1438,669,769,0.46522948539638387,0.5347705146036161
E01007081,1491,700,791,0.4694835680751174,0.5305164319248826
E01006991,1496,736,760,0.4919786096256685,0.5080213903743316
E01006992,1125,529,596,0.4702222222222222,0.5297777777777778
E01006993,1498,720,778,0.48064085447263016,0.5193591455273698
E01007078,1545,751,794,0.486084142394822,0.513915857605178
E01007075,1370,623,747,0.45474452554744527,0.5452554744525547
E01007076,1414,677,737,0.4787835926449788,0.5212164073550212
E01007077,1512,730,782,0.4828042328042328,0.5171957671957672
E01007082,1434,700,734,0.4881450488145049,0.5118549511854951
E01007067,1393,661,732,0.4745154343144293,0.5254845656855707
E01007068,1272,613,659,0.48191823899371067,0.5180817610062893
E01007069,1445,661,784,0.457439446366782,0.542560553633218
E01007070,1471,732,739,0.49762066621346024,0.5023793337865398
E01007101,1440,700,740,0.4861111111111111,0.5138888888888888
E01007095,1583,754,829,0.476310802274163,0.523689197725837
E01007096,1332,619,713,0.4647147147147147,0.5352852852852853
E01007100,1391,664,727,0.47735442127965494,0.5226455787203451
E01033096,2531,1269,1262,0.50138285262742,0.49861714737258
E01007074,1506,704,802,0.4674634794156706,0.5325365205843293
E01007097,1529,742,787,0.48528449967298887,0.5147155003270111
E01007098,1418,695,723,0.4901269393511989,0.5098730606488011
E01007099,1511,674,837,0.44606221045665123,0.5539377895433488
E01007065,1338,664,674,0.4962630792227205,0.5037369207772795
E01007066,1560,751,809,0.4814102564102564,0.5185897435897436
E01007071,1256,607,649,0.48328025477707004,0.51671974522293
E01007072,1440,676,764,0.46944444444444444,0.5305555555555556
E01007073,1336,645,691,0.48278443113772457,0.5172155688622755
E01007020,1419,682,737,0.4806201550387597,0.5193798449612403
E01007022,1420,715,705,0.5035211267605634,0.4964788732394366
E01007023,1345,623,722,0.46319702602230484,0.5368029739776952
E01007027,2063,1016,1047,0.4924866698982065,0.5075133301017936
E01007037,1506,707,799,0.46945551128818064,0.5305444887118194
E01007038,1488,715,773,0.48051075268817206,0.519489247311828
E01006936,1502,702,800,0.4673768308921438,0.5326231691078562
E01006937,1306,633,673,0.48468606431852984,0.5153139356814701
E01006938,1237,594,643,0.4801940177849636,0.5198059822150364
E01006939,1479,682,797,0.46112237998647737,0.5388776200135227
E01006940,1434,671,763,0.4679218967921897,0.5320781032078103
E01006943,1229,578,651,0.47030105777054515,0.5296989422294548
E01007083,1187,555,632,0.4675652906486942,0.5324347093513058
E01007085,1353,613,740,0.4530672579453067,0.5469327420546932
E01007086,1274,577,697,0.45290423861852436,0.5470957613814756
E01007091,1285,585,700,0.45525291828793774,0.5447470817120622
E01007092,1106,511,595,0.4620253164556962,0.5379746835443038
E01006979,1453,694,759,0.47763248451479695,0.522367515485203
E01006980,1473,711,762,0.48268839103869654,0.5173116089613035
E01007024,1174,520,654,0.44293015332197616,0.5570698466780238
E01007026,1145,526,619,0.45938864628820963,0.5406113537117904
E01007089,1378,632,746,0.45863570391872277,0.5413642960812772
E01007021,1304,629,675,0.48236196319018404,0.5176380368098159
E01007025,1339,654,685,0.48842419716206126,0.5115758028379388
E01007105,1628,763,865,0.46867321867321865,0.5313267813267813
E01007106,1477,697,780,0.4719025050778605,0.5280974949221394
E01007107,1357,632,725,0.4657332350773766,0.5342667649226235
E01007108,1571,770,801,0.49013367281986,0.50986632718014
E01007039,1268,621,647,0.48974763406940064,0.5102523659305994
E01007040,2225,1247,978,0.5604494382022472,0.4395505617977528
E01007042,1275,604,671,0.47372549019607846,0.5262745098039215
E01007044,1367,643,724,0.4703730797366496,0.5296269202633505
E01007045,1236,602,634,0.48705501618122976,0.5129449838187702
E01007041,1403,668,735,0.47612259444048466,0.5238774055595153
E01007043,1408,682,726,0.484375,0.515625
E01007046,1593,775,818,0.48650345260514755,0.5134965473948525
E01007053,1408,671,737,0.4765625,0.5234375
E01007084,1385,673,712,0.48592057761732854,0.5140794223826715
E01006941,1632,746,886,0.4571078431372549,0.5428921568627451
E01006942,1461,713,748,0.48802190280629704,0.5119780971937029
E01006954,1501,730,771,0.48634243837441704,0.513657561625583
E01007104,1396,671,725,0.4806590257879656,0.5193409742120344
E01007109,1531,690,841,0.45068582625734815,0.5493141737426519
E01007048,1620,762,858,0.4703703703703704,0.5296296296296297
E01007054,1396,681,715,0.4878223495702006,0.5121776504297995
E01007087,1319,616,703,0.4670204700530705,0.5329795299469295
E01007088,1293,606,687,0.46867749419953597,0.531322505800464
E01007090,1143,535,608,0.4680664916885389,0.531933508311461
E01006955,1650,804,846,0.48727272727272725,0.5127272727272727
E01006956,1568,792,776,0.5051020408163265,0.49489795918367346
E01006958,1460,749,711,0.513013698630137,0.48698630136986304
E01007102,1513,739,774,0.488433575677462,0.511566424322538
E01007103,1477,713,764,0.4827352742044685,0.5172647257955315
E01006978,1397,667,730,0.47745168217609163,0.5225483178239084
E01006981,1486,701,785,0.4717362045760431,0.528263795423957
E01006982,1382,634,748,0.45875542691751087,0.5412445730824892
E01006983,1651,786,865,0.4760751059963658,0.5239248940036342
E01006984,1351,625,726,0.46262028127313104,0.537379718726869
E01006952,1370,690,680,0.5036496350364964,0.49635036496350365
E01006953,1438,707,731,0.4916550764951321,0.5083449235048678
E01006957,1529,813,716,0.5317200784826684,0.4682799215173316
E01006959,1552,745,807,0.4800257731958763,0.5199742268041238
E01006977,1639,789,850,0.48139109212934716,0.5186089078706528
E01006976,1454,711,743,0.4889958734525447,0.5110041265474553
E01007014,1588,770,818,0.48488664987405544,0.5151133501259446
E01007047,1439,700,739,0.4864489228630994,0.5135510771369006
E01033095,1845,893,952,0.48401084010840106,0.5159891598915989
E01007004,1415,674,741,0.4763250883392226,0.5236749116607774
E01007005,1317,632,685,0.47987851176917234,0.5201214882308276
E01007011,1454,704,750,0.48418156808803303,0.515818431911967
E01007016,1802,844,958,0.4683684794672586,0.5316315205327414
E01007017,1541,736,805,0.47761194029850745,0.5223880597014925
E01007019,1376,629,747,0.4571220930232558,0.5428779069767442
E01007049,1526,751,775,0.4921363040629096,0.5078636959370905
E01007050,1349,640,709,0.4744255003706449,0.5255744996293551
E01007051,1213,573,640,0.47238252267106345,0.5276174773289365
E01007052,1386,657,729,0.474025974025974,0.525974025974026
E01006964,1469,704,765,0.4792375765827093,0.5207624234172906
E01007003,1222,604,618,0.49427168576104746,0.5057283142389526
E01007006,1427,643,784,0.4505956552207428,0.5494043447792571
E01007012,1318,638,680,0.48406676783004554,0.5159332321699545
E01007013,1431,688,743,0.4807826694619147,0.5192173305380853
E01006967,1511,746,765,0.4937127729980146,0.5062872270019855
E01007007,1232,649,583,0.5267857142857143,0.4732142857142857
E01007008,1261,623,638,0.4940523394131642,0.5059476605868358
E01007009,1300,712,588,0.5476923076923077,0.4523076923076923
E01007010,1091,543,548,0.4977085242896425,0.5022914757103575
E01006960,1161,574,587,0.49440137812230833,0.5055986218776917
E01006961,1562,772,790,0.4942381562099872,0.5057618437900128
E01006962,1406,638,768,0.45376955903271693,0.5462304409672831
E01006963,1496,733,763,0.4899732620320856,0.5100267379679144
E01006965,1478,694,784,0.469553450608931,0.530446549391069
E01006966,1487,717,770,0.4821788836583726,0.5178211163416274
E01006882,1188,572,616,0.48148148148148145,0.5185185185185185
E01006883,1305,615,690,0.47126436781609193,0.5287356321839081
E01006884,1353,651,702,0.4811529933481153,0.5188470066518847
E01006885,1278,608,670,0.4757433489827856,0.5242566510172144
E01006886,1311,618,693,0.47139588100686497,0.528604118993135
E01006887,1344,635,709,0.4724702380952381,0.5275297619047619
E01006802,1653,815,838,0.49304295220810646,0.5069570477918935
E01006804,1613,812,801,0.5034097954122753,0.49659020458772474
E01006806,1544,803,741,0.5200777202072538,0.4799222797927461
E01006807,1369,652,717,0.4762600438276114,0.5237399561723886
E01006803,1446,743,703,0.5138312586445366,0.48616874135546334
E01006805,1539,777,762,0.5048732943469786,0.4951267056530214
E01006808,1300,658,642,0.5061538461538462,0.4938461538461538
E01006809,1468,711,757,0.4843324250681199,0.5156675749318801
E01006849,1444,692,752,0.4792243767313019,0.5207756232686981
E01006850,1519,761,758,0.500987491770902,0.4990125082290981
E01006851,1274,623,651,0.489010989010989,0.510989010989011
E01006852,1319,665,654,0.5041698256254739,0.49583017437452614
E01006853,1342,690,652,0.5141579731743666,0.4858420268256334
E01006854,1458,707,751,0.4849108367626886,0.5150891632373114
E01006855,1459,699,760,0.47909527073337904,0.520904729266621
E01006836,1417,704,713,0.49682427664079043,0.5031757233592096
E01006839,1341,659,682,0.49142431021625654,0.5085756897837435
E01006840,1502,760,742,0.5059920106524634,0.4940079893475366
E01006842,1577,738,839,0.4679771718452758,0.5320228281547241
E01006837,1551,769,782,0.49580915538362347,0.5041908446163765
E01006838,1444,705,739,0.48822714681440443,0.5117728531855956
E01006841,1681,824,857,0.49018441403926233,0.5098155859607376
E01006843,1195,580,615,0.48535564853556484,0.5146443514644351
E01006914,1224,622,602,0.5081699346405228,0.4918300653594771
E01006915,1576,776,800,0.49238578680203043,0.5076142131979695
E01006916,1558,785,773,0.5038510911424904,0.4961489088575096
E01006917,1666,796,870,0.4777911164465786,0.5222088835534213
E01006918,1254,617,637,0.4920255183413078,0.5079744816586922
E01006919,1545,737,808,0.47702265372168284,0.5229773462783172
E01006810,1279,639,640,0.49960906958561374,0.5003909304143862
E01006811,1361,674,687,0.4952240999265246,0.5047759000734754
E01006812,1416,668,748,0.4717514124293785,0.5282485875706214
E01006813,1490,722,768,0.48456375838926175,0.5154362416107383
E01006814,1554,787,767,0.5064350064350064,0.49356499356499356
E01006815,1299,597,702,0.45958429561200925,0.5404157043879908
E01006818,1283,621,662,0.48402182385035075,0.5159781761496492
E01006822,1382,669,713,0.4840810419681621,0.515918958031838
E01006823,1264,601,663,0.4754746835443038,0.5245253164556962
E01006824,1246,620,626,0.49759229534510435,0.5024077046548957
E01006825,1463,718,745,0.49077238550922764,0.5092276144907724
E01006866,1546,732,814,0.47347994825355755,0.5265200517464425
E01006867,2075,1013,1062,0.48819277108433734,0.5118072289156627
E01006868,1497,756,741,0.5050100200400801,0.49498997995991983
E01006869,1474,745,729,0.505427408412483,0.494572591587517
E01006819,1507,761,746,0.5049767750497678,0.49502322495023227
E01006820,1455,697,758,0.47903780068728524,0.5209621993127148
E01006821,1417,694,723,0.48976711362032466,0.5102328863796753
E01006871,1547,736,811,0.47575953458306397,0.524240465416936
E01006832,1646,851,795,0.517010935601458,0.48298906439854195
E01006834,1236,594,642,0.48058252427184467,0.5194174757281553
E01006877,1424,762,662,0.5351123595505618,0.4648876404494382
E01006880,1440,704,736,0.4888888888888889,0.5111111111111111
E01006881,1441,735,706,0.5100624566273422,0.4899375433726579
E01006863,1631,818,813,0.5015328019619865,0.4984671980380135
E01006864,1866,903,963,0.48392282958199356,0.5160771704180064
E01006865,1738,839,899,0.4827387802071346,0.5172612197928653
E01006845,1508,744,764,0.493368700265252,0.506631299734748
E01006870,1370,676,694,0.49343065693430654,0.5065693430656935
E01006872,1443,790,653,0.5474705474705475,0.45252945252945254
E01006873,1293,588,705,0.4547563805104408,0.5452436194895591
E01006874,1204,583,621,0.48421926910299,0.5157807308970099
E01006856,1346,708,638,0.5260029717682021,0.4739970282317979
E01006857,1424,710,714,0.49859550561797755,0.5014044943820225
E01006858,1486,693,793,0.46635262449528936,0.5336473755047106
E01006859,1644,847,797,0.5152068126520681,0.48479318734793186
E01006860,1391,699,692,0.5025161754133717,0.4974838245866283
E01006861,1595,746,849,0.4677115987460815,0.5322884012539185
E01006862,1320,637,683,0.4825757575757576,0.5174242424242425
E01006831,1464,711,753,0.48565573770491804,0.514344262295082
E01006833,1615,791,824,0.48978328173374613,0.5102167182662539
E01006835,1409,713,696,0.5060326472675657,0.49396735273243436
E01006876,1477,737,740,0.4989844278943805,0.5010155721056195
E01006878,1346,662,684,0.4918276374442793,0.5081723625557206
E01006879,1512,753,759,0.498015873015873,0.501984126984127
E01006904,1686,821,865,0.48695136417556345,0.5130486358244365
E01006816,1694,841,853,0.4964580873671783,0.5035419126328218
E01006817,1330,668,662,0.5022556390977444,0.49774436090225566
E01006875,1292,621,671,0.4806501547987616,0.5193498452012384
E01006899,2046,1003,1043,0.49022482893450636,0.5097751710654936
E01006826,1338,677,661,0.5059790732436472,0.4940209267563528
E01006827,1594,791,803,0.49623588456712675,0.5037641154328732
E01006828,2146,1024,1122,0.4771668219944082,0.5228331780055918
E01006829,1246,599,647,0.48073836276083465,0.5192616372391653
E01006830,1344,648,696,0.48214285714285715,0.5178571428571429
E01006903,1521,755,766,0.49638395792241946,0.5036160420775806
E01006905,1338,659,679,0.49252615844544095,0.507473841554559
E01006906,1481,711,770,0.4800810263335584,0.5199189736664416
E01006907,1570,757,813,0.4821656050955414,0.5178343949044586
E01006912,1508,744,764,0.493368700265252,0.506631299734748
E01006913,1317,627,690,0.4760820045558087,0.5239179954441914
E01032904,1880,948,932,0.5042553191489362,0.4957446808510638
E01032905,1570,772,798,0.49171974522292994,0.5082802547770701
E01006844,1603,762,841,0.47535870243293826,0.5246412975670618
E01006846,1428,693,735,0.4852941176470588,0.5147058823529411
E01006847,1725,841,884,0.487536231884058,0.5124637681159421
E01006848,1403,703,700,0.5010691375623664,0.4989308624376336
E01006896,1523,755,768,0.49573210768220616,0.5042678923177938
E01006897,1469,719,750,0.48944860449285227,0.5105513955071477
E01006901,1309,658,651,0.5026737967914439,0.49732620320855614
E01006890,1459,725,734,0.49691569568197397,0.5030843043180261
E01006892,1208,598,610,0.49503311258278143,0.5049668874172185
E01006893,1382,679,703,0.4913169319826339,0.5086830680173662
E01006894,1351,662,689,0.4900074019245004,0.5099925980754997
E01006898,1618,764,854,0.4721878862793572,0.5278121137206427
E01006900,2712,1354,1358,0.49926253687315636,0.5007374631268436
E01006908,1339,660,679,0.49290515309932786,0.5070948469006722
E01006909,1325,632,693,0.4769811320754717,0.5230188679245283
E01006910,1711,845,866,0.4938632378725891,0.5061367621274109
E01006911,1508,758,750,0.5026525198938993,0.4973474801061008
E01006888,1217,578,639,0.47493837304847986,0.5250616269515201
E01006889,1444,722,722,0.5,0.5
E01006891,1391,672,719,0.4831056793673616,0.5168943206326384
E01006895,1401,669,732,0.47751605995717344,0.5224839400428265
E01007229,1665,801,864,0.4810810810810811,0.518918918918919
E01007230,1239,585,654,0.4721549636803874,0.5278450363196125
E01007231,1578,803,775,0.508871989860583,0.491128010139417
E01007237,1516,747,769,0.49274406332453824,0.5072559366754618
E01007238,1549,768,781,0.49580374435119434,0.5041962556488057
E01007218,1492,730,762,0.48927613941018766,0.5107238605898123
E01007232,1522,740,782,0.48620236530880423,0.5137976346911958
E01007233,1848,901,947,0.4875541125541126,0.5124458874458875
E01007234,1577,785,792,0.49778059606848446,0.5022194039315155
E01007236,1402,640,762,0.456490727532097,0.543509272467903
E01007307,1753,861,892,0.49115801483171706,0.5088419851682829
E01007308,1489,715,774,0.4801880456682337,0.5198119543317663
E01007312,1491,712,779,0.47753185781354796,0.5224681421864521
E01007313,1553,746,807,0.48036059240180295,0.519639407598197
E01007315,1543,750,793,0.4860661049902787,0.5139338950097213
E01007211,1183,590,593,0.4987320371935757,0.5012679628064244
E01007235,1525,730,795,0.4786885245901639,0.521311475409836
E01007310,1388,653,735,0.47046109510086453,0.5295389048991355
E01007311,1473,722,751,0.49015614392396467,0.5098438560760353
E01007314,1489,687,802,0.4613834788448623,0.5386165211551377
E01007316,1535,730,805,0.4755700325732899,0.5244299674267101
E01007215,1596,805,791,0.5043859649122807,0.4956140350877193
E01007216,1550,762,788,0.4916129032258065,0.5083870967741936
E01007219,1558,793,765,0.5089858793324775,0.4910141206675225
E01007220,1259,601,658,0.47736298649722003,0.52263701350278
E01007275,1562,765,797,0.48975672215108834,0.5102432778489117
E01007203,2022,1000,1022,0.49455984174085066,0.5054401582591493
E01007205,1541,732,809,0.47501622323166776,0.5249837767683323
E01007210,1955,925,1030,0.4731457800511509,0.5268542199488491
E01007309,1546,764,782,0.49417852522639066,0.5058214747736093
E01007212,1468,721,747,0.49114441416893734,0.5088555858310627
E01007213,1553,738,815,0.4752092723760464,0.5247907276239536
E01007214,1507,739,768,0.49037823490378235,0.5096217650962177
E01007217,1582,762,820,0.48166877370417194,0.5183312262958281
E01007276,1550,773,777,0.49870967741935485,0.5012903225806452
E01007272,1487,749,738,0.503698722259583,0.49630127774041694
E01007273,1310,611,699,0.466412213740458,0.533587786259542
E01007274,1368,654,714,0.4780701754385965,0.5219298245614035
E01007277,1459,730,729,0.5003427004797807,0.4996572995202193
E01007278,1476,735,741,0.49796747967479676,0.5020325203252033
E01007204,1656,749,907,0.4522946859903382,0.5477053140096618
E01007206,1868,917,951,0.49089935760171305,0.5091006423982869
E01007207,1351,621,730,0.45965951147298295,0.540340488527017
E01007209,1293,623,670,0.48182521268368134,0.5181747873163186
E01007269,1816,863,953,0.4752202643171806,0.5247797356828194
E01007270,1689,863,826,0.5109532267613973,0.48904677323860274
E01007271,1670,811,859,0.48562874251497007,0.51437125748503
E01032903,2451,1137,1314,0.4638922888616891,0.5361077111383109
E01007120,1394,653,741,0.4684361549497848,0.5315638450502153
E01007121,1475,677,798,0.4589830508474576,0.5410169491525424
E01007122,1381,667,714,0.4829833454018827,0.5170166545981173
E01007123,1748,782,966,0.4473684210526316,0.5526315789473685
E01007124,1512,667,845,0.44113756613756616,0.5588624338624338
E01007208,1727,820,907,0.4748118123914302,0.5251881876085698
E01007221,1472,717,755,0.48709239130434784,0.5129076086956522
E01007225,1804,896,908,0.49667405764966743,0.5033259423503326
E01007227,1507,713,794,0.47312541473125413,0.5268745852687459
E01007228,1399,698,701,0.498927805575411,0.501072194424589
E01007195,1624,756,868,0.46551724137931033,0.5344827586206896
E01007199,1547,751,796,0.4854557207498384,0.5145442792501616
E01007222,1608,789,819,0.4906716417910448,0.5093283582089553
E01007223,1394,664,730,0.4763271162123386,0.5236728837876614
E01007193,1668,803,865,0.4814148681055156,0.5185851318944844
E01007194,1495,696,799,0.46555183946488293,0.534448160535117
E01007200,1732,826,906,0.476905311778291,0.523094688221709
E01007201,1460,699,761,0.47876712328767124,0.5212328767123288
E01007202,1383,665,718,0.48083875632682577,0.5191612436731743
E01007125,1683,813,870,0.483065953654189,0.5169340463458111
E01007156,1525,745,780,0.4885245901639344,0.5114754098360655
E01007157,1538,745,793,0.48439531859557866,0.5156046814044213
E01007158,1517,736,781,0.4851680949241925,0.5148319050758076
E01007159,1846,877,969,0.4750812567713976,0.5249187432286024
E01007126,1858,989,869,0.5322927879440258,0.46770721205597415
E01007127,1565,732,833,0.46773162939297125,0.5322683706070288
E01007128,1651,861,790,0.5215021199273168,0.47849788007268323
E01007129,1563,797,766,0.5099168266154831,0.49008317338451696
E01007133,1086,559,527,0.5147329650092081,0.4852670349907919
E01007224,1476,708,768,0.4796747967479675,0.5203252032520326
E01007226,1599,751,848,0.46966854283927456,0.5303314571607255
E01007265,1365,649,716,0.47545787545787543,0.5245421245421246
E01007299,1344,652,692,0.4851190476190476,0.5148809523809523
E01007306,1612,762,850,0.47270471464019853,0.5272952853598015
E01007297,1436,626,810,0.435933147632312,0.564066852367688
E01007298,1529,708,821,0.4630477436232832,0.5369522563767168
E01007301,1632,783,849,0.4797794117647059,0.5202205882352942
E01007302,1435,703,732,0.48989547038327524,0.5101045296167247
E01007305,1631,766,865,0.4696505211526671,0.530349478847333
E01007119,1427,667,760,0.46741415557112825,0.5325858444288718
E01007161,1538,746,792,0.4850455136540962,0.5149544863459038
E01007162,1503,652,851,0.4337990685296075,0.5662009314703925
E01007300,1914,853,1061,0.4456635318704284,0.5543364681295716
E01007155,1830,906,924,0.49508196721311476,0.5049180327868853
E01007160,1704,858,846,0.5035211267605634,0.4964788732394366
E01007240,1580,828,752,0.5240506329113924,0.4759493670886076
E01007241,1472,665,807,0.4517663043478261,0.548233695652174
E01007242,1662,795,867,0.47833935018050544,0.5216606498194946
E01007130,1774,866,908,0.4881623449830891,0.5118376550169109
E01007131,1595,769,826,0.48213166144200625,0.5178683385579937
E01007179,1292,638,654,0.4938080495356037,0.5061919504643962
E01007291,1670,823,847,0.492814371257485,0.5071856287425149
E01007292,1472,689,783,0.468070652173913,0.5319293478260869
E01007294,1481,686,795,0.46320054017555706,0.536799459824443
E01007180,1552,767,785,0.49420103092783507,0.5057989690721649
E01007181,1493,714,779,0.478231748158071,0.521768251841929
E01007239,1754,863,891,0.492018244013683,0.507981755986317
E01007243,1604,754,850,0.470074812967581,0.529925187032419
E01007244,2077,1025,1052,0.49350024073182475,0.5064997592681753
E01007259,1208,585,623,0.48427152317880795,0.515728476821192
E01007261,1364,663,701,0.48607038123167157,0.5139296187683284
E01007264,1412,677,735,0.4794617563739377,0.5205382436260623
E01007266,1538,737,801,0.47919375812743825,0.5208062418725617
E01007267,1454,675,779,0.4642365887207703,0.5357634112792297
E01007268,1317,634,683,0.48139711465451784,0.5186028853454822
E01007163,2347,1140,1207,0.48572645930975716,0.5142735406902429
E01007245,1539,785,754,0.5100714749837557,0.4899285250162443
E01007246,1553,770,783,0.49581455247907275,0.5041854475209272
E01007247,1756,866,890,0.49316628701594534,0.5068337129840547
E01007252,1548,735,813,0.4748062015503876,0.5251937984496124
E01007249,1358,644,714,0.4742268041237113,0.5257731958762887
E01007251,1169,597,572,0.5106928999144568,0.4893071000855432
E01007257,1299,615,684,0.47344110854503463,0.5265588914549654
E01007303,1438,666,772,0.4631432545201669,0.5368567454798331
E01007304,1569,694,875,0.44231994901210964,0.5576800509878904
E01007196,1617,718,899,0.4440321583178726,0.5559678416821274
E01007197,1693,827,866,0.4884819846426462,0.5115180153573539
E01007198,1703,807,896,0.4738696418085731,0.5261303581914268
E01007263,1415,672,743,0.47491166077738517,0.5250883392226149
E01007282,1418,660,758,0.46544428772919605,0.5345557122708039
E01007175,1846,898,948,0.48645720476706394,0.5135427952329361
E01007290,1743,875,868,0.5020080321285141,0.4979919678714859
E01007293,1483,684,799,0.4612272420768712,0.5387727579231288
E01007295,1185,566,619,0.47763713080168774,0.5223628691983122
E01007296,1713,783,930,0.45709281961471104,0.542907180385289
E01007258,1454,701,753,0.48211829436038517,0.5178817056396149
E01007260,1561,743,818,0.47597693786034595,0.5240230621396541
E01007262,1499,749,750,0.49966644429619744,0.5003335557038026
E01007281,1333,636,697,0.477119279819955,0.522880720180045
E01007283,1266,604,662,0.47709320695102686,0.5229067930489731
E01007173,1552,754,798,0.48582474226804123,0.5141752577319587
E01007174,1562,744,818,0.47631241997439183,0.5236875800256082
E01007176,1612,801,811,0.4968982630272953,0.5031017369727047
E01007177,1507,674,833,0.44724618447246184,0.5527538155275381
E01007178,1556,759,797,0.4877892030848329,0.5122107969151671
E01007248,1535,754,781,0.49120521172638437,0.5087947882736157
E01007250,1415,691,724,0.488339222614841,0.511660777385159
E01007253,1552,743,809,0.4787371134020619,0.5212628865979382
E01007254,1524,722,802,0.473753280839895,0.526246719160105
E01007115,1594,767,827,0.48117942283563364,0.5188205771643664
E01007138,1633,825,808,0.5052051439069197,0.4947948560930802
E01007139,1552,766,786,0.49355670103092786,0.5064432989690721
E01007141,1593,740,853,0.4645323289391086,0.5354676710608914
E01007289,1599,768,831,0.4803001876172608,0.5196998123827392
E01007111,1575,759,816,0.4819047619047619,0.518095238095238
E01007112,1535,732,803,0.47687296416938113,0.5231270358306189
E01007113,1376,671,705,0.4876453488372093,0.5123546511627907
E01007114,1530,724,806,0.47320261437908495,0.526797385620915
E01007116,1552,764,788,0.49226804123711343,0.5077319587628866
E01007280,1742,852,890,0.4890929965556831,0.5109070034443168
E01007284,1623,781,842,0.48120764017252005,0.51879235982748
E01007285,1489,701,788,0.470785762256548,0.529214237743452
E01007287,1837,868,969,0.472509526401742,0.5274904735982581
E01007183,1285,647,638,0.5035019455252918,0.4964980544747082
E01007255,1502,728,774,0.48468708388814913,0.5153129161118508
E01007256,1581,715,866,0.4522454142947502,0.5477545857052498
E01007279,1680,802,878,0.4773809523809524,0.5226190476190476
E01007286,1437,714,723,0.4968684759916493,0.5031315240083507
E01007110,1601,754,847,0.47095565271705186,0.5290443472829481
E01007117,1697,818,879,0.48202710665880966,0.5179728933411903
E01007118,1558,739,819,0.4743260590500642,0.5256739409499358
E01007151,1570,752,818,0.4789808917197452,0.5210191082802548
E01007154,1545,748,797,0.4841423948220065,0.5158576051779935
E01007140,1692,847,845,0.5005910165484634,0.49940898345153667
E01007142,1812,838,974,0.4624724061810154,0.5375275938189845
E01007143,1672,822,850,0.4916267942583732,0.5083732057416268
E01007152,1653,776,877,0.4694494857834241,0.530550514216576
E01007153,1513,669,844,0.44216787838731,0.55783212161269
E01007182,1522,708,814,0.4651773981603154,0.5348226018396847
E01007184,1509,685,824,0.45394300861497683,0.5460569913850232
E01007185,1594,748,846,0.46925972396486826,0.5307402760351317
E01007192,1306,615,691,0.47090352220520676,0.5290964777947933
E01007288,1587,720,867,0.45368620037807184,0.5463137996219282
E01007144,1383,628,755,0.45408532176428057,0.5459146782357195
E01007145,1318,638,680,0.48406676783004554,0.5159332321699545
E01007146,1566,753,813,0.48084291187739464,0.5191570881226054
E01007147,1402,683,719,0.4871611982881598,0.5128388017118403
E01007148,1660,821,839,0.49457831325301205,0.505421686746988
E01007135,1572,775,797,0.49300254452926207,0.5069974554707379
E01007136,1681,804,877,0.47828673408685307,0.5217132659131469
E01007137,1643,766,877,0.4662203286670724,0.5337796713329276
E01007170,1532,748,784,0.48825065274151436,0.5117493472584856
E01007186,1590,752,838,0.4729559748427673,0.5270440251572327
E01007187,1464,697,767,0.4760928961748634,0.5239071038251366
E01007188,1491,729,762,0.48893360160965793,0.5110663983903421
E01007189,1614,780,834,0.483271375464684,0.516728624535316
E01007190,1485,705,780,0.47474747474747475,0.5252525252525253
E01007191,1336,675,661,0.5052395209580839,0.49476047904191617
E01007149,1489,750,739,0.503693754197448,0.49630624580255206
E01007150,1480,746,734,0.504054054054054,0.49594594594594593
E01007165,1338,655,683,0.48953662182361735,0.5104633781763827
E01007171,1551,796,755,0.513217279174726,0.486782720825274
E01007172,1438,677,761,0.47079276773296247,0.5292072322670376
E01007164,1730,844,886,0.48786127167630056,0.5121387283236994
E01007166,1446,715,731,0.49446749654218536,0.5055325034578146
E01007167,1492,715,777,0.4792225201072386,0.5207774798927614
E01007168,1640,762,878,0.46463414634146344,0.5353658536585366
E01007169,1715,818,897,0.4769679300291545,0.5230320699708455
E01012933,1040,499,541,0.4798076923076923,0.5201923076923077
E01012934,1536,740,796,0.4817708333333333,0.5182291666666666
E01012938,2273,1072,1201,0.471623405191377,0.528376594808623
E01012939,1820,872,948,0.47912087912087914,0.5208791208791209
E01012940,1655,817,838,0.4936555891238671,0.5063444108761329
E01012941,1364,649,715,0.47580645161290325,0.5241935483870968
E01012929,1952,945,1007,0.48411885245901637,0.5158811475409836
E01012930,1424,664,760,0.46629213483146065,0.5337078651685393
E01012935,1308,611,697,0.46712538226299694,0.5328746177370031
E01012937,2161,1058,1103,0.4895881536325775,0.5104118463674225
E01012942,1226,566,660,0.46166394779771613,0.5383360522022839
E01012928,1680,793,887,0.4720238095238095,0.5279761904761905
E01012931,1580,743,837,0.47025316455696203,0.529746835443038
E01012932,1637,790,847,0.48259010384850337,0.5174098961514967
E01012946,1617,775,842,0.479282622139765,0.520717377860235
E01012949,1390,636,754,0.45755395683453237,0.5424460431654676
E01012936,1359,625,734,0.459896983075791,0.5401030169242089
E01012943,1628,779,849,0.4785012285012285,0.5214987714987716
E01012945,1601,806,795,0.5034353529044348,0.49656464709556525
E01012952,1444,742,702,0.5138504155124654,0.48614958448753465
E01012944,1448,772,676,0.5331491712707183,0.46685082872928174
E01012947,1424,683,741,0.47963483146067415,0.5203651685393258
E01012948,1409,718,691,0.5095812633073101,0.49041873669268987
E01012951,1381,657,724,0.47574221578566256,0.5242577842143374
E01012950,1442,702,740,0.4868238557558946,0.5131761442441054
E01012990,1379,663,716,0.4807831762146483,0.5192168237853517
E01012991,1580,766,814,0.48481012658227846,0.5151898734177215
E01012992,1490,726,764,0.487248322147651,0.512751677852349
E01012978,1418,678,740,0.4781382228490832,0.5218617771509168
E01012981,1406,694,712,0.49359886201991465,0.5064011379800853
E01012983,1795,895,900,0.4986072423398329,0.5013927576601671
E01012989,1731,811,920,0.4685153090699018,0.5314846909300982
E01013125,1724,842,882,0.48839907192575405,0.511600928074246
E01013057,1503,738,765,0.49101796407185627,0.5089820359281437
E01013059,1620,793,827,0.48950617283950615,0.5104938271604939
E01013060,1914,899,1015,0.4696969696969697,0.5303030303030303
E01013061,1614,768,846,0.4758364312267658,0.5241635687732342
E01013126,2154,1388,766,0.6443825441039925,0.3556174558960074
E01012986,1563,778,785,0.49776071657069737,0.5022392834293026
E01012987,1698,840,858,0.49469964664310956,0.5053003533568905
E01012988,1522,760,762,0.49934296977660975,0.5006570302233903
E01013048,2059,1019,1040,0.49490043710539094,0.505099562894609
E01013052,1540,753,787,0.488961038961039,0.5110389610389611
E01013053,1379,651,728,0.4720812182741117,0.5279187817258884
E01013054,2057,986,1071,0.4793388429752066,0.5206611570247934
E01013055,1523,740,783,0.48588312541037426,0.5141168745896257
E01013056,1624,784,840,0.4827586206896552,0.5172413793103449
E01013058,1328,648,680,0.4879518072289157,0.5120481927710844
E01013119,1492,747,745,0.5006702412868632,0.49932975871313673
E01013046,1640,759,881,0.4628048780487805,0.5371951219512195
E01013047,1601,757,844,0.4728294815740162,0.5271705184259837
E01013049,1603,771,832,0.4809731752963194,0.5190268247036806
E01013050,1676,857,819,0.5113365155131265,0.4886634844868735
E01013051,1579,752,827,0.47625079164027867,0.5237492083597214
E01012922,1490,747,743,0.5013422818791946,0.4986577181208054
E01012923,1618,844,774,0.5216316440049443,0.4783683559950556
E01012925,1329,642,687,0.48306997742663654,0.5169300225733634
E01012927,1571,794,777,0.5054105665181413,0.4945894334818587
E01012924,1731,865,866,0.49971114962449453,0.5002888503755055
E01012926,2433,1195,1238,0.49116317303740237,0.5088368269625976
E01013027,1628,790,838,0.48525798525798525,0.5147420147420148
E01013034,1801,892,909,0.49528039977790117,0.5047196002220988
E01013120,1957,958,999,0.4895247828308636,0.5104752171691365
E01013121,2026,1010,1016,0.49851924975320827,0.5014807502467917
E01013123,1552,779,773,0.5019329896907216,0.49806701030927836
E01013124,2051,954,1097,0.46513895660653337,0.5348610433934666
E01013064,1492,705,787,0.4725201072386059,0.5274798927613941
E01013065,1644,804,840,0.48905109489051096,0.5109489051094891
E01013066,1621,768,853,0.47378161628624305,0.526218383713757
E01013067,1732,844,888,0.48729792147806006,0.5127020785219399
E01013068,1419,669,750,0.4714587737843552,0.5285412262156448
E01013070,1534,708,826,0.46153846153846156,0.5384615384615384
E01013038,1554,772,782,0.4967824967824968,0.5032175032175032
E01013045,1572,749,823,0.47646310432569977,0.5235368956743003
E01013069,1563,779,784,0.4984005118362124,0.5015994881637876
E01013071,1619,751,868,0.4638665843113033,0.5361334156886968
E01013022,1884,951,933,0.5047770700636943,0.49522292993630573
E01013023,1838,909,929,0.49455930359085964,0.5054406964091404
E01013024,1832,882,950,0.4814410480349345,0.5185589519650655
E01013122,1487,728,759,0.48957632817753866,0.5104236718224613
E01013127,1500,760,740,0.5066666666666667,0.49333333333333335
E01013036,1530,722,808,0.4718954248366013,0.5281045751633987
E01013037,1481,726,755,0.4902093180283592,0.5097906819716408
E01013040,2022,995,1027,0.4920870425321464,0.5079129574678536
E01013041,1559,701,858,0.4496472097498396,0.5503527902501604
E01013062,1690,811,879,0.4798816568047337,0.5201183431952663
E01013063,1514,724,790,0.47820343461030385,0.5217965653896962
E01012919,1527,696,831,0.45579567779960706,0.5442043222003929
E01012921,1149,552,597,0.4804177545691906,0.5195822454308094
E01013039,1735,870,865,0.5014409221902018,0.49855907780979825
E01013042,1698,826,872,0.48645465253239106,0.5135453474676089
E01013043,1468,696,772,0.47411444141689374,0.5258855585831063
E01013044,1621,804,817,0.4959901295496607,0.5040098704503393
E01013029,1468,717,751,0.4884196185286104,0.5115803814713896
E01013030,1493,751,742,0.5030140656396517,0.49698593436034827
E01013031,1512,740,772,0.4894179894179894,0.5105820105820106
E01013032,1444,704,740,0.48753462603878117,0.5124653739612188
E01013035,1324,670,654,0.5060422960725075,0.49395770392749244
E01012954,1241,593,648,0.47784045124899277,0.5221595487510072
E01012956,1242,606,636,0.48792270531400966,0.5120772946859904
E01012958,1047,507,540,0.48424068767908307,0.5157593123209169
E01012961,1516,738,778,0.4868073878627968,0.5131926121372031
E01012966,1284,607,677,0.4727414330218069,0.5272585669781932
E01012953,1076,536,540,0.49814126394052044,0.5018587360594795
E01012955,1538,721,817,0.4687906371911573,0.5312093628088427
E01012959,1463,721,742,0.49282296650717705,0.507177033492823
E01012962,1150,532,618,0.46260869565217394,0.5373913043478261
E01012964,1680,838,842,0.4988095238095238,0.5011904761904762
E01012920,1472,726,746,0.49320652173913043,0.5067934782608695
E01012965,1015,478,537,0.470935960591133,0.529064039408867
E01012967,1569,742,827,0.47291268323773106,0.5270873167622689
E01012968,1717,866,851,0.5043680838672102,0.49563191613278973
E01012969,1844,1251,593,0.678416485900217,0.3215835140997831
E01012957,2586,1300,1286,0.502706883217324,0.49729311678267596
E01012960,1653,763,890,0.4615849969751966,0.5384150030248034
E01012963,1457,671,786,0.4605353466026081,0.5394646533973919
E01013112,1424,683,741,0.47963483146067415,0.5203651685393258
E01013018,1855,876,979,0.47223719676549863,0.5277628032345013
E01013019,1174,584,590,0.49744463373083475,0.5025553662691652
E01013021,1496,746,750,0.49866310160427807,0.5013368983957219
E01013025,1348,670,678,0.4970326409495549,0.5029673590504451
E01013026,1661,835,826,0.5027092113184829,0.49729078868151716
E01013105,1439,679,760,0.4718554551772064,0.5281445448227936
E01013110,1574,722,852,0.45870393900889456,0.5412960609911055
E01013111,1464,720,744,0.4918032786885246,0.5081967213114754
E01013115,1533,743,790,0.4846705805609915,0.5153294194390085
E01013117,1540,750,790,0.487012987012987,0.512987012987013
E01013108,1541,766,775,0.4970798182998053,0.5029201817001947
E01013113,1522,729,793,0.47897503285151116,0.5210249671484888
E01013114,1502,755,747,0.5026631158455392,0.4973368841544607
E01013116,1543,774,769,0.5016202203499676,0.4983797796500324
E01013118,1476,703,773,0.47628726287262874,0.5237127371273713
E01013094,1412,686,726,0.48583569405099153,0.5141643059490085
E01013095,1563,723,840,0.46257197696737046,0.5374280230326296
E01013096,1674,795,879,0.47491039426523296,0.525089605734767
E01013097,1437,720,717,0.5010438413361169,0.4989561586638831
E01013102,1425,683,742,0.4792982456140351,0.5207017543859649
E01013028,1558,798,760,0.5121951219512195,0.4878048780487805
E01013078,1423,712,711,0.500351370344343,0.49964862965565704
E01013081,1485,734,751,0.49427609427609426,0.5057239057239057
E01013082,1587,805,782,0.5072463768115942,0.4927536231884058
E01013085,1654,830,824,0.501813784764208,0.49818621523579204
E01012970,1460,711,749,0.48698630136986304,0.513013698630137
E01012972,1544,747,797,0.4838082901554404,0.5161917098445595
E01012973,2795,1399,1396,0.5005366726296959,0.49946332737030413
E01012974,1532,720,812,0.4699738903394256,0.5300261096605744
E01013092,2027,996,1031,0.4913665515540207,0.5086334484459792
E01033495,1392,689,703,0.4949712643678161,0.5050287356321839
E01033496,1722,839,883,0.48722415795586527,0.5127758420441347
E01013033,1608,792,816,0.4925373134328358,0.5074626865671642
E01013098,2229,1086,1143,0.48721399730820997,0.5127860026917901
E01013099,1341,646,695,0.4817300521998509,0.5182699478001491
E01013100,1697,847,850,0.4991160872127283,0.5008839127872716
E01013101,1695,856,839,0.5050147492625369,0.49498525073746313
E01013008,1501,712,789,0.4743504330446369,0.5256495669553631
E01013009,1522,728,794,0.4783180026281209,0.5216819973718791
E01013013,1528,733,795,0.47971204188481675,0.5202879581151832
E01013014,1521,760,761,0.4996712689020381,0.5003287310979618
E01013107,1534,713,821,0.46479791395045633,0.5352020860495437
E01013088,1657,825,832,0.4978877489438745,0.5021122510561256
E01013089,1674,790,884,0.47192353643966545,0.5280764635603346
E01013090,1414,700,714,0.49504950495049505,0.504950495049505
E01013091,1612,800,812,0.49627791563275436,0.5037220843672456
E01013093,1487,736,751,0.4949562878278413,0.5050437121721587
E01013005,1472,704,768,0.4782608695652174,0.5217391304347826
E01013007,1568,737,831,0.4700255102040816,0.5299744897959183
E01013011,1512,723,789,0.4781746031746032,0.5218253968253969
E01013012,1373,670,703,0.4879825200291333,0.5120174799708667
E01012996,1579,771,808,0.4882837238758708,0.5117162761241292
E01012998,2189,1052,1137,0.48058474189127454,0.5194152581087255
E01013015,1570,798,772,0.5082802547770701,0.49171974522292994
E01013016,1656,831,825,0.5018115942028986,0.49818840579710144
E01013003,1447,711,736,0.49136143745680716,0.5086385625431928
E01013017,1639,803,836,0.4899328859060403,0.5100671140939598
E01013020,1800,871,929,0.48388888888888887,0.5161111111111111
E01013076,1493,757,736,0.507032819825854,0.49296718017414604
E01013079,1516,761,755,0.5019788918205804,0.4980211081794195
E01013080,1365,674,691,0.4937728937728938,0.5062271062271062
E01013083,1483,748,735,0.5043830074173972,0.49561699258260283
E01013084,1439,683,756,0.47463516330785266,0.5253648366921473
E01013086,1576,815,761,0.5171319796954315,0.48286802030456855
E01013087,1365,674,691,0.4937728937728938,0.5062271062271062
E01012993,1410,654,756,0.46382978723404256,0.5361702127659574
E01012997,1855,912,943,0.49164420485175203,0.508355795148248
E01012999,1740,865,875,0.49712643678160917,0.5028735632183908
E01013001,1801,864,937,0.47973348139922267,0.5202665186007773
E01013074,1633,811,822,0.4966319657072872,0.5033680342927128
E01012994,1755,864,891,0.49230769230769234,0.5076923076923077
E01012995,1923,929,994,0.4830993239729589,0.516900676027041
E01013000,1820,968,852,0.5318681318681319,0.46813186813186813
E01013002,1619,812,807,0.5015441630636195,0.49845583693638046
E01013004,1672,787,885,0.4706937799043062,0.5293062200956937
E01013072,1698,832,866,0.48998822143698467,0.5100117785630153
E01013073,1592,793,799,0.4981155778894472,0.5018844221105527
E01013075,1322,670,652,0.5068078668683812,0.49319213313161875
E01013077,1987,945,1042,0.47559134373427275,0.5244086562657272
E01013006,1532,743,789,0.4849869451697128,0.5150130548302873
E01013010,1471,712,759,0.4840244731475187,0.5159755268524813
E01013103,1419,688,731,0.48484848484848486,0.5151515151515151
E01013104,1243,590,653,0.4746580852775543,0.5253419147224457
E01013106,1198,594,604,0.4958263772954925,0.5041736227045075
E01032596,1420,673,747,0.47394366197183097,0.526056338028169
E01012975,1509,721,788,0.4777998674618953,0.5222001325381047
E01012977,2597,1252,1345,0.4820947246823258,0.5179052753176743
E01012984,1679,843,836,0.5020845741512805,0.49791542584871945
E01012985,1692,813,879,0.4804964539007092,0.5195035460992907
E01012976,1457,696,761,0.4776938915579959,0.5223061084420041
E01012979,1508,734,774,0.48673740053050396,0.513262599469496
E01012980,1855,884,971,0.4765498652291105,0.5234501347708895
E01012982,1654,783,871,0.47339782345828296,0.526602176541717
E01012779,1283,586,697,0.4567420109119252,0.5432579890880749
E01012780,1560,750,810,0.4807692307692308,0.5192307692307693
E01012781,1241,579,662,0.4665592264302981,0.5334407735697019
E01012832,1393,685,708,0.49174443646805455,0.5082555635319455
E01033105,1448,735,713,0.5075966850828729,0.4924033149171271
E01033106,1155,574,581,0.49696969696969695,0.503030303030303
E01033107,1315,636,679,0.48365019011406846,0.5163498098859316
E01033108,1451,732,719,0.5044796691936595,0.49552033080634045
E01012782,1441,682,759,0.4732824427480916,0.5267175572519084
E01012785,1328,656,672,0.4939759036144578,0.5060240963855421
E01012786,1222,600,622,0.4909983633387889,0.5090016366612111
E01012787,1517,775,742,0.5108767303889256,0.4891232696110745
E01012788,1472,717,755,0.48709239130434784,0.5129076086956522
E01012789,1343,643,700,0.4787788533134773,0.5212211466865228
E01012875,1495,729,766,0.48762541806020065,0.5123745819397993
E01012876,1706,804,902,0.4712778429073857,0.5287221570926143
E01012877,1434,668,766,0.46582984658298465,0.5341701534170153
E01012878,1574,759,815,0.4822109275730623,0.5177890724269377
E01012879,1431,738,693,0.5157232704402516,0.48427672955974843
E01012778,1480,683,797,0.4614864864864865,0.5385135135135135
E01012783,1217,585,632,0.4806902218570255,0.5193097781429745
E01012784,2108,1009,1099,0.4786527514231499,0.5213472485768501
E01012790,1321,641,680,0.48523845571536717,0.5147615442846328
E01012906,1611,745,866,0.46244568590937307,0.5375543140906269
E01012908,1189,590,599,0.496215306980656,0.503784693019344
E01012764,1165,591,574,0.5072961373390558,0.4927038626609442
E01012765,1503,730,773,0.4856952761144378,0.5143047238855623
E01012768,1359,648,711,0.4768211920529801,0.5231788079470199
E01012769,1334,669,665,0.5014992503748126,0.4985007496251874
E01012829,1593,787,806,0.49403640929064657,0.5059635907093534
E01012830,1470,737,733,0.501360544217687,0.49863945578231295
E01012905,1339,651,688,0.48618371919342795,0.513816280806572
E01012910,1298,657,641,0.5061633281972265,0.4938366718027735
E01012912,1837,932,905,0.5073489384866631,0.492651061513337
E01012822,1506,741,765,0.49203187250996017,0.5079681274900398
E01012904,1460,709,751,0.48561643835616436,0.5143835616438356
E01012907,1398,702,696,0.5021459227467812,0.4978540772532189
E01012909,1303,640,663,0.4911742133537989,0.508825786646201
E01012911,1214,610,604,0.5024711696869851,0.4975288303130148
E01012873,1542,725,817,0.4701686121919585,0.5298313878080415
E01012874,1580,786,794,0.49746835443037973,0.5025316455696203
E01012880,1720,816,904,0.4744186046511628,0.5255813953488372
E01012881,1520,752,768,0.49473684210526314,0.5052631578947369
E01012915,1483,705,778,0.4753877275792313,0.5246122724207687
E01012917,1621,786,835,0.4848858729179519,0.5151141270820481
E01012918,1552,772,780,0.49742268041237114,0.5025773195876289
E01012833,1494,686,808,0.45917001338688085,0.5408299866131191
E01012835,1154,567,587,0.4913344887348354,0.5086655112651647
E01012836,1507,806,701,0.5348374253483743,0.46516257465162575
E01012839,1297,637,660,0.49113338473400153,0.5088666152659984
E01012840,1490,706,784,0.4738255033557047,0.5261744966442953
E01012824,1685,833,852,0.4943620178041543,0.5056379821958457
E01012825,1499,688,811,0.4589726484322882,0.5410273515677118
E01012834,1613,739,874,0.45815251084934905,0.541847489150651
E01012837,1656,733,923,0.4426328502415459,0.5573671497584541
E01012838,1510,710,800,0.47019867549668876,0.5298013245033113
E01012821,1219,565,654,0.4634946677604594,0.5365053322395406
E01012823,1456,719,737,0.49381868131868134,0.5061813186813187
E01012826,1510,717,793,0.47483443708609274,0.5251655629139073
E01012827,1491,694,797,0.46545942320590206,0.5345405767940979
E01012828,1539,743,796,0.48278102664067574,0.5172189733593242
E01012766,1433,727,706,0.5073272854152129,0.4926727145847872
E01012767,1709,896,813,0.5242832065535401,0.4757167934464599
E01012914,2150,1134,1016,0.5274418604651163,0.47255813953488374
E01012916,1558,795,763,0.5102695763799743,0.48973042362002567
E01012812,1449,742,707,0.5120772946859904,0.48792270531400966
E01012813,1777,884,893,0.4974676420934159,0.5025323579065841
E01012814,1540,746,794,0.4844155844155844,0.5155844155844156
E01012815,1598,835,763,0.5225281602002503,0.47747183979974966
E01012818,1250,609,641,0.4872,0.5128
E01012791,1672,822,850,0.4916267942583732,0.5083732057416268
E01012792,1590,793,797,0.4987421383647799,0.5012578616352201
E01012793,1483,694,789,0.4679703304113284,0.5320296695886716
E01012794,1588,797,791,0.5018891687657431,0.4981108312342569
E01012913,1979,952,1027,0.4810510358767054,0.5189489641232946
E01012761,1757,961,796,0.5469550369948777,0.45304496300512237
E01012868,1749,920,829,0.5260148656375071,0.47398513436249284
E01012869,1774,971,803,0.5473506200676438,0.45264937993235627
E01012871,1829,1006,823,0.5500273373428103,0.4499726626571897
E01012872,1852,1001,851,0.5404967602591793,0.45950323974082075
E01012804,1467,743,724,0.5064758009543285,0.49352419904567146
E01012806,1461,738,723,0.5051334702258727,0.4948665297741273
E01012807,1377,677,700,0.4916485112563544,0.5083514887436456
E01012817,1370,701,669,0.5116788321167883,0.48832116788321167
E01012819,1435,711,724,0.49547038327526133,0.5045296167247387
E01012841,1603,738,865,0.46038677479725515,0.5396132252027449
E01012844,1333,646,687,0.4846211552888222,0.5153788447111778
E01012849,1496,733,763,0.4899732620320856,0.5100267379679144
E01012895,1501,718,783,0.47834776815456365,0.5216522318454364
E01012897,1551,714,837,0.46034816247582205,0.539651837524178
E01012898,1380,625,755,0.4528985507246377,0.5471014492753623
E01012758,1588,811,777,0.510705289672544,0.4892947103274559
E01012762,1575,788,787,0.5003174603174603,0.4996825396825397
E01012763,2064,1170,894,0.5668604651162791,0.4331395348837209
E01012866,1576,830,746,0.5266497461928934,0.4733502538071066
E01012870,1683,837,846,0.49732620320855614,0.5026737967914439
E01012774,1549,765,784,0.49386701097482244,0.5061329890251776
E01012795,1937,930,1007,0.4801239029426949,0.5198760970573051
E01012797,1386,651,735,0.4696969696969697,0.5303030303030303
E01012798,1543,690,853,0.4471808165910564,0.5528191834089436
E01012801,1456,728,728,0.5,0.5
E01012816,1391,685,706,0.49245147375988496,0.507548526240115
E01012848,1828,1318,510,0.7210065645514223,0.2789934354485777
E01012894,1562,758,804,0.4852752880921895,0.5147247119078106
E01012896,2102,1015,1087,0.48287345385347286,0.5171265461465271
E01012901,1482,734,748,0.49527665317139,0.50472334682861
E01012842,1523,720,803,0.4727511490479317,0.5272488509520683
E01012843,1543,717,826,0.4646791963707064,0.5353208036292936
E01012845,1572,763,809,0.48536895674300257,0.5146310432569975
E01012846,1437,693,744,0.4822546972860125,0.5177453027139874
E01012847,1298,626,672,0.48228043143297383,0.5177195685670262
E01012820,1430,723,707,0.5055944055944056,0.4944055944055944
E01012899,1530,747,783,0.48823529411764705,0.5117647058823529
E01012900,1646,835,811,0.5072904009720535,0.49270959902794653
E01012902,1586,806,780,0.5081967213114754,0.4918032786885246
E01012903,1724,847,877,0.49129930394431554,0.5087006960556845
E01012796,1310,638,672,0.4870229007633588,0.5129770992366413
E01012799,1253,609,644,0.4860335195530726,0.5139664804469274
E01012800,1499,757,742,0.505003335557038,0.494996664442962
E01012802,1403,689,714,0.49109052031361367,0.5089094796863863
E01012803,1440,702,738,0.4875,0.5125
E01012850,1917,1120,797,0.584246218049035,0.4157537819509651
E01012852,1693,912,781,0.5386887182516243,0.46131128174837566
E01012856,1599,835,764,0.5222013758599124,0.47779862414008756
E01012857,1607,858,749,0.5339141257000622,0.46608587429993775
E01012867,1648,847,801,0.5139563106796117,0.48604368932038833
E01012756,1532,741,791,0.48368146214099217,0.5163185378590078
E01012757,1551,822,729,0.5299806576402321,0.4700193423597679
E01012759,1649,836,813,0.5069739235900546,0.49302607640994545
E01012760,1510,777,733,0.5145695364238411,0.48543046357615893
E01012862,1339,668,671,0.4988797610156833,0.5011202389843167
E01012805,1369,721,648,0.5266617969320672,0.4733382030679328
E01012808,1679,850,829,0.5062537224538416,0.4937462775461584
E01012809,1803,976,827,0.5413200221852468,0.45867997781475317
E01012810,1893,954,939,0.5039619651347068,0.4960380348652932
E01012811,1676,925,751,0.551909307875895,0.448090692124105
E01012773,1703,842,861,0.4944216089254257,0.5055783910745743
E01012776,1453,686,767,0.47212663454920856,0.5278733654507914
E01012863,1449,735,714,0.5072463768115942,0.4927536231884058
E01012864,1688,939,749,0.5562796208530806,0.4437203791469194
E01012865,1399,708,691,0.5060757684060043,0.49392423159399573
E01012770,1499,750,749,0.5003335557038026,0.49966644429619744
E01012771,1536,758,778,0.4934895833333333,0.5065104166666666
E01012772,1466,724,742,0.49386084583901774,0.5061391541609823
E01012775,1452,706,746,0.48622589531680444,0.5137741046831956
E01012777,1462,695,767,0.47537619699042405,0.5246238030095759
E01012851,2333,1381,952,0.591941705957994,0.408058294042006
E01012854,2144,1296,848,0.6044776119402985,0.39552238805970147
E01012855,1774,986,788,0.5558060879368658,0.44419391206313413
E01033104,1314,761,553,0.5791476407914764,0.4208523592085236
E01033109,1306,812,494,0.6217457886676876,0.3782542113323124
E01012859,1498,764,734,0.5100133511348465,0.48998664886515353
E01012889,1391,680,711,0.4888569374550683,0.5111430625449317
E01012891,2181,1232,949,0.5648784961027051,0.4351215038972948
E01012892,1928,975,953,0.5057053941908713,0.49429460580912865
E01012893,1513,709,804,0.46860541969596825,0.5313945803040317
E01012858,1756,835,921,0.4755125284738041,0.5244874715261959
E01012860,1622,793,829,0.48890258939580766,0.5110974106041923
E01012886,1584,780,804,0.49242424242424243,0.5075757575757576
E01012888,1489,755,734,0.5070517125587642,0.49294828744123576
E01033110,1502,736,766,0.49001331557922767,0.5099866844207723
E01012882,1617,786,831,0.48608534322820035,0.5139146567717996
E01012883,1487,688,799,0.46267652992602554,0.5373234700739744
E01012884,1839,849,990,0.46166394779771613,0.5383360522022839
E01012887,1460,740,720,0.5068493150684932,0.4931506849315068
E01032595,1817,876,941,0.48211337369290036,0.5178866263070996
E01013174,1462,660,802,0.45143638850889195,0.5485636114911081
E01013175,1380,699,681,0.5065217391304347,0.4934782608695652
E01013176,1403,693,710,0.49394155381325733,0.5060584461867427
E01013177,1588,800,788,0.5037783375314862,0.49622166246851385
E01013178,1472,723,749,0.49116847826086957,0.5088315217391305
E01013179,1516,730,786,0.4815303430079156,0.5184696569920845
E01013180,1452,725,727,0.49931129476584024,0.5006887052341598
E01013136,1484,806,678,0.5431266846361186,0.4568733153638814
E01013137,1476,856,620,0.5799457994579946,0.42005420054200543
E01013139,1217,597,620,0.4905505341002465,0.5094494658997535
E01013142,1717,845,872,0.49213744903902157,0.5078625509609784
E01013218,1407,714,693,0.5074626865671642,0.4925373134328358
E01013219,1407,653,754,0.4641080312722104,0.5358919687277897
E01013220,1636,801,835,0.4896088019559902,0.5103911980440098
E01013221,1744,909,835,0.5212155963302753,0.47878440366972475
E01013222,1560,765,795,0.49038461538461536,0.5096153846153846
E01013144,1463,720,743,0.49213943950786054,0.5078605604921395
E01013145,1302,634,668,0.4869431643625192,0.5130568356374808
E01013146,1742,859,883,0.4931113662456946,0.5068886337543054
E01013148,1439,737,702,0.5121612230715775,0.48783877692842254
E01013195,1448,705,743,0.48687845303867405,0.513121546961326
E01013196,1415,695,720,0.4911660777385159,0.508833922261484
E01013201,1540,783,757,0.5084415584415585,0.4915584415584416
E01013202,1543,765,778,0.4957874270900843,0.5042125729099157
E01013203,1653,859,794,0.5196612220205686,0.48033877797943136
E01013138,1382,705,677,0.5101302460202605,0.48986975397973953
E01013140,1555,746,809,0.4797427652733119,0.5202572347266881
E01013141,1628,803,825,0.49324324324324326,0.5067567567567568
E01013143,1376,661,715,0.4803779069767442,0.5196220930232558
E01013173,1234,593,641,0.4805510534846029,0.5194489465153971
E01013223,2940,1456,1484,0.49523809523809526,0.5047619047619047
E01013224,1883,931,952,0.4944237918215613,0.5055762081784386
E01013226,1531,772,759,0.504245591116917,0.495754408883083
E01013187,1405,707,698,0.503202846975089,0.496797153024911
E01013188,1568,780,788,0.49744897959183676,0.5025510204081632
E01013231,1635,779,856,0.4764525993883792,0.5235474006116208
E01013233,1444,699,745,0.4840720221606648,0.5159279778393352
E01013147,1406,662,744,0.47083926031294454,0.5291607396870555
E01013234,1443,654,789,0.45322245322245325,0.5467775467775468
E01033414,2297,1105,1192,0.4810622551153679,0.5189377448846322
E01013128,1449,718,731,0.49551414768806074,0.5044858523119393
E01013198,1439,694,745,0.48227936066712995,0.51772063933287
E01013199,1187,587,600,0.4945240101095198,0.5054759898904801
E01013200,1279,637,642,0.4980453479280688,0.5019546520719312
E01013159,1489,779,710,0.5231699126930826,0.4768300873069174
E01013161,1429,716,713,0.5010496850944717,0.4989503149055283
E01013162,1608,857,751,0.5329601990049752,0.4670398009950249
E01013165,1346,699,647,0.5193164933135216,0.48068350668647847
E01013158,1465,709,756,0.48395904436860065,0.5160409556313993
E01013160,1483,740,743,0.4989885367498314,0.5010114632501685
E01013163,1324,679,645,0.5128398791540786,0.4871601208459215
E01013164,1869,895,974,0.47886570358480474,0.5211342964151953
E01013197,1285,621,664,0.4832684824902724,0.5167315175097277
E01013149,1152,568,584,0.4930555555555556,0.5069444444444444
E01013150,1324,646,678,0.4879154078549849,0.5120845921450151
E01013227,1618,767,851,0.47404202719406674,0.5259579728059333
E01013228,1573,783,790,0.49777495232040686,0.5022250476795931
E01013229,1494,729,765,0.4879518072289157,0.5120481927710844
E01013131,1529,715,814,0.4676258992805755,0.5323741007194245
E01013132,1465,731,734,0.49897610921501706,0.5010238907849829
E01013133,1530,727,803,0.47516339869281043,0.5248366013071896
E01013134,1450,659,791,0.45448275862068965,0.5455172413793103
E01013206,1351,640,711,0.47372316802368614,0.5262768319763138
E01013207,1345,639,706,0.475092936802974,0.5249070631970261
E01013211,1512,739,773,0.4887566137566138,0.5112433862433863
E01013212,1396,677,719,0.48495702005730656,0.5150429799426934
E01013181,1541,790,751,0.5126541207008436,0.4873458792991564
E01013182,1532,744,788,0.4856396866840731,0.5143603133159269
E01013183,1560,780,780,0.5,0.5
E01013184,1573,806,767,0.512396694214876,0.48760330578512395
E01013185,1616,780,836,0.48267326732673266,0.5173267326732673
E01013186,1378,673,705,0.488388969521045,0.511611030478955
E01013129,1533,790,743,0.5153294194390085,0.4846705805609915
E01013151,1262,617,645,0.4889064976228209,0.5110935023771791
E01013152,1505,739,766,0.49102990033222593,0.5089700996677741
E01013155,1393,672,721,0.4824120603015075,0.5175879396984925
E01013130,1375,653,722,0.4749090909090909,0.525090909090909
E01013135,1439,675,764,0.46907574704656013,0.5309242529534399
E01013154,1396,702,694,0.502865329512894,0.497134670487106
E01013156,1250,542,708,0.4336,0.5664
E01013204,1415,675,740,0.47703180212014135,0.5229681978798587
E01013205,1362,636,726,0.4669603524229075,0.5330396475770925
E01013208,1418,670,748,0.47249647390691113,0.5275035260930888
E01013209,1483,729,754,0.4915711395819285,0.5084288604180714
E01013210,1446,684,762,0.4730290456431535,0.5269709543568465
E01013153,1332,631,701,0.47372372372372373,0.5262762762762763
E01013157,1864,877,987,0.47049356223175964,0.5295064377682404
E01013166,1589,766,823,0.48206419131529266,0.5179358086847073
E01013167,1787,904,883,0.5058757694459989,0.4941242305540011
E01013169,1049,498,551,0.4747378455672069,0.5252621544327931
E01013189,1480,712,768,0.4810810810810811,0.518918918918919
E01013190,2822,1387,1435,0.49149539333805814,0.5085046066619419
E01013191,1584,758,826,0.47853535353535354,0.5214646464646465
E01013192,1485,724,761,0.48754208754208755,0.5124579124579125
E01013194,1461,690,771,0.4722792607802875,0.5277207392197125
E01013168,1658,829,829,0.5,0.5
E01013170,1508,721,787,0.4781167108753316,0.5218832891246684
E01013171,1776,894,882,0.5033783783783784,0.4966216216216216
E01013172,1481,702,779,0.47400405131667794,0.5259959486833221
E01013193,1576,768,808,0.4873096446700508,0.5126903553299492
E01013213,1225,552,673,0.4506122448979592,0.5493877551020409
E01013214,1441,710,731,0.49271339347675225,0.5072866065232478
E01013215,1608,765,843,0.47574626865671643,0.5242537313432836
E01013216,1301,639,662,0.49116064565718676,0.5088393543428132
E01013217,1442,727,715,0.5041608876560333,0.4958391123439667
E01013225,1086,499,587,0.4594843462246777,0.5405156537753223
E01013254,1706,818,888,0.4794841735052755,0.5205158264947245
E01013255,1678,802,876,0.47794994040524436,0.5220500595947557
E01013256,2479,1249,1230,0.5038321903993546,0.49616780960064544
E01013257,1788,886,902,0.4955257270693512,0.5044742729306487
E01013258,1699,825,874,0.4855797527957622,0.5144202472042377
E01013259,1716,800,916,0.4662004662004662,0.5337995337995338
E01013303,1292,660,632,0.5108359133126935,0.4891640866873065
E01013304,1614,806,808,0.4993804213135068,0.5006195786864932
E01013305,1636,829,807,0.5067237163814181,0.4932762836185819
E01013307,1740,841,899,0.48333333333333334,0.5166666666666667
E01013288,1579,808,771,0.5117162761241292,0.4882837238758708
E01013291,1595,780,815,0.4890282131661442,0.5109717868338558
E01013292,1725,845,880,0.48985507246376814,0.5101449275362319
E01013294,1552,780,772,0.5025773195876289,0.49742268041237114
E01013270,1929,934,995,0.48418869880767235,0.5158113011923277
E01013306,1544,762,782,0.49352331606217614,0.5064766839378239
E01013308,1742,865,877,0.4965556831228473,0.5034443168771527
E01013309,1586,765,821,0.4823455233291299,0.5176544766708702
E01013286,2329,1129,1200,0.48475740661227995,0.51524259338772
E01013287,1487,746,741,0.5016812373907196,0.49831876260928043
E01013289,1664,824,840,0.4951923076923077,0.5048076923076923
E01013290,1662,827,835,0.49759326113116725,0.5024067388688327
E01013293,1549,776,773,0.5009683666881859,0.49903163331181405
E01013245,1488,750,738,0.5040322580645161,0.4959677419354839
E01013246,1530,787,743,0.5143790849673202,0.48562091503267973
E01013247,1756,874,882,0.4977220956719818,0.5022779043280182
E01013248,1779,904,875,0.508150646430579,0.491849353569421
E01013249,1735,872,863,0.5025936599423632,0.4974063400576369
E01013297,2193,1112,1081,0.5070679434564523,0.49293205654354766
E01013300,1707,887,820,0.5196250732278852,0.4803749267721148
E01013302,1465,753,712,0.5139931740614334,0.48600682593856653
E01013331,1673,864,809,0.5164375373580394,0.48356246264196057
E01013296,1655,876,779,0.5293051359516616,0.4706948640483384
E01013298,1605,798,807,0.497196261682243,0.502803738317757
E01013299,1640,798,842,0.4865853658536585,0.5134146341463415
E01013330,1745,914,831,0.52378223495702,0.47621776504297997
E01013332,1877,963,914,0.5130527437400106,0.48694725625998936
E01013295,1385,680,705,0.49097472924187724,0.5090252707581228
E01013301,1616,794,822,0.49133663366336633,0.5086633663366337
E01013333,1631,853,778,0.5229920294297977,0.47700797057020233
E01013334,1556,778,778,0.5,0.5
E01013310,1481,717,764,0.4841323430114787,0.5158676569885212
E01013312,1798,867,931,0.482202447163515,0.517797552836485
E01013313,1554,766,788,0.4929214929214929,0.5070785070785071
E01013314,1516,776,740,0.5118733509234829,0.48812664907651715
E01013267,1253,624,629,0.4980047885075818,0.5019952114924182
E01013268,1262,600,662,0.4754358161648177,0.5245641838351822
E01013269,1752,886,866,0.5057077625570776,0.4942922374429224
E01013271,1923,927,996,0.48205928237129486,0.5179407176287052
E01013272,1675,841,834,0.502089552238806,0.49791044776119403
E01013273,1745,842,903,0.4825214899713467,0.5174785100286533
E01013279,1474,706,768,0.4789687924016282,0.5210312075983717
E01013285,1262,633,629,0.5015847860538827,0.49841521394611726
E01013316,1456,735,721,0.5048076923076923,0.4951923076923077
E01013321,1684,827,857,0.4910926365795725,0.5089073634204275
E01013274,2116,1031,1085,0.4872400756143667,0.5127599243856332
E01013275,1563,767,796,0.490722968650032,0.509277031349968
E01013276,1628,796,832,0.48894348894348894,0.5110565110565111
E01013277,1486,716,770,0.48183041722745623,0.5181695827725438
E01013315,1520,688,832,0.45263157894736844,0.5473684210526316
E01013317,1407,673,734,0.4783226723525231,0.5216773276474769
E01013318,1537,743,794,0.483409238776838,0.516590761223162
E01013319,2243,1138,1105,0.507356219349086,0.49264378065091396
E01013238,1677,829,848,0.49433512224209897,0.505664877757901
E01013240,2356,1170,1186,0.4966044142614601,0.5033955857385399
E01013311,1852,901,951,0.4865010799136069,0.5134989200863931
E01013320,1494,758,736,0.5073627844712182,0.4926372155287818
E01013278,1500,737,763,0.49133333333333334,0.5086666666666667
E01013280,1462,703,759,0.48084815321477425,0.5191518467852257
E01013281,1375,652,723,0.4741818181818182,0.5258181818181819
E01013283,1483,723,760,0.4875252865812542,0.5124747134187457
E01013236,1557,738,819,0.47398843930635837,0.5260115606936416
E01013239,1623,792,831,0.4879852125693161,0.512014787430684
E01013282,1587,778,809,0.4902331442974165,0.5097668557025835
E01013284,1606,772,834,0.4806973848069738,0.5193026151930261
E01013237,1802,832,970,0.46170921198668147,0.5382907880133185
E01013261,1458,712,746,0.4883401920438957,0.5116598079561042
E01013262,1358,683,675,0.5029455081001473,0.49705449189985274
E01013263,1434,695,739,0.48465829846582986,0.5153417015341701
E01033296,1439,702,737,0.48783877692842254,0.5121612230715775
E01033297,1669,844,825,0.5056920311563811,0.49430796884361894
E01013260,1477,722,755,0.4888287068381855,0.5111712931618145
E01013264,1729,859,870,0.496818970503181,0.503181029496819
E01013265,1648,818,830,0.4963592233009709,0.5036407766990292
E01013266,1934,925,1009,0.4782833505687694,0.5217166494312306
E01013241,1520,724,796,0.4763157894736842,0.5236842105263158
E01013242,1770,902,868,0.5096045197740113,0.4903954802259887
E01013243,2147,1026,1121,0.4778761061946903,0.5221238938053098
E01013244,1810,891,919,0.4922651933701657,0.5077348066298343
E01013324,1553,783,770,0.5041854475209272,0.49581455247907275
E01013326,1586,782,804,0.4930643127364439,0.5069356872635561
E01013327,1409,680,729,0.48261178140525196,0.517388218594748
E01013328,1293,611,682,0.4725444702242846,0.5274555297757154
E01013322,1940,948,992,0.488659793814433,0.511340206185567
E01013323,1691,861,830,0.5091661738616203,0.49083382613837967
E01013325,1564,784,780,0.5012787723785166,0.49872122762148335
E01013329,1819,887,932,0.4876305662451897,0.5123694337548104
E01013250,1618,768,850,0.4746600741656366,0.5253399258343634
E01013251,1816,887,929,0.4884361233480176,0.5115638766519823
E01013252,1761,862,899,0.4894946053378762,0.5105053946621237
E01013253,1967,969,998,0.4926283680732079,0.507371631926792
E01013436,1762,863,899,0.4897843359818388,0.5102156640181612
E01013438,1790,854,936,0.4770949720670391,0.5229050279329609
E01013439,1515,737,778,0.4864686468646865,0.5135313531353135
E01013440,1856,896,960,0.4827586206896552,0.5172413793103449
E01013370,1501,686,815,0.4570286475682878,0.5429713524317122
E01013373,1480,702,778,0.4743243243243243,0.5256756756756756
E01013375,1308,592,716,0.4525993883792049,0.5474006116207951
E01013376,1467,701,766,0.4778459441036128,0.5221540558963872
E01013371,1465,716,749,0.4887372013651877,0.5112627986348123
E01013372,1608,691,917,0.42972636815920395,0.570273631840796
E01013374,1557,766,791,0.4919717405266538,0.5080282594733462
E01013377,1652,770,882,0.4661016949152542,0.5338983050847458
E01013404,1452,693,759,0.4772727272727273,0.5227272727272727
E01013407,1441,645,796,0.4476058292852186,0.5523941707147814
E01013408,1329,622,707,0.4680210684725357,0.5319789315274642
E01013410,1431,637,794,0.4451432564640112,0.5548567435359888
E01013405,1404,669,735,0.47649572649572647,0.5235042735042735
E01013406,1959,959,1000,0.4895354772843287,0.5104645227156712
E01013409,1566,743,823,0.47445721583652617,0.5255427841634738
E01013411,1526,721,805,0.4724770642201835,0.5275229357798165
E01013428,1638,809,829,0.4938949938949939,0.5061050061050061
E01013429,2065,1035,1030,0.5012106537530266,0.49878934624697335
E01013430,1549,762,787,0.4919302775984506,0.5080697224015494
E01013431,1556,755,801,0.4852185089974293,0.5147814910025706
E01013435,1466,714,752,0.4870395634379263,0.5129604365620737
E01013344,1597,818,779,0.5122103944896681,0.48778960551033185
E01013346,1651,806,845,0.4881889763779528,0.5118110236220472
E01013432,2109,987,1122,0.46799431009957326,0.5320056899004267
E01013433,1461,701,760,0.4798083504449008,0.5201916495550992
E01013434,1462,720,742,0.49247606019151846,0.5075239398084815
E01013379,1476,708,768,0.4796747967479675,0.5203252032520326
E01013380,1771,883,888,0.49858836815358554,0.5014116318464145
E01013385,1459,715,744,0.4900616860863605,0.5099383139136395
E01013387,1477,705,772,0.47731888964116453,0.5226811103588355
E01013388,1033,497,536,0.48112294288480156,0.5188770571151985
E01013389,1158,578,580,0.4991364421416235,0.5008635578583766
E01013437,1214,625,589,0.514827018121911,0.48517298187808894
E01013343,2005,943,1062,0.47032418952618454,0.5296758104738155
E01013345,1720,818,902,0.4755813953488372,0.5244186046511627
E01013347,1637,799,838,0.48808796579108127,0.5119120342089187
E01013349,1387,686,701,0.494592645998558,0.505407354001442
E01013350,1638,786,852,0.47985347985347987,0.5201465201465202
E01013348,1913,893,1020,0.46680606377417666,0.5331939362258233
E01013368,2246,1079,1167,0.4804096170970614,0.5195903829029386
E01013382,1656,786,870,0.4746376811594203,0.5253623188405797
E01013383,2298,1170,1128,0.5091383812010444,0.4908616187989556
E01013386,1772,836,936,0.4717832957110609,0.5282167042889391
E01013421,1548,703,845,0.4541343669250646,0.5458656330749354
E01013422,1686,801,885,0.4750889679715303,0.5249110320284698
E01013426,1669,788,881,0.4721390053924506,0.5278609946075494
E01013427,1442,698,744,0.4840499306518724,0.5159500693481276
E01013335,1582,730,852,0.461441213653603,0.538558786346397
E01013336,1470,744,726,0.5061224489795918,0.49387755102040815
E01013337,1650,812,838,0.4921212121212121,0.5078787878787879
E01013338,2307,1146,1161,0.4967490247074122,0.5032509752925878
E01013339,1595,782,813,0.490282131661442,0.509717868338558
E01013392,1560,815,745,0.5224358974358975,0.4775641025641026
E01013366,1992,1086,906,0.5451807228915663,0.45481927710843373
E01013369,1863,929,934,0.4986580783682233,0.5013419216317767
E01013416,1564,754,810,0.4820971867007673,0.5179028132992327
E01033067,1363,691,672,0.5069699192956714,0.4930300807043287
E01033068,1144,613,531,0.5358391608391608,0.46416083916083917
E01033069,1158,602,556,0.5198618307426598,0.48013816925734026
E01033070,1538,760,778,0.494148244473342,0.505851755526658
E01013381,1544,770,774,0.49870466321243523,0.5012953367875648
E01013402,1758,873,885,0.49658703071672355,0.5034129692832765
E01013419,1532,704,828,0.4595300261096606,0.5404699738903395
E01013420,2038,1011,1027,0.49607458292443574,0.5039254170755643
E01013384,1749,868,881,0.49628359062321326,0.5037164093767867
E01013398,1625,787,838,0.48430769230769233,0.5156923076923077
E01013399,1774,846,928,0.4768883878241263,0.5231116121758738
E01013400,1936,1018,918,0.5258264462809917,0.47417355371900827
E01013401,1697,898,799,0.5291691219799647,0.47083087802003537
E01013403,1887,951,936,0.5039745627980922,0.4960254372019078
E01013393,1599,759,840,0.474671669793621,0.525328330206379
E01013394,1312,623,689,0.47484756097560976,0.5251524390243902
E01013395,1450,733,717,0.5055172413793103,0.49448275862068963
E01013396,1644,769,875,0.4677615571776156,0.5322384428223844
E01013441,1532,717,815,0.4680156657963446,0.5319843342036553
E01013445,1538,725,813,0.47139141742522755,0.5286085825747724
E01013390,1573,774,799,0.49205340114431023,0.5079465988556897
E01013391,2198,1124,1074,0.5113739763421292,0.4886260236578708
E01013397,1496,744,752,0.49732620320855614,0.5026737967914439
E01013413,1676,843,833,0.502983293556086,0.4970167064439141
E01013417,1978,975,1003,0.4929221435793731,0.5070778564206269
E01013442,1379,644,735,0.467005076142132,0.5329949238578681
E01013443,1536,731,805,0.4759114583333333,0.5240885416666666
E01013444,1413,662,751,0.46850672328379334,0.5314932767162066
E01013446,1660,799,861,0.48132530120481926,0.5186746987951807
E01013447,1499,710,789,0.47364909939959976,0.5263509006004002
E01013448,1375,700,675,0.509090909090909,0.4909090909090909
E01013360,1848,892,956,0.48268398268398266,0.5173160173160173
E01013361,1894,940,954,0.4963041182682154,0.5036958817317846
E01013362,1977,1098,879,0.5553869499241275,0.44461305007587254
E01013363,2094,1031,1063,0.4923591212989494,0.5076408787010506
E01013364,2031,1053,978,0.518463810930576,0.4815361890694239
E01013418,1555,737,818,0.4739549839228296,0.5260450160771705
E01013351,1907,917,990,0.480859989512323,0.519140010487677
E01013352,1720,836,884,0.48604651162790696,0.513953488372093
E01013451,1239,602,637,0.4858757062146893,0.5141242937853108
E01013452,1674,784,890,0.46833930704898447,0.5316606929510155
E01013357,2024,953,1071,0.4708498023715415,0.5291501976284585
E01013358,1574,773,801,0.49110546378653114,0.5088945362134689
E01013412,1780,857,923,0.48146067415730337,0.5185393258426966
E01013414,1661,810,851,0.4876580373269115,0.5123419626730885
E01013353,1597,766,831,0.4796493425172198,0.5203506574827802
E01013354,1414,688,726,0.48656294200848654,0.5134370579915134
E01013355,1476,704,772,0.47696476964769646,0.5230352303523035
E01013356,1452,709,743,0.48829201101928377,0.5117079889807162
E01013359,1547,757,790,0.48933419521654814,0.5106658047834518
E01013449,1679,813,866,0.48421679571173315,0.5157832042882668
E01013365,2785,1311,1474,0.47073608617594254,0.5292639138240575
E01013378,4792,2185,2607,0.45596828046744575,0.5440317195325542
E01013450,1240,629,611,0.507258064516129,0.49274193548387096
E01013340,1274,634,640,0.4976452119309262,0.5023547880690737
E01013341,1272,578,694,0.45440251572327045,0.5455974842767296
E01013342,1360,666,694,0.48970588235294116,0.5102941176470588
E01013423,1285,640,645,0.4980544747081712,0.5019455252918288
E01013424,1335,665,670,0.49812734082397003,0.50187265917603
E01013425,1553,737,816,0.4745653573728268,0.5254346426271732
E01027558,1881,918,963,0.4880382775119617,0.5119617224880383
E01027559,1725,863,862,0.5002898550724638,0.49971014492753624
E01027569,1334,651,683,0.48800599700149927,0.5119940029985007
E01027570,2474,1196,1278,0.4834276475343573,0.5165723524656427
E01027562,1641,838,803,0.5106642291285801,0.4893357708714199
E01027567,1611,748,863,0.4643078833022967,0.5356921166977033
E01027585,1874,906,968,0.4834578441835646,0.5165421558164355
E01027568,2168,1066,1102,0.49169741697416974,0.5083025830258303
E01027571,1929,965,964,0.5002592016588906,0.4997407983411094
E01027572,2012,986,1026,0.4900596421471173,0.5099403578528827
E01027573,1569,745,824,0.4748247291268324,0.5251752708731676
E01027557,1673,832,841,0.49731022115959356,0.5026897788404064
E01027561,1879,905,974,0.4816391697711549,0.5183608302288452
E01027576,1567,749,818,0.4779834077855775,0.5220165922144224
E01027574,1458,709,749,0.48628257887517146,0.5137174211248285
E01027575,1898,885,1013,0.46628029504741836,0.5337197049525817
E01027577,1918,934,984,0.4869655891553702,0.5130344108446299
E01027579,1132,529,603,0.4673144876325088,0.5326855123674912
E01027578,1517,726,791,0.47857613711272246,0.5214238628872775
E01027580,1122,535,587,0.4768270944741533,0.5231729055258467
E01027581,2500,1206,1294,0.4824,0.5176
E01027582,1511,730,781,0.4831237590999338,0.5168762409000662
E01027556,1690,835,855,0.4940828402366864,0.5059171597633136
E01027560,2355,1169,1186,0.49639065817409767,0.5036093418259023
E01027563,1396,641,755,0.45916905444126077,0.5408309455587392
E01027586,1934,933,1001,0.4824198552223371,0.5175801447776629
E01027555,1947,920,1027,0.47252182845403184,0.5274781715459682
E01027564,1211,542,669,0.4475639966969447,0.5524360033030553
E01027565,1530,720,810,0.47058823529411764,0.5294117647058824
E01027566,1239,604,635,0.48748991121872476,0.5125100887812752
E01027583,2098,974,1124,0.4642516682554814,0.5357483317445186
E01027584,1616,794,822,0.49133663366336633,0.5086633663366337
E01027591,1669,828,841,0.49610545236668663,0.5038945476333133
E01027597,1568,791,777,0.5044642857142857,0.4955357142857143
E01027599,1653,791,862,0.4785238959467635,0.5214761040532365
E01027623,1297,597,700,0.4602929838087895,0.5397070161912105
E01027625,1651,761,890,0.4609327680193822,0.5390672319806178
E01027598,1752,850,902,0.4851598173515982,0.5148401826484018
E01027618,2421,1187,1234,0.4902932672449401,0.5097067327550598
E01027624,1269,615,654,0.4846335697399527,0.5153664302600472
E01027626,1320,630,690,0.4772727272727273,0.5227272727272727
E01027627,1820,919,901,0.5049450549450549,0.4950549450549451
E01027590,2055,1015,1040,0.49391727493917276,0.5060827250608273
E01027592,1744,888,856,0.5091743119266054,0.4908256880733945
E01027613,1764,887,877,0.5028344671201814,0.4971655328798186
E01027617,1100,560,540,0.509090909090909,0.4909090909090909
E01027605,1632,810,822,0.4963235294117647,0.5036764705882353
E01027606,1522,708,814,0.4651773981603154,0.5348226018396847
E01027608,1822,999,823,0.5482985729967069,0.4517014270032931
E01027609,1342,642,700,0.4783904619970194,0.5216095380029806
E01027610,1685,802,883,0.47596439169139465,0.5240356083086053
E01027611,1953,926,1027,0.47414234511008707,0.525857654889913
E01027612,1693,817,876,0.4825753101004135,0.5174246898995866
E01027616,1434,669,765,0.4665271966527197,0.5334728033472803
E01027603,1966,967,999,0.4918616480162767,0.5081383519837233
E01027604,1761,848,913,0.48154457694491765,0.5184554230550823
E01027607,1237,603,634,0.4874696847210994,0.5125303152789006
E01027614,1236,583,653,0.4716828478964401,0.5283171521035599
E01027615,1276,626,650,0.49059561128526646,0.5094043887147336
E01027587,1358,652,706,0.4801178203240059,0.5198821796759941
E01027588,1570,744,826,0.47388535031847134,0.5261146496815287
E01027589,1673,829,844,0.4955170352659892,0.5044829647340108
E01027593,1728,864,864,0.5,0.5
E01027628,1865,921,944,0.4938337801608579,0.5061662198391421
E01027633,1852,898,954,0.48488120950323976,0.5151187904967602
E01033065,1199,602,597,0.5020850708924104,0.49791492910758967
E01033066,2301,1426,875,0.6197305519339418,0.3802694480660582
E01027620,1979,940,1039,0.4749873673572511,0.5250126326427489
E01027630,1740,842,898,0.4839080459770115,0.5160919540229885
E01027631,1386,692,694,0.49927849927849927,0.5007215007215007
E01027632,1484,740,744,0.49865229110512127,0.5013477088948787
E01027637,1863,903,960,0.48470209339774556,0.5152979066022544
E01027621,2270,1107,1163,0.48766519823788546,0.5123348017621145
E01027629,1378,655,723,0.4753265602322206,0.5246734397677794
E01027635,2604,1445,1159,0.554915514592934,0.4450844854070661
E01027636,2078,1018,1060,0.4898941289701636,0.5101058710298364
E01027594,1499,677,822,0.45163442294863243,0.5483655770513676
E01027595,1620,748,872,0.4617283950617284,0.5382716049382716
E01027596,1508,695,813,0.4608753315649867,0.5391246684350133
E01027601,1940,941,999,0.4850515463917526,0.5149484536082474
E01027622,1919,931,988,0.48514851485148514,0.5148514851485149
E01027600,1922,987,935,0.5135275754422477,0.48647242455775236
E01027619,2672,1384,1288,0.5179640718562875,0.4820359281437126
E01027634,2090,1022,1068,0.48899521531100476,0.5110047846889952
E01027666,1715,833,882,0.4857142857142857,0.5142857142857142
E01027667,1394,690,704,0.4949784791965567,0.5050215208034433
E01027685,1205,558,647,0.46307053941908716,0.5369294605809128
E01027686,1145,577,568,0.5039301310043668,0.4960698689956332
E01027712,1748,1047,701,0.5989702517162472,0.4010297482837529
E01027713,1686,809,877,0.47983392645314354,0.5201660735468565
E01027714,1657,808,849,0.4876282438141219,0.512371756185878
E01027715,1196,594,602,0.49665551839464883,0.5033444816053512
E01027643,1449,725,724,0.5003450655624568,0.4996549344375431
E01027688,1590,742,848,0.4666666666666667,0.5333333333333333
E01027736,1638,765,873,0.46703296703296704,0.532967032967033
E01027737,1841,1031,810,0.5600217273221075,0.43997827267789247
E01027705,1668,843,825,0.5053956834532374,0.49460431654676257
E01027706,1943,951,992,0.4894493051981472,0.5105506948018528
E01027707,1751,863,888,0.49286122215876643,0.5071387778412336
E01027708,1430,692,738,0.48391608391608393,0.5160839160839161
E01027709,1207,603,604,0.4995857497928749,0.5004142502071252
E01027710,1120,527,593,0.4705357142857143,0.5294642857142857
E01027711,1296,644,652,0.49691358024691357,0.5030864197530864
E01027644,1511,722,789,0.47782925215089345,0.5221707478491066
E01027645,1593,762,831,0.4783427495291902,0.5216572504708098
E01027647,1609,796,813,0.4947172156619018,0.5052827843380981
E01027687,1498,759,739,0.5066755674232309,0.493324432576769
E01027681,1607,796,811,0.4953329184816428,0.5046670815183572
E01027693,1793,881,912,0.4913552704963748,0.5086447295036252
E01027701,1576,787,789,0.4993654822335025,0.5006345177664975
E01027702,1142,541,601,0.47373029772329245,0.5262697022767076
E01027642,1393,681,712,0.48887293610911703,0.511127063890883
E01027646,1546,733,813,0.4741267787839586,0.5258732212160414
E01027674,1398,679,719,0.48569384835479257,0.5143061516452074
E01027675,2395,1189,1206,0.4964509394572025,0.5035490605427975
E01027641,1297,656,641,0.5057825751734772,0.49421742482652276
E01027664,2169,1052,1117,0.4850161364684186,0.5149838635315813
E01027665,1137,565,572,0.4969217238346526,0.5030782761653474
E01027722,1425,692,733,0.4856140350877193,0.5143859649122807
E01027668,1539,722,817,0.4691358024691358,0.5308641975308642
E01027669,1847,906,941,0.49052517596101786,0.5094748240389821
E01027673,1754,854,900,0.4868871151653364,0.5131128848346637
E01027676,1762,869,893,0.4931895573212259,0.5068104426787742
E01027638,1339,668,671,0.4988797610156833,0.5011202389843167
E01027639,1284,615,669,0.47897196261682246,0.5210280373831776
E01027640,1489,713,776,0.4788448623237072,0.5211551376762928
E01027690,1424,676,748,0.4747191011235955,0.5252808988764045
E01027738,1321,651,670,0.4928084784254353,0.5071915215745647
E01027739,1100,546,554,0.49636363636363634,0.5036363636363637
E01027741,1369,652,717,0.4762600438276114,0.5237399561723886
E01027689,1392,678,714,0.4870689655172414,0.5129310344827587
E01027691,1494,724,770,0.48460508701472554,0.5153949129852744
E01027720,1480,738,742,0.49864864864864866,0.5013513513513513
E01027721,1507,731,776,0.48506967485069674,0.5149303251493033
E01027723,1490,726,764,0.487248322147651,0.512751677852349
E01027670,1627,802,825,0.4929317762753534,0.5070682237246465
E01027671,1570,760,810,0.4840764331210191,0.5159235668789809
E01027672,1782,851,931,0.4775533108866442,0.5224466891133558
E01027704,1171,578,593,0.4935952177625961,0.5064047822374039
E01027649,1754,849,905,0.48403648802736604,0.515963511972634
E01027651,1519,708,811,0.4660961158657011,0.5339038841342989
E01027657,1260,656,604,0.5206349206349207,0.4793650793650794
E01027658,1566,758,808,0.4840357598978289,0.5159642401021711
E01027692,1176,577,599,0.4906462585034014,0.5093537414965986
E01027740,1556,733,823,0.47107969151670953,0.5289203084832905
E01027648,1606,783,823,0.487546699875467,0.512453300124533
E01027650,1538,727,811,0.4726918075422627,0.5273081924577373
E01027726,1749,850,899,0.48599199542595767,0.5140080045740423
E01027727,1558,757,801,0.4858793324775353,0.5141206675224647
E01027728,1343,628,715,0.4676098287416232,0.5323901712583767
E01027729,1576,751,825,0.47652284263959394,0.5234771573604061
E01027652,1585,742,843,0.46813880126182966,0.5318611987381704
E01027655,1483,638,845,0.43020903573836816,0.5697909642616318
E01027659,1786,955,831,0.5347144456886898,0.4652855543113102
E01027677,1429,722,707,0.5052484254723583,0.4947515745276417
E01027678,1697,910,787,0.5362404242781379,0.4637595757218621
E01027680,1307,639,668,0.4889058913542464,0.5110941086457537
E01027683,1457,717,740,0.4921070693205216,0.5078929306794784
E01027684,1431,721,710,0.5038434661076171,0.49615653389238296
E01027695,1686,826,860,0.48991696322657174,0.5100830367734283
E01027696,1989,1037,952,0.5213675213675214,0.47863247863247865
E01027703,1844,873,971,0.4734273318872017,0.5265726681127982
E01027660,1537,744,793,0.4840598568640208,0.5159401431359791
E01027661,1438,684,754,0.4756606397774687,0.5243393602225312
E01027662,1262,611,651,0.48415213946117275,0.5158478605388273
E01027663,1359,635,724,0.4672553348050037,0.5327446651949963
E01027697,1454,711,743,0.4889958734525447,0.5110041265474553
E01027733,1415,667,748,0.4713780918727915,0.5286219081272084
E01027682,1639,797,842,0.4862721171446004,0.5137278828553996
E01027694,1332,662,670,0.496996996996997,0.503003003003003
E01027734,1549,767,782,0.49515816655907036,0.5048418334409296
E01027735,1649,834,815,0.5057610673135233,0.4942389326864767
E01027656,1652,803,849,0.4860774818401937,0.5139225181598063
E01027679,1595,733,862,0.45956112852664577,0.5404388714733542
E01027730,1533,756,777,0.4931506849315068,0.5068493150684932
E01027731,1459,675,784,0.46264564770390676,0.5373543522960932
E01027732,1342,634,708,0.47242921013412814,0.5275707898658718
E01027653,1454,647,807,0.4449793672627235,0.5550206327372765
E01027654,1228,580,648,0.4723127035830619,0.5276872964169381
E01027698,1561,747,814,0.478539397821909,0.521460602178091
E01027716,1437,680,757,0.4732080723729993,0.5267919276270007
E01027717,1560,734,826,0.4705128205128205,0.5294871794871795
E01027718,1886,871,1015,0.4618239660657476,0.5381760339342524
E01027719,1477,721,756,0.4881516587677725,0.5118483412322274
E01027699,1362,653,709,0.47944199706314244,0.5205580029368576
E01027700,1185,585,600,0.4936708860759494,0.5063291139240507
E01027724,1595,794,801,0.49780564263322885,0.5021943573667712
E01027725,1505,702,803,0.4664451827242525,0.5335548172757475
E01027743,1224,602,622,0.4918300653594771,0.5081699346405228
E01027751,1272,635,637,0.4992138364779874,0.5007861635220126
E01027752,1184,596,588,0.5033783783783784,0.4966216216216216
E01027759,1406,682,724,0.4850640113798009,0.5149359886201992
E01027761,1183,574,609,0.48520710059171596,0.514792899408284
E01027762,1309,667,642,0.5095492742551566,0.4904507257448434
E01027765,1613,766,847,0.47489150650960943,0.5251084934903906
E01027766,1220,577,643,0.47295081967213115,0.5270491803278688
E01027767,1515,718,797,0.4739273927392739,0.526072607260726
E01027768,1166,558,608,0.47855917667238423,0.5214408233276158
E01027769,1293,627,666,0.48491879350348027,0.5150812064965197
E01027770,1606,793,813,0.4937733499377335,0.5062266500622665
E01027745,1662,802,860,0.4825511432009627,0.5174488567990373
E01027746,1412,689,723,0.48796033994334276,0.5120396600566572
E01027747,1979,1267,712,0.64022233451238,0.35977766548762
E01027748,1176,564,612,0.47959183673469385,0.5204081632653061
E01027749,1983,960,1023,0.48411497730711045,0.5158850226928896
E01027750,2877,1554,1323,0.5401459854014599,0.45985401459854014
E01027754,1382,707,675,0.5115774240231549,0.48842257597684513
E01027771,3508,2624,884,0.7480045610034207,0.2519954389965792
E01027772,1302,652,650,0.500768049155146,0.49923195084485406
E01033183,1600,827,773,0.516875,0.483125
E01033184,2628,1798,830,0.6841704718417048,0.3158295281582953
E01027742,1328,654,674,0.4924698795180723,0.5075301204819277
E01027753,1347,670,677,0.4974016332590943,0.5025983667409057
E01027763,1135,563,572,0.4960352422907489,0.5039647577092511
E01027764,1230,599,631,0.4869918699186992,0.5130081300813009
E01027773,1075,547,528,0.5088372093023256,0.49116279069767443
E01027744,1269,613,656,0.4830575256107171,0.5169424743892829
E01027756,1766,864,902,0.48924122310305773,0.5107587768969423
E01027758,1477,804,673,0.5443466486120515,0.45565335138794855
E01027760,1284,635,649,0.4945482866043614,0.5054517133956387
E01033185,1256,594,662,0.4729299363057325,0.5270700636942676
E01033186,1298,625,673,0.4815100154083205,0.5184899845916795
E01027776,1542,767,775,0.4974059662775616,0.5025940337224384
E01027777,1413,727,686,0.5145081387119603,0.4854918612880396
E01027783,1765,863,902,0.4889518413597734,0.5110481586402267
E01027784,1679,805,874,0.4794520547945205,0.5205479452054794
E01027792,1802,828,974,0.4594894561598224,0.5405105438401776
E01027793,1418,642,776,0.4527503526093089,0.5472496473906912
E01027794,2029,954,1075,0.4701823558403154,0.5298176441596846
E01027795,1581,754,827,0.4769133459835547,0.5230866540164453
E01027801,1633,770,863,0.47152480097979177,0.5284751990202082
E01027802,1623,796,827,0.4904497843499692,0.5095502156500308
E01027775,2153,1211,942,0.5624709707385044,0.43752902926149556
E01027780,1811,913,898,0.5041413583655439,0.4958586416344561
E01027781,1255,600,655,0.47808764940239046,0.5219123505976095
E01027800,1685,808,877,0.4795252225519288,0.5204747774480712
E01027779,1165,578,587,0.496137339055794,0.503862660944206
E01027796,1743,884,859,0.5071715433161216,0.49282845668387837
E01027798,1980,984,996,0.49696969696969695,0.503030303030303
E01027803,1801,909,892,0.5047196002220988,0.49528039977790117
E01027774,2032,1013,1019,0.4985236220472441,0.5014763779527559
E01027778,2285,1147,1138,0.5019693654266958,0.49803063457330415
E01027782,1656,793,863,0.4788647342995169,0.5211352657004831
E01027797,1696,832,864,0.49056603773584906,0.5094339622641509
E01027799,1729,830,899,0.4800462695199537,0.5199537304800462
E01027785,1531,778,753,0.5081645983017635,0.4918354016982365
E01027786,1566,761,805,0.4859514687100894,0.5140485312899106
E01027787,1791,873,918,0.48743718592964824,0.5125628140703518
E01027788,1405,696,709,0.49537366548042705,0.504626334519573
E01027789,2491,1182,1309,0.47450822962665595,0.525491770373344
E01027790,1936,944,992,0.48760330578512395,0.512396694214876
E01027791,1555,771,784,0.4958199356913183,0.5041800643086817
E01027837,1406,641,765,0.45590327169274536,0.5440967283072546
E01027839,1685,788,897,0.4676557863501484,0.5323442136498516
E01027869,1100,585,515,0.5318181818181819,0.4681818181818182
E01027870,1332,652,680,0.4894894894894895,0.5105105105105106
E01027871,1521,688,833,0.4523339907955293,0.5476660092044707
E01027813,2072,1023,1049,0.4937258687258687,0.5062741312741312
E01027822,1401,702,699,0.5010706638115632,0.4989293361884368
E01027840,2098,1042,1056,0.4966634890371783,0.5033365109628217
E01027841,1320,651,669,0.49318181818181817,0.5068181818181818
E01027838,1561,749,812,0.4798206278026906,0.5201793721973094
E01027864,1457,737,720,0.5058339052848319,0.49416609471516815
E01027865,1616,829,787,0.5129950495049505,0.4870049504950495
E01027866,1535,750,785,0.48859934853420195,0.511400651465798
E01027821,1412,677,735,0.4794617563739377,0.5205382436260623
E01027823,1442,665,777,0.46116504854368934,0.5388349514563107
E01027831,1070,522,548,0.48785046728971965,0.5121495327102804
E01027832,1066,526,540,0.49343339587242024,0.5065666041275797
E01027836,2210,1057,1153,0.47828054298642536,0.5217194570135747
E01027857,1325,645,680,0.4867924528301887,0.5132075471698113
E01027842,1625,767,858,0.472,0.528
E01027843,1430,665,765,0.46503496503496505,0.534965034965035
E01027844,1556,756,800,0.48586118251928023,0.5141388174807198
E01027845,1741,821,920,0.47156806433084436,0.5284319356691557
E01027855,1482,711,771,0.4797570850202429,0.520242914979757
E01027856,1157,529,628,0.45721694036300775,0.5427830596369922
E01027805,1498,728,770,0.48598130841121495,0.514018691588785
E01027806,1740,910,830,0.5229885057471264,0.47701149425287354
E01027846,1884,941,943,0.4994692144373673,0.5005307855626328
E01027847,1883,1010,873,0.5363781200212427,0.4636218799787573
E01027848,1052,511,541,0.48574144486692017,0.5142585551330798
E01027849,1199,586,613,0.48874061718098416,0.5112593828190158
E01027850,1302,644,658,0.4946236559139785,0.5053763440860215
E01027872,1466,699,767,0.4768076398362892,0.5231923601637107
E01027874,1658,787,871,0.4746682750301568,0.5253317249698432
E01027810,1691,805,886,0.47604967474866944,0.5239503252513306
E01027811,1708,782,926,0.45784543325526933,0.5421545667447307
E01027812,1783,854,929,0.47896803140773975,0.5210319685922602
E01027851,1537,740,797,0.4814573845152895,0.5185426154847105
E01027862,1638,790,848,0.4822954822954823,0.5177045177045178
E01027824,1431,655,776,0.45772187281621246,0.5422781271837875
E01027825,1898,917,981,0.48314014752370915,0.5168598524762908
E01027826,1526,761,765,0.4986893840104849,0.5013106159895151
E01027861,1318,631,687,0.4787556904400607,0.5212443095599393
E01027863,1425,661,764,0.463859649122807,0.536140350877193
E01027873,1486,692,794,0.46567967698519513,0.5343203230148048
E01027804,1505,780,725,0.5182724252491694,0.48172757475083056
E01027852,1674,883,791,0.527479091995221,0.472520908004779
E01027853,1263,617,646,0.4885193982581156,0.5114806017418844
E01027854,1488,754,734,0.5067204301075269,0.4932795698924731
E01027868,2270,1023,1247,0.4506607929515419,0.5493392070484582
E01027807,1464,703,761,0.4801912568306011,0.519808743169399
E01027808,1440,708,732,0.49166666666666664,0.5083333333333333
E01027809,1248,589,659,0.4719551282051282,0.5280448717948718
E01027818,1371,640,731,0.4668125455871627,0.5331874544128373
E01027867,1561,729,832,0.46700832799487507,0.5329916720051249
E01027817,1407,684,723,0.4861407249466951,0.5138592750533049
E01027819,1432,702,730,0.49022346368715086,0.5097765363128491
E01027820,1400,657,743,0.4692857142857143,0.5307142857142857
E01027858,1377,663,714,0.48148148148148145,0.5185185185185185
E01027860,1550,760,790,0.49032258064516127,0.5096774193548387
E01027814,1588,755,833,0.47544080604534006,0.52455919395466
E01027815,1327,623,704,0.4694800301431801,0.5305199698568199
E01027816,1571,740,831,0.4710375556970083,0.5289624443029918
E01027859,1720,837,883,0.4866279069767442,0.5133720930232558
E01027827,1617,750,867,0.46382189239332094,0.536178107606679
E01027828,1636,750,886,0.45843520782396086,0.5415647921760391
E01027829,1471,700,771,0.47586675730795375,0.5241332426920462
E01027830,1806,860,946,0.47619047619047616,0.5238095238095238
E01027833,1581,780,801,0.49335863377609107,0.5066413662239089
E01027834,1542,735,807,0.4766536964980545,0.5233463035019456
E01027835,1741,866,875,0.4974152785755313,0.5025847214244687
E01027918,1485,740,745,0.4983164983164983,0.5016835016835017
E01027919,1149,580,569,0.504786771105309,0.49521322889469105
E01027920,1187,580,607,0.4886267902274642,0.5113732097725358
E01027921,1741,827,914,0.47501435956346927,0.5249856404365307
E01027922,1699,837,862,0.492642731018246,0.5073572689817539
E01027875,1865,938,927,0.5029490616621984,0.4970509383378016
E01027886,1334,669,665,0.5014992503748126,0.4985007496251874
E01027887,1548,757,791,0.48901808785529716,0.5109819121447028
E01027888,1754,839,915,0.47833523375142534,0.5216647662485747
E01027904,2341,1150,1191,0.4912430585219991,0.5087569414780009
E01027876,1635,796,839,0.4868501529051988,0.5131498470948013
E01027877,1249,616,633,0.4931945556445156,0.5068054443554844
E01027900,1913,924,989,0.4830109775222164,0.5169890224777836
E01027901,1559,751,808,0.4817190506735087,0.5182809493264914
E01027902,1559,759,800,0.4868505452212957,0.5131494547787043
E01027903,1194,505,689,0.42294807370184256,0.5770519262981575
E01027898,2368,1143,1225,0.4826858108108108,0.5173141891891891
E01027914,1680,826,854,0.49166666666666664,0.5083333333333333
E01027915,1614,799,815,0.4950433705080545,0.5049566294919455
E01027916,1532,739,793,0.48237597911227154,0.5176240208877284
E01027917,1831,931,900,0.5084653194975424,0.4915346805024577
E01027878,1279,628,651,0.4910086004691165,0.5089913995308835
E01027905,1871,941,930,0.5029396044895778,0.49706039551042225
E01027907,1377,689,688,0.5003631082062454,0.49963689179375453
E01027908,1578,766,812,0.48542458808618505,0.514575411913815
E01027909,2022,1014,1008,0.5014836795252225,0.49851632047477745
E01027910,2759,1333,1426,0.48314606741573035,0.5168539325842697
E01027881,1294,618,676,0.4775888717156105,0.5224111282843895
E01027906,1424,673,751,0.4726123595505618,0.5273876404494382
E01027911,1479,682,797,0.46112237998647737,0.5388776200135227
E01027912,1030,500,530,0.4854368932038835,0.5145631067961165
E01027913,1191,581,610,0.4878253568429891,0.5121746431570109
E01027879,1345,666,679,0.49516728624535317,0.5048327137546469
E01027880,1583,767,816,0.4845230574857865,0.5154769425142135
E01027882,1830,941,889,0.514207650273224,0.48579234972677593
E01027894,1889,947,942,0.5013234515616728,0.49867654843832715
E01027895,1567,774,793,0.49393746011486916,0.5060625398851308
E01027883,1125,541,584,0.48088888888888887,0.5191111111111111
E01027884,1628,822,806,0.504914004914005,0.4950859950859951
E01027885,1564,752,812,0.48081841432225064,0.5191815856777494
E01027896,1998,994,1004,0.4974974974974975,0.5025025025025025
E01027897,2100,1050,1050,0.5,0.5
E01027891,1672,819,853,0.48983253588516745,0.5101674641148325
E01027892,1866,914,952,0.48981779206859594,0.5101822079314041
E01027893,1859,902,957,0.48520710059171596,0.514792899408284
E01027899,1728,862,866,0.4988425925925926,0.5011574074074074
E01027889,1794,906,888,0.5050167224080268,0.49498327759197325
E01027890,1969,961,1008,0.48806500761808025,0.5119349923819198
E01027923,2266,1134,1132,0.500441306266549,0.499558693733451
E01027924,2125,1064,1061,0.5007058823529412,0.49929411764705883
E01007434,1933,963,970,0.4981893429901707,0.5018106570098293
E01007435,1579,771,808,0.4882837238758708,0.5117162761241292
E01007438,1557,722,835,0.46371226718047526,0.5362877328195247
E01007439,1210,607,603,0.5016528925619834,0.4983471074380165
E01007433,1615,775,840,0.47987616099071206,0.5201238390092879
E01007436,1267,620,647,0.489344909234412,0.510655090765588
E01007437,1476,755,721,0.5115176151761518,0.48848238482384826
E01007440,1520,753,767,0.4953947368421053,0.5046052631578948
E01007329,1594,788,806,0.49435382685069007,0.5056461731493099
E01007331,1853,926,927,0.4997301672962763,0.5002698327037237
E01007342,1398,686,712,0.4907010014306152,0.5092989985693849
E01007343,1346,656,690,0.487369985141159,0.512630014858841
E01007356,1381,669,712,0.4844315713251267,0.5155684286748733
E01007357,1397,667,730,0.47745168217609163,0.5225483178239084
E01007361,1656,799,857,0.482487922705314,0.517512077294686
E01007362,1633,816,817,0.49969381506429883,0.5003061849357011
E01007363,1575,755,820,0.4793650793650794,0.5206349206349207
E01007355,1537,773,764,0.5029277813923227,0.4970722186076773
E01007358,1497,717,780,0.4789579158316633,0.5210420841683366
E01007359,1509,739,770,0.4897282968853545,0.5102717031146454
E01007360,1546,733,813,0.4741267787839586,0.5258732212160414
E01007386,1714,830,884,0.48424737456242706,0.5157526254375729
E01007328,1922,940,982,0.4890738813735692,0.5109261186264308
E01007330,1708,826,882,0.48360655737704916,0.5163934426229508
E01007332,2306,1132,1174,0.4908933217692975,0.5091066782307025
E01007333,1331,659,672,0.49511645379413977,0.5048835462058603
E01007323,1483,748,735,0.5043830074173972,0.49561699258260283
E01007324,1667,819,848,0.4913017396520696,0.5086982603479304
E01007325,1714,829,885,0.4836639439906651,0.5163360560093349
E01007326,1526,736,790,0.48230668414154654,0.5176933158584535
E01007327,1676,809,867,0.48269689737470167,0.5173031026252983
E01007411,1191,605,586,0.5079764903442485,0.4920235096557515
E01007341,1264,627,637,0.49604430379746833,0.5039556962025317
E01007345,1620,800,820,0.49382716049382713,0.5061728395061729
E01007346,1620,788,832,0.48641975308641977,0.5135802469135803
E01007347,1594,791,803,0.49623588456712675,0.5037641154328732
E01007334,1356,683,673,0.5036873156342183,0.4963126843657817
E01007335,1506,739,767,0.4907038512616202,0.5092961487383798
E01007400,2017,1018,999,0.5047099652949926,0.49529003470500743
E01007404,1287,642,645,0.4988344988344988,0.5011655011655012
E01007406,1720,840,880,0.4883720930232558,0.5116279069767442
E01007408,1516,719,797,0.4742744063324538,0.5257255936675461
E01007409,1458,734,724,0.5034293552812071,0.49657064471879286
E01007410,1631,792,839,0.4855916615573268,0.5144083384426732
E01032550,2841,1408,1433,0.4956001407954945,0.5043998592045055
E01032551,2567,1285,1282,0.5005843396961434,0.49941566030385665
E01007344,2135,1069,1066,0.5007025761124122,0.4992974238875878
E01007402,1660,782,878,0.4710843373493976,0.5289156626506024
E01007403,1536,754,782,0.4908854166666667,0.5091145833333334
E01007405,1418,653,765,0.4605077574047955,0.5394922425952046
E01007379,1591,764,827,0.48020113136392206,0.5197988686360779
E01007380,1810,910,900,0.5027624309392266,0.4972375690607735
E01007381,1547,759,788,0.4906270200387847,0.5093729799612152
E01007387,1452,716,736,0.4931129476584022,0.5068870523415978
E01007442,1377,670,707,0.4865649963689179,0.5134350036310821
E01007444,1550,759,791,0.4896774193548387,0.5103225806451613
E01007446,1335,650,685,0.4868913857677903,0.5131086142322098
E01007336,1557,801,756,0.5144508670520231,0.48554913294797686
E01007340,1636,826,810,0.5048899755501223,0.49511002444987773
E01007415,1495,732,763,0.48963210702341137,0.5103678929765886
E01007417,1591,789,802,0.49591451917033313,0.5040854808296669
E01007441,1537,773,764,0.5029277813923227,0.4970722186076773
E01007443,2000,1086,914,0.543,0.457
E01007445,1451,715,736,0.49276361130255,0.50723638869745
E01007372,1287,608,679,0.47241647241647244,0.5275835275835276
E01007373,1594,809,785,0.5075282308657465,0.49247176913425345
E01007374,1470,704,766,0.47891156462585033,0.5210884353741496
E01007375,1659,792,867,0.47739602169981915,0.5226039783001808
E01007377,1105,561,544,0.5076923076923077,0.49230769230769234
E01007378,1572,771,801,0.4904580152671756,0.5095419847328244
E01007319,1465,718,747,0.4901023890784983,0.5098976109215017
E01007321,1433,690,743,0.48150732728541523,0.5184926727145848
E01007322,2082,1039,1043,0.4990393852065322,0.5009606147934679
E01007337,1775,928,847,0.5228169014084507,0.4771830985915493
E01007418,1279,618,661,0.4831899921813917,0.5168100078186083
E01007419,1721,828,893,0.4811156304474143,0.5188843695525857
E01007420,1432,703,729,0.4909217877094972,0.5090782122905028
E01007425,1470,737,733,0.501360544217687,0.49863945578231295
E01007338,1533,756,777,0.4931506849315068,0.5068493150684932
E01007339,1490,763,727,0.5120805369127517,0.4879194630872483
E01007413,1349,650,699,0.48183839881393625,0.5181616011860638
E01007414,1638,788,850,0.4810744810744811,0.518925518925519
E01007317,1493,747,746,0.5003348961821835,0.4996651038178165
E01007318,1544,781,763,0.5058290155440415,0.49417098445595853
E01007320,1596,798,798,0.5,0.5
E01007416,1194,577,617,0.483249581239531,0.516750418760469
E01007382,1483,714,769,0.48145650708024273,0.5185434929197572
E01007383,1370,698,672,0.5094890510948905,0.4905109489051095
E01007384,1614,798,816,0.4944237918215613,0.5055762081784386
E01007385,1433,688,745,0.4801116538729937,0.5198883461270063
E01007348,1444,696,748,0.481994459833795,0.518005540166205
E01007349,1533,728,805,0.4748858447488584,0.5251141552511416
E01007350,1185,600,585,0.5063291139240507,0.4936708860759494
E01007351,1426,699,727,0.4901823281907433,0.5098176718092566
E01007352,1412,683,729,0.48371104815864024,0.5162889518413598
E01007353,1605,771,834,0.4803738317757009,0.5196261682242991
E01007354,1681,817,864,0.4860202260559191,0.5139797739440809
E01007458,1455,727,728,0.49965635738831615,0.5003436426116838
E01007459,1509,726,783,0.48111332007952284,0.5188866799204771
E01007460,1437,720,717,0.5010438413361169,0.4989561586638831
E01007461,1647,844,803,0.5124468731026108,0.48755312689738917
E01007462,1602,741,861,0.46254681647940077,0.5374531835205992
E01007463,1766,843,923,0.4773499433748584,0.5226500566251415
E01007369,1490,762,728,0.5114093959731544,0.4885906040268456
E01007370,1389,683,706,0.4917206623470122,0.5082793376529877
E01007371,1954,957,997,0.4897645854657114,0.5102354145342887
E01007376,1407,691,716,0.49111584932480457,0.5088841506751954
E01007447,1544,750,794,0.48575129533678757,0.5142487046632125
E01007448,1594,828,766,0.5194479297365119,0.48055207026348806
E01007449,1770,887,883,0.5011299435028248,0.49887005649717514
E01007450,1516,763,753,0.5032981530343008,0.4967018469656992
E01007427,1554,787,767,0.5064350064350064,0.49356499356499356
E01007428,1445,715,730,0.49480968858131485,0.5051903114186851
E01007429,1422,674,748,0.4739803094233474,0.5260196905766527
E01007430,2277,1130,1147,0.4962670180061484,0.5037329819938515
E01007431,1363,677,686,0.4966984592809978,0.5033015407190022
E01007432,1431,709,722,0.4954577218728162,0.5045422781271838
E01007364,1390,662,728,0.4762589928057554,0.5237410071942447
E01007365,1212,564,648,0.46534653465346537,0.5346534653465347
E01007366,2005,991,1014,0.4942643391521197,0.5057356608478804
E01007367,1178,590,588,0.5008488964346349,0.499151103565365
E01007368,1675,814,861,0.48597014925373133,0.5140298507462686
E01007451,1712,845,867,0.4935747663551402,0.5064252336448598
E01007452,1555,777,778,0.4996784565916399,0.5003215434083601
E01007453,1558,721,837,0.46277278562259305,0.537227214377407
E01007455,1358,666,692,0.49042709867452133,0.5095729013254786
E01032924,1562,761,801,0.4871959026888604,0.5128040973111395
E01032925,1390,656,734,0.4719424460431655,0.5280575539568345
E01007421,1330,669,661,0.5030075187969925,0.49699248120300754
E01007422,1571,808,763,0.5143220878421387,0.4856779121578612
E01007423,1655,809,846,0.48882175226586105,0.511178247734139
E01007426,1558,785,773,0.5038510911424904,0.4961489088575096
E01007396,1580,754,826,0.4772151898734177,0.5227848101265823
E01007397,1456,681,775,0.4677197802197802,0.5322802197802198
E01007398,1632,784,848,0.4803921568627451,0.5196078431372549
E01007399,2057,993,1064,0.4827418570734079,0.5172581429265921
E01007424,1671,817,854,0.4889287851585877,0.5110712148414124
E01007388,1615,815,800,0.5046439628482973,0.4953560371517028
E01007393,1837,882,955,0.48013064779531844,0.5198693522046816
E01007394,1384,687,697,0.4963872832369942,0.5036127167630058
E01007456,1756,854,902,0.4863325740318907,0.5136674259681093
E01007457,1648,793,855,0.4811893203883495,0.5188106796116505
E01007389,1396,701,695,0.5021489971346705,0.4978510028653295
E01007390,1527,744,783,0.48722986247544203,0.5127701375245579
E01007391,1468,723,745,0.4925068119891008,0.5074931880108992
E01007392,1538,763,775,0.4960988296488947,0.5039011703511054
E01007395,2016,956,1060,0.4742063492063492,0.5257936507936508
E01007632,1617,782,835,0.4836116264687693,0.5163883735312307
E01007633,1355,660,695,0.4870848708487085,0.5129151291512916
E01007634,1636,803,833,0.4908312958435208,0.5091687041564792
E01007635,1410,681,729,0.4829787234042553,0.5170212765957447
E01007487,1615,771,844,0.4773993808049536,0.5226006191950464
E01007488,1738,897,841,0.5161104718066744,0.48388952819332565
E01007489,1721,847,874,0.49215572341661823,0.5078442765833817
E01007490,1565,782,783,0.4996805111821086,0.5003194888178913
E01007491,1754,854,900,0.4868871151653364,0.5131128848346637
E01007492,1496,726,770,0.4852941176470588,0.5147058823529411
E01007493,1784,879,905,0.49271300448430494,0.5072869955156951
E01007636,1521,718,803,0.4720578566732413,0.5279421433267587
E01007637,1542,722,820,0.4682230869001297,0.5317769130998703
E01007638,1587,760,827,0.4788909892879647,0.5211090107120353
E01007639,1894,951,943,0.5021119324181627,0.4978880675818374
E01007640,1616,815,801,0.5043316831683168,0.49566831683168316
E01007641,1512,726,786,0.4801587301587302,0.5198412698412699
E01007642,1605,780,825,0.48598130841121495,0.514018691588785
E01007625,1537,783,754,0.5094339622641509,0.49056603773584906
E01007626,1226,626,600,0.5106035889070146,0.4893964110929853
E01007627,1671,786,885,0.4703770197486535,0.5296229802513465
E01007628,1439,688,751,0.47810979847116053,0.5218902015288395
E01007629,1606,779,827,0.4850560398505604,0.5149439601494396
E01007468,1296,612,684,0.4722222222222222,0.5277777777777778
E01007469,1355,675,680,0.4981549815498155,0.5018450184501845
E01007470,1428,708,720,0.4957983193277311,0.5042016806722689
E01007472,1624,799,825,0.4919950738916256,0.5080049261083743
E01007473,1457,721,736,0.4948524365133837,0.5051475634866164
E01007474,1325,611,714,0.4611320754716981,0.5388679245283019
E01007554,1594,787,807,0.49372647427854455,0.5062735257214555
E01007555,1464,667,797,0.45560109289617484,0.5443989071038251
E01007556,1364,661,703,0.4846041055718475,0.5153958944281525
E01007561,1472,716,756,0.48641304347826086,0.5135869565217391
E01007562,1362,682,680,0.5007342143906021,0.49926578560939794
E01007563,1455,695,760,0.47766323024054985,0.5223367697594502
E01007621,1410,691,719,0.4900709219858156,0.5099290780141844
E01007622,1515,733,782,0.48382838283828383,0.5161716171617162
E01007623,1224,607,617,0.4959150326797386,0.5040849673202614
E01007624,1864,929,935,0.49839055793991416,0.5016094420600858
E01007630,1358,668,690,0.49189985272459497,0.508100147275405
E01007631,1221,594,627,0.4864864864864865,0.5135135135135135
E01007553,1693,845,848,0.4991139988186651,0.5008860011813349
E01007557,2784,2284,500,0.8204022988505747,0.17959770114942528
E01007558,1453,715,738,0.49208534067446663,0.5079146593255334
E01007559,1162,686,476,0.5903614457831325,0.40963855421686746
E01007560,1523,728,795,0.4780039395929087,0.5219960604070912
E01007464,1497,728,769,0.4863059452237809,0.5136940547762191
E01007465,1483,721,762,0.4861766689143628,0.5138233310856373
E01007466,1755,855,900,0.48717948717948717,0.5128205128205128
E01007467,1553,767,786,0.49388280746941404,0.506117192530586
E01007471,1542,762,780,0.49416342412451364,0.5058365758754864
E01007504,1532,765,767,0.4993472584856397,0.5006527415143603
E01007507,1375,693,682,0.504,0.496
E01007506,1441,708,733,0.4913254684247051,0.508674531575295
E01007508,1664,808,856,0.4855769230769231,0.5144230769230769
E01007509,1760,847,913,0.48125,0.51875
E01007510,1568,720,848,0.45918367346938777,0.5408163265306123
E01007511,1576,751,825,0.47652284263959394,0.5234771573604061
E01007475,1549,768,781,0.49580374435119434,0.5041962556488057
E01007476,1457,685,772,0.47014413177762526,0.5298558682223747
E01007477,1431,690,741,0.48218029350104824,0.5178197064989518
E01007478,1532,780,752,0.5091383812010444,0.4908616187989556
E01007512,1671,827,844,0.49491322561340517,0.5050867743865949
E01007513,1435,657,778,0.4578397212543554,0.5421602787456447
E01007515,1570,773,797,0.4923566878980892,0.5076433121019108
E01007518,1489,715,774,0.4801880456682337,0.5198119543317663
E01007519,1298,622,676,0.47919876733436056,0.5208012326656395
E01007505,1673,844,829,0.5044829647340108,0.4955170352659892
E01007514,1465,734,731,0.5010238907849829,0.49897610921501706
E01007516,1336,652,684,0.4880239520958084,0.5119760479041916
E01007517,1553,756,797,0.4867997424339987,0.5132002575660013
E01007479,1593,785,808,0.49278091650973005,0.5072190834902699
E01007480,1509,723,786,0.47912524850894633,0.5208747514910537
E01007482,1374,632,742,0.45997088791848617,0.5400291120815138
E01033259,1599,784,815,0.4903064415259537,0.5096935584740463
E01033260,1611,807,804,0.5009310986964618,0.49906890130353815
E01007570,1482,691,791,0.46626180836707154,0.5337381916329285
E01007650,1649,808,841,0.4899939357186173,0.5100060642813826
E01007651,1830,868,962,0.4743169398907104,0.5256830601092897
E01007652,1889,909,980,0.48120698782424565,0.5187930121757544
E01007653,1579,823,756,0.5212159594680177,0.47878404053198226
E01007656,1589,742,847,0.4669603524229075,0.5330396475770925
E01007581,1559,784,775,0.5028864656831302,0.4971135343168698
E01007582,1457,709,748,0.48661633493479756,0.5133836650652025
E01007588,1692,814,878,0.48108747044917255,0.5189125295508275
E01007589,1712,832,880,0.48598130841121495,0.514018691588785
E01007483,1381,663,718,0.48008689355539463,0.5199131064446053
E01007484,1445,704,741,0.48719723183391006,0.5128027681660899
E01007485,1435,697,738,0.4857142857142857,0.5142857142857142
E01007486,1317,640,677,0.4859529233105543,0.5140470766894457
E01007564,1536,716,820,0.4661458333333333,0.5338541666666666
E01007565,1527,740,787,0.48461034708578915,0.5153896529142109
E01007566,1626,800,826,0.4920049200492005,0.5079950799507995
E01007567,1342,656,686,0.488822652757079,0.511177347242921
E01007568,1662,777,885,0.4675090252707581,0.5324909747292419
E01007569,1601,752,849,0.4697064334790756,0.5302935665209244
E01007644,1549,771,778,0.4977404777275662,0.5022595222724339
E01007646,1463,779,684,0.5324675324675324,0.4675324675324675
E01007647,1503,712,791,0.4737192282102462,0.5262807717897539
E01007648,1884,1047,837,0.5557324840764332,0.4442675159235669
E01007649,1549,784,765,0.5061329890251776,0.49386701097482244
E01007654,1539,783,756,0.5087719298245614,0.49122807017543857
E01007583,1455,701,754,0.481786941580756,0.518213058419244
E01007586,1522,743,779,0.48817345597897505,0.511826544021025
E01007587,1542,718,824,0.4656290531776913,0.5343709468223087
E01007620,1606,786,820,0.48941469489414696,0.5105853051058531
E01007584,1548,738,810,0.47674418604651164,0.5232558139534884
E01007585,1606,738,868,0.45952677459526775,0.5404732254047323
E01007617,1511,716,795,0.4738583719391132,0.5261416280608868
E01007618,1267,613,654,0.48382004735595896,0.516179952644041
E01007619,1810,894,916,0.49392265193370166,0.5060773480662983
E01007529,2047,1329,718,0.6492427943331704,0.3507572056668295
E01007530,1206,616,590,0.5107794361525705,0.4892205638474295
E01007531,1625,820,805,0.5046153846153846,0.49538461538461537
E01007643,1665,799,866,0.4798798798798799,0.5201201201201201
E01007645,2072,1100,972,0.5308880308880309,0.4691119691119691
E01007655,1893,1017,876,0.5372424722662441,0.46275752773375595
E01007494,1529,764,765,0.499672988881622,0.5003270111183781
E01007532,1774,1030,744,0.580608793686584,0.41939120631341603
E01007533,1419,735,684,0.5179704016913319,0.4820295983086681
E01007535,1596,784,812,0.49122807017543857,0.5087719298245614
E01007522,1550,758,792,0.4890322580645161,0.5109677419354839
E01007525,1532,706,826,0.4608355091383812,0.5391644908616188
E01007528,1392,659,733,0.4734195402298851,0.5265804597701149
E01007604,1431,693,738,0.48427672955974843,0.5157232704402516
E01007521,1491,698,793,0.4681421864520456,0.5318578135479544
E01007523,1486,717,769,0.48250336473755046,0.5174966352624495
E01007524,1581,790,791,0.49968374446552816,0.5003162555344719
E01007526,1633,773,860,0.4733619105939988,0.5266380894060012
E01007607,1444,693,751,0.47991689750692523,0.5200831024930748
E01007599,1763,861,902,0.4883720930232558,0.5116279069767442
E01007600,1434,694,740,0.4839609483960948,0.5160390516039052
E01007601,1367,653,714,0.4776883686905633,0.5223116313094367
E01007602,1500,735,765,0.49,0.51
E01007603,1484,728,756,0.49056603773584906,0.5094339622641509
E01007520,1418,675,743,0.47602256699576867,0.5239774330042313
E01007527,2325,1156,1169,0.4972043010752688,0.5027956989247312
E01007605,1543,762,781,0.4938431626701231,0.5061568373298768
E01007606,1536,792,744,0.515625,0.484375
E01007495,1857,888,969,0.4781906300484653,0.5218093699515347
E01007500,1308,638,670,0.4877675840978593,0.5122324159021406
E01007502,2750,1387,1363,0.5043636363636363,0.49563636363636365
E01007534,2022,1061,961,0.5247279920870426,0.4752720079129575
E01007496,1622,797,825,0.4913686806411837,0.5086313193588162
E01007497,1376,661,715,0.4803779069767442,0.5196220930232558
E01007498,1580,803,777,0.5082278481012659,0.4917721518987342
E01007499,1501,694,807,0.46235842771485675,0.5376415722851432
E01007501,1456,707,749,0.4855769230769231,0.5144230769230769
E01007503,1620,819,801,0.5055555555555555,0.49444444444444446
E01007575,1408,632,776,0.44886363636363635,0.5511363636363636
E01007578,1616,807,809,0.4993811881188119,0.5006188118811881
E01007579,1504,775,729,0.5152925531914894,0.48470744680851063
E01007580,1378,707,671,0.5130624092888244,0.4869375907111756
E01007571,1610,797,813,0.49503105590062113,0.5049689440993789
E01007572,1416,705,711,0.4978813559322034,0.5021186440677966
E01007573,1546,763,783,0.4935316946959897,0.5064683053040103
E01007574,1577,738,839,0.4679771718452758,0.5320228281547241
E01007576,1518,733,785,0.48287220026350464,0.5171277997364954
E01007577,1540,767,773,0.4980519480519481,0.5019480519480519
E01007536,1971,982,989,0.49822425164890916,0.5017757483510908
E01007542,1778,864,914,0.4859392575928009,0.5140607424071991
E01007543,1500,710,790,0.47333333333333333,0.5266666666666666
E01007544,1752,836,916,0.4771689497716895,0.5228310502283106
E01007546,1428,709,719,0.4964985994397759,0.5035014005602241
E01007551,1671,840,831,0.5026929982046678,0.49730700179533216
E01007552,1408,674,734,0.4786931818181818,0.5213068181818182
E01007613,1579,781,798,0.49461684610512985,0.5053831538948702
E01007545,1484,736,748,0.49595687331536387,0.5040431266846361
E01007547,1529,753,776,0.4924787442773054,0.5075212557226946
E01007548,1103,506,597,0.4587488667271079,0.5412511332728921
E01007549,1455,711,744,0.488659793814433,0.511340206185567
E01007550,1665,793,872,0.4762762762762763,0.5237237237237238
E01007537,1733,842,891,0.48586266589728794,0.514137334102712
E01007538,1530,722,808,0.4718954248366013,0.5281045751633987
E01007539,1443,682,761,0.4726264726264726,0.5273735273735274
E01007540,1633,796,837,0.4874464176362523,0.5125535823637477
E01007541,1520,773,747,0.5085526315789474,0.49144736842105263
E01007591,1452,713,739,0.49104683195592286,0.5089531680440771
E01007594,2036,1011,1025,0.49656188605108054,0.5034381139489195
E01007596,1246,598,648,0.4799357945425361,0.5200642054574639
E01007598,1534,772,762,0.5032594524119948,0.49674054758800523
E01007590,1215,605,610,0.49794238683127573,0.5020576131687243
E01007592,1652,786,866,0.47578692493946734,0.5242130750605327
E01007593,1306,618,688,0.47320061255742724,0.5267993874425727
E01007595,1528,726,802,0.47513089005235604,0.524869109947644
E01007597,1568,714,854,0.45535714285714285,0.5446428571428571
E01007608,1707,832,875,0.4874048037492677,0.5125951962507322
E01007609,2310,1129,1181,0.48874458874458876,0.5112554112554113
E01007610,1799,873,926,0.48526959421901056,0.5147304057809894
E01007611,1293,624,669,0.48259860788863107,0.5174013921113689
E01007612,1378,662,716,0.48040638606676345,0.5195936139332366
E01007614,1353,655,698,0.48410938654841096,0.515890613451589
E01007615,1258,576,682,0.4578696343402226,0.5421303656597775
E01007616,1239,573,666,0.46246973365617433,0.5375302663438256
E01007693,2148,1075,1073,0.500465549348231,0.4995344506517691
E01007694,1758,884,874,0.502844141069397,0.49715585893060293
E01007695,2461,1204,1257,0.48923201950426654,0.5107679804957335
E01007697,1577,760,817,0.4819277108433735,0.5180722891566265
E01007698,1517,761,756,0.5016479894528675,0.4983520105471325
E01007816,1672,828,844,0.49521531100478466,0.5047846889952153
E01007817,1421,676,745,0.4757213230119634,0.5242786769880365
E01007819,1481,758,723,0.511816340310601,0.48818365968939903
E01007820,1483,734,749,0.4949426837491571,0.5050573162508429
E01007821,1608,746,862,0.4639303482587065,0.5360696517412935
E01007822,1540,696,844,0.45194805194805193,0.548051948051948
E01007796,1156,523,633,0.4524221453287197,0.5475778546712803
E01007797,1362,688,674,0.5051395007342144,0.4948604992657856
E01007798,1261,630,631,0.49960348929421095,0.500396510705789
E01007799,1414,685,729,0.48444130127298446,0.5155586987270155
E01007800,1474,729,745,0.494572591587517,0.505427408412483
E01007818,1594,776,818,0.4868255959849435,0.5131744040150564
E01007777,1616,789,827,0.48824257425742573,0.5117574257425742
E01007793,1366,688,678,0.5036603221083455,0.49633967789165445
E01007794,1433,685,748,0.47801814375436147,0.5219818562456385
E01007795,1439,722,717,0.501737317581654,0.4982626824183461
E01007778,1526,763,763,0.5,0.5
E01007779,1257,638,619,0.507557677008751,0.492442322991249
E01007780,1414,698,716,0.49363507779349364,0.5063649222065064
E01007781,1524,743,781,0.48753280839895013,0.5124671916010499
E01007782,1495,705,790,0.47157190635451507,0.5284280936454849
E01007771,1421,701,720,0.4933145672061928,0.5066854327938072
E01007772,1329,651,678,0.4898419864559819,0.510158013544018
E01007773,1412,653,759,0.46246458923512745,0.5375354107648725
E01007774,1503,737,766,0.490352628077179,0.5096473719228211
E01007696,1478,693,785,0.4688768606224628,0.5311231393775372
E01007801,1491,718,773,0.4815560026827633,0.5184439973172368
E01007802,1330,651,679,0.48947368421052634,0.5105263157894737
E01007803,1337,664,673,0.49663425579655945,0.5033657442034405
E01007808,1469,746,723,0.5078284547311096,0.4921715452688904
E01007775,1341,637,704,0.4750186428038777,0.5249813571961223
E01007776,1487,733,754,0.4929388029589778,0.5070611970410221
E01007783,1674,802,872,0.47909199522102747,0.5209080047789725
E01007784,1761,872,889,0.4951731970471323,0.5048268029528676
E01007728,1116,561,555,0.5026881720430108,0.49731182795698925
E01007729,1620,841,779,0.5191358024691358,0.4808641975308642
E01007730,1417,711,706,0.5017642907551164,0.4982357092448836
E01007731,1238,600,638,0.48465266558966075,0.5153473344103393
E01007732,1415,734,681,0.5187279151943462,0.4812720848056537
E01007733,1323,668,655,0.5049130763416477,0.4950869236583522
E01007719,1247,618,629,0.4955894145950281,0.504410585404972
E01007720,1504,728,776,0.48404255319148937,0.5159574468085106
E01007721,1575,744,831,0.4723809523809524,0.5276190476190477
E01007727,1498,722,776,0.4819759679572764,0.5180240320427236
E01007740,1533,726,807,0.4735812133072407,0.5264187866927593
E01007804,1436,693,743,0.48259052924791085,0.5174094707520891
E01007805,1430,683,747,0.47762237762237764,0.5223776223776224
E01007806,1304,637,667,0.48849693251533743,0.5115030674846626
E01007807,1448,720,728,0.4972375690607735,0.5027624309392266
E01007681,1331,647,684,0.4861006761833208,0.5138993238166792
E01007691,2045,1011,1034,0.49437652811735944,0.5056234718826406
E01007692,1519,734,785,0.48321263989466756,0.5167873601053324
E01032926,1773,886,887,0.49971799210377893,0.5002820078962211
E01032927,1505,741,764,0.49235880398671095,0.507641196013289
E01007723,1379,690,689,0.5003625815808557,0.49963741841914433
E01007735,1427,699,728,0.4898388227049755,0.5101611772950245
E01007737,1583,782,801,0.4939987365761213,0.5060012634238787
E01007738,1516,737,779,0.4861477572559367,0.5138522427440633
E01007739,1587,780,807,0.4914933837429111,0.5085066162570888
E01007736,1618,800,818,0.49443757725587145,0.5055624227441285
E01007765,1518,753,765,0.49604743083003955,0.5039525691699605
E01007766,1468,729,739,0.49659400544959126,0.5034059945504087
E01007768,1936,1003,933,0.5180785123966942,0.4819214876033058
E01007770,1759,864,895,0.49118817509948837,0.5088118249005117
E01007741,1527,750,777,0.4911591355599214,0.5088408644400786
E01007742,1421,676,745,0.4757213230119634,0.5242786769880365
E01007743,1302,656,646,0.5038402457757296,0.49615975422427033
E01007744,1556,794,762,0.5102827763496144,0.4897172236503856
E01007745,1551,735,816,0.4738878143133462,0.5261121856866537
E01007746,1542,756,786,0.490272373540856,0.5097276264591439
E01007715,1797,923,874,0.5136338341680579,0.48636616583194214
E01007716,1911,983,928,0.5143903715332286,0.4856096284667713
E01007717,1898,904,994,0.47629083245521603,0.523709167544784
E01007718,1489,785,704,0.5271994627266622,0.4728005372733378
E01007677,1467,708,759,0.48261758691206547,0.5173824130879345
E01007714,2022,1081,941,0.5346191889218596,0.46538081107814044
E01007767,1663,836,827,0.502705953096813,0.497294046903187
E01007769,1728,899,829,0.5202546296296297,0.47974537037037035
E01007685,1437,715,722,0.4975643702157272,0.5024356297842728
E01007754,1409,704,705,0.49964513839602553,0.5003548616039745
E01007755,1386,691,695,0.49855699855699853,0.5014430014430015
E01007756,1446,710,736,0.49100968188105115,0.5089903181189488
E01007761,1616,782,834,0.4839108910891089,0.5160891089108911
E01007762,1471,700,771,0.47586675730795375,0.5241332426920462
E01007682,1440,717,723,0.4979166666666667,0.5020833333333333
E01007683,1433,714,719,0.4982554082344731,0.5017445917655269
E01007686,1417,668,749,0.47141848976711365,0.5285815102328864
E01007688,1429,653,776,0.456962911126662,0.543037088873338
E01007725,1332,648,684,0.4864864864864865,0.5135135135135135
E01007726,1600,765,835,0.478125,0.521875
E01007757,1669,806,863,0.4829239065308568,0.5170760934691432
E01007758,1336,645,691,0.48278443113772457,0.5172155688622755
E01007759,1473,716,757,0.4860828241683639,0.5139171758316361
E01007760,1784,907,877,0.5084080717488789,0.4915919282511211
E01007763,1561,761,800,0.4875080076873799,0.5124919923126201
E01007764,1705,850,855,0.49853372434017595,0.501466275659824
E01007708,1672,773,899,0.4623205741626794,0.5376794258373205
E01007709,1456,701,755,0.48145604395604397,0.5185439560439561
E01007710,1564,762,802,0.48721227621483376,0.5127877237851662
E01007711,1799,856,943,0.47581989994441354,0.5241801000555865
E01007724,1372,665,707,0.4846938775510204,0.5153061224489796
E01007734,1766,795,971,0.45016987542468856,0.5498301245753114
E01007684,1627,803,824,0.49354640442532266,0.5064535955746773
E01007687,1452,701,751,0.48278236914600553,0.5172176308539945
E01007689,1537,735,802,0.4782042940793754,0.5217957059206246
E01007690,1644,791,853,0.4811435523114355,0.5188564476885644
E01007675,1854,895,959,0.48274002157497303,0.517259978425027
E01007678,1597,789,808,0.4940513462742642,0.5059486537257357
E01007679,1854,920,934,0.4962243797195254,0.5037756202804746
E01007680,1882,945,937,0.502125398512221,0.49787460148777896
E01007712,1965,973,992,0.4951653944020356,0.5048346055979643
E01007713,1625,786,839,0.4836923076923077,0.5163076923076924
E01007811,1358,666,692,0.49042709867452133,0.5095729013254786
E01007812,1241,616,625,0.49637389202256244,0.5036261079774376
E01007813,1331,676,655,0.5078888054094666,0.49211119459053343
E01007814,1112,542,570,0.48741007194244607,0.512589928057554
E01007676,1629,772,857,0.47391037446286066,0.5260896255371393
E01007702,1595,780,815,0.4890282131661442,0.5109717868338558
E01007703,1237,587,650,0.47453516572352467,0.5254648342764754
E01007704,1450,712,738,0.4910344827586207,0.5089655172413793
E01007705,1522,758,764,0.4980289093298292,0.5019710906701709
E01007707,1527,762,765,0.49901768172888017,0.5009823182711198
E01007666,1357,672,685,0.4952100221075903,0.5047899778924098
E01007809,1553,781,772,0.5028976175144881,0.4971023824855119
E01007810,1958,984,974,0.5025536261491318,0.4974463738508682
E01007815,1715,816,899,0.47580174927113705,0.524198250728863
E01007665,1820,906,914,0.4978021978021978,0.5021978021978022
E01007699,1826,890,936,0.4874041621029573,0.5125958378970427
E01007700,1813,863,950,0.4760066188637617,0.5239933811362383
E01007701,1658,809,849,0.4879372738238842,0.5120627261761158
E01007706,1458,742,716,0.5089163237311386,0.49108367626886146
E01007787,2769,1389,1380,0.5016251354279523,0.49837486457204766
E01007788,1501,764,737,0.5089940039973351,0.49100599600266487
E01007789,1617,787,830,0.4867037724180581,0.5132962275819418
E01007792,1347,688,659,0.5107646622123236,0.4892353377876763
E01007657,1447,709,738,0.48997926744989634,0.5100207325501037
E01007659,1148,576,572,0.5017421602787456,0.49825783972125437
E01007785,1351,650,701,0.4811250925240563,0.5188749074759438
E01007786,1208,559,649,0.46274834437086093,0.5372516556291391
E01007790,1485,734,751,0.49427609427609426,0.5057239057239057
E01007791,1371,681,690,0.49671772428884026,0.5032822757111597
E01007667,1359,672,687,0.49448123620309054,0.5055187637969095
E01007668,1571,764,807,0.4863144493952896,0.5136855506047103
E01007669,1504,746,758,0.49601063829787234,0.5039893617021277
E01007670,1449,713,736,0.49206349206349204,0.5079365079365079
E01007672,1433,702,731,0.4898813677599442,0.5101186322400558
E01007673,1496,718,778,0.4799465240641711,0.5200534759358288
E01007671,2117,1042,1075,0.49220595181861126,0.5077940481813887
E01007674,1939,948,991,0.4889118102114492,0.5110881897885508
E01007747,1295,636,659,0.4911196911196911,0.5088803088803089
E01007750,1521,746,775,0.4904667981591059,0.5095332018408941
E01007658,1391,670,721,0.48166786484543495,0.5183321351545651
E01007660,1227,628,599,0.5118174409127955,0.48818255908720454
E01007661,1401,706,695,0.5039257673090649,0.49607423269093504
E01007662,1035,490,545,0.47342995169082125,0.5265700483091788
E01007663,1460,700,760,0.4794520547945205,0.5205479452054794
E01007664,1854,893,961,0.4816612729234088,0.5183387270765911
E01007748,1444,688,756,0.47645429362880887,0.5235457063711911
E01007749,1804,885,919,0.49057649667405767,0.5094235033259423
E01007751,1962,964,998,0.49133537206931704,0.508664627930683
E01007752,1487,714,773,0.4801613987895091,0.519838601210491
E01007753,1545,739,806,0.47831715210355985,0.5216828478964401
E01008144,1666,825,841,0.4951980792316927,0.5048019207683073
E01008145,1472,735,737,0.499320652173913,0.5006793478260869
E01008148,1509,739,770,0.4897282968853545,0.5102717031146454
E01008149,1496,733,763,0.4899732620320856,0.5100267379679144
E01008150,1454,686,768,0.4718019257221458,0.5281980742778541
E01008142,1478,738,740,0.4993234100135318,0.5006765899864682
E01008143,1620,794,826,0.4901234567901235,0.5098765432098765
E01008146,1334,656,678,0.4917541229385307,0.5082458770614693
E01008147,1426,688,738,0.48246844319775595,0.517531556802244
E01007888,1379,686,693,0.49746192893401014,0.5025380710659898
E01007892,1466,689,777,0.46998635743519784,0.5300136425648022
E01007893,1491,728,763,0.48826291079812206,0.5117370892018779
E01007898,1470,689,781,0.46870748299319726,0.5312925170068027
E01007899,1463,704,759,0.48120300751879697,0.518796992481203
E01007900,1694,826,868,0.48760330578512395,0.512396694214876
E01007901,1481,710,771,0.47940580688723833,0.5205941931127617
E01007887,1362,661,701,0.4853157121879589,0.5146842878120411
E01007889,2677,1339,1338,0.500186776242062,0.49981322375793796
E01007890,1442,712,730,0.49375866851595007,0.5062413314840499
E01007891,1551,775,776,0.4996776273372018,0.5003223726627982
E01007894,1458,701,757,0.48079561042524005,0.5192043895747599
E01007895,1456,695,761,0.47733516483516486,0.5226648351648352
E01007896,1280,628,652,0.490625,0.509375
E01007897,1386,699,687,0.5043290043290043,0.49567099567099565
E01008134,1331,641,690,0.48159278737791134,0.5184072126220887
E01008135,1770,864,906,0.488135593220339,0.511864406779661
E01008137,1441,676,765,0.46911866759195003,0.5308813324080499
E01008141,1591,758,833,0.4764299182903834,0.5235700817096166
E01008053,1245,611,634,0.4907630522088353,0.5092369477911647
E01008056,1497,732,765,0.48897795591182364,0.5110220440881763
E01008058,1465,715,750,0.4880546075085324,0.5119453924914675
E01008138,1302,618,684,0.47465437788018433,0.5253456221198156
E01008139,1582,782,800,0.4943109987357775,0.5056890012642224
E01007856,1317,650,667,0.4935459377372817,0.5064540622627183
E01008054,1324,623,701,0.4705438066465257,0.5294561933534743
E01008055,1485,689,796,0.463973063973064,0.5360269360269361
E01008057,1489,700,789,0.47011417058428473,0.5298858294157153
E01008126,1552,758,794,0.4884020618556701,0.5115979381443299
E01008128,1714,846,868,0.4935822637106184,0.5064177362893816
E01008136,1355,682,673,0.5033210332103321,0.4966789667896679
E01008140,1806,877,929,0.4856035437430786,0.5143964562569213
E01033275,1611,804,807,0.49906890130353815,0.5009310986964618
E01033280,1637,843,794,0.5149664019547954,0.48503359804520463
E01008085,1368,660,708,0.4824561403508772,0.5175438596491229
E01008086,1349,643,706,0.4766493699036323,0.5233506300963677
E01008116,1327,652,675,0.49133383571966843,0.5086661642803316
E01008117,1221,633,588,0.5184275184275184,0.48157248157248156
E01008118,1397,687,710,0.4917680744452398,0.5082319255547602
E01008119,1279,606,673,0.473807662236122,0.5261923377638781
E01008125,1481,707,774,0.4773801485482782,0.5226198514517219
E01007849,2113,1024,1089,0.4846190250828206,0.5153809749171794
E01007857,1557,737,820,0.4733461785484907,0.5266538214515093
E01008059,1512,700,812,0.46296296296296297,0.5370370370370371
E01008060,1386,655,731,0.4725829725829726,0.5274170274170275
E01008061,1596,744,852,0.46616541353383456,0.5338345864661654
E01008063,1541,760,781,0.49318624269954575,0.5068137573004543
E01033277,2334,1163,1171,0.49828620394173095,0.501713796058269
E01008087,1555,766,789,0.492604501607717,0.5073954983922829
E01008088,1429,703,726,0.4919524142757173,0.5080475857242828
E01008090,1624,773,851,0.47598522167487683,0.5240147783251231
E01008092,1427,696,731,0.4877365101611773,0.5122634898388227
E01008122,1350,648,702,0.48,0.52
E01008124,1499,709,790,0.47298198799199465,0.5270180120080054
E01007848,1717,811,906,0.47233546884100175,0.5276645311589983
E01007851,1483,710,773,0.4787592717464599,0.5212407282535402
E01007947,1626,794,832,0.4883148831488315,0.5116851168511685
E01007948,1757,786,971,0.4473534433693796,0.5526465566306203
E01008062,1693,796,897,0.47017129356172477,0.5298287064382753
E01007847,1297,650,647,0.5011565150346955,0.49884348496530456
E01007850,1562,743,819,0.47567221510883484,0.5243277848911652
E01007852,1482,763,719,0.5148448043184886,0.4851551956815115
E01007853,1568,775,793,0.4942602040816326,0.5057397959183674
E01007854,1735,785,950,0.45244956772334294,0.547550432276657
E01007855,2035,1023,1012,0.5027027027027027,0.4972972972972973
E01007941,1623,798,825,0.49168207024029575,0.5083179297597042
E01007945,1780,857,923,0.48146067415730337,0.5185393258426966
E01007946,1585,763,822,0.48138801261829656,0.5186119873817034
E01007950,1529,720,809,0.4708960104643558,0.5291039895356442
E01008123,1313,635,678,0.4836252856054836,0.5163747143945163
E01007987,1468,721,747,0.49114441416893734,0.5088555858310627
E01007988,1520,722,798,0.475,0.525
E01007989,1419,666,753,0.4693446088794926,0.5306553911205074
E01007991,1503,674,829,0.44843646041250834,0.5515635395874917
E01007995,1472,719,753,0.48845108695652173,0.5115489130434783
E01008089,1679,807,872,0.4806432400238237,0.5193567599761763
E01008091,1464,746,718,0.5095628415300546,0.49043715846994534
E01008093,1455,720,735,0.4948453608247423,0.5051546391752577
E01007903,1588,813,775,0.5119647355163728,0.4880352644836272
E01007904,1701,844,857,0.49617871840094063,0.5038212815990594
E01007913,1481,755,726,0.5097906819716408,0.4902093180283592
E01007914,1559,785,774,0.5035279025016036,0.4964720974983964
E01007870,1843,983,860,0.5333695062398264,0.4666304937601736
E01007871,1783,926,857,0.5193494111048794,0.4806505888951206
E01007943,1748,828,920,0.47368421052631576,0.5263157894736842
E01008094,1115,565,550,0.5067264573991032,0.49327354260089684
E01007869,1714,839,875,0.4894982497082847,0.5105017502917153
E01007872,1753,866,887,0.4940102681118083,0.5059897318881916
E01007873,1760,914,846,0.5193181818181818,0.48068181818181815
E01007942,1862,983,879,0.5279269602577873,0.47207303974221265
E01007949,1592,792,800,0.49748743718592964,0.5025125628140703
E01007990,1485,722,763,0.4861952861952862,0.5138047138047138
E01007992,1624,798,826,0.49137931034482757,0.5086206896551724
E01007993,1682,835,847,0.49643281807372175,0.5035671819262783
E01007994,1435,700,735,0.4878048780487805,0.5121951219512195
E01007996,1552,756,796,0.48711340206185566,0.5128865979381443
E01007874,1862,880,982,0.47261009667024706,0.527389903329753
E01007875,1838,994,844,0.5408052230685527,0.4591947769314472
E01007877,1446,695,751,0.4806362378976487,0.5193637621023514
E01007940,1693,826,867,0.48789131718842293,0.5121086828115771
E01007944,2058,1113,945,0.5408163265306123,0.45918367346938777
E01033269,1919,988,931,0.5148514851485149,0.48514851485148514
E01033270,1484,862,622,0.5808625336927223,0.4191374663072776
E01008129,1409,694,715,0.49254790631653655,0.5074520936834634
E01008130,1494,716,778,0.47925033467202144,0.5207496653279786
E01008131,1576,757,819,0.4803299492385787,0.5196700507614214
E01008132,1416,691,725,0.4879943502824859,0.5120056497175142
E01008133,1530,724,806,0.47320261437908495,0.526797385620915
E01008151,1539,818,721,0.5315139701104613,0.46848602988953864
E01008153,1653,837,816,0.5063520871143375,0.49364791288566245
E01008154,1628,778,850,0.47788697788697787,0.5221130221130221
E01008155,1546,792,754,0.5122897800776197,0.48771021992238034
E01008156,1449,720,729,0.4968944099378882,0.5031055900621118
E01008160,1399,660,739,0.47176554681915656,0.5282344531808435
E01007997,1479,716,763,0.4841108857336038,0.5158891142663962
E01007998,1592,807,785,0.5069095477386935,0.49309045226130654
E01008152,1426,722,704,0.5063113604488079,0.49368863955119213
E01008158,1535,730,805,0.4755700325732899,0.5244299674267101
E01008065,1922,1056,866,0.5494276795005203,0.4505723204994797
E01008068,2860,1458,1402,0.5097902097902098,0.4902097902097902
E01008072,1590,816,774,0.5132075471698113,0.4867924528301887
E01008157,1557,742,815,0.4765574823378292,0.5234425176621709
E01008161,1668,833,835,0.49940047961630696,0.500599520383693
E01007883,1322,629,693,0.47579425113464446,0.5242057488653555
E01007902,1752,930,822,0.5308219178082192,0.4691780821917808
E01007905,1770,851,919,0.4807909604519774,0.5192090395480226
E01007906,2081,1054,1027,0.5064872657376261,0.49351273426237385
E01008064,1687,850,837,0.5038529934795495,0.4961470065204505
E01008066,1598,799,799,0.5,0.5
E01008069,1617,815,802,0.5040197897340755,0.49598021026592454
E01008074,1460,760,700,0.5205479452054794,0.4794520547945205
E01007951,1585,769,816,0.48517350157728706,0.5148264984227129
E01007960,1580,762,818,0.48227848101265824,0.5177215189873418
E01007962,1465,690,775,0.4709897610921502,0.5290102389078498
E01008159,1527,735,792,0.481335952848723,0.518664047151277
E01007866,1727,886,841,0.5130283729009844,0.48697162709901565
E01007867,2010,955,1055,0.47512437810945274,0.5248756218905473
E01007868,1179,548,631,0.46480067854113655,0.5351993214588634
E01008067,1684,886,798,0.5261282660332541,0.47387173396674587
E01008073,1702,922,780,0.5417156286721504,0.4582843713278496
E01007907,1656,854,802,0.5157004830917874,0.48429951690821255
E01007908,1492,747,745,0.5006702412868632,0.49932975871313673
E01007909,2047,1019,1028,0.4978016609672692,0.5021983390327308
E01007911,1397,683,714,0.4889047959914102,0.5110952040085899
E01008014,1579,752,827,0.47625079164027867,0.5237492083597214
E01008016,1492,764,728,0.5120643431635389,0.4879356568364611
E01007952,1569,758,811,0.48311026131293816,0.5168897386870618
E01007953,1565,746,819,0.47667731629392973,0.5233226837060703
E01007954,1650,799,851,0.48424242424242425,0.5157575757575757
E01007961,1508,749,759,0.496684350132626,0.503315649867374
E01007859,1638,870,768,0.5311355311355311,0.46886446886446886
E01007860,1553,783,770,0.5041854475209272,0.49581455247907275
E01007863,1865,889,976,0.4766756032171582,0.5233243967828418
E01007864,1882,932,950,0.4952178533475027,0.5047821466524973
E01008104,1587,827,760,0.5211090107120353,0.4788909892879647
E01007910,1638,767,871,0.46825396825396826,0.5317460317460317
E01007912,1516,739,777,0.487467018469657,0.512532981530343
E01007971,1434,688,746,0.4797768479776848,0.5202231520223152
E01007973,1523,763,760,0.5009848982271832,0.4990151017728168
E01007858,1443,713,730,0.4941094941094941,0.5058905058905059
E01007861,1525,738,787,0.4839344262295082,0.5160655737704918
E01007862,4183,1985,2198,0.4745398039684437,0.5254601960315562
E01007865,1682,832,850,0.4946492271105826,0.5053507728894173
E01008011,1633,786,847,0.48132271892222905,0.518677281077771
E01008012,2144,1044,1100,0.4869402985074627,0.5130597014925373
E01008013,1168,574,594,0.4914383561643836,0.5085616438356164
E01008015,1608,836,772,0.5199004975124378,0.48009950248756217
E01008017,1588,792,796,0.4987405541561713,0.5012594458438288
E01008018,1287,599,688,0.4654234654234654,0.5345765345765345
E01008105,3329,1689,1640,0.507359567437669,0.49264043256233103
E01008107,1527,805,722,0.527177472167649,0.472822527832351
E01008111,1688,826,862,0.48933649289099523,0.5106635071090048
E01033271,1403,817,586,0.5823235923022095,0.41767640769779046
E01033272,1159,639,520,0.551337359792925,0.4486626402070751
E01007955,1371,659,712,0.48067104303428154,0.5193289569657185
E01007956,2197,1070,1127,0.48702776513427404,0.512972234865726
E01007957,1629,804,825,0.49355432780847147,0.5064456721915286
E01007958,1465,689,776,0.47030716723549487,0.5296928327645051
E01007959,1491,706,785,0.47350771294433264,0.5264922870556673
E01008108,1981,1077,904,0.5436648157496214,0.4563351842503786
E01008109,2035,1064,971,0.5228501228501229,0.47714987714987717
E01008112,1750,953,797,0.5445714285714286,0.4554285714285714
E01008113,1732,922,810,0.5323325635103926,0.4676674364896074
E01033273,2422,1246,1176,0.5144508670520231,0.48554913294797686
E01033274,2410,1130,1280,0.46887966804979253,0.5311203319502075
E01008095,1589,857,732,0.539332913782253,0.460667086217747
E01008096,2176,1023,1153,0.47012867647058826,0.5298713235294118
E01008097,1621,784,837,0.4836520666255398,0.5163479333744602
E01008101,1763,859,904,0.48723766307430516,0.5127623369256948
E01007965,1906,865,1041,0.45383001049317945,0.5461699895068206
E01007969,1557,781,776,0.5016056518946692,0.4983943481053308
E01007972,1473,707,766,0.47997284453496264,0.5200271554650373
E01007974,1468,722,746,0.49182561307901906,0.5081743869209809
E01007963,1443,713,730,0.4941094941094941,0.5058905058905059
E01007967,1668,821,847,0.4922062350119904,0.5077937649880095
E01007999,1349,678,671,0.502594514455152,0.49740548554484804
E01008008,1648,759,889,0.46055825242718446,0.5394417475728155
E01008009,1547,713,834,0.4608920491273432,0.5391079508726567
E01008043,1730,847,883,0.48959537572254336,0.5104046242774567
E01008044,1615,770,845,0.47678018575851394,0.5232198142414861
E01008047,1509,782,727,0.5182239893969516,0.48177601060304837
E01008048,1534,793,741,0.5169491525423728,0.4830508474576271
E01008050,1411,727,684,0.5152374202693125,0.4847625797306875
E01007931,1604,762,842,0.47506234413965087,0.5249376558603491
E01007934,1468,709,759,0.4829700272479564,0.5170299727520435
E01007935,1419,683,736,0.4813248766737139,0.5186751233262861
E01007936,1590,752,838,0.4729559748427673,0.5270440251572327
E01007937,1395,682,713,0.4888888888888889,0.5111111111111111
E01007938,1509,713,796,0.47249834327369117,0.5275016567263088
E01008098,1590,740,850,0.46540880503144655,0.5345911949685535
E01008100,1265,587,678,0.46403162055335967,0.5359683794466403
E01008102,1115,517,598,0.46367713004484307,0.536322869955157
E01008103,1410,676,734,0.4794326241134752,0.5205673758865248
E01007964,1529,752,777,0.4918247220405494,0.5081752779594506
E01007966,1551,753,798,0.48549323017408125,0.5145067698259188
E01007968,1467,703,764,0.47920927062031354,0.5207907293796864
E01007970,1577,830,747,0.5263157894736842,0.47368421052631576
E01008042,1634,852,782,0.5214198286413708,0.4785801713586291
E01008045,1393,696,697,0.4996410624551328,0.5003589375448672
E01008046,1659,832,827,0.5015069318866787,0.4984930681133213
E01008049,1589,775,814,0.48772813089993705,0.512271869100063
E01008051,1762,924,838,0.5244040862656073,0.47559591373439275
E01008052,1794,958,836,0.5340022296544036,0.4659977703455964
E01007975,1636,828,808,0.5061124694376528,0.4938875305623472
E01007976,1485,708,777,0.4767676767676768,0.5232323232323233
E01007977,1496,750,746,0.5013368983957219,0.49866310160427807
E01007979,1634,721,913,0.4412484700122399,0.5587515299877601
E01008099,1598,823,775,0.5150187734668336,0.48498122653316644
E01008000,1503,729,774,0.48502994011976047,0.5149700598802395
E01008001,1535,741,794,0.4827361563517915,0.5172638436482084
E01008004,1606,752,854,0.46824408468244083,0.5317559153175592
E01008005,1546,757,789,0.4896507115135834,0.5103492884864166
E01008010,1454,688,766,0.4731774415405777,0.5268225584594223
E01007978,1664,844,820,0.5072115384615384,0.49278846153846156
E01007980,1544,738,806,0.47797927461139894,0.522020725388601
E01007981,1448,744,704,0.5138121546961326,0.4861878453038674
E01007983,1483,731,752,0.49291975724882,0.50708024275118
E01007985,1555,764,791,0.49131832797427655,0.5086816720257235
E01007982,1821,923,898,0.5068643602416255,0.49313563975837454
E01008002,1565,773,792,0.4939297124600639,0.5060702875399361
E01008003,1410,681,729,0.4829787234042553,0.5170212765957447
E01008006,1362,658,704,0.4831130690161527,0.5168869309838473
E01007927,1672,817,855,0.48863636363636365,0.5113636363636364
E01007928,1751,850,901,0.4854368932038835,0.5145631067961165
E01007929,1628,816,812,0.5012285012285013,0.4987714987714988
E01007930,1476,697,779,0.4722222222222222,0.5277777777777778
E01007932,1415,687,728,0.48551236749116605,0.5144876325088339
E01007939,1534,733,801,0.47783572359843546,0.5221642764015645
E01008028,1547,749,798,0.4841628959276018,0.5158371040723982
E01008029,1496,739,757,0.4939839572192513,0.5060160427807486
E01008032,1407,672,735,0.47761194029850745,0.5223880597014925
E01008034,1745,837,908,0.4796561604584527,0.5203438395415473
E01007828,1710,780,930,0.45614035087719296,0.543859649122807
E01007829,1562,784,778,0.5019206145966709,0.4980793854033291
E01007831,1523,716,807,0.4701247537754432,0.5298752462245568
E01007832,1543,744,799,0.48217757615035645,0.5178224238496435
E01007986,1369,685,684,0.5003652300949598,0.4996347699050402
E01008007,1698,849,849,0.5,0.5
E01008075,1441,685,756,0.4753643303261624,0.5246356696738376
E01008076,1352,648,704,0.47928994082840237,0.5207100591715976
E01008077,1461,684,777,0.4681724845995893,0.5318275154004107
E01008031,1436,701,735,0.4881615598885794,0.5118384401114207
E01008033,1290,630,660,0.4883720930232558,0.5116279069767442
E01008038,1535,734,801,0.4781758957654723,0.5218241042345277
E01008040,1704,845,859,0.49589201877934275,0.5041079812206573
E01007835,1442,691,751,0.4791955617198336,0.5208044382801664
E01007836,1631,797,834,0.48865726548129984,0.5113427345187002
E01007843,1600,780,820,0.4875,0.5125
E01007846,1494,712,782,0.47657295850066933,0.5234270414993306
E01008030,1456,714,742,0.49038461538461536,0.5096153846153846
E01008035,1195,617,578,0.5163179916317991,0.48368200836820086
E01008036,1427,723,704,0.5066573230553609,0.4933426769446391
E01008041,1519,742,777,0.48847926267281105,0.511520737327189
E01007827,1504,754,750,0.5013297872340425,0.49867021276595747
E01007830,1547,739,808,0.4776987718164189,0.5223012281835812
E01007833,1648,789,859,0.4787621359223301,0.5212378640776699
E01007984,1435,711,724,0.49547038327526133,0.5045296167247387
E01008078,1335,649,686,0.4861423220973783,0.5138576779026217
E01008079,1235,609,626,0.4931174089068826,0.5068825910931174
E01008019,1866,900,966,0.48231511254019294,0.5176848874598071
E01008020,1434,727,707,0.50697350069735,0.4930264993026499
E01008022,1513,770,743,0.5089226701916721,0.4910773298083278
E01008027,1532,750,782,0.489556135770235,0.5104438642297651
E01008037,1392,629,763,0.45186781609195403,0.548132183908046
E01008039,1312,625,687,0.4763719512195122,0.5236280487804879
E01007824,1393,684,709,0.4910265613783202,0.5089734386216799
E01007825,1457,682,775,0.46808510638297873,0.5319148936170213
E01007826,1526,749,777,0.4908256880733945,0.5091743119266054
E01007834,1654,771,883,0.466142684401451,0.533857315598549
E01007920,1638,784,854,0.47863247863247865,0.5213675213675214
E01007921,1571,726,845,0.4621260343730108,0.5378739656269892
E01007923,1802,859,943,0.47669256381798003,0.52330743618202
E01007925,1630,789,841,0.4840490797546012,0.5159509202453988
E01007926,1714,819,895,0.47782963827304553,0.5221703617269545
E01007933,1663,809,854,0.4864702345159351,0.5135297654840649
E01007823,1658,791,867,0.47708082026537996,0.52291917973462
E01007916,1529,733,796,0.47939829954218444,0.5206017004578156
E01007919,1603,757,846,0.47223955084217095,0.527760449157829
E01008080,1483,735,748,0.49561699258260283,0.5043830074173972
E01008081,1481,784,697,0.5293720459149224,0.4706279540850776
E01008082,1488,711,777,0.4778225806451613,0.5221774193548387
E01008083,1514,699,815,0.4616908850726552,0.5383091149273448
E01008084,1644,791,853,0.4811435523114355,0.5188564476885644
E01007915,1415,663,752,0.4685512367491166,0.5314487632508834
E01007917,1460,699,761,0.47876712328767124,0.5212328767123288
E01007918,1635,778,857,0.4758409785932722,0.5241590214067279
E01007922,1406,690,716,0.4907539118065434,0.5092460881934566
E01007924,1543,768,775,0.49773169151004537,0.5022683084899546
E01008021,1472,732,740,0.49728260869565216,0.5027173913043478
E01008023,2110,1087,1023,0.5151658767772512,0.4848341232227488
E01008024,1786,869,917,0.486562150055991,0.513437849944009
E01008025,2021,989,1032,0.48936170212765956,0.5106382978723404
E01032585,1409,691,718,0.49041873669268987,0.5095812633073101
E01033261,1767,901,866,0.5099037917374081,0.490096208262592
E01033262,1749,1064,685,0.6083476272155517,0.39165237278444825
E01033263,1330,692,638,0.5203007518796993,0.47969924812030074
E01033264,1487,698,789,0.4694014794889038,0.5305985205110961
E01033276,2923,1570,1353,0.5371193978788915,0.46288060212110843
E01008114,2615,1295,1320,0.49521988527724664,0.5047801147227533
E01008115,1817,1029,788,0.5663181067694001,0.4336818932305999
E01033265,1304,756,548,0.5797546012269938,0.42024539877300615
E01033266,1611,879,732,0.5456238361266295,0.4543761638733706
E01033267,1387,656,731,0.47296322999279017,0.5270367700072098
E01007878,1716,1022,694,0.5955710955710956,0.40442890442890445
E01007879,1646,854,792,0.5188335358444714,0.48116646415552855
E01007881,1609,823,786,0.5114978247358608,0.4885021752641392
E01007882,1637,936,701,0.5717776420281002,0.42822235797189984
E01007885,1557,774,783,0.49710982658959535,0.5028901734104047
E01007886,1623,739,884,0.4553296364756624,0.5446703635243376
E01033268,2373,1333,1040,0.5617361989043405,0.4382638010956595
E01007838,1507,731,776,0.48506967485069674,0.5149303251493033
E01007839,1635,803,832,0.491131498470948,0.5088685015290519
E01007841,1665,793,872,0.4762762762762763,0.5237237237237238
E01007842,1575,741,834,0.4704761904761905,0.5295238095238095
E01033278,2431,1145,1286,0.4709995886466475,0.5290004113533525
E01033279,2378,1179,1199,0.49579478553406225,0.5042052144659378
E01010646,1319,639,680,0.4844579226686884,0.5155420773313116
E01010647,1091,518,573,0.4747937671860678,0.5252062328139322
E01010648,1320,637,683,0.4825757575757576,0.5174242424242425
E01010692,1864,912,952,0.4892703862660944,0.5107296137339056
E01010691,1528,707,821,0.462696335078534,0.537303664921466
E01010693,1549,719,830,0.4641704325371207,0.5358295674628792
E01010694,1576,741,835,0.47017766497461927,0.5298223350253807
E01010695,1664,758,906,0.45552884615384615,0.5444711538461539
E01010696,1548,744,804,0.4806201550387597,0.5193798449612403
E01010697,1515,706,809,0.466006600660066,0.533993399339934
E01010698,1808,888,920,0.4911504424778761,0.5088495575221239
E01010699,1757,804,953,0.45759817871371655,0.5424018212862834
E01010767,1450,688,762,0.47448275862068967,0.5255172413793103
E01010768,1659,815,844,0.4912597950572634,0.5087402049427366
E01010769,1579,723,856,0.4578847371754275,0.5421152628245726
E01010771,1260,641,619,0.5087301587301587,0.49126984126984125
E01010638,1523,731,792,0.4799737360472751,0.5200262639527249
E01010639,1762,885,877,0.5022701475595914,0.4977298524404086
E01010640,1691,812,879,0.48018923713778827,0.5198107628622117
E01010641,1528,708,820,0.46335078534031415,0.5366492146596858
E01010642,1764,858,906,0.48639455782312924,0.5136054421768708
E01010643,1423,687,736,0.48278285312719604,0.517217146872804
E01010644,1614,766,848,0.4745972738537794,0.5254027261462205
E01010645,1338,629,709,0.4701046337817638,0.5298953662182362
E01010770,1629,817,812,0.5015346838551259,0.49846531614487416
E01010772,1270,617,653,0.4858267716535433,0.5141732283464567
E01010773,1400,697,703,0.49785714285714283,0.5021428571428571
E01010774,1589,732,857,0.460667086217747,0.539332913782253
E01010706,1671,818,853,0.48952722920406944,0.5104727707959306
E01010707,1736,849,887,0.4890552995391705,0.5109447004608295
E01010708,1656,812,844,0.49033816425120774,0.5096618357487923
E01010709,2663,1301,1362,0.4885467517837026,0.5114532482162975
E01010719,1721,862,859,0.5008715862870424,0.4991284137129576
E01010727,1718,859,859,0.5,0.5
E01010728,1800,888,912,0.49333333333333335,0.5066666666666667
E01010729,1603,765,838,0.47723019338739864,0.5227698066126014
E01010700,1533,771,762,0.50293542074364,0.49706457925636005
E01010701,1474,732,742,0.4966078697421981,0.5033921302578019
E01010702,2145,1067,1078,0.49743589743589745,0.5025641025641026
E01010703,1642,770,872,0.4689403166869671,0.5310596833130329
E01010704,1461,759,702,0.5195071868583162,0.4804928131416838
E01010705,1699,824,875,0.4849911712772219,0.5150088287227781
E01010710,2047,1124,923,0.5490962383976551,0.4509037616023449
E01010712,1771,885,886,0.4997176736307171,0.5002823263692829
E01010720,1571,746,825,0.4748567791215786,0.5251432208784214
E01010721,1450,709,741,0.4889655172413793,0.5110344827586207
E01010723,1614,837,777,0.5185873605947955,0.48141263940520446
E01010724,1452,687,765,0.4731404958677686,0.5268595041322314
E01010725,1555,731,824,0.470096463022508,0.5299035369774919
E01010579,1574,748,826,0.47522236340533675,0.5247776365946633
E01010580,2499,1199,1300,0.4797919167667067,0.5202080832332934
E01010764,1637,820,817,0.5009163103237629,0.499083689676237
E01010765,2227,1082,1145,0.48585541086663675,0.5141445891333633
E01010766,1302,640,662,0.4915514592933948,0.5084485407066052
E01010711,1401,743,658,0.5303354746609564,0.4696645253390435
E01010713,1350,651,699,0.4822222222222222,0.5177777777777778
E01010714,1393,664,729,0.4766690595836324,0.5233309404163675
E01010716,1865,916,949,0.49115281501340485,0.5088471849865952
E01010715,1144,526,618,0.4597902097902098,0.5402097902097902
E01010717,1606,746,860,0.46450809464508097,0.5354919053549191
E01010718,1583,775,808,0.4895767530006317,0.5104232469993683
E01010726,1517,724,793,0.4772577455504285,0.5227422544495716
E01010859,1650,806,844,0.48848484848484847,0.5115151515151515
E01010573,1782,894,888,0.5016835016835017,0.4983164983164983
E01010574,1400,647,753,0.46214285714285713,0.5378571428571428
E01010575,1619,810,809,0.5003088326127239,0.4996911673872761
E01010577,1592,765,827,0.4805276381909548,0.5194723618090452
E01010722,1584,765,819,0.48295454545454547,0.5170454545454546
E01010860,1549,763,786,0.4925758553905746,0.5074241446094254
E01010862,1726,832,894,0.4820393974507532,0.5179606025492468
E01010863,1505,750,755,0.4983388704318937,0.5016611295681063
E01010578,1531,780,751,0.5094709340300457,0.49052906596995427
E01010581,1686,835,851,0.49525504151838673,0.5047449584816133
E01010582,1629,843,786,0.5174953959484346,0.48250460405156537
E01010584,1747,901,846,0.5157412707498569,0.4842587292501431
E01010585,1924,901,1023,0.4682952182952183,0.5317047817047817
E01010568,1782,896,886,0.5028058361391695,0.49719416386083054
E01010569,1712,802,910,0.46845794392523366,0.5315420560747663
E01010571,1649,815,834,0.4942389326864767,0.5057610673135233
E01010572,1450,671,779,0.4627586206896552,0.5372413793103449
E01010576,1546,728,818,0.47089262613195343,0.5291073738680466
E01010683,1613,816,797,0.5058896466212027,0.4941103533787973
E01010684,1523,703,820,0.46158896913985553,0.5384110308601444
E01010685,1654,812,842,0.4909310761789601,0.5090689238210399
E01010686,1617,810,807,0.5009276437847866,0.49907235621521334
E01010570,1412,698,714,0.4943342776203966,0.5056657223796034
E01010583,1620,815,805,0.5030864197530864,0.49691358024691357
E01010784,1592,759,833,0.47675879396984927,0.5232412060301508
E01010785,1568,740,828,0.4719387755102041,0.5280612244897959
E01010786,1545,747,798,0.48349514563106794,0.516504854368932
E01010790,1479,711,768,0.48073022312373226,0.5192697768762677
E01010680,1778,882,896,0.49606299212598426,0.5039370078740157
E01010681,1385,704,681,0.5083032490974729,0.49169675090252707
E01010682,1508,676,832,0.4482758620689655,0.5517241379310345
E01010687,1853,913,940,0.49271451699946034,0.5072854830005397
E01010688,1880,973,907,0.5175531914893617,0.4824468085106383
E01010689,1696,819,877,0.4829009433962264,0.5170990566037735
E01010690,1922,942,980,0.49011446409989595,0.5098855359001041
E01010782,1747,861,886,0.4928448769318832,0.5071551230681167
E01010787,1591,772,819,0.4852294154619736,0.5147705845380264
E01010788,1484,739,745,0.49797843665768193,0.5020215633423181
E01033689,1196,679,517,0.5677257525083612,0.4322742474916388
E01033694,1011,526,485,0.5202769535113749,0.4797230464886251
E01010776,1681,835,846,0.49672813801308746,0.5032718619869125
E01010777,1482,733,749,0.49460188933873145,0.5053981106612686
E01010779,1420,674,746,0.47464788732394364,0.5253521126760563
E01010781,1501,740,761,0.49300466355762823,0.5069953364423717
E01010783,1571,751,820,0.47803946530872055,0.5219605346912795
E01010586,1600,790,810,0.49375,0.50625
E01010587,1859,899,960,0.4835933297471759,0.516406670252824
E01010588,1665,801,864,0.4810810810810811,0.518918918918919
E01010589,1516,719,797,0.4742744063324538,0.5257255936675461
E01010591,1524,731,793,0.47965879265091865,0.5203412073490814
E01010593,1768,803,965,0.45418552036199095,0.545814479638009
E01010596,1462,721,741,0.49316005471956226,0.5068399452804377
E01010854,1756,870,886,0.49544419134396356,0.5045558086560364
E01010855,1755,874,881,0.498005698005698,0.501994301994302
E01010856,1601,787,814,0.4915677701436602,0.5084322298563397
E01010857,1580,789,791,0.49936708860759493,0.5006329113924051
E01010858,1584,742,842,0.4684343434343434,0.5315656565656566
E01010861,1837,907,930,0.49373979314099076,0.5062602068590093
E01010603,1646,822,824,0.4993924665856622,0.5006075334143378
E01010604,1809,882,927,0.48756218905472637,0.5124378109452736
E01010605,1541,752,789,0.4879948085658663,0.5120051914341337
E01010775,1849,928,921,0.5018929150892374,0.49810708491076255
E01010778,1876,917,959,0.48880597014925375,0.5111940298507462
E01010789,1799,889,910,0.49416342412451364,0.5058365758754864
E01010791,1747,850,897,0.48654836863194045,0.5134516313680595
E01010792,1876,944,932,0.5031982942430704,0.4968017057569296
E01010793,1953,1036,917,0.5304659498207885,0.46953405017921146
E01010652,1554,730,824,0.4697554697554698,0.5302445302445302
E01010653,1572,739,833,0.47010178117048346,0.5298982188295165
E01010655,1446,695,751,0.4806362378976487,0.5193637621023514
E01010656,1507,741,766,0.49170537491705374,0.5082946250829462
E01010657,1542,738,804,0.4785992217898833,0.5214007782101168
E01010649,1395,694,701,0.4974910394265233,0.5025089605734767
E01010650,1647,763,884,0.4632665452337584,0.5367334547662417
E01010654,1398,662,736,0.47353361945636624,0.5264663805436338
E01010826,1468,716,752,0.4877384196185286,0.5122615803814714
E01010597,1518,758,760,0.4993412384716733,0.5006587615283268
E01010598,1751,846,905,0.48315248429468877,0.5168475157053113
E01010599,1376,675,701,0.49055232558139533,0.5094476744186046
E01010600,1433,686,747,0.47871598046057223,0.5212840195394278
E01010602,1549,733,816,0.47320852162685606,0.526791478373144
E01010670,1699,888,811,0.5226603884638023,0.47733961153619775
E01010671,1694,844,850,0.4982290436835891,0.5017709563164109
E01010673,1816,903,913,0.4972466960352423,0.5027533039647577
E01010675,1990,946,1044,0.47537688442211057,0.5246231155778894
E01010669,1934,929,1005,0.48035160289555323,0.5196483971044468
E01010674,1627,798,829,0.49047326367547633,0.5095267363245236
E01010677,2129,1014,1115,0.47627994363550963,0.5237200563644904
E01010805,1604,804,800,0.5012468827930174,0.49875311720698257
E01010590,1796,844,952,0.46993318485523383,0.5300668151447662
E01010592,1460,685,775,0.4691780821917808,0.5308219178082192
E01010594,1690,823,867,0.48698224852071004,0.51301775147929
E01010595,1799,894,905,0.49694274596998333,0.5030572540300167
E01010601,1728,857,871,0.49594907407407407,0.5040509259259259
E01010651,1521,749,772,0.49243918474687703,0.5075608152531229
E01010825,1346,667,679,0.49554234769687966,0.5044576523031203
E01010827,1322,618,704,0.46747352496217853,0.5325264750378215
E01010804,2330,1185,1145,0.5085836909871244,0.49141630901287553
E01010806,1581,762,819,0.4819734345351044,0.5180265654648957
E01010807,2094,1068,1026,0.5100286532951289,0.4899713467048711
E01010808,2275,1148,1127,0.5046153846153846,0.49538461538461537
E01010809,2235,1096,1139,0.49038031319910513,0.5096196868008949
E01010676,2439,1165,1274,0.4776547765477655,0.5223452234522346
E01010679,1746,954,792,0.5463917525773195,0.4536082474226804
E01010824,1689,947,742,0.5606867969212552,0.43931320307874483
E01010840,1664,808,856,0.4855769230769231,0.5144230769230769
E01010841,1827,968,859,0.5298303229337712,0.4701696770662288
E01010828,1624,783,841,0.48214285714285715,0.5178571428571429
E01010829,1650,826,824,0.5006060606060606,0.4993939393939394
E01010830,1836,913,923,0.49727668845315903,0.5027233115468409
E01010831,1995,1028,967,0.5152882205513785,0.48471177944862154
E01010832,1750,825,925,0.4714285714285714,0.5285714285714286
E01010672,1301,644,657,0.49500384319754037,0.5049961568024597
E01010678,1345,671,674,0.4988847583643123,0.5011152416356878
E01010799,1518,729,789,0.48023715415019763,0.5197628458498024
E01010800,1759,819,940,0.46560545764639,0.5343945423536101
E01010801,1831,898,933,0.4904423812124522,0.5095576187875478
E01010802,1600,776,824,0.485,0.515
E01010803,1809,968,841,0.53510226644555,0.46489773355444997
E01010810,2055,1025,1030,0.49878345498783455,0.5012165450121655
E01010811,2202,1061,1141,0.4818346957311535,0.5181653042688465
E01010813,1811,908,903,0.5013804527885146,0.4986195472114854
E01010618,1704,877,827,0.5146713615023474,0.48532863849765256
E01010619,2240,1094,1146,0.48839285714285713,0.5116071428571428
E01010625,1731,854,877,0.49335644136337375,0.5066435586366262
E01010626,2009,980,1029,0.4878048780487805,0.5121951219512195
E01010627,1604,786,818,0.49002493765586036,0.5099750623441397
E01010606,1998,1054,944,0.5275275275275275,0.4724724724724725
E01010607,2072,1043,1029,0.5033783783783784,0.4966216216216216
E01010617,1403,695,708,0.4953670705630791,0.5046329294369208
E01010842,1945,1004,941,0.5161953727506426,0.4838046272493573
E01033690,1138,704,434,0.6186291739894552,0.38137082601054484
E01033691,1524,847,677,0.5557742782152231,0.44422572178477693
E01033692,1079,636,443,0.5894346617238183,0.41056533827618164
E01033693,2417,1266,1151,0.5237898220935043,0.47621017790649567
E01010628,1727,830,897,0.4806022003474233,0.5193977996525767
E01010629,1928,920,1008,0.47717842323651455,0.5228215767634855
E01010630,1574,751,823,0.4771283354510801,0.52287166454892
E01010631,1544,713,831,0.46178756476683935,0.5382124352331606
E01010632,1338,654,684,0.48878923766816146,0.5112107623318386
E01010658,1989,1006,983,0.5057817998994469,0.49421820010055306
E01010812,2044,1039,1005,0.5083170254403131,0.4916829745596869
E01010833,1663,850,813,0.5111244738424534,0.4888755261575466
E01010843,2125,1101,1024,0.5181176470588236,0.4818823529411765
E01010620,1826,913,913,0.5,0.5
E01010621,2371,1190,1181,0.5018979333614508,0.4981020666385491
E01010622,2436,1235,1201,0.5069786535303776,0.4930213464696223
E01010623,1682,880,802,0.5231866825208086,0.4768133174791914
E01010624,2274,1156,1118,0.5083553210202286,0.4916446789797713
E01010794,1835,887,948,0.4833787465940054,0.5166212534059945
E01010795,1796,892,904,0.49665924276169265,0.5033407572383074
E01010796,1619,790,829,0.48795552810376774,0.5120444718962323
E01010797,1406,699,707,0.4971550497866287,0.5028449502133713
E01010798,1584,772,812,0.48737373737373735,0.5126262626262627
E01010834,3721,2088,1633,0.5611394786347756,0.4388605213652244
E01010835,3196,1674,1522,0.5237797246558198,0.4762202753441802
E01010836,2249,1219,1030,0.5420186749666518,0.45798132503334815
E01010837,2188,1120,1068,0.5118829981718465,0.48811700182815354
E01010838,1920,1009,911,0.5255208333333333,0.4744791666666667
E01010839,1664,864,800,0.5192307692307693,0.4807692307692308
E01010608,1884,939,945,0.4984076433121019,0.5015923566878981
E01010613,1477,684,793,0.4631008801624915,0.5368991198375085
E01010730,1568,880,688,0.5612244897959183,0.4387755102040816
E01010734,1574,801,773,0.5088945362134689,0.49110546378653114
E01010609,1542,723,819,0.4688715953307393,0.5311284046692607
E01010610,1573,735,838,0.4672600127145582,0.5327399872854418
E01010611,2210,1135,1075,0.5135746606334841,0.48642533936651583
E01010614,1470,782,688,0.5319727891156463,0.46802721088435373
E01010633,1563,742,821,0.47472808701215613,0.5252719129878439
E01010634,1488,723,765,0.48588709677419356,0.5141129032258065
E01010635,1453,695,758,0.4783207157604955,0.5216792842395045
E01010636,1757,811,946,0.46158224245873647,0.5384177575412635
E01010637,1883,631,1252,0.3351035581518853,0.6648964418481147
E01010731,1768,1029,739,0.5820135746606335,0.41798642533936653
E01010732,2066,1113,953,0.5387221684414327,0.4612778315585673
E01010733,1885,982,903,0.5209549071618037,0.4790450928381963
E01010736,2049,1051,998,0.5129331381161543,0.4870668618838458
E01010737,1734,872,862,0.5028835063437139,0.497116493656286
E01010659,1876,893,983,0.47601279317697226,0.5239872068230277
E01010662,1376,663,713,0.48183139534883723,0.5181686046511628
E01010664,1523,742,781,0.48719632304661853,0.5128036769533815
E01010761,1637,778,859,0.4752596212583995,0.5247403787416005
E01033695,1975,980,995,0.4962025316455696,0.5037974683544304
E01033696,1533,742,791,0.4840182648401826,0.5159817351598174
E01033697,2837,1441,1396,0.5079309129362002,0.4920690870637998
E01010663,1641,816,825,0.49725776965265084,0.5027422303473492
E01010665,1661,800,861,0.481637567730283,0.518362432269717
E01010666,1551,706,845,0.4551901998710509,0.5448098001289491
E01010667,1605,807,798,0.502803738317757,0.497196261682243
E01010735,1776,876,900,0.49324324324324326,0.5067567567567568
E01010738,2032,1059,973,0.5211614173228346,0.47883858267716534
E01010739,1789,893,896,0.4991615427613192,0.5008384572386808
E01010740,1816,918,898,0.5055066079295154,0.4944933920704846
E01010744,1825,917,908,0.5024657534246575,0.49753424657534245
E01010612,1377,669,708,0.485838779956427,0.514161220043573
E01010819,1573,712,861,0.452638270820089,0.547361729179911
E01010820,1525,723,802,0.4740983606557377,0.5259016393442623
E01010821,2046,997,1049,0.48729227761485827,0.5127077223851417
E01010822,1412,674,738,0.4773371104815864,0.5226628895184136
E01010615,1419,697,722,0.49119097956307256,0.5088090204369274
E01010616,1859,892,967,0.47982786444324904,0.5201721355567509
E01010742,1988,993,995,0.4994969818913481,0.5005030181086519
E01010743,1817,935,882,0.5145844799119428,0.4854155200880572
E01010847,1579,768,811,0.4863837872070931,0.5136162127929069
E01010848,1504,706,798,0.46941489361702127,0.5305851063829787
E01010852,1594,756,838,0.4742785445420326,0.5257214554579673
E01010853,1325,648,677,0.4890566037735849,0.510943396226415
E01010668,1356,670,686,0.4941002949852507,0.5058997050147492
E01010755,1673,777,896,0.46443514644351463,0.5355648535564853
E01010762,1594,766,828,0.48055207026348806,0.5194479297365119
E01010763,1531,721,810,0.47093403004572176,0.5290659699542782
E01010846,2150,1036,1114,0.48186046511627906,0.5181395348837209
E01010745,1657,803,854,0.48461074230537116,0.5153892576946288
E01010747,1614,793,821,0.4913258983890954,0.5086741016109045
E01010748,1507,692,815,0.45919044459190445,0.5408095554080955
E01010749,1344,647,697,0.48139880952380953,0.5186011904761905
E01010814,1652,816,836,0.4939467312348668,0.5060532687651331
E01010815,2397,1160,1237,0.48393825615352526,0.5160617438464747
E01010816,1873,936,937,0.4997330485851575,0.5002669514148425
E01010817,2186,1021,1165,0.4670631290027447,0.5329368709972553
E01010818,1856,918,938,0.49461206896551724,0.5053879310344828
E01010752,1733,859,874,0.4956722446624351,0.5043277553375649
E01010753,1437,691,746,0.48086290883785665,0.5191370911621433
E01010754,1607,784,823,0.4878655880522713,0.5121344119477287
E01010756,1478,710,768,0.4803788903924222,0.5196211096075778
E01010758,1290,630,660,0.4883720930232558,0.5116279069767442
E01010759,1565,773,792,0.4939297124600639,0.5060702875399361
E01010760,1576,771,805,0.48921319796954316,0.5107868020304569
E01010741,1487,747,740,0.5023537323470074,0.4976462676529926
E01010845,2031,936,1095,0.4608567208271787,0.5391432791728212
E01010849,1429,707,722,0.4947515745276417,0.5052484254723583
E01010850,1381,633,748,0.45836350470673426,0.5416364952932657
E01010851,1585,773,812,0.48769716088328074,0.5123028391167193
E01010864,1320,648,672,0.4909090909090909,0.509090909090909
E01010867,1468,724,744,0.49318801089918257,0.5068119891008175
E01010874,1240,564,676,0.45483870967741935,0.5451612903225806
E01010746,1628,780,848,0.47911547911547914,0.5208845208845209
E01010750,1617,768,849,0.4749536178107607,0.5250463821892394
E01010751,1509,733,776,0.48575215374420144,0.5142478462557986
E01010865,1618,791,827,0.4888751545117429,0.5111248454882571
E01010866,1379,667,712,0.48368382886149386,0.5163161711385061
E01010868,1602,801,801,0.5,0.5
E01010869,1694,804,890,0.47461629279811096,0.525383707201889
E01010870,1503,750,753,0.499001996007984,0.500998003992016
E01010871,1686,820,866,0.4863582443653618,0.5136417556346382
E01010872,1627,791,836,0.4861708666256915,0.5138291333743086
E01010873,1224,590,634,0.4820261437908497,0.5179738562091504
E01010911,1713,838,875,0.4892002335084647,0.5107997664915354
E01010912,1586,748,838,0.47162673392181587,0.5283732660781841
E01010913,1283,633,650,0.49337490257209665,0.5066250974279034
E01010915,1429,703,726,0.4919524142757173,0.5080475857242828
E01010914,1841,877,964,0.4763715372080391,0.5236284627919608
E01010924,1186,623,563,0.5252951096121417,0.47470489038785835
E01010925,1404,673,731,0.4793447293447293,0.5206552706552706
E01010926,1196,557,639,0.4657190635451505,0.5342809364548495
E01010931,1406,675,731,0.4800853485064011,0.5199146514935988
E01010932,1547,765,782,0.4945054945054945,0.5054945054945055
E01010933,1578,747,831,0.47338403041825095,0.526615969581749
E01010935,1560,750,810,0.4807692307692308,0.5192307692307693
E01010936,2000,958,1042,0.479,0.521
E01010937,1560,774,786,0.49615384615384617,0.5038461538461538
E01010881,1652,778,874,0.47094430992736075,0.5290556900726392
E01010882,1448,682,766,0.47099447513812154,0.5290055248618785
E01010883,1533,763,770,0.4977168949771689,0.502283105022831
E01010887,1609,799,810,0.49658172778123055,0.5034182722187694
E01010888,1531,725,806,0.47354670150228606,0.5264532984977139
E01010923,1601,773,828,0.48282323547782635,0.5171767645221736
E01010916,1427,674,753,0.47231955150665733,0.5276804484933427
E01010939,1766,874,892,0.49490373725934317,0.5050962627406569
E01010941,1346,630,716,0.46805349182763745,0.5319465081723626
E01010942,1605,810,795,0.5046728971962616,0.4953271028037383
E01010944,1379,681,698,0.4938361131254532,0.5061638868745467
E01010938,1427,670,757,0.4695164681149264,0.5304835318850736
E01010940,1437,708,729,0.49269311064718163,0.5073068893528184
E01010943,1495,725,770,0.48494983277591974,0.5150501672240803
E01010961,1163,579,584,0.49785038693035255,0.5021496130696474
E01010917,1814,872,942,0.4807056229327453,0.5192943770672547
E01010918,1695,810,885,0.4778761061946903,0.5221238938053098
E01010919,1591,745,846,0.46825895663104966,0.5317410433689503
E01010920,1670,855,815,0.5119760479041916,0.4880239520958084
E01010921,1640,805,835,0.49085365853658536,0.5091463414634146
E01010934,1967,962,1005,0.48906964921199797,0.5109303507880021
E01010967,1504,768,736,0.5106382978723404,0.48936170212765956
E01010994,1727,934,793,0.540822235089751,0.459177764910249
E01032923,2313,1172,1141,0.5067012537829658,0.4932987462170342
E01010927,1657,797,860,0.48098974049487025,0.5190102595051298
E01010928,1415,646,769,0.4565371024734982,0.5434628975265018
E01010997,1455,703,752,0.4831615120274914,0.5168384879725086
E01010999,1498,745,753,0.49732977303070763,0.5026702269692924
E01010929,2369,1190,1179,0.5023216547066273,0.49767834529337274
E01010930,1576,731,845,0.46383248730964466,0.5361675126903553
E01010998,1611,792,819,0.49162011173184356,0.5083798882681564
E01011000,2060,1005,1055,0.4878640776699029,0.5121359223300971
E01010904,1395,702,693,0.5032258064516129,0.4967741935483871
E01010906,1411,707,704,0.5010630758327428,0.49893692416725727
E01010907,1436,724,712,0.5041782729805014,0.4958217270194986
E01010909,1521,696,825,0.45759368836291914,0.5424063116370809
E01010960,1692,846,846,0.5,0.5
E01010964,1629,804,825,0.49355432780847147,0.5064456721915286
E01010965,1473,758,715,0.5145960624575696,0.48540393754243044
E01010966,1691,844,847,0.4991129509166174,0.5008870490833827
E01010995,1351,720,631,0.532938564026647,0.4670614359733531
E01010982,1336,626,710,0.468562874251497,0.531437125748503
E01010983,1610,792,818,0.4919254658385093,0.5080745341614907
E01010985,1416,709,707,0.5007062146892656,0.4992937853107345
E01010986,1690,830,860,0.4911242603550296,0.5088757396449705
E01010987,1791,827,964,0.4617532104969291,0.5382467895030709
E01010988,1474,699,775,0.47421981004070557,0.5257801899592944
E01010996,1603,800,803,0.4990642545227698,0.5009357454772302
E01011001,1640,815,825,0.4969512195121951,0.5030487804878049
E01011002,1745,869,876,0.49799426934097424,0.5020057306590258
E01011003,1214,648,566,0.5337726523887973,0.46622734761120266
E01010878,1756,900,856,0.5125284738041003,0.4874715261958998
E01010879,1834,895,939,0.48800436205016356,0.5119956379498364
E01010905,1865,882,983,0.47292225201072385,0.5270777479892761
E01010908,2086,1041,1045,0.4990412272291467,0.5009587727708533
E01010910,1275,617,658,0.483921568627451,0.516078431372549
E01010969,1697,840,857,0.4949911608721273,0.5050088391278728
E01010970,1841,898,943,0.48777838131450296,0.512221618685497
E01010974,1524,744,780,0.4881889763779528,0.5118110236220472
E01010977,1515,733,782,0.48382838283828383,0.5161716171617162
E01010975,1533,701,832,0.4572733202870189,0.542726679712981
E01010976,1794,900,894,0.5016722408026756,0.4983277591973244
E01010978,1303,660,643,0.5065234075211051,0.49347659247889486
E01010979,1513,772,741,0.5102445472571051,0.4897554527428949
E01010980,1499,737,762,0.4916611074049366,0.5083388925950634
E01010981,1472,741,731,0.5033967391304348,0.49660326086956524
E01010989,1501,764,737,0.5089940039973351,0.49100599600266487
E01010990,1636,804,832,0.49144254278728605,0.508557457212714
E01010991,1576,783,793,0.49682741116751267,0.5031725888324873
E01010992,1709,853,856,0.49912229373902867,0.5008777062609713
E01010993,1686,810,876,0.4804270462633452,0.5195729537366548
E01010875,1734,815,919,0.4700115340253749,0.5299884659746251
E01010876,1628,802,826,0.4926289926289926,0.5073710073710074
E01010877,1525,764,761,0.5009836065573771,0.49901639344262294
E01010880,1482,718,764,0.4844804318488529,0.5155195681511471
E01010949,1545,763,782,0.49385113268608416,0.5061488673139158
E01010922,1911,919,992,0.48090005232862376,0.5190999476713762
E01010956,1539,754,785,0.4899285250162443,0.5100714749837557
E01010958,1471,664,807,0.451393609789259,0.548606390210741
E01010959,1776,872,904,0.49099099099099097,0.509009009009009
E01010968,1823,873,950,0.4788809654415798,0.5211190345584202
E01010971,1906,899,1007,0.47166841552990557,0.5283315844700944
E01010972,1593,765,828,0.480225988700565,0.519774011299435
E01010973,1673,803,870,0.47997609085475196,0.5200239091452481
E01010884,1602,734,868,0.4581772784019975,0.5418227215980025
E01010885,1430,693,737,0.4846153846153846,0.5153846153846153
E01010886,1113,551,562,0.4950584007187781,0.504941599281222
E01010984,1287,649,638,0.5042735042735043,0.49572649572649574
E01010946,1379,658,721,0.47715736040609136,0.5228426395939086
E01010947,1490,740,750,0.4966442953020134,0.5033557046979866
E01010950,1440,723,717,0.5020833333333333,0.4979166666666667
E01010951,1511,729,782,0.4824619457313038,0.5175380542686963
E01010891,1737,848,889,0.4881980426021877,0.5118019573978123
E01010892,1904,933,971,0.4900210084033613,0.5099789915966386
E01010895,1440,735,705,0.5104166666666666,0.4895833333333333
E01010945,1618,790,828,0.48825710754017304,0.511742892459827
E01010948,1451,693,758,0.4776016540317023,0.5223983459682977
E01010889,1742,838,904,0.48105625717566014,0.5189437428243399
E01010890,1792,883,909,0.4927455357142857,0.5072544642857143
E01010893,1420,669,751,0.47112676056338026,0.5288732394366197
E01010894,1614,793,821,0.4913258983890954,0.5086741016109045
E01010901,1653,781,872,0.4724742891712039,0.5275257108287962
E01010903,1667,775,892,0.46490701859628075,0.5350929814037193
E01010896,1628,802,826,0.4926289926289926,0.5073710073710074
E01010897,1671,832,839,0.49790544584081387,0.5020945541591861
E01010898,1651,833,818,0.5045427013930951,0.4954572986069049
E01010899,1408,667,741,0.4737215909090909,0.5262784090909091
E01010900,1595,786,809,0.4927899686520376,0.5072100313479624
E01010902,1616,771,845,0.4771039603960396,0.5228960396039604
E01010952,1546,712,834,0.46054333764553684,0.5394566623544631
E01010953,1467,723,744,0.49284253578732107,0.5071574642126789
E01010954,2389,1174,1215,0.49141900376726666,0.5085809962327333
E01010955,1471,760,711,0.5166553365057783,0.4833446634942216
E01010957,1485,726,759,0.4888888888888889,0.5111111111111111
E01011051,1566,731,835,0.466794380587484,0.533205619412516
E01011055,1264,632,632,0.5,0.5
E01011056,1642,768,874,0.46772228989037756,0.5322777101096224
E01011057,1365,662,703,0.484981684981685,0.515018315018315
E01011058,1263,609,654,0.4821852731591449,0.517814726840855
E01011048,1639,780,859,0.4758999389871873,0.5241000610128127
E01011049,1644,785,859,0.4774939172749392,0.5225060827250608
E01011050,1520,768,752,0.5052631578947369,0.49473684210526314
E01011052,1642,797,845,0.4853836784409257,0.5146163215590743
E01011053,1476,742,734,0.502710027100271,0.497289972899729
E01011059,1524,719,805,0.4717847769028871,0.5282152230971129
E01011062,1694,847,847,0.5,0.5
E01011064,1470,712,758,0.48435374149659866,0.5156462585034014
E01011068,1669,811,858,0.4859197124026363,0.5140802875973637
E01011069,1341,676,665,0.5041014168530947,0.49589858314690527
E01011241,1705,844,861,0.4950146627565982,0.5049853372434018
E01011242,1580,753,827,0.47658227848101264,0.5234177215189874
E01011243,1681,834,847,0.496133254015467,0.5038667459845331
E01011244,2033,1013,1020,0.49827840629611414,0.5017215937038859
E01011060,1645,814,831,0.4948328267477204,0.5051671732522797
E01011061,1689,839,850,0.49674363528715215,0.5032563647128478
E01011063,2047,1005,1042,0.49096238397655106,0.509037616023449
E01011065,1662,813,849,0.4891696750902527,0.5108303249097473
E01011066,1515,749,766,0.49438943894389437,0.5056105610561056
E01011027,1258,616,642,0.48966613672496023,0.5103338632750397
E01011028,1481,743,738,0.5016880486158002,0.49831195138419987
E01011030,1530,758,772,0.4954248366013072,0.5045751633986928
E01011031,1627,805,822,0.4947756607252612,0.5052243392747388
E01011054,1385,689,696,0.49747292418772565,0.5025270758122744
E01011013,1544,737,807,0.47733160621761656,0.5226683937823834
E01011014,1534,770,764,0.5019556714471969,0.4980443285528031
E01011023,1670,851,819,0.5095808383233533,0.49041916167664673
E01011024,1762,886,876,0.5028376844494892,0.49716231555051077
E01011067,1586,776,810,0.489281210592686,0.510718789407314
E01011247,1579,769,810,0.487017099430019,0.512982900569981
E01011249,1585,784,801,0.4946372239747634,0.5053627760252366
E01011251,1622,777,845,0.4790382244143033,0.5209617755856967
E01011245,1566,785,781,0.5012771392081737,0.4987228607918263
E01011246,1475,704,771,0.47728813559322036,0.5227118644067796
E01011248,1486,721,765,0.4851951547779273,0.5148048452220727
E01011250,1647,825,822,0.5009107468123861,0.4990892531876138
E01011015,1607,772,835,0.48039825762289984,0.5196017423771002
E01011029,1446,750,696,0.5186721991701245,0.48132780082987553
E01011032,1566,750,816,0.4789272030651341,0.5210727969348659
E01011034,1629,805,824,0.4941682013505218,0.5058317986494782
E01011157,1645,803,842,0.48814589665653496,0.511854103343465
E01011161,1311,626,685,0.4774980930587338,0.5225019069412662
E01011163,1370,663,707,0.48394160583941603,0.516058394160584
E01011164,1695,822,873,0.4849557522123894,0.5150442477876106
E01011165,1823,917,906,0.5030170049369171,0.49698299506308286
E01011166,1623,834,789,0.5138632162661737,0.48613678373382624
E01011167,1932,944,988,0.4886128364389234,0.5113871635610766
E01011033,1686,856,830,0.5077105575326216,0.49228944246737844
E01011035,1685,876,809,0.5198813056379822,0.4801186943620178
E01011036,1728,866,862,0.5011574074074074,0.4988425925925926
E01011037,2104,1038,1066,0.49334600760456276,0.5066539923954373
E01011016,1557,788,769,0.5061014771997431,0.4938985228002569
E01011017,1674,837,837,0.5,0.5
E01011018,1540,775,765,0.5032467532467533,0.4967532467532468
E01011019,1714,865,849,0.5046674445740957,0.4953325554259043
E01011020,1348,687,661,0.5096439169139466,0.4903560830860534
E01011021,1643,833,810,0.5069993913572732,0.4930006086427267
E01011022,1449,713,736,0.49206349206349204,0.5079365079365079
E01011126,1547,760,787,0.491273432449903,0.5087265675500969
E01011127,1415,706,709,0.4989399293286219,0.5010600706713781
E01011156,1556,767,789,0.4929305912596401,0.5070694087403599
E01011158,1808,889,919,0.49170353982300885,0.5082964601769911
E01011159,1743,857,886,0.4916810097532989,0.5083189902467011
E01011160,1399,694,705,0.4960686204431737,0.5039313795568263
E01011162,1485,736,749,0.49562289562289563,0.5043771043771044
E01011025,1570,794,776,0.5057324840764331,0.4942675159235669
E01011026,1510,745,765,0.49337748344370863,0.5066225165562914
E01011136,1480,733,747,0.49527027027027026,0.5047297297297297
E01011137,1516,720,796,0.47493403693931396,0.525065963060686
E01011128,2000,1034,966,0.517,0.483
E01011130,2017,1019,998,0.5052057511155181,0.4947942488844819
E01033542,2916,1521,1395,0.5216049382716049,0.4783950617283951
E01011121,1482,736,746,0.4966261808367072,0.5033738191632928
E01011122,1414,668,746,0.4724186704384724,0.5275813295615276
E01011123,1623,792,831,0.4879852125693161,0.512014787430684
E01011124,1858,936,922,0.503767491926803,0.49623250807319697
E01011125,1543,750,793,0.4860661049902787,0.5139338950097213
E01011129,1353,637,716,0.4708056171470806,0.5291943828529194
E01011138,1684,846,838,0.502375296912114,0.497624703087886
E01011139,1446,720,726,0.4979253112033195,0.5020746887966805
E01011140,1643,815,828,0.4960438222763238,0.5039561777236762
E01011141,1787,901,886,0.5041969781757135,0.49580302182428654
E01011132,1445,693,752,0.4795847750865052,0.5204152249134948
E01011142,1557,772,785,0.49582530507385997,0.50417469492614
E01011217,1601,752,849,0.4697064334790756,0.5302935665209244
E01011218,1626,779,847,0.479089790897909,0.5209102091020911
E01011216,1464,707,757,0.48292349726775957,0.5170765027322405
E01011219,1551,755,796,0.486782720825274,0.513217279174726
E01011220,1793,863,930,0.48131622978248745,0.5186837702175126
E01011221,1744,836,908,0.4793577981651376,0.5206422018348624
E01011046,1332,661,671,0.49624624624624625,0.5037537537537538
E01011100,1502,716,786,0.4766977363515313,0.5233022636484687
E01011102,1414,703,711,0.4971711456859972,0.5028288543140028
E01011108,1460,717,743,0.4910958904109589,0.5089041095890411
E01011133,1483,757,726,0.5104517869184086,0.48954821308159135
E01011134,1964,962,1002,0.48981670061099797,0.5101832993890021
E01011143,1621,809,812,0.49907464528069095,0.5009253547193091
E01011144,1510,756,754,0.5006622516556292,0.49933774834437084
E01011260,1354,688,666,0.5081240768094535,0.4918759231905465
E01011257,2226,1124,1102,0.504941599281222,0.4950584007187781
E01011258,2074,1156,918,0.5573770491803278,0.4426229508196721
E01011259,1697,838,859,0.4938126104890984,0.5061873895109016
E01011261,1402,687,715,0.4900142653352354,0.5099857346647646
E01011262,1656,815,841,0.4921497584541063,0.5078502415458938
E01011263,1636,813,823,0.4969437652811736,0.5030562347188264
E01011101,1738,830,908,0.47756041426927504,0.522439585730725
E01011103,1330,629,701,0.47293233082706765,0.5270676691729324
E01011104,1583,727,856,0.4592545799115603,0.5407454200884396
E01011105,2041,954,1087,0.46741793238608526,0.5325820676139148
E01011212,1612,739,873,0.45843672456575685,0.5415632754342432
E01011213,1587,776,811,0.48897290485192185,0.5110270951480781
E01011214,1545,759,786,0.4912621359223301,0.5087378640776699
E01011215,2038,1027,1011,0.5039254170755643,0.49607458292443574
E01011039,1808,889,919,0.49170353982300885,0.5082964601769911
E01011042,1590,810,780,0.5094339622641509,0.49056603773584906
E01011047,1549,756,793,0.4880568108457069,0.511943189154293
E01011210,1952,982,970,0.5030737704918032,0.4969262295081967
E01011252,1151,567,584,0.4926151172893136,0.5073848827106864
E01011253,1264,590,674,0.46677215189873417,0.5332278481012658
E01011254,1514,749,765,0.4947159841479524,0.5052840158520475
E01011255,1464,692,772,0.4726775956284153,0.5273224043715847
E01011256,1355,679,676,0.5011070110701107,0.4988929889298893
E01011038,1713,791,922,0.46176298890834794,0.5382370110916521
E01011041,1539,770,769,0.5003248862897985,0.4996751137102014
E01011106,1485,727,758,0.4895622895622896,0.5104377104377105
E01011107,1813,1061,752,0.5852178709321566,0.41478212906784334
E01011201,1731,810,921,0.4679376083188908,0.5320623916811091
E01011203,1805,863,942,0.4781163434903047,0.5218836565096953
E01011209,1556,751,805,0.48264781491002573,0.5173521850899743
E01011211,1591,771,820,0.4846008799497172,0.5153991200502829
E01011040,1879,944,935,0.5023948908994146,0.4976051091005854
E01011043,2346,1235,1111,0.5264279624893435,0.47357203751065646
E01011044,1542,770,772,0.4993514915693904,0.5006485084306096
E01011045,1888,1031,857,0.5460805084745762,0.4539194915254237
E01011089,1297,593,704,0.4572089437162683,0.5427910562837317
E01011091,1456,709,747,0.48695054945054944,0.5130494505494505
E01011092,1276,628,648,0.49216300940438873,0.5078369905956113
E01011200,2357,1177,1180,0.4993635977938057,0.5006364022061943
E01011204,1485,718,767,0.4835016835016835,0.5164983164983165
E01011206,1679,810,869,0.48243001786777845,0.5175699821322216
E01011208,1606,771,835,0.4800747198007472,0.5199252801992528
E01011240,1699,767,932,0.4514420247204238,0.5485579752795762
E01011231,1533,742,791,0.4840182648401826,0.5159817351598174
E01011236,1740,1010,730,0.5804597701149425,0.41954022988505746
E01011238,1642,847,795,0.5158343483556638,0.48416565164433617
E01011239,1627,803,824,0.49354640442532266,0.5064535955746773
E01011093,1436,700,736,0.48746518105849584,0.5125348189415042
E01011094,1542,714,828,0.46303501945525294,0.5369649805447471
E01011096,1561,732,829,0.4689301729660474,0.5310698270339526
E01011098,1532,824,708,0.5378590078328982,0.4621409921671018
E01011146,1557,776,781,0.4983943481053308,0.5016056518946692
E01011151,1636,817,819,0.4993887530562347,0.5006112469437652
E01011202,1565,741,824,0.47348242811501595,0.526517571884984
E01011205,1605,779,826,0.4853582554517134,0.5146417445482866
E01011090,1550,762,788,0.4916129032258065,0.5083870967741936
E01011095,1405,677,728,0.48185053380782916,0.5181494661921708
E01011097,1560,756,804,0.4846153846153846,0.5153846153846153
E01011099,1489,744,745,0.49966420416386836,0.5003357958361316
E01011150,1616,791,825,0.48948019801980197,0.510519801980198
E01011155,1861,938,923,0.5040300913487372,0.4959699086512628
E01011207,1495,721,774,0.4822742474916388,0.5177257525083612
E01011234,1487,722,765,0.4855413584398117,0.5144586415601883
E01011232,1639,821,818,0.50091519219036,0.49908480780964004
E01011233,1653,803,850,0.48578342407743497,0.514216575922565
E01011235,1814,1014,800,0.5589856670341786,0.4410143329658214
E01011237,1661,816,845,0.4912703190848886,0.5087296809151114
E01011004,1363,637,726,0.4673514306676449,0.532648569332355
E01011006,1547,728,819,0.47058823529411764,0.5294117647058824
E01011008,1505,770,735,0.5116279069767442,0.4883720930232558
E01011012,1668,806,862,0.4832134292565947,0.5167865707434053
E01011145,1530,766,764,0.5006535947712418,0.4993464052287582
E01011147,1533,749,784,0.4885844748858447,0.5114155251141552
E01011148,1656,793,863,0.4788647342995169,0.5211352657004831
E01011152,1708,846,862,0.4953161592505855,0.5046838407494145
E01011007,1486,797,689,0.5363391655450875,0.4636608344549125
E01011223,1982,938,1044,0.47325933400605447,0.5267406659939455
E01011225,1788,889,899,0.49720357941834453,0.5027964205816555
E01011229,2881,1570,1311,0.5449496702533843,0.45505032974661574
E01011080,1924,973,951,0.5057172557172557,0.49428274428274427
E01011081,1809,976,833,0.5395245992260918,0.46047540077390825
E01011082,1836,978,858,0.5326797385620915,0.4673202614379085
E01011230,2094,1092,1002,0.5214899713467048,0.4785100286532951
E01011005,1521,747,774,0.4911242603550296,0.5088757396449705
E01011009,1340,641,699,0.4783582089552239,0.5216417910447761
E01011010,1572,738,834,0.46946564885496184,0.5305343511450382
E01011011,1576,781,795,0.49555837563451777,0.5044416243654822
E01011077,1612,816,796,0.5062034739454094,0.49379652605459057
E01011149,1860,928,932,0.4989247311827957,0.5010752688172043
E01011153,1715,860,855,0.5014577259475219,0.49854227405247814
E01011154,1588,766,822,0.482367758186398,0.517632241813602
E01011191,1576,777,799,0.4930203045685279,0.506979695431472
E01011192,1577,750,827,0.4755865567533291,0.5244134432466709
E01011193,1912,933,979,0.48797071129707115,0.5120292887029289
E01011194,1370,660,710,0.48175182481751827,0.5182481751824818
E01011079,1887,937,950,0.4965553789083201,0.5034446210916799
E01011083,1782,872,910,0.489337822671156,0.510662177328844
E01011084,1819,842,977,0.462891698735569,0.537108301264431
E01011085,1554,714,840,0.4594594594594595,0.5405405405405406
E01011224,1726,798,928,0.4623406720741599,0.5376593279258401
E01011226,1560,767,793,0.49166666666666664,0.5083333333333333
E01011227,1619,792,827,0.4891908585546634,0.5108091414453366
E01011228,1499,734,765,0.4896597731821214,0.5103402268178786
E01011071,1678,861,817,0.5131108462455304,0.4868891537544696
E01011072,1613,802,811,0.4972101673899566,0.5027898326100434
E01011073,1504,751,753,0.49933510638297873,0.5006648936170213
E01011078,1754,859,895,0.48973774230330674,0.5102622576966933
E01011086,1628,797,831,0.48955773955773957,0.5104422604422605
E01011087,1588,775,813,0.4880352644836272,0.5119647355163728
E01011088,1414,667,747,0.47171145685997173,0.5282885431400283
E01011222,1768,924,844,0.5226244343891403,0.47737556561085975
E01011190,1617,795,822,0.49165120593692024,0.5083487940630798
E01011195,2230,1147,1083,0.5143497757847534,0.4856502242152466
E01011196,1820,891,929,0.48956043956043954,0.5104395604395604
E01011197,1565,754,811,0.4817891373801917,0.5182108626198083
E01011070,1574,778,796,0.49428208386277,0.5057179161372299
E01011074,1912,918,994,0.4801255230125523,0.5198744769874477
E01011075,1439,702,737,0.48783877692842254,0.5121612230715775
E01011076,1476,720,756,0.4878048780487805,0.5121951219512195
E01011169,1448,727,721,0.5020718232044199,0.4979281767955801
E01011170,1838,924,914,0.5027203482045702,0.4972796517954298
E01011171,1388,702,686,0.5057636887608069,0.4942363112391931
E01011172,1016,458,558,0.4507874015748031,0.5492125984251969
E01011173,1321,636,685,0.4814534443603331,0.5185465556396669
E01011176,1432,697,735,0.486731843575419,0.513268156424581
E01011109,1795,905,890,0.5041782729805014,0.4958217270194986
E01011113,1691,830,861,0.49083382613837967,0.5091661738616203
E01011114,1537,729,808,0.47430058555627846,0.5256994144437215
E01011119,1497,734,763,0.49031396125584503,0.509686038744155
E01011168,1631,773,858,0.4739423666462293,0.5260576333537706
E01011174,1851,906,945,0.48946515397082657,0.5105348460291734
E01011175,1450,721,729,0.49724137931034484,0.5027586206896552
E01011177,1745,828,917,0.47449856733524354,0.5255014326647565
E01011178,1857,907,950,0.4884221863220248,0.5115778136779753
E01011118,1578,778,800,0.49302915082382764,0.5069708491761724
E01011120,1575,785,790,0.4984126984126984,0.5015873015873016
E01011198,1593,765,828,0.480225988700565,0.519774011299435
E01011199,1518,745,773,0.49077733860342554,0.5092226613965745
E01011110,1358,692,666,0.5095729013254786,0.49042709867452133
E01011111,1634,803,831,0.49143206854345167,0.5085679314565483
E01011112,1616,778,838,0.4814356435643564,0.5185643564356436
E01011115,1790,884,906,0.49385474860335193,0.506145251396648
E01011116,1661,829,832,0.4990969295605057,0.5009030704394943
E01011117,1786,885,901,0.4955207166853303,0.5044792833146696
E01011180,1917,949,968,0.49504434011476267,0.5049556598852374
E01011182,1734,876,858,0.5051903114186851,0.49480968858131485
E01011186,1608,796,812,0.49502487562189057,0.5049751243781094
E01011188,1717,844,873,0.49155503785672683,0.5084449621432732
E01011179,1771,886,885,0.5002823263692829,0.4997176736307171
E01011181,1788,901,887,0.5039149888143176,0.4960850111856823
E01011183,1999,996,1003,0.49824912456228115,0.5017508754377189
E01011184,1472,729,743,0.4952445652173913,0.5047554347826086
E01011185,1565,766,799,0.4894568690095847,0.5105431309904154
E01011187,1758,853,905,0.4852104664391354,0.5147895335608647
E01011189,1603,782,821,0.4878353087960075,0.5121646912039926
E01011698,1503,736,767,0.48968729208250167,0.5103127079174984
E01011699,1345,649,696,0.48252788104089217,0.5174721189591078
E01011701,1287,631,656,0.4902874902874903,0.5097125097125097
E01011702,1184,578,606,0.48817567567567566,0.5118243243243243
E01011703,1279,605,674,0.4730258014073495,0.5269741985926505
E01011697,2091,1432,659,0.6848397895743663,0.3151602104256337
E01011700,1353,742,611,0.5484109386548411,0.4515890613451589
E01011704,1770,835,935,0.4717514124293785,0.5282485875706214
E01011705,1378,633,745,0.4593613933236575,0.5406386066763426
E01011581,1469,709,760,0.48264125255275697,0.517358747447243
E01011582,1651,783,868,0.4742580254391278,0.5257419745608722
E01011583,1479,707,772,0.47802569303583503,0.521974306964165
E01011584,1250,590,660,0.472,0.528
E01011569,1662,838,824,0.5042117930204573,0.49578820697954273
E01011571,1597,746,851,0.46712586098935505,0.532874139010645
E01011572,1763,862,901,0.48893930799773117,0.5110606920022689
E01011573,1341,653,688,0.48695003728560776,0.5130499627143923
E01011574,1456,688,768,0.4725274725274725,0.5274725274725275
E01011707,1359,641,718,0.47167034584253126,0.5283296541574687
E01011709,1588,747,841,0.4704030226700252,0.5295969773299748
E01011710,1421,689,732,0.4848698099929627,0.5151301900070373
E01011711,1389,650,739,0.4679625629949604,0.5320374370050396
E01011712,1359,647,712,0.4760853568800589,0.5239146431199412
E01011561,1217,586,631,0.4815119145439606,0.5184880854560394
E01011696,1498,725,773,0.48397863818424564,0.5160213618157543
E01011706,1526,757,769,0.49606815203145477,0.5039318479685452
E01011708,1468,704,764,0.47956403269754766,0.5204359673024523
E01011713,1843,921,922,0.49972870320130225,0.5002712967986978
E01011570,2284,1152,1132,0.5043782837127846,0.4956217162872154
E01011576,1432,689,743,0.48114525139664804,0.5188547486033519
E01032503,1465,734,731,0.5010238907849829,0.49897610921501706
E01032504,1584,757,827,0.4779040404040404,0.5220959595959596
E01011266,2027,1017,1010,0.5017266896891959,0.49827331031080413
E01011270,1616,794,822,0.49133663366336633,0.5086633663366337
E01011279,1312,601,711,0.4580792682926829,0.541920731707317
E01011280,1757,857,900,0.4877632327831531,0.5122367672168469
E01011265,1625,765,860,0.4707692307692308,0.5292307692307693
E01011267,1496,732,764,0.4893048128342246,0.5106951871657754
E01011271,2158,1059,1099,0.4907321594068582,0.5092678405931418
E01011272,1521,767,754,0.5042735042735043,0.49572649572649574
E01011268,1394,696,698,0.49928263988522237,0.5007173601147776
E01011273,1487,705,782,0.4741089441829186,0.5258910558170814
E01011274,1488,711,777,0.4778225806451613,0.5221774193548387
E01011275,1350,645,705,0.4777777777777778,0.5222222222222223
E01011264,1279,601,678,0.4698983580922596,0.5301016419077405
E01011269,1552,751,801,0.4838917525773196,0.5161082474226805
E01011276,1384,703,681,0.5079479768786127,0.4920520231213873
E01011578,1321,616,705,0.4663133989401968,0.5336866010598031
E01011554,1446,705,741,0.487551867219917,0.5124481327800829
E01011562,1592,779,813,0.48932160804020103,0.510678391959799
E01011563,1416,694,722,0.4901129943502825,0.5098870056497176
E01011564,1501,734,767,0.4890073284477015,0.5109926715522984
E01011567,1393,661,732,0.4745154343144293,0.5254845656855707
E01011376,1516,739,777,0.487467018469657,0.512532981530343
E01011377,1386,672,714,0.48484848484848486,0.5151515151515151
E01011378,1394,674,720,0.4835007173601148,0.5164992826398852
E01011382,1456,697,759,0.47870879120879123,0.5212912087912088
E01011277,1511,708,803,0.4685638649900728,0.5314361350099271
E01011278,1631,777,854,0.47639484978540775,0.5236051502145923
E01011579,1245,617,628,0.4955823293172691,0.5044176706827309
E01011580,1342,642,700,0.4783904619970194,0.5216095380029806
E01011556,1576,732,844,0.46446700507614214,0.5355329949238579
E01011557,1529,705,824,0.46108567691301505,0.538914323086985
E01011565,1433,693,740,0.48360083740404747,0.5163991625959525
E01011566,1309,621,688,0.4744079449961803,0.5255920550038197
E01011568,1831,855,976,0.4669579464773348,0.5330420535226652
E01011380,1523,753,770,0.4944189100459619,0.505581089954038
E01011381,1312,622,690,0.4740853658536585,0.5259146341463414
E01011385,1249,605,644,0.4843875100080064,0.5156124899919936
E01011386,1419,699,720,0.492600422832981,0.507399577167019
E01011379,1482,699,783,0.4716599190283401,0.52834008097166
E01011384,1485,717,768,0.48282828282828283,0.5171717171717172
E01032501,1173,584,589,0.4978687127024723,0.5021312872975278
E01032502,1842,880,962,0.4777415852334419,0.5222584147665581
E01011555,1362,663,699,0.486784140969163,0.513215859030837
E01011558,1577,709,868,0.4495878249841471,0.5504121750158529
E01011559,1259,579,680,0.4598888006354249,0.5401111993645751
E01011560,1800,894,906,0.49666666666666665,0.5033333333333333
E01011383,1566,736,830,0.46998722860791825,0.5300127713920817
E01011388,1407,653,754,0.4641080312722104,0.5358919687277897
E01011684,1548,748,800,0.48320413436692505,0.5167958656330749
E01011695,1590,762,828,0.47924528301886793,0.5207547169811321
E01011650,1443,674,769,0.4670824670824671,0.532917532917533
E01011651,1446,711,735,0.491701244813278,0.508298755186722
E01011653,1352,663,689,0.49038461538461536,0.5096153846153846
E01011655,1396,670,726,0.4799426934097421,0.5200573065902578
E01011455,1382,672,710,0.48625180897250364,0.5137481910274964
E01011456,1707,822,885,0.48154657293497366,0.5184534270650264
E01011459,1582,789,793,0.49873577749683945,0.5012642225031606
E01011461,1530,753,777,0.492156862745098,0.5078431372549019
E01011311,1217,588,629,0.48315529991783074,0.5168447000821693
E01011649,1466,720,746,0.49113233287858116,0.5088676671214188
E01011715,1289,631,658,0.4895267649340574,0.5104732350659426
E01011719,1427,687,740,0.48142957252978275,0.5185704274702172
E01011509,1351,625,726,0.46262028127313104,0.537379718726869
E01011511,1329,672,657,0.5056433408577878,0.49435665914221216
E01011512,1566,774,792,0.4942528735632184,0.5057471264367817
E01011515,1421,704,717,0.4954257565095003,0.5045742434904996
E01011516,1704,852,852,0.5,0.5
E01011508,1414,719,695,0.5084865629420084,0.4915134370579915
E01011517,1638,792,846,0.4835164835164835,0.5164835164835165
E01011652,1331,663,668,0.49812171299774605,0.5018782870022539
E01011654,1434,714,720,0.497907949790795,0.502092050209205
E01011505,1599,762,837,0.47654784240150094,0.5234521575984991
E01011506,1439,702,737,0.48783877692842254,0.5121612230715775
E01011507,1580,763,817,0.4829113924050633,0.5170886075949367
E01011510,1576,769,807,0.4879441624365482,0.5120558375634517
E01011514,1631,791,840,0.48497854077253216,0.5150214592274678
E01011452,1524,741,783,0.4862204724409449,0.5137795275590551
E01011454,1492,721,771,0.4832439678284182,0.5167560321715817
E01011457,1591,768,823,0.48271527341294784,0.5172847265870522
E01011458,1382,691,691,0.5,0.5
E01011465,1532,687,845,0.44843342036553524,0.5515665796344648
E01011453,1482,718,764,0.4844804318488529,0.5155195681511471
E01011460,1409,665,744,0.47196593328601844,0.5280340667139816
E01011462,1632,814,818,0.4987745098039216,0.5012254901960784
E01011463,1583,739,844,0.4668351231838282,0.5331648768161719
E01011464,1678,814,864,0.48510131108462456,0.5148986889153755
E01011714,1474,716,758,0.48575305291723203,0.514246947082768
E01011716,1486,717,769,0.48250336473755046,0.5174966352624495
E01011717,1495,717,778,0.47959866220735786,0.5204013377926422
E01011718,1400,659,741,0.4707142857142857,0.5292857142857142
E01011720,1498,758,740,0.5060080106809078,0.4939919893190921
E01011296,1678,800,878,0.4767580452920143,0.5232419547079857
E01011297,1585,787,798,0.4965299684542587,0.5034700315457413
E01011309,1507,718,789,0.47644326476443266,0.5235567352355673
E01011310,1623,776,847,0.47812692544670365,0.5218730745532963
E01011513,2181,1034,1147,0.474094452086199,0.5259055479138011
E01011688,1488,719,769,0.4831989247311828,0.5168010752688172
E01011689,1552,730,822,0.47036082474226804,0.529639175257732
E01011691,1527,710,817,0.46496398166339226,0.5350360183366077
E01011504,1426,673,753,0.47194950911640954,0.5280504908835905
E01011641,1522,740,782,0.48620236530880423,0.5137976346911958
E01011642,1326,646,680,0.48717948717948717,0.5128205128205128
E01011645,1472,678,794,0.46059782608695654,0.5394021739130435
E01011484,1538,739,799,0.48049414824447334,0.5195058517555267
E01011485,1524,733,791,0.4809711286089239,0.5190288713910761
E01011686,1545,753,792,0.487378640776699,0.512621359223301
E01032493,1343,646,697,0.4810126582278481,0.5189873417721519
E01032494,1745,847,898,0.4853868194842407,0.5146131805157593
E01011350,1625,791,834,0.4867692307692308,0.5132307692307693
E01011351,1696,804,892,0.4740566037735849,0.5259433962264151
E01011352,1790,855,935,0.4776536312849162,0.5223463687150838
E01011353,1865,871,994,0.4670241286863271,0.532975871313673
E01011656,1490,722,768,0.48456375838926175,0.5154362416107383
E01011657,1307,610,697,0.4667176740627391,0.5332823259372609
E01011659,1373,664,709,0.48361252731245447,0.5163874726875455
E01011661,1598,734,864,0.4593241551939925,0.5406758448060075
E01011643,1392,653,739,0.46910919540229884,0.5308908045977011
E01011644,1249,584,665,0.4675740592473979,0.5324259407526021
E01011646,1666,814,852,0.4885954381752701,0.5114045618247299
E01011647,1716,845,871,0.49242424242424243,0.5075757575757576
E01011648,1744,860,884,0.49311926605504586,0.5068807339449541
E01011354,1397,665,732,0.4760200429491768,0.5239799570508232
E01011355,1378,638,740,0.4629898403483309,0.5370101596516691
E01011357,1914,886,1028,0.46290491118077326,0.5370950888192267
E01011450,1226,589,637,0.4804241435562806,0.5195758564437194
E01011588,1725,867,858,0.5026086956521739,0.4973913043478261
E01011589,1521,739,782,0.48586456278763973,0.5141354372123603
E01011590,1540,767,773,0.4980519480519481,0.5019480519480519
E01011592,1402,640,762,0.456490727532097,0.543509272467903
E01011593,1764,867,897,0.4914965986394558,0.5085034013605442
E01011421,1486,697,789,0.4690444145356662,0.5309555854643337
E01011425,1561,762,799,0.48814862267777065,0.5118513773222293
E01011658,1344,614,730,0.4568452380952381,0.5431547619047619
E01011660,1359,659,700,0.48491537895511405,0.515084621044886
E01011662,1189,583,606,0.49032800672834315,0.5096719932716569
E01011721,1522,691,831,0.4540078843626807,0.5459921156373193
E01011722,1893,881,1012,0.4653988378235605,0.5346011621764395
E01011723,1417,666,751,0.4700070571630205,0.5299929428369795
E01011724,1821,872,949,0.47885777045579353,0.5211422295442065
E01011356,1926,956,970,0.4963655244029076,0.5036344755970924
E01011358,1453,697,756,0.4796971782518926,0.5203028217481074
E01011359,1682,809,873,0.48097502972651607,0.5190249702734839
E01011360,2075,1002,1073,0.48289156626506025,0.5171084337349398
E01011361,2478,1179,1299,0.47578692493946734,0.5242130750605327
E01011435,1820,920,900,0.5054945054945055,0.4945054945054945
E01011440,1622,726,896,0.4475955610357583,0.5524044389642416
E01011441,1954,1032,922,0.5281473899692938,0.4718526100307062
E01032945,3163,1629,1534,0.5150173885551691,0.48498261144483085
E01011477,1928,967,961,0.5015560165975104,0.49844398340248963
E01011480,1590,784,806,0.4930817610062893,0.5069182389937107
E01011488,1431,722,709,0.5045422781271838,0.4954577218728162
E01011489,1687,827,860,0.4902193242442205,0.5097806757557795
E01011324,2251,1148,1103,0.5099955575299867,0.49000444247001335
E01011325,1436,688,748,0.479108635097493,0.520891364902507
E01011326,1359,658,701,0.4841795437821928,0.5158204562178073
E01011332,1340,603,737,0.45,0.55
E01011423,1622,760,862,0.468557336621455,0.531442663378545
E01011424,1600,768,832,0.48,0.52
E01011427,1769,844,925,0.4771057094403618,0.5228942905596382
E01011431,1878,943,935,0.5021299254526091,0.49787007454739085
E01011422,1485,774,711,0.5212121212121212,0.47878787878787876
E01011426,1705,871,834,0.510850439882698,0.48914956011730204
E01011428,1870,964,906,0.5155080213903743,0.4844919786096257
E01011429,2007,1017,990,0.5067264573991032,0.49327354260089684
E01011663,1256,572,684,0.4554140127388535,0.5445859872611465
E01011664,1110,501,609,0.45135135135135135,0.5486486486486486
E01011665,1386,696,690,0.5021645021645021,0.49783549783549785
E01011667,1491,675,816,0.45271629778672035,0.5472837022132797
E01011323,1267,594,673,0.46882399368587213,0.5311760063141279
E01011329,1486,719,767,0.4838492597577389,0.5161507402422612
E01011330,1254,615,639,0.4904306220095694,0.5095693779904307
E01011333,1263,642,621,0.5083135391923991,0.4916864608076009
E01011327,1325,647,678,0.48830188679245284,0.5116981132075472
E01011328,1491,754,737,0.505700871898055,0.494299128101945
E01011335,1671,796,875,0.476361460203471,0.5236385397965291
E01011591,1616,800,816,0.49504950495049505,0.504950495049505
E01011430,1508,793,715,0.5258620689655172,0.47413793103448276
E01011432,1558,774,784,0.496790757381258,0.503209242618742
E01011433,1538,764,774,0.4967490247074122,0.5032509752925878
E01011434,1397,723,674,0.5175375805297066,0.4824624194702935
E01011445,1679,746,933,0.4443120905300774,0.5556879094699225
E01011446,1574,788,786,0.5006353240152478,0.4993646759847522
E01011447,1428,726,702,0.5084033613445378,0.49159663865546216
E01011448,1572,768,804,0.48854961832061067,0.5114503816793893
E01011449,1383,734,649,0.5307302964569776,0.4692697035430224
E01011670,2634,1302,1332,0.49430523917995445,0.5056947608200456
E01011671,1535,708,827,0.46123778501628665,0.5387622149837134
E01033002,1310,741,569,0.565648854961832,0.43435114503816796
E01033003,1783,1062,721,0.5956253505328098,0.40437464946719015
E01033005,3530,1718,1812,0.486685552407932,0.513314447592068
E01011478,1679,885,794,0.5270994639666469,0.4729005360333532
E01011479,1476,804,672,0.5447154471544715,0.45528455284552843
E01011481,1578,844,734,0.5348542458808618,0.46514575411913817
E01011482,1693,887,806,0.5239220318960425,0.47607796810395747
E01011483,1570,819,751,0.521656050955414,0.478343949044586
E01011406,1403,655,748,0.4668567355666429,0.5331432644333571
E01011407,1448,685,763,0.47306629834254144,0.5269337016574586
E01011408,1451,675,776,0.4651964162646451,0.534803583735355
E01011409,1397,687,710,0.4917680744452398,0.5082319255547602
E01011410,1274,617,657,0.48430141287284145,0.5156985871271585
E01011412,1370,670,700,0.48905109489051096,0.5109489051094891
E01011331,1238,605,633,0.4886914378029079,0.5113085621970921
E01011334,1293,637,656,0.49265274555297756,0.5073472544470224
E01011336,1525,718,807,0.47081967213114756,0.5291803278688525
E01011337,1399,637,762,0.455325232308792,0.544674767691208
E01011281,1878,910,968,0.4845580404685836,0.5154419595314164
E01011282,1378,644,734,0.46734397677793904,0.532656023222061
E01011283,1331,637,694,0.47858752817430505,0.521412471825695
E01011286,1244,613,631,0.4927652733118971,0.5072347266881029
E01011295,1526,732,794,0.4796854521625164,0.5203145478374837
E01011339,1783,881,902,0.4941110487941671,0.5058889512058329
E01011340,1616,742,874,0.4591584158415842,0.5408415841584159
E01011342,1410,675,735,0.4787234042553192,0.5212765957446809
E01011346,1791,874,917,0.4879955332216639,0.5120044667783361
E01011341,1484,675,809,0.45485175202156336,0.5451482479784366
E01011343,1663,835,828,0.50210463018641,0.4978953698135899
E01011345,1418,628,790,0.44287729196050774,0.5571227080394923
E01011666,1490,728,762,0.4885906040268456,0.5114093959731544
E01011585,1435,684,751,0.47665505226480837,0.5233449477351917
E01011587,1663,826,837,0.49669272399278414,0.5033072760072159
E01011594,1455,685,770,0.47079037800687284,0.5292096219931272
E01011596,1675,818,857,0.48835820895522386,0.5116417910447761
E01011598,1544,722,822,0.4676165803108808,0.5323834196891192
E01011678,4156,1858,2298,0.44706448508180946,0.5529355149181906
E01011681,1734,886,848,0.510957324106113,0.48904267589388695
E01033006,3385,1690,1695,0.49926144756277696,0.5007385524372231
E01011338,1671,858,813,0.5134649910233393,0.4865350089766607
E01011673,1691,869,822,0.5138971023063276,0.4861028976936724
E01011677,1526,790,736,0.5176933158584535,0.48230668414154654
E01033031,1289,716,573,0.5554693560899923,0.44453064391000774
E01033035,1412,834,578,0.5906515580736544,0.4093484419263456
E01011344,1764,866,898,0.4909297052154195,0.5090702947845805
E01011347,1671,796,875,0.476361460203471,0.5236385397965291
E01011348,1622,816,806,0.5030826140567201,0.4969173859432799
E01011349,1716,914,802,0.5326340326340326,0.46736596736596736
E01011586,1494,719,775,0.48125836680053546,0.5187416331994645
E01011595,1804,873,931,0.4839246119733925,0.5160753880266076
E01011597,1507,748,759,0.49635036496350365,0.5036496350364964
E01011599,1535,729,806,0.4749185667752443,0.5250814332247556
E01011287,1320,633,687,0.47954545454545455,0.5204545454545455
E01032499,1749,857,892,0.48999428244711263,0.5100057175528874
E01032500,1144,631,513,0.5515734265734266,0.44842657342657344
E01032606,1982,997,985,0.5030272452068617,0.49697275479313824
E01032607,1101,558,543,0.5068119891008175,0.49318801089918257
E01032608,1170,583,587,0.4982905982905983,0.5017094017094017
E01011608,1384,672,712,0.48554913294797686,0.5144508670520231
E01011609,1453,719,734,0.49483826565726086,0.5051617343427391
E01011610,1418,674,744,0.47531734837799716,0.5246826516220028
E01011611,1364,644,720,0.47214076246334313,0.5278592375366569
E01011614,1811,876,935,0.48371065709552735,0.5162893429044727
E01011413,1562,773,789,0.49487836107554417,0.5051216389244558
E01011415,1594,795,799,0.4987452948557089,0.501254705144291
E01011416,1498,737,761,0.49198931909212285,0.5080106809078772
E01011417,1496,723,773,0.4832887700534759,0.5167112299465241
E01011420,1293,626,667,0.48414539829853054,0.5158546017014695
E01011615,1529,758,771,0.49574885546108566,0.5042511445389143
E01011617,1608,748,860,0.4651741293532338,0.5348258706467661
E01011618,1581,742,839,0.4693232131562302,0.5306767868437697
E01011621,1486,694,792,0.4670255720053836,0.5329744279946165
E01011284,1751,907,844,0.5179897201599086,0.48201027984009137
E01011292,1619,807,812,0.49845583693638046,0.5015441630636195
E01011293,1720,904,816,0.5255813953488372,0.4744186046511628
E01011294,1518,979,539,0.644927536231884,0.35507246376811596
E01011363,1614,808,806,0.5006195786864932,0.4993804213135068
E01011616,1431,659,772,0.4605171208944794,0.5394828791055206
E01011620,1314,615,699,0.4680365296803653,0.5319634703196348
E01011622,1635,782,853,0.4782874617737003,0.5217125382262997
E01011624,1823,874,949,0.4794295117937466,0.5205704882062534
E01011411,1591,784,807,0.4927718416090509,0.507228158390949
E01011414,1484,735,749,0.49528301886792453,0.5047169811320755
E01011418,1476,717,759,0.48577235772357724,0.5142276422764228
E01011419,1223,615,608,0.5028618152085037,0.4971381847914963
E01011396,1766,842,924,0.47678369195922987,0.5232163080407701
E01011399,1481,703,778,0.474679270762998,0.525320729237002
E01011400,1428,674,754,0.47198879551820727,0.5280112044817927
E01011403,1396,638,758,0.45702005730659023,0.5429799426934098
E01011623,1517,754,763,0.4970336189848385,0.5029663810151616
E01011625,1472,755,717,0.5129076086956522,0.48709239130434784
E01011626,1782,948,834,0.531986531986532,0.468013468013468
E01033021,1300,638,662,0.4907692307692308,0.5092307692307693
E01033033,1580,860,720,0.5443037974683544,0.45569620253164556
E01033034,1025,590,435,0.5756097560975609,0.424390243902439
E01011602,1525,710,815,0.46557377049180326,0.5344262295081967
E01011603,1516,727,789,0.4795514511873351,0.5204485488126649
E01011605,1458,712,746,0.4883401920438957,0.5116598079561042
E01011606,1682,804,878,0.4780023781212842,0.5219976218787158
E01011613,1303,615,688,0.47198772064466615,0.5280122793553338
E01011397,1506,717,789,0.4760956175298805,0.5239043824701195
E01011398,1257,610,647,0.48528241845664283,0.5147175815433572
E01011401,1509,750,759,0.4970178926441352,0.5029821073558648
E01011404,1321,648,673,0.49053747161241484,0.5094625283875852
E01011405,1425,668,757,0.4687719298245614,0.5312280701754386
E01011725,1557,790,767,0.5073859987154785,0.49261400128452154
E01011729,1614,767,847,0.4752168525402726,0.5247831474597274
E01011730,1559,752,807,0.482360487491982,0.517639512508018
E01011735,1659,771,888,0.46473779385171793,0.5352622061482821
E01011600,1519,729,790,0.4799210006583278,0.5200789993416721
E01011601,1494,721,773,0.4825970548862115,0.5174029451137885
E01011604,1334,627,707,0.4700149925037481,0.5299850074962519
E01011607,1588,754,834,0.4748110831234257,0.5251889168765743
E01011612,1302,549,753,0.4216589861751152,0.5783410138248848
E01011726,1449,705,744,0.4865424430641822,0.5134575569358178
E01011727,1547,761,786,0.4919198448610213,0.5080801551389786
E01011728,1414,654,760,0.4625176803394625,0.5374823196605375
E01011739,1530,759,771,0.49607843137254903,0.503921568627451
E01011362,1820,961,859,0.528021978021978,0.47197802197802197
E01011731,1418,699,719,0.4929478138222849,0.5070521861777151
E01011732,1861,919,942,0.4938205265986029,0.5061794734013971
E01011733,1492,718,774,0.4812332439678284,0.5187667560321716
E01011366,1588,831,757,0.5232997481108312,0.47670025188916876
E01011368,1275,683,592,0.5356862745098039,0.46431372549019606
E01011370,1724,961,763,0.5574245939675174,0.4425754060324826
E01033013,1189,670,519,0.5634987384356602,0.43650126156433977
E01033032,1278,724,554,0.5665101721439749,0.433489827856025
E01011734,2315,1156,1159,0.49935205183585313,0.5006479481641468
E01011736,1485,722,763,0.4861952861952862,0.5138047138047138
E01011737,1563,747,816,0.4779270633397313,0.5220729366602687
E01011738,1435,699,736,0.4871080139372822,0.5128919860627178
E01011364,1631,857,774,0.5254445125689761,0.47455548743102394
E01011371,1460,733,727,0.5020547945205479,0.49794520547945204
E01011373,1439,746,693,0.5184155663655317,0.4815844336344684
E01011374,1195,595,600,0.497907949790795,0.502092050209205
E01011312,1599,812,787,0.5078173858661663,0.49218261413383363
E01011316,1657,892,765,0.5383222691611346,0.46167773083886543
E01011372,1380,754,626,0.5463768115942029,0.45362318840579713
E01011375,1847,1005,842,0.5441256090958311,0.4558743909041689
E01011390,1443,688,755,0.4767844767844768,0.5232155232155232
E01011391,1645,812,833,0.49361702127659574,0.5063829787234042
E01011392,1463,697,766,0.4764183185235817,0.5235816814764184
E01011402,1768,841,927,0.4756787330316742,0.5243212669683258
E01011298,1538,776,762,0.5045513654096229,0.49544863459037713
E01011299,2238,1113,1125,0.4973190348525469,0.5026809651474531
E01011302,1406,693,713,0.49288762446657186,0.5071123755334281
E01011303,1145,547,598,0.4777292576419214,0.5222707423580786
E01011300,1469,717,752,0.48808713410483323,0.5119128658951668
E01011301,1336,673,663,0.5037425149700598,0.4962574850299401
E01011304,1591,765,826,0.4808296668761785,0.5191703331238215
E01011305,1496,733,763,0.4899732620320856,0.5100267379679144
E01011306,1342,657,685,0.48956780923994037,0.5104321907600596
E01011315,1552,794,758,0.5115979381443299,0.4884020618556701
E01011317,1705,825,880,0.4838709677419355,0.5161290322580645
E01011318,1470,698,772,0.4748299319727891,0.5251700680272109
E01011321,1544,751,793,0.48639896373056996,0.5136010362694301
E01011369,1561,719,842,0.4606021780909673,0.5393978219090326
E01011313,1595,785,810,0.49216300940438873,0.5078369905956113
E01011314,1472,728,744,0.4945652173913043,0.5054347826086957
E01011319,1568,767,801,0.48915816326530615,0.5108418367346939
E01011320,1674,805,869,0.480884109916368,0.519115890083632
E01011322,1544,754,790,0.4883419689119171,0.5116580310880829
E01011471,1400,650,750,0.4642857142857143,0.5357142857142857
E01011472,1598,736,862,0.46057571964956195,0.5394242803504381
E01011473,1476,691,785,0.46815718157181574,0.5318428184281843
E01011474,1457,715,742,0.4907343857240906,0.5092656142759094
E01011518,2187,1061,1126,0.4851394604481024,0.5148605395518976
E01011524,1241,612,629,0.4931506849315068,0.5068493150684932
E01011526,1291,648,643,0.5019364833462432,0.49806351665375675
E01011531,1461,686,775,0.46954140999315536,0.5304585900068446
E01011466,1489,730,759,0.49026192075218267,0.5097380792478173
E01011469,1460,743,717,0.5089041095890411,0.4910958904109589
E01011475,1497,731,766,0.48830995323981297,0.511690046760187
E01011476,1195,549,646,0.4594142259414226,0.5405857740585774
E01011519,1488,725,763,0.48723118279569894,0.5127688172043011
E01011522,1396,690,706,0.49426934097421205,0.505730659025788
E01011525,1576,775,801,0.491751269035533,0.508248730964467
E01011528,1596,797,799,0.4993734335839599,0.5006265664160401
E01011532,1556,733,823,0.47107969151670953,0.5289203084832905
E01011520,1491,741,750,0.4969818913480885,0.5030181086519114
E01011521,1968,974,994,0.4949186991869919,0.5050813008130082
E01011523,1782,823,959,0.4618406285072952,0.5381593714927049
E01011527,1773,901,872,0.5081782289904118,0.4918217710095883
E01011529,1434,692,742,0.4825662482566248,0.5174337517433751
E01011635,1547,744,803,0.48093083387201035,0.5190691661279897
E01011637,1768,880,888,0.497737556561086,0.502262443438914
E01011638,1487,754,733,0.5070611970410221,0.4929388029589778
E01032487,1013,488,525,0.4817374136229023,0.5182625863770978
E01032488,1846,888,958,0.4810400866738895,0.5189599133261105
E01011627,1417,674,743,0.4756527875793931,0.5243472124206069
E01011628,1328,630,698,0.4743975903614458,0.5256024096385542
E01011629,1302,619,683,0.4754224270353303,0.5245775729646698
E01011632,1335,605,730,0.45318352059925093,0.5468164794007491
E01011633,1472,716,756,0.48641304347826086,0.5135869565217391
E01011490,2518,1211,1307,0.48093725178713265,0.5190627482128674
E01011502,1333,605,728,0.45386346586646664,0.5461365341335334
E01032497,1496,731,765,0.48863636363636365,0.5113636363636364
E01032498,1531,757,774,0.49444807315480077,0.5055519268451992
E01011496,1510,756,754,0.5006622516556292,0.49933774834437084
E01011630,2088,993,1095,0.4755747126436782,0.5244252873563219
E01011634,1499,733,766,0.48899266177451634,0.5110073382254836
E01011636,1625,766,859,0.4713846153846154,0.5286153846153846
E01011639,1523,706,817,0.46355876559422193,0.5364412344057781
E01011491,1357,623,734,0.4591009579955785,0.5408990420044215
E01011492,1366,614,752,0.4494875549048316,0.5505124450951684
E01011493,1540,742,798,0.4818181818181818,0.5181818181818182
E01011494,1304,632,672,0.48466257668711654,0.5153374233128835
E01011497,1608,769,839,0.47823383084577115,0.5217661691542289
E01011540,1439,696,743,0.4836692147324531,0.5163307852675469
E01032489,1936,966,970,0.4989669421487603,0.5010330578512396
E01032490,1396,683,713,0.4892550143266476,0.5107449856733525
E01032491,1230,600,630,0.4878048780487805,0.5121951219512195
E01032492,1991,950,1041,0.47714716223003517,0.5228528377699648
E01011307,1526,731,795,0.47903014416775885,0.5209698558322412
E01011308,1528,739,789,0.4836387434554974,0.5163612565445026
E01011393,1725,826,899,0.47884057971014493,0.5211594202898551
E01011394,1237,611,626,0.4939369442198868,0.5060630557801131
E01011395,1184,588,596,0.4966216216216216,0.5033783783783784
E01011533,1294,643,651,0.49690880989180836,0.5030911901081917
E01011541,1714,822,892,0.4795799299883314,0.5204200700116686
E01011545,1388,684,704,0.49279538904899134,0.5072046109510087
E01011547,1781,844,937,0.4738910724312184,0.5261089275687816
E01011499,2588,1283,1305,0.4957496136012365,0.5042503863987635
E01011500,1590,745,845,0.46855345911949686,0.5314465408805031
E01032495,2399,1179,1220,0.49145477282200917,0.5085452271779908
E01032496,2044,1006,1038,0.49217221135029354,0.5078277886497065
E01011530,1460,735,725,0.5034246575342466,0.4965753424657534
E01011534,1421,705,716,0.49612948627726955,0.5038705137227305
E01011546,1664,784,880,0.47115384615384615,0.5288461538461539
E01011548,1445,706,739,0.4885813148788927,0.5114186851211072
E01011550,1404,700,704,0.4985754985754986,0.5014245014245015
E01011537,2066,1023,1043,0.4951597289448209,0.504840271055179
E01011538,1507,734,773,0.4870603848706038,0.5129396151293961
E01011551,1565,782,783,0.4996805111821086,0.5003194888178913
E01011552,1467,699,768,0.47648261758691207,0.523517382413088
E01011535,1664,822,842,0.49399038461538464,0.5060096153846154
E01011536,1587,751,836,0.4732199117832388,0.5267800882167611
E01011549,1503,748,755,0.4976713240186294,0.5023286759813705
E01011553,1436,703,733,0.4895543175487465,0.5104456824512534
E01011685,2153,1121,1032,0.5206688341848583,0.4793311658151417
E01011687,1488,746,742,0.5013440860215054,0.4986559139784946
E01011690,1356,672,684,0.49557522123893805,0.504424778761062
E01011692,1404,729,675,0.5192307692307693,0.4807692307692308
E01011693,1521,779,742,0.5121630506245891,0.4878369493754109
E01011694,1804,897,907,0.49722838137472286,0.5027716186252772
E01032876,2691,1208,1483,0.44890375325157933,0.5510962467484206
E01011442,1619,850,769,0.5250154416306362,0.4749845583693638
E01011443,1381,660,721,0.4779145546705286,0.5220854453294714
E01011444,1849,901,948,0.4872904272579773,0.5127095727420227
E01011451,2107,943,1164,0.44755576649264356,0.5524442335073564
E01011668,1609,821,788,0.5102548166563082,0.4897451833436917
E01011669,1475,780,695,0.5288135593220339,0.4711864406779661
E01032946,2472,1171,1301,0.47370550161812297,0.526294498381877
E01033008,1120,631,489,0.5633928571428571,0.43660714285714286
E01033010,2807,1369,1438,0.48770929818311365,0.5122907018168864
E01033011,1373,847,526,0.616897305171158,0.38310269482884196
E01033015,1167,685,482,0.586975149957155,0.4130248500428449
E01033016,1017,590,427,0.5801376597836775,0.4198623402163225
E01011467,1542,721,821,0.4675745784695201,0.5324254215304799
E01011468,1500,741,759,0.494,0.506
E01011470,1266,636,630,0.5023696682464455,0.4976303317535545
E01033018,1137,664,473,0.5839929639401935,0.4160070360598065
E01033019,1700,884,816,0.52,0.48
E01011740,1499,716,783,0.47765176784523017,0.5223482321547699
E01011741,1486,734,752,0.4939434724091521,0.506056527590848
E01011742,1637,815,822,0.49786194257788635,0.5021380574221136
E01011745,1745,832,913,0.47679083094555874,0.5232091690544413
E01011746,1504,736,768,0.48936170212765956,0.5106382978723404
E01011752,1547,762,785,0.49256625727213965,0.5074337427278603
E01011753,1402,684,718,0.48787446504992865,0.5121255349500713
E01011756,1444,680,764,0.4709141274238227,0.5290858725761773
E01011760,1674,849,825,0.507168458781362,0.492831541218638
E01011762,1572,773,799,0.4917302798982188,0.5082697201017812
E01011743,1466,742,724,0.5061391541609823,0.49386084583901774
E01011744,1621,798,823,0.4922887106724244,0.5077112893275756
E01011747,1640,754,886,0.45975609756097563,0.5402439024390244
E01011750,1572,769,803,0.4891857506361323,0.5108142493638677
E01011754,1452,698,754,0.4807162534435262,0.5192837465564738
E01011757,1851,906,945,0.48946515397082657,0.5105348460291734
E01011759,1895,945,950,0.49868073878627966,0.5013192612137203
E01011761,1885,933,952,0.49496021220159153,0.5050397877984085
E01011763,1443,701,742,0.4857934857934858,0.5142065142065142
E01011764,1552,766,786,0.49355670103092786,0.5064432989690721
E01011748,1630,798,832,0.48957055214723927,0.5104294478527608
E01011749,2119,1059,1060,0.49976403964134025,0.5002359603586597
E01011751,1317,662,655,0.5026575550493546,0.4973424449506454
E01011755,1647,815,832,0.49483910139647846,0.5051608986035215
E01011873,1575,777,798,0.49333333333333335,0.5066666666666667
E01011877,1496,788,708,0.5267379679144385,0.4732620320855615
E01011894,1390,659,731,0.4741007194244604,0.5258992805755396
E01011895,1482,730,752,0.4925775978407557,0.5074224021592443
E01011875,1435,681,754,0.4745644599303136,0.5254355400696864
E01011876,1401,689,712,0.4917915774446824,0.5082084225553176
E01011878,1565,765,800,0.48881789137380194,0.5111821086261981
E01011880,1480,722,758,0.48783783783783785,0.5121621621621621
E01011881,1468,745,723,0.5074931880108992,0.4925068119891008
E01011887,1217,593,624,0.48726376335250615,0.5127362366474938
E01011893,1505,716,789,0.4757475083056478,0.5242524916943522
E01011896,1391,674,717,0.4845434938892883,0.5154565061107117
E01011897,1423,682,741,0.4792691496837667,0.5207308503162333
E01011874,1655,810,845,0.48942598187311176,0.5105740181268882
E01011879,1458,732,726,0.5020576131687243,0.49794238683127573
E01011882,1511,723,788,0.4784910655195235,0.5215089344804765
E01011883,1414,695,719,0.4915134370579915,0.5084865629420084
E01011805,1463,733,730,0.5010252904989747,0.4989747095010253
E01011807,1425,710,715,0.4982456140350877,0.5017543859649123
E01011808,1731,866,865,0.5002888503755055,0.49971114962449453
E01011810,1527,756,771,0.4950884086444008,0.5049115913555993
E01011803,1379,666,713,0.48295866569978246,0.5170413343002176
E01011804,1618,759,859,0.46909765142150806,0.530902348578492
E01011806,1515,763,752,0.5036303630363036,0.49636963696369635
E01011809,1474,721,753,0.4891451831750339,0.510854816824966
E01011811,1578,756,822,0.4790874524714829,0.5209125475285171
E01011835,1503,755,748,0.5023286759813705,0.4976713240186294
E01011836,1462,726,736,0.49658002735978113,0.5034199726402189
E01011839,1612,779,833,0.4832506203473945,0.5167493796526055
E01011843,1643,781,862,0.4753499695678637,0.5246500304321363
E01011844,1918,943,975,0.4916579770594369,0.5083420229405631
E01011758,1350,680,670,0.5037037037037037,0.4962962962962963
E01011812,2595,1299,1296,0.500578034682081,0.49942196531791905
E01011820,1485,724,761,0.48754208754208755,0.5124579124579125
E01011821,1327,642,685,0.48379804069329313,0.5162019593067069
E01011885,1474,692,782,0.4694708276797829,0.5305291723202171
E01011886,1475,715,760,0.4847457627118644,0.5152542372881356
E01011888,1443,727,716,0.5038115038115039,0.4961884961884962
E01011890,1269,640,629,0.5043341213553979,0.49566587864460204
E01011891,1525,696,829,0.45639344262295084,0.5436065573770492
E01011834,1587,761,826,0.47952110901071204,0.520478890989288
E01011837,1467,717,750,0.4887525562372188,0.5112474437627812
E01011838,1958,1006,952,0.5137895812053116,0.48621041879468846
E01011841,1522,769,753,0.5052562417871223,0.4947437582128778
E01011842,1429,699,730,0.48915325402379284,0.5108467459762072
E01011813,1621,763,858,0.47069710055521286,0.5293028994447871
E01011814,1698,879,819,0.5176678445229682,0.4823321554770318
E01011815,1523,754,769,0.495075508864084,0.504924491135916
E01011816,1411,661,750,0.4684620836286322,0.5315379163713678
E01011819,1567,772,795,0.49266113592852584,0.5073388640714741
E01011822,1428,682,746,0.47759103641456585,0.5224089635854342
E01011884,2339,1160,1179,0.4959384352287302,0.5040615647712697
E01011912,1552,833,719,0.5367268041237113,0.4632731958762887
E01011913,1660,843,817,0.5078313253012048,0.49216867469879516
E01011916,2002,1147,855,0.5729270729270729,0.4270729270729271
E01011840,1540,732,808,0.4753246753246753,0.5246753246753246
E01011850,1522,718,804,0.47174770039421815,0.5282522996057819
E01011852,1626,769,857,0.47293972939729395,0.527060270602706
E01011853,1461,694,767,0.4750171115674196,0.5249828884325805
E01011920,2305,1539,766,0.6676789587852494,0.33232104121475053
E01011923,1633,855,778,0.5235762400489896,0.4764237599510104
E01011924,1536,768,768,0.5,0.5
E01011925,1692,795,897,0.4698581560283688,0.5301418439716312
E01011909,1404,692,712,0.4928774928774929,0.5071225071225072
E01011910,1515,748,767,0.49372937293729374,0.5062706270627063
E01011911,1526,739,787,0.4842726081258191,0.5157273918741808
E01011914,1547,749,798,0.4841628959276018,0.5158371040723982
E01011915,1611,772,839,0.4792054624456859,0.520794537554314
E01011823,1413,677,736,0.47912243453644726,0.5208775654635527
E01011824,1520,717,803,0.47171052631578947,0.5282894736842105
E01011825,1838,904,934,0.49183895538628947,0.5081610446137106
E01011826,1434,688,746,0.4797768479776848,0.5202231520223152
E01011827,1177,583,594,0.4953271028037383,0.5046728971962616
E01011828,1427,703,724,0.4926419060967064,0.5073580939032937
E01011889,1303,653,650,0.501151189562548,0.49884881043745205
E01011892,1801,876,925,0.4863964464186563,0.5136035535813437
E01011919,1824,908,916,0.49780701754385964,0.5021929824561403
E01011921,1468,715,753,0.48705722070844687,0.5129427792915532
E01011926,1600,800,800,0.5,0.5
E01011927,1353,634,719,0.4685883222468588,0.5314116777531411
E01011845,1367,662,705,0.4842721287490856,0.5157278712509145
E01011846,1362,661,701,0.4853157121879589,0.5146842878120411
E01011847,1428,694,734,0.48599439775910364,0.5140056022408963
E01011848,1469,695,774,0.47311095983662355,0.5268890401633765
E01011851,1429,711,718,0.49755073477956613,0.5024492652204339
E01011775,2867,1414,1453,0.49319846529473316,0.5068015347052668
E01011776,1609,774,835,0.4810441267868241,0.5189558732131759
E01011777,1352,665,687,0.4918639053254438,0.5081360946745562
E01011778,1568,729,839,0.4649234693877551,0.5350765306122449
E01011817,1332,649,683,0.4872372372372372,0.5127627627627628
E01011818,1331,646,685,0.48534936138241924,0.5146506386175808
E01011829,1426,687,739,0.48176718092566617,0.5182328190743338
E01011830,1255,602,653,0.4796812749003984,0.5203187250996016
E01011831,1708,851,857,0.49824355971896955,0.5017564402810304
E01011832,1411,702,709,0.49751948972360027,0.5024805102763997
E01011833,1507,729,778,0.48374253483742535,0.5162574651625746
E01011899,1506,709,797,0.4707835325365206,0.5292164674634794
E01011900,1531,736,795,0.480731548007838,0.519268451992162
E01011901,1645,734,911,0.4462006079027356,0.5537993920972645
E01011904,1427,692,735,0.4849334267694464,0.5150665732305536
E01011918,1543,727,816,0.4711600777705768,0.5288399222294232
E01011922,1452,695,757,0.4786501377410468,0.5213498622589532
E01011779,1508,740,768,0.4907161803713528,0.5092838196286472
E01011780,1832,870,962,0.47489082969432317,0.5251091703056768
E01011781,1710,818,892,0.4783625730994152,0.5216374269005848
E01011782,1490,717,773,0.4812080536912752,0.5187919463087248
E01011783,1308,655,653,0.5007645259938838,0.49923547400611623
E01011902,1390,680,710,0.4892086330935252,0.5107913669064749
E01011903,1215,606,609,0.49876543209876545,0.5012345679012346
E01011905,1618,786,832,0.4857849196538937,0.5142150803461063
E01011907,1765,899,866,0.5093484419263457,0.4906515580736544
E01011793,1621,796,825,0.4910549043800123,0.5089450956199877
E01011794,1399,692,707,0.49463902787705505,0.505360972122945
E01011795,1278,618,660,0.4835680751173709,0.5164319248826291
E01011796,1440,715,725,0.4965277777777778,0.5034722222222222
E01011799,1590,728,862,0.4578616352201258,0.5421383647798742
E01011800,1658,812,846,0.4897466827503016,0.5102533172496985
E01011898,1456,743,713,0.5103021978021978,0.4896978021978022
E01011906,1584,770,814,0.4861111111111111,0.5138888888888888
E01011908,2215,1133,1082,0.5115124153498871,0.4884875846501129
E01011917,1590,828,762,0.5207547169811321,0.47924528301886793
E01011944,1389,708,681,0.509719222462203,0.490280777537797
E01011797,1721,849,872,0.49331783846600813,0.5066821615339918
E01011798,1301,611,690,0.46963873943120676,0.5303612605687933
E01011801,1516,729,787,0.4808707124010554,0.5191292875989446
E01011802,1508,712,796,0.47214854111405835,0.5278514588859416
E01011765,1545,764,781,0.49449838187702266,0.5055016181229773
E01011766,1523,750,773,0.49244911359159554,0.5075508864084045
E01011773,1490,740,750,0.4966442953020134,0.5033557046979866
E01011774,1387,677,710,0.48810382119682766,0.5118961788031723
E01011939,1483,719,764,0.48482805124747136,0.5151719487525287
E01011945,1491,719,772,0.48222669349429914,0.5177733065057009
E01011947,1580,772,808,0.48860759493670886,0.5113924050632911
E01011948,1590,771,819,0.4849056603773585,0.5150943396226415
E01011767,1768,867,901,0.49038461538461536,0.5096153846153846
E01011768,1374,659,715,0.4796215429403202,0.5203784570596798
E01011769,2133,1088,1045,0.5100796999531176,0.4899203000468823
E01011770,1912,906,1006,0.47384937238493724,0.5261506276150628
E01011849,1576,774,802,0.49111675126903553,0.5088832487309645
E01011857,1641,820,821,0.4996953077391834,0.5003046922608165
E01011928,1334,643,691,0.48200899550224885,0.5179910044977512
E01011931,1506,741,765,0.49203187250996017,0.5079681274900398
E01011932,1417,699,718,0.49329569513055754,0.5067043048694425
E01011938,1706,693,1013,0.40621336459554513,0.5937866354044549
E01011929,1601,783,818,0.48906933166770766,0.5109306683322923
E01011930,1711,824,887,0.48158971361776737,0.5184102863822326
E01011933,1604,784,820,0.48877805486284287,0.5112219451371571
E01011937,1420,695,725,0.4894366197183099,0.5105633802816901
E01011934,1459,753,706,0.5161069225496916,0.4838930774503084
E01011936,1476,685,791,0.4640921409214092,0.5359078590785907
E01011940,1439,728,711,0.5059068797776234,0.49409312022237667
E01011943,1741,822,919,0.47214244686961515,0.5278575531303848
E01011935,1798,881,917,0.4899888765294772,0.5100111234705228
E01011941,1449,673,776,0.4644582470669427,0.5355417529330573
E01011942,1246,619,627,0.4967897271268058,0.5032102728731942
E01011946,1482,721,761,0.4865047233468286,0.5134952766531714
E01011785,1558,755,803,0.48459563543003853,0.5154043645699615
E01011789,1268,606,662,0.47791798107255523,0.5220820189274448
E01011791,1503,753,750,0.500998003992016,0.499001996007984
E01011792,1516,750,766,0.4947229551451187,0.5052770448548812
E01011771,1301,604,697,0.4642582628747118,0.5357417371252883
E01011772,1593,811,782,0.5091023226616447,0.4908976773383553
E01011784,1817,889,928,0.4892680242157402,0.5107319757842598
E01011786,1610,789,821,0.49006211180124226,0.5099378881987577
E01011854,1228,619,609,0.504071661237785,0.495928338762215
E01011855,1591,782,809,0.491514770584538,0.5084852294154619
E01011856,1425,712,713,0.49964912280701756,0.5003508771929824
E01011858,1588,776,812,0.48866498740554154,0.5113350125944585
E01011787,1710,856,854,0.5005847953216375,0.4994152046783626
E01011788,1672,834,838,0.4988038277511962,0.5011961722488039
E01011790,1629,816,813,0.5009208103130756,0.4990791896869245
E01011865,1680,815,865,0.4851190476190476,0.5148809523809523
E01011867,1643,769,874,0.46804625684723067,0.5319537431527693
E01011859,1469,699,770,0.4758339006126617,0.5241660993873384
E01011869,1435,719,716,0.5010452961672474,0.4989547038327526
E01011870,1407,710,697,0.5046197583511016,0.4953802416488984
E01011871,1561,782,779,0.5009609224855862,0.49903907751441384
E01011860,1514,750,764,0.4953764861294584,0.5046235138705416
E01011861,2017,994,1023,0.4928111056023798,0.5071888943976203
E01011862,1480,751,729,0.5074324324324324,0.4925675675675676
E01011863,1314,632,682,0.4809741248097412,0.5190258751902588
E01011864,1642,804,838,0.48964677222898906,0.510353227771011
E01011866,1598,780,818,0.4881101376720901,0.5118898623279099
E01011868,1912,923,989,0.4827405857740586,0.5172594142259415
E01011872,1550,773,777,0.49870967741935485,0.5012903225806452
E01013461,1635,805,830,0.4923547400611621,0.5076452599388379
E01013462,1524,720,804,0.47244094488188976,0.5275590551181102
E01013463,1524,753,771,0.4940944881889764,0.5059055118110236
E01013464,1452,695,757,0.4786501377410468,0.5213498622589532
E01013465,1661,829,832,0.4990969295605057,0.5009030704394943
E01013466,1542,735,807,0.4766536964980545,0.5233463035019456
E01013467,1389,671,718,0.48308135349172066,0.5169186465082793
E01013468,1615,781,834,0.48359133126934983,0.5164086687306502
E01013469,1280,609,671,0.47578125,0.52421875
E01013574,1355,677,678,0.4996309963099631,0.5003690036900369
E01013575,1404,695,709,0.495014245014245,0.5049857549857549
E01013576,1482,734,748,0.49527665317139,0.50472334682861
E01013577,1583,792,791,0.5003158559696779,0.4996841440303222
E01013578,1383,675,708,0.4880694143167028,0.5119305856832972
E01013579,1456,733,723,0.5034340659340659,0.4965659340659341
E01013580,1475,692,783,0.46915254237288134,0.5308474576271186
E01013530,1530,758,772,0.4954248366013072,0.5045751633986928
E01013531,1415,694,721,0.49045936395759715,0.5095406360424029
E01013532,1491,717,774,0.48088531187122735,0.5191146881287726
E01013581,1556,730,826,0.4691516709511568,0.5308483290488432
E01013526,1610,801,809,0.49751552795031057,0.5024844720496895
E01013527,1511,745,766,0.4930509596293845,0.5069490403706155
E01013528,1648,780,868,0.4733009708737864,0.5266990291262136
E01013529,2362,1148,1214,0.48602878916172737,0.5139712108382727
E01013505,1508,740,768,0.4907161803713528,0.5092838196286472
E01013506,1592,781,811,0.4905778894472362,0.5094221105527639
E01013513,1292,620,672,0.47987616099071206,0.5201238390092879
E01013534,1654,811,843,0.49032648125755746,0.5096735187424426
E01013582,1565,739,826,0.47220447284345046,0.5277955271565495
E01013533,1645,771,874,0.46869300911854106,0.5313069908814589
E01013535,1615,764,851,0.47306501547987617,0.5269349845201239
E01013536,1595,774,821,0.4852664576802508,0.5147335423197492
E01013537,1635,812,823,0.4966360856269113,0.5033639143730887
E01013538,1522,753,769,0.4947437582128778,0.5052562417871223
E01013522,1736,932,804,0.5368663594470046,0.4631336405529954
E01013523,1547,873,674,0.5643180349062702,0.4356819650937298
E01013524,2497,1337,1160,0.5354425310372447,0.4645574689627553
E01013525,1986,1029,957,0.5181268882175226,0.4818731117824773
E01013548,1511,724,787,0.47915287888815355,0.5208471211118465
E01013549,1431,682,749,0.47658979734451434,0.5234102026554857
E01013552,1671,764,907,0.4572112507480551,0.542788749251945
E01013553,1488,703,785,0.4724462365591398,0.5275537634408602
E01013555,1532,750,782,0.489556135770235,0.5104438642297651
E01013592,1401,702,699,0.5010706638115632,0.4989293361884368
E01013594,1353,672,681,0.49667405764966743,0.5033259423503326
E01013596,1559,731,828,0.46889031430404104,0.531109685695959
E01013599,1388,708,680,0.5100864553314121,0.4899135446685879
E01013547,1754,972,782,0.5541619156214367,0.44583808437856326
E01013550,1279,626,653,0.48944487881157156,0.5105551211884285
E01013551,1876,1017,859,0.5421108742004265,0.4578891257995736
E01013554,1638,886,752,0.5409035409035409,0.4590964590964591
E01013507,1527,757,770,0.495743287491814,0.5042567125081859
E01013508,1261,609,652,0.4829500396510706,0.5170499603489295
E01013509,1673,822,851,0.4913329348475792,0.5086670651524208
E01013510,1519,721,798,0.47465437788018433,0.5253456221198156
E01013511,1561,795,766,0.5092889173606663,0.4907110826393338
E01013512,1480,722,758,0.48783783783783785,0.5121621621621621
E01013453,2358,1220,1138,0.5173876166242578,0.48261238337574214
E01013454,1529,775,754,0.5068672334859385,0.49313276651406146
E01013456,2042,1110,932,0.5435847208619001,0.4564152791380999
E01013457,1838,889,949,0.4836779107725789,0.5163220892274211
E01013460,2017,1048,969,0.5195835399107586,0.48041646008924144
E01013479,2035,1192,843,0.5857493857493857,0.41425061425061427
E01013593,1378,679,699,0.4927431059506531,0.5072568940493469
E01013595,2320,1123,1197,0.484051724137931,0.5159482758620689
E01013597,1436,681,755,0.4742339832869081,0.525766016713092
E01013598,1542,768,774,0.4980544747081712,0.5019455252918288
E01013556,1430,676,754,0.4727272727272727,0.5272727272727272
E01013557,1384,670,714,0.4841040462427746,0.5158959537572254
E01013558,2038,984,1054,0.48282630029440626,0.5171736997055937
E01013559,1368,664,704,0.4853801169590643,0.5146198830409356
E01013564,2000,973,1027,0.4865,0.5135
E01013480,2050,1148,902,0.56,0.44
E01013483,2119,1111,1008,0.5243039169419538,0.4756960830580462
E01013485,2064,1035,1029,0.501453488372093,0.498546511627907
E01013565,1719,875,844,0.5090168702734148,0.4909831297265852
E01013566,2019,1078,941,0.5339276869737494,0.46607231302625063
E01013455,1921,953,968,0.4960957834461218,0.5039042165538782
E01013458,1633,802,831,0.4911206368646663,0.5088793631353338
E01013542,1732,840,892,0.48498845265588914,0.5150115473441108
E01013546,1679,827,852,0.4925550923168553,0.5074449076831448
E01013481,1885,958,927,0.5082228116710875,0.4917771883289125
E01013484,1956,1029,927,0.5260736196319018,0.47392638036809814
E01013486,2004,1021,983,0.5094810379241517,0.49051896207584833
E01013487,2254,1137,1117,0.5044365572315883,0.4955634427684117
E01033166,1087,626,461,0.5758969641214351,0.42410303587856485
E01033167,1136,618,518,0.5440140845070423,0.45598591549295775
E01013540,1558,752,806,0.48267008985879334,0.5173299101412067
E01013560,1509,749,760,0.4963552021206097,0.5036447978793903
E01013561,1554,764,790,0.49163449163449163,0.5083655083655083
E01013562,1381,571,810,0.41346850108616945,0.5865314989138306
E01013563,1358,672,686,0.4948453608247423,0.5051546391752577
E01013459,1996,981,1015,0.49148296593186375,0.5085170340681363
E01013567,2022,1030,992,0.5093966369930761,0.49060336300692386
E01013568,2065,1050,1015,0.5084745762711864,0.4915254237288136
E01013569,1581,804,777,0.50853889943074,0.49146110056925996
E01013539,2476,1238,1238,0.5,0.5
E01013541,1625,759,866,0.46707692307692306,0.5329230769230769
E01013543,1816,891,925,0.4906387665198238,0.5093612334801763
E01013544,1844,922,922,0.5,0.5
E01013545,1645,804,841,0.4887537993920973,0.5112462006079027
E01013488,1563,772,791,0.49392194497760716,0.5060780550223928
E01013489,1565,752,813,0.4805111821086262,0.5194888178913738
E01013490,1521,695,826,0.4569362261669954,0.5430637738330046
E01013491,1668,806,862,0.4832134292565947,0.5167865707434053
E01013570,1964,966,998,0.49185336048879835,0.5081466395112016
E01013571,1904,915,989,0.4805672268907563,0.5194327731092437
E01013572,1724,815,909,0.47273781902552203,0.527262180974478
E01013573,2073,1025,1048,0.4944524843222383,0.5055475156777617
E01013470,1470,731,739,0.49727891156462584,0.5027210884353741
E01013474,1535,764,771,0.4977198697068404,0.5022801302931597
E01013476,1447,719,728,0.4968901174844506,0.5031098825155494
E01033171,1399,701,698,0.501072194424589,0.498927805575411
E01033172,1557,827,730,0.5311496467565832,0.46885035324341684
E01013471,1858,898,960,0.48331539289558667,0.5166846071044133
E01013473,1516,733,783,0.48350923482849606,0.5164907651715039
E01013475,1587,773,814,0.4870825456836799,0.5129174543163201
E01013477,1793,922,871,0.5142219743446738,0.4857780256553263
E01013502,1429,704,725,0.4926522043386984,0.5073477956613016
E01013503,1525,779,746,0.5108196721311475,0.48918032786885246
E01013472,2093,1006,1087,0.4806497849976111,0.5193502150023889
E01013497,1533,722,811,0.4709719504240052,0.5290280495759948
E01013504,1912,943,969,0.4932008368200837,0.5067991631799164
E01013583,1663,803,860,0.48286229705351774,0.5171377029464823
E01013590,1774,848,926,0.47801578354002255,0.5219842164599775
E01013591,2035,997,1038,0.48992628992628995,0.51007371007371
E01013492,1595,764,831,0.4789968652037618,0.5210031347962383
E01013493,1517,715,802,0.4713249835201055,0.5286750164798946
E01013494,1860,873,987,0.4693548387096774,0.5306451612903226
E01013495,1766,857,909,0.485277463193658,0.5147225368063421
E01013496,1545,710,835,0.459546925566343,0.540453074433657
E01013498,1456,720,736,0.4945054945054945,0.5054945054945055
E01013499,1384,668,716,0.48265895953757226,0.5173410404624278
E01013500,1690,813,877,0.48106508875739645,0.5189349112426036
E01013501,1400,675,725,0.48214285714285715,0.5178571428571429
E01013584,1870,929,941,0.49679144385026736,0.5032085561497326
E01013585,1751,832,919,0.47515705311250717,0.5248429468874929
E01013586,1552,719,833,0.4632731958762887,0.5367268041237113
E01013587,1528,762,766,0.4986910994764398,0.5013089005235603
E01013588,1532,734,798,0.47911227154047,0.52088772845953
E01013589,1423,722,701,0.5073787772312017,0.49262122276879833
E01013517,1426,676,750,0.4740532959326788,0.5259467040673211
E01013518,1416,687,729,0.4851694915254237,0.5148305084745762
E01013521,1346,668,678,0.4962852897473997,0.5037147102526003
E01033168,1350,671,679,0.49703703703703705,0.502962962962963
E01033169,1774,876,898,0.49379932356257045,0.5062006764374295
E01033170,1232,596,636,0.4837662337662338,0.5162337662337663
E01013514,1632,781,851,0.47855392156862747,0.5214460784313726
E01013515,1842,883,959,0.4793702497285559,0.5206297502714441
E01013519,1648,779,869,0.47269417475728154,0.5273058252427184
E01013520,1532,755,777,0.49281984334203655,0.5071801566579635
E01013615,1526,764,762,0.5006553079947575,0.49934469200524245
E01013616,1597,751,846,0.47025673137132123,0.5297432686286788
E01013618,1564,785,779,0.5019181585677749,0.49808184143222506
E01013619,1744,881,863,0.5051605504587156,0.4948394495412844
E01013733,1625,820,805,0.5046153846153846,0.49538461538461537
E01013734,1484,743,741,0.5006738544474394,0.49932614555256066
E01013735,1328,652,676,0.49096385542168675,0.5090361445783133
E01013736,1708,821,887,0.4806791569086651,0.5193208430913349
E01013737,1437,703,734,0.4892136395267919,0.510786360473208
E01013600,1921,902,1019,0.46954711087975015,0.5304528891202499
E01013601,1684,825,859,0.48990498812351546,0.5100950118764845
E01013602,1846,926,920,0.5016251354279523,0.49837486457204766
E01013603,1721,818,903,0.47530505520046484,0.5246949447995352
E01013604,1663,801,862,0.481659651232712,0.5183403487672881
E01013605,1774,873,901,0.49210822998872605,0.507891770011274
E01013617,2548,1280,1268,0.5023547880690737,0.4976452119309262
E01013620,1812,854,958,0.47130242825607066,0.5286975717439294
E01013621,1891,958,933,0.5066102591221576,0.49338974087784243
E01013622,1635,860,775,0.5259938837920489,0.4740061162079511
E01013623,2163,1087,1076,0.502542764678687,0.497457235321313
E01013732,2107,1029,1078,0.4883720930232558,0.5116279069767442
E01013739,1537,735,802,0.4782042940793754,0.5217957059206246
E01013740,1513,754,759,0.4983476536682089,0.5016523463317911
E01013741,1675,836,839,0.4991044776119403,0.5008955223880597
E01013625,1864,970,894,0.5203862660944206,0.4796137339055794
E01013628,1534,696,838,0.45371577574967403,0.546284224250326
E01013715,1314,630,684,0.4794520547945205,0.5205479452054794
E01013716,1812,884,928,0.4878587196467991,0.5121412803532008
E01013738,1548,750,798,0.4844961240310077,0.5155038759689923
E01013624,1464,721,743,0.4924863387978142,0.5075136612021858
E01013626,1855,935,920,0.5040431266846361,0.49595687331536387
E01013627,1301,650,651,0.49961568024596464,0.5003843197540354
E01013629,1715,837,878,0.4880466472303207,0.5119533527696793
E01013630,1825,880,945,0.4821917808219178,0.5178082191780822
E01013606,1744,875,869,0.5017201834862385,0.49827981651376146
E01013607,2573,1344,1229,0.5223474543334629,0.47765254566653714
E01013680,2088,1038,1050,0.49712643678160917,0.5028735632183908
E01013685,1476,719,757,0.48712737127371275,0.5128726287262872
E01013686,1850,913,937,0.4935135135135135,0.5064864864864865
E01013696,2442,1181,1261,0.4836199836199836,0.5163800163800164
E01013697,2639,1334,1305,0.5054945054945055,0.4945054945054945
E01013699,1709,830,879,0.48566413107080164,0.5143358689291984
E01032862,2010,973,1037,0.48407960199004973,0.5159203980099503
E01032863,1708,853,855,0.4994145199063232,0.5005854800936768
E01032865,2120,1036,1084,0.48867924528301887,0.5113207547169811
E01013713,1543,788,755,0.5106934543097861,0.48930654569021387
E01013714,1724,835,889,0.484338747099768,0.515661252900232
E01013717,1569,774,795,0.4933078393881453,0.5066921606118547
E01013718,1587,742,845,0.4675488342785129,0.5324511657214871
E01013719,1562,784,778,0.5019206145966709,0.4980793854033291
E01013720,1346,589,757,0.437592867756315,0.562407132243685
E01013651,1716,868,848,0.5058275058275058,0.49417249417249415
E01013652,1791,867,924,0.48408710217755446,0.5159128978224455
E01013653,1899,912,987,0.4802527646129542,0.5197472353870458
E01013655,2039,1078,961,0.5286905345757724,0.4713094654242276
E01013721,1598,747,851,0.467459324155194,0.532540675844806
E01013723,1382,652,730,0.4717800289435601,0.5282199710564399
E01013725,1400,662,738,0.47285714285714286,0.5271428571428571
E01013726,1727,792,935,0.4585987261146497,0.5414012738853503
E01013728,1616,765,851,0.47339108910891087,0.5266089108910891
E01013694,1647,772,875,0.46873102610807527,0.5312689738919247
E01013700,1517,729,788,0.48055372445616346,0.5194462755438365
E01013770,1390,671,719,0.4827338129496403,0.5172661870503598
E01013771,1604,771,833,0.48067331670822944,0.5193266832917706
E01013773,1480,742,738,0.5013513513513513,0.49864864864864866
E01013681,1813,902,911,0.49751792608935463,0.5024820739106454
E01013682,1787,881,906,0.4930050363738109,0.5069949636261891
E01013683,2097,1096,1001,0.5226514067715784,0.47734859322842155
E01013684,1961,1017,944,0.5186129525752168,0.4813870474247833
E01013654,2199,1063,1136,0.48340154615734426,0.5165984538426558
E01013656,1828,916,912,0.5010940919037199,0.4989059080962801
E01013657,1819,899,920,0.49422759758108853,0.5057724024189115
E01013658,1870,993,877,0.5310160427807487,0.46898395721925135
E01013659,2008,1020,988,0.5079681274900398,0.49203187250996017
E01013743,1645,826,819,0.502127659574468,0.4978723404255319
E01013745,1680,852,828,0.5071428571428571,0.4928571428571429
E01013742,1822,901,921,0.49451152579582874,0.5054884742041712
E01013744,1983,1012,971,0.5103378719112456,0.4896621280887544
E01013746,1857,988,869,0.5320409262250942,0.46795907377490575
E01013748,2017,1018,999,0.5047099652949926,0.49529003470500743
E01013754,2059,1016,1043,0.49344341913550266,0.5065565808644973
E01013755,2216,1051,1165,0.4742779783393502,0.5257220216606499
E01013660,1814,932,882,0.5137816979051819,0.4862183020948181
E01013661,1716,823,893,0.4796037296037296,0.5203962703962703
E01013664,1834,891,943,0.48582333696837515,0.5141766630316249
E01013665,1837,962,875,0.5236799129014698,0.4763200870985302
E01013667,1568,751,817,0.4789540816326531,0.5210459183673469
E01013668,1581,750,831,0.47438330170777987,0.5256166982922201
E01013729,1296,646,650,0.4984567901234568,0.5015432098765432
E01013780,1497,738,759,0.49298597194388777,0.5070140280561122
E01013783,1554,750,804,0.4826254826254826,0.5173745173745173
E01013785,1520,741,779,0.4875,0.5125
E01013786,1518,754,764,0.49670619235836627,0.5032938076416338
E01013662,1792,936,856,0.5223214285714286,0.47767857142857145
E01013663,1798,885,913,0.4922135706340378,0.5077864293659622
E01013747,1905,977,928,0.5128608923884515,0.48713910761154855
E01013749,1616,807,809,0.4993811881188119,0.5006188118811881
E01013750,1522,792,730,0.5203679369250985,0.47963206307490147
E01013758,1641,832,809,0.5070079219987812,0.49299207800121875
E01013751,1962,1006,956,0.5127420998980632,0.4872579001019368
E01013752,1570,809,761,0.5152866242038217,0.48471337579617835
E01013753,1717,882,835,0.5136866627839255,0.48631333721607456
E01013760,1963,1116,847,0.5685175751400917,0.4314824248599083
E01013761,2100,1065,1035,0.5071428571428571,0.4928571428571429
E01013762,1887,966,921,0.5119236883942766,0.48807631160572335
E01013774,1749,909,840,0.5197255574614065,0.48027444253859347
E01013776,1711,970,741,0.5669199298655757,0.4330800701344243
E01013778,2502,1204,1298,0.4812150279776179,0.518784972022382
E01013779,1950,980,970,0.5025641025641026,0.49743589743589745
E01013781,1637,859,778,0.5247403787416005,0.4752596212583995
E01013782,1516,704,812,0.46437994722955145,0.5356200527704486
E01013784,1367,728,639,0.5325530358449159,0.46744696415508413
E01013666,1588,766,822,0.482367758186398,0.517632241813602
E01013669,1429,696,733,0.48705388383484954,0.5129461161651504
E01013670,1792,865,927,0.48270089285714285,0.5172991071428571
E01013671,1804,872,932,0.48337028824833705,0.516629711751663
E01013672,1371,677,694,0.4938001458789205,0.5061998541210795
E01013631,1548,749,799,0.4838501291989664,0.5161498708010336
E01013632,1871,912,959,0.48743987172634956,0.5125601282736505
E01013638,1729,805,924,0.46558704453441296,0.5344129554655871
E01013640,1950,932,1018,0.47794871794871796,0.522051282051282
E01013756,1935,976,959,0.5043927648578811,0.49560723514211885
E01013757,1664,818,846,0.49158653846153844,0.5084134615384616
E01013759,1965,955,1010,0.4860050890585242,0.5139949109414759
E01013763,2053,1095,958,0.53336580613736,0.46663419386264005
E01013764,1636,799,837,0.4883863080684597,0.5116136919315404
E01013765,1698,929,769,0.5471142520612485,0.45288574793875147
E01013766,1848,923,925,0.49945887445887444,0.5005411255411255
E01013633,1650,786,864,0.4763636363636364,0.5236363636363637
E01013634,1533,714,819,0.4657534246575342,0.5342465753424658
E01013637,1968,955,1013,0.48526422764227645,0.5147357723577236
E01013639,1464,666,798,0.45491803278688525,0.5450819672131147
E01013641,1609,813,796,0.5052827843380981,0.4947172156619018
E01013635,1491,734,757,0.4922870556673374,0.5077129443326627
E01013636,1360,669,691,0.4919117647058823,0.5080882352941176
E01013775,2155,1119,1036,0.5192575406032482,0.48074245939675175
E01013777,1577,862,715,0.5466074825618262,0.45339251743817377
E01013642,1821,877,944,0.4816035145524437,0.5183964854475562
E01013643,1844,906,938,0.4913232104121475,0.5086767895878525
E01013649,1541,784,757,0.508760545100584,0.49123945489941595
E01013650,1808,883,925,0.4883849557522124,0.5116150442477876
E01013702,1573,790,783,0.5022250476795931,0.49777495232040686
E01013710,1409,727,682,0.5159687721788503,0.48403122782114977
E01013711,1625,797,828,0.49046153846153845,0.5095384615384615
E01013613,1646,810,836,0.49210206561360875,0.5078979343863913
E01013614,1561,755,806,0.4836643177450352,0.5163356822549647
E01013687,1573,804,769,0.5111252383979656,0.4888747616020343
E01013688,1450,715,735,0.49310344827586206,0.506896551724138
E01013703,1290,635,655,0.49224806201550386,0.5077519379844961
E01013704,1436,664,772,0.4623955431754875,0.5376044568245125
E01013706,1628,785,843,0.4821867321867322,0.5178132678132679
E01013707,1598,763,835,0.47747183979974966,0.5225281602002503
E01013712,1512,728,784,0.48148148148148145,0.5185185185185185
E01013608,1547,788,759,0.5093729799612152,0.4906270200387847
E01013609,1575,774,801,0.49142857142857144,0.5085714285714286
E01013610,1699,830,869,0.4885226603884638,0.5114773396115362
E01013611,1581,788,793,0.49841872232764073,0.5015812776723593
E01013612,1542,757,785,0.4909208819714656,0.5090791180285343
E01013678,1644,800,844,0.48661800486618007,0.51338199513382
E01013679,1559,757,802,0.48556767158434894,0.514432328415651
E01013691,1659,751,908,0.4526823387582881,0.5473176612417119
E01013692,1413,646,767,0.45718329794762913,0.5428167020523709
E01013693,1477,692,785,0.4685172647257955,0.5314827352742044
E01013673,1557,745,812,0.47848426461143223,0.5215157353885678
E01013674,1621,728,893,0.44910549043800124,0.5508945095619988
E01013675,1634,773,861,0.4730722154222766,0.5269277845777234
E01013676,1971,907,1064,0.46017250126839165,0.5398274987316083
E01013677,1534,748,786,0.4876140808344198,0.5123859191655802
E01013695,1525,694,831,0.4550819672131148,0.5449180327868852
E01013698,1537,748,789,0.4866623292127521,0.5133376707872479
E01013767,1537,735,802,0.4782042940793754,0.5217957059206246
E01013768,1544,752,792,0.48704663212435234,0.5129533678756477
E01013772,1601,784,817,0.4896939412866958,0.5103060587133041
E01032597,1440,680,760,0.4722222222222222,0.5277777777777778
E01013689,1837,869,968,0.47305389221556887,0.5269461077844312
E01013690,1540,769,771,0.4993506493506494,0.5006493506493507
E01013705,1579,766,813,0.4851171627612413,0.5148828372387587
E01013709,1576,779,797,0.49428934010152287,0.5057106598984772
E01032599,1579,772,807,0.4889170360987967,0.5110829639012033
E01013722,1753,828,925,0.47233314318311465,0.5276668568168853
E01013727,1491,722,769,0.4842387659289068,0.5157612340710932
E01013730,1574,769,805,0.48856416772554,0.51143583227446
E01013731,1619,764,855,0.4718962322421248,0.5281037677578753
E01032602,1672,814,858,0.4868421052631579,0.5131578947368421
E01013646,2760,1445,1315,0.5235507246376812,0.47644927536231885
E01013647,2504,1210,1294,0.48322683706070285,0.5167731629392971
E01013648,2688,1279,1409,0.4758184523809524,0.5241815476190477
E01032875,1903,835,1068,0.43878087230688384,0.5612191276931161
E01032867,1800,990,810,0.55,0.45
E01032868,1692,747,945,0.44148936170212766,0.5585106382978723
E01032872,1206,686,520,0.5688225538971807,0.4311774461028192
E01032873,1334,790,544,0.5922038980509745,0.4077961019490255
E01013887,1534,762,772,0.49674054758800523,0.5032594524119948
E01013892,1414,682,732,0.4823196605374823,0.5176803394625177
E01013893,1349,627,722,0.4647887323943662,0.5352112676056338
E01013894,1476,707,769,0.47899728997289975,0.5210027100271003
E01013879,1293,588,705,0.4547563805104408,0.5452436194895591
E01013880,1533,701,832,0.4572733202870189,0.542726679712981
E01013881,1505,689,816,0.4578073089700997,0.5421926910299003
E01013882,1432,662,770,0.4622905027932961,0.5377094972067039
E01013885,1662,803,859,0.4831528279181709,0.5168471720818292
E01013886,1450,714,736,0.4924137931034483,0.5075862068965518
E01013888,1507,745,762,0.49435965494359657,0.5056403450564034
E01013889,1653,807,846,0.4882032667876588,0.5117967332123412
E01013890,1546,750,796,0.4851228978007762,0.5148771021992238
E01013891,1685,825,860,0.4896142433234421,0.5103857566765578
E01013875,1371,709,662,0.5171407731582787,0.4828592268417214
E01013876,1797,871,926,0.48469671675013914,0.5153032832498609
E01013877,1394,632,762,0.4533715925394548,0.5466284074605452
E01013878,1296,634,662,0.48919753086419754,0.5108024691358025
E01013883,1524,712,812,0.4671916010498688,0.5328083989501312
E01013884,1350,668,682,0.4948148148148148,0.5051851851851852
E01013853,1475,726,749,0.4922033898305085,0.5077966101694915
E01013854,1429,673,756,0.4709587123862841,0.5290412876137159
E01013855,1602,754,848,0.4706616729088639,0.529338327091136
E01013856,1616,742,874,0.4591584158415842,0.5408415841584159
E01033397,1770,856,914,0.48361581920903957,0.5163841807909605
E01033398,1150,613,537,0.5330434782608696,0.46695652173913044
E01013963,1569,736,833,0.46908859145952836,0.5309114085404716
E01013964,1679,817,862,0.4865991661703395,0.5134008338296605
E01013965,1483,673,810,0.4538098449089683,0.5461901550910316
E01013966,1416,634,782,0.4477401129943503,0.5522598870056498
E01013967,1811,1150,661,0.635008282716731,0.3649917172832689
E01013827,1481,709,772,0.4787305874409183,0.5212694125590817
E01013828,1646,821,825,0.49878493317132444,0.5012150668286756
E01013834,1600,728,872,0.455,0.545
E01013835,1647,795,852,0.48269581056466304,0.517304189435337
E01013836,1876,915,961,0.4877398720682303,0.5122601279317697
E01013829,1625,789,836,0.48553846153846153,0.5144615384615384
E01013830,1669,819,850,0.4907130017974835,0.5092869982025164
E01013831,1553,757,796,0.4874436574372183,0.5125563425627817
E01013832,1769,879,890,0.4968908988128886,0.5031091011871114
E01013833,1341,659,682,0.49142431021625654,0.5085756897837435
E01013935,1526,767,759,0.5026212319790302,0.49737876802096986
E01013968,1304,619,685,0.4746932515337423,0.5253067484662577
E01013969,1610,820,790,0.5093167701863354,0.4906832298136646
E01013970,1554,759,795,0.48841698841698844,0.5115830115830116
E01013971,1533,830,703,0.5414220482713633,0.45857795172863663
E01013817,1707,818,889,0.479203280609256,0.520796719390744
E01013818,1774,805,969,0.45377677564825253,0.5462232243517474
E01013822,1705,778,927,0.4563049853372434,0.5436950146627566
E01013825,1850,888,962,0.48,0.52
E01013826,1947,876,1071,0.44992295839753466,0.5500770416024653
E01013837,1772,886,886,0.5,0.5
E01013838,1800,888,912,0.49333333333333335,0.5066666666666667
E01013839,1757,841,916,0.4786568013659647,0.5213431986340353
E01013840,2195,1118,1077,0.5093394077448747,0.49066059225512526
E01013841,1583,809,774,0.511054958938724,0.48894504106127606
E01013819,1720,810,910,0.47093023255813954,0.5290697674418605
E01013820,1781,848,933,0.47613700168444695,0.523862998315553
E01013821,1679,784,895,0.4669446098868374,0.5330553901131626
E01013823,1853,905,948,0.4883971937398813,0.5116028062601188
E01013824,1606,763,843,0.475093399750934,0.524906600249066
E01013864,1530,718,812,0.469281045751634,0.530718954248366
E01013865,1552,733,819,0.4722938144329897,0.5277061855670103
E01013866,1499,726,773,0.48432288192128087,0.5156771180787192
E01013867,1594,746,848,0.46800501882057716,0.5319949811794228
E01013937,1740,895,845,0.514367816091954,0.48563218390804597
E01013938,1548,789,759,0.5096899224806202,0.4903100775193798
E01013941,1638,823,815,0.5024420024420024,0.49755799755799757
E01013943,1820,992,828,0.545054945054945,0.45494505494505494
E01013972,1455,725,730,0.49828178694158076,0.5017182130584192
E01013936,2165,1060,1105,0.4896073903002309,0.5103926096997691
E01013939,1535,787,748,0.5127035830618892,0.48729641693811077
E01013940,1761,904,857,0.5133446905167518,0.48665530948324814
E01013942,2113,1055,1058,0.4992901088499763,0.5007098911500236
E01013843,1597,862,735,0.5397620538509705,0.4602379461490294
E01013844,1473,827,646,0.561439239646979,0.43856076035302105
E01013845,1688,876,812,0.518957345971564,0.48104265402843605
E01013847,1373,741,632,0.5396941005098325,0.46030589949016754
E01013810,1657,837,820,0.5051297525648762,0.4948702474351237
E01013811,1455,830,625,0.570446735395189,0.42955326460481097
E01013812,1624,849,775,0.5227832512315271,0.4772167487684729
E01013842,1675,887,788,0.5295522388059701,0.47044776119402987
E01013846,1738,882,856,0.5074798619102416,0.49252013808975836
E01013930,1980,1021,959,0.5156565656565657,0.48434343434343435
E01013931,1690,804,886,0.4757396449704142,0.5242603550295858
E01013932,1744,868,876,0.49770642201834864,0.5022935779816514
E01013933,1840,934,906,0.5076086956521739,0.4923913043478261
E01013934,1531,770,761,0.5029392553886349,0.4970607446113651
E01013859,1454,697,757,0.4793672627235213,0.5206327372764786
E01013861,1520,711,809,0.4677631578947368,0.5322368421052631
E01013868,1572,736,836,0.4681933842239186,0.5318066157760815
E01013929,1917,914,1003,0.4767866458007303,0.5232133541992697
E01013954,1339,660,679,0.49290515309932786,0.5070948469006722
E01013959,1834,928,906,0.5059978189749182,0.4940021810250818
E01013960,1569,785,784,0.5003186743148502,0.4996813256851498
E01013962,1812,884,928,0.4878587196467991,0.5121412803532008
E01013813,2199,1168,1031,0.5311505229649841,0.4688494770350159
E01013814,2024,1129,895,0.557806324110672,0.44219367588932806
E01013815,1804,902,902,0.5,0.5
E01013816,2558,1327,1231,0.5187646598905394,0.4812353401094605
E01013958,1806,880,926,0.48726467331118495,0.512735326688815
E01013961,2303,1139,1164,0.4945722970039079,0.5054277029960921
E01033399,2099,1067,1032,0.5083373034778466,0.4916626965221534
E01033401,1059,616,443,0.5816808309726157,0.4183191690273843
E01033405,1300,764,536,0.5876923076923077,0.4123076923076923
E01033409,1537,837,700,0.5445673389720235,0.4554326610279766
E01033411,1066,577,489,0.5412757973733584,0.45872420262664165
E01013913,1762,898,864,0.5096481271282634,0.49035187287173665
E01013914,1755,868,887,0.4945868945868946,0.5054131054131055
E01013915,1560,740,820,0.47435897435897434,0.5256410256410257
E01013916,1503,730,773,0.4856952761144378,0.5143047238855623
E01013917,1752,880,872,0.502283105022831,0.4977168949771689
E01013858,1457,692,765,0.47494852436513385,0.5250514756348662
E01013860,1577,759,818,0.48129359543436906,0.518706404565631
E01013862,1573,738,835,0.4691671964399237,0.5308328035600763
E01013863,1464,714,750,0.48770491803278687,0.5122950819672131
E01013944,1728,893,835,0.5167824074074074,0.4832175925925926
E01013945,1843,991,852,0.5377102550189907,0.4622897449810092
E01013947,2000,1111,889,0.5555,0.4445
E01013948,1281,777,504,0.6065573770491803,0.39344262295081966
E01013953,3298,1646,1652,0.4990903577926016,0.5009096422073984
E01033395,2172,1092,1080,0.5027624309392266,0.4972375690607735
E01033396,1097,612,485,0.5578851412944393,0.4421148587055606
E01013977,1891,960,931,0.5076679005817029,0.4923320994182972
E01013978,1682,838,844,0.4982164090368609,0.5017835909631391
E01013979,1600,820,780,0.5125,0.4875
E01013981,1672,802,870,0.4796650717703349,0.5203349282296651
E01032520,2092,1153,939,0.5511472275334608,0.4488527724665392
E01032522,2046,1183,863,0.5782013685239492,0.42179863147605084
E01033404,3857,2093,1764,0.542649727767695,0.4573502722323049
E01013918,1932,1016,916,0.525879917184265,0.474120082815735
E01013919,2048,1119,929,0.54638671875,0.45361328125
E01013920,2241,1261,980,0.5626952253458277,0.4373047746541722
E01013921,2201,1172,1029,0.5324852339845525,0.4675147660154475
E01013957,1592,779,813,0.48932160804020103,0.510678391959799
E01013980,1629,796,833,0.4886433394720687,0.5113566605279313
E01013982,1591,775,816,0.4871150219987429,0.5128849780012571
E01013983,1419,717,702,0.5052854122621564,0.49471458773784355
E01013984,1459,680,779,0.4660726525017135,0.5339273474982865
E01013985,1798,879,919,0.4888765294771969,0.5111234705228032
E01013924,1648,988,660,0.5995145631067961,0.40048543689320387
E01013926,1661,921,740,0.5544852498494882,0.44551475015051173
E01013928,1582,879,703,0.5556257901390644,0.4443742098609355
E01033408,3356,1780,1576,0.5303933253873659,0.4696066746126341
E01033410,2673,1454,1219,0.543958099513655,0.4560419004863449
E01013973,3880,1878,2002,0.48402061855670103,0.515979381443299
E01013974,2071,1091,980,0.5267986479961372,0.4732013520038629
E01013975,2387,1212,1175,0.5077503142019271,0.4922496857980729
E01013976,1614,814,800,0.5043370508054523,0.49566294919454773
E01013895,1507,728,779,0.48307896483078966,0.5169210351692104
E01013896,1307,648,659,0.4957918898240245,0.5042081101759756
E01013901,1458,750,708,0.51440329218107,0.48559670781893005
E01013902,1463,708,755,0.4839371155160629,0.5160628844839371
E01013897,1505,709,796,0.47109634551495017,0.5289036544850498
E01013898,1626,808,818,0.4969249692496925,0.5030750307503075
E01013899,1271,593,678,0.46656176239181746,0.5334382376081825
E01013900,1502,738,764,0.49134487350199735,0.5086551264980027
E01013903,1249,630,619,0.5044035228182546,0.4955964771817454
E01013907,1467,716,751,0.48807089297886846,0.5119291070211316
E01013905,1548,766,782,0.49483204134366926,0.5051679586563308
E01013908,1685,773,912,0.45875370919881303,0.5412462908011869
E01013909,1529,729,800,0.47678221059516024,0.5232177894048398
E01013912,1581,792,789,0.5009487666034156,0.4990512333965844
E01013904,1550,750,800,0.4838709677419355,0.5161290322580645
E01013906,1611,765,846,0.4748603351955307,0.5251396648044693
E01013910,1456,715,741,0.49107142857142855,0.5089285714285714
E01013911,1520,756,764,0.49736842105263157,0.5026315789473684
E01013849,1541,700,841,0.45425048669695,0.54574951330305
E01013850,1462,714,748,0.4883720930232558,0.5116279069767442
E01013851,1571,715,856,0.45512412476129854,0.5448758752387015
E01013852,1550,771,779,0.4974193548387097,0.5025806451612903
E01032621,1587,758,829,0.47763074984247006,0.5223692501575299
E01013874,1476,774,702,0.524390243902439,0.47560975609756095
E01033400,1309,683,626,0.5217723453017571,0.4782276546982429
E01033402,1063,643,420,0.6048918156161807,0.3951081843838194
E01033403,1083,652,431,0.6020313942751616,0.3979686057248384
E01033406,1049,635,414,0.6053384175405148,0.39466158245948524
E01033407,1070,642,428,0.6,0.4
E01013870,2018,1059,959,0.5247770069375619,0.47522299306243804
E01013871,1711,893,818,0.5219170075978959,0.47808299240210406
E01013872,1798,963,835,0.53559510567297,0.46440489432703
E01013873,2092,1093,999,0.5224665391969407,0.47753346080305925
E01013788,2646,1364,1282,0.5154950869236583,0.48450491307634164
E01013789,1404,703,701,0.5007122507122507,0.49928774928774927
E01013790,2064,1443,621,0.6991279069767442,0.3008720930232558
E01013796,1698,948,750,0.558303886925795,0.4416961130742049
E01013793,1371,662,709,0.4828592268417214,0.5171407731582787
E01013800,1536,751,785,0.4889322916666667,0.5110677083333334
E01013801,1691,820,871,0.48492016558249557,0.5150798344175045
E01013809,1253,610,643,0.4868316041500399,0.5131683958499601
E01013798,1424,694,730,0.48735955056179775,0.5126404494382022
E01013799,1689,801,888,0.47424511545293074,0.5257548845470693
E01013802,2530,1194,1336,0.47193675889328063,0.5280632411067193
E01013803,2259,1099,1160,0.4864984506418769,0.5135015493581231
E01013791,1145,572,573,0.4995633187772926,0.5004366812227075
E01013792,1684,819,865,0.48634204275534443,0.5136579572446556
E01013797,1675,827,848,0.4937313432835821,0.506268656716418
E01013804,1544,747,797,0.4838082901554404,0.5161917098445595
E01013805,1336,692,644,0.5179640718562875,0.4820359281437126
E01013787,1283,627,656,0.4886983632112237,0.5113016367887763
E01013794,1274,625,649,0.49058084772370486,0.5094191522762951
E01013795,1118,537,581,0.4803220035778175,0.5196779964221825
E01013806,2050,1093,957,0.5331707317073171,0.46682926829268295
E01013807,1397,682,715,0.4881889763779528,0.5118110236220472
E01013808,1298,605,693,0.4661016949152542,0.5338983050847458
E01019400,1590,809,781,0.5088050314465409,0.4911949685534591
E01019401,1659,797,862,0.4804098854731766,0.5195901145268234
E01019402,1580,791,789,0.5006329113924051,0.49936708860759493
E01019404,1630,809,821,0.496319018404908,0.503680981595092
E01019406,1027,487,540,0.4741966893865628,0.5258033106134372
E01019423,1209,595,614,0.4921422663358147,0.5078577336641853
E01019424,1192,600,592,0.5033557046979866,0.4966442953020134
E01019477,2202,1077,1125,0.4891008174386921,0.510899182561308
E01019403,1512,701,811,0.4636243386243386,0.5363756613756614
E01019444,1365,668,697,0.48937728937728936,0.5106227106227106
E01019468,1538,767,771,0.4986996098829649,0.5013003901170351
E01019469,1654,809,845,0.48911729141475213,0.5108827085852479
E01019471,1405,658,747,0.46832740213523133,0.5316725978647687
E01019443,1519,722,797,0.47531270572745227,0.5246872942725477
E01019470,1658,850,808,0.5126658624849216,0.4873341375150784
E01019473,1317,662,655,0.5026575550493546,0.4973424449506454
E01019474,1225,606,619,0.4946938775510204,0.5053061224489795
E01019475,1176,571,605,0.48554421768707484,0.5144557823129252
E01019476,1366,678,688,0.49633967789165445,0.5036603221083455
E01019420,1363,650,713,0.4768892149669846,0.5231107850330154
E01019442,1537,780,757,0.5074821080026025,0.49251789199739754
E01019445,1400,720,680,0.5142857142857142,0.4857142857142857
E01019455,1374,686,688,0.4992721979621543,0.5007278020378457
E01019456,1815,869,946,0.47878787878787876,0.5212121212121212
E01019457,1335,677,658,0.5071161048689139,0.49288389513108616
E01019429,1590,806,784,0.5069182389937107,0.4930817610062893
E01019454,1422,674,748,0.4739803094233474,0.5260196905766527
E01019460,1625,794,831,0.4886153846153846,0.5113846153846154
E01019461,1431,675,756,0.4716981132075472,0.5283018867924528
E01019462,1258,627,631,0.4984101748807631,0.5015898251192369
E01019405,1458,751,707,0.5150891632373114,0.4849108367626886
E01019414,1594,783,811,0.49121706398996234,0.5087829360100377
E01019428,1497,727,770,0.48563794255177023,0.5143620574482298
E01019430,1926,989,937,0.5134994807892004,0.48650051921079956
E01019421,1931,977,954,0.5059554634904194,0.4940445365095805
E01019422,1553,781,772,0.5028976175144881,0.4971023824855119
E01019432,1982,973,1009,0.4909182643794147,0.5090817356205852
E01019458,1538,786,752,0.5110533159947984,0.4889466840052016
E01019459,1368,636,732,0.4649122807017544,0.5350877192982456
E01019463,1547,754,793,0.48739495798319327,0.5126050420168067
E01019408,1500,755,745,0.5033333333333333,0.49666666666666665
E01019409,1744,866,878,0.49655963302752293,0.5034403669724771
E01019412,1570,767,803,0.48853503184713376,0.5114649681528662
E01019413,1423,705,718,0.4954321855235418,0.5045678144764582
E01019416,1433,718,715,0.5010467550593162,0.4989532449406839
E01019407,2094,1006,1088,0.4804202483285578,0.5195797516714422
E01019415,1817,880,937,0.48431480462300497,0.5156851953769951
E01019417,1958,925,1033,0.4724208375893769,0.5275791624106231
E01019419,1928,941,987,0.4880705394190871,0.5119294605809128
E01019410,1469,734,735,0.4996596324029952,0.5003403675970047
E01019411,1516,756,760,0.49868073878627966,0.5013192612137203
E01019418,1777,883,894,0.49690489589195275,0.5030951041080473
E01019447,1538,734,804,0.47724317295188556,0.5227568270481144
E01019449,1744,862,882,0.49426605504587157,0.5057339449541285
E01019431,1507,747,760,0.49568679495686796,0.504313205043132
E01019433,1846,908,938,0.49187432286023836,0.5081256771397616
E01019438,1705,864,841,0.5067448680351906,0.49325513196480936
E01019451,1943,963,980,0.49562532166752443,0.5043746783324755
E01019464,2015,973,1042,0.48287841191067,0.5171215880893301
E01019434,1196,591,605,0.49414715719063546,0.5058528428093646
E01019435,1644,827,817,0.5030413625304136,0.49695863746958635
E01019436,1310,658,652,0.5022900763358779,0.49770992366412214
E01019439,1358,674,684,0.4963181148748159,0.5036818851251841
E01019440,1521,756,765,0.4970414201183432,0.5029585798816568
E01019446,1222,581,641,0.47545008183306053,0.5245499181669394
E01019448,1705,846,859,0.4961876832844575,0.5038123167155425
E01019450,1478,703,775,0.47564276048714477,0.5243572395128552
E01019465,1142,556,586,0.4868651488616462,0.5131348511383538
E01019467,1478,733,745,0.4959404600811908,0.5040595399188093
E01019425,1639,790,849,0.4820012202562538,0.5179987797437462
E01019426,1551,715,836,0.46099290780141844,0.5390070921985816
E01019427,1856,931,925,0.5016163793103449,0.4983836206896552
E01019472,2671,1351,1320,0.5058030700112317,0.49419692998876824
E01019437,1483,717,766,0.48347943358057993,0.5165205664194201
E01019441,1483,711,772,0.4794335805799056,0.5205664194200944
E01019452,1630,785,845,0.4815950920245399,0.5184049079754601
E01019453,1832,898,934,0.490174672489083,0.509825327510917
E01032613,1215,610,605,0.5020576131687243,0.49794238683127573
E01019478,1541,764,777,0.49578195976638545,0.5042180402336145
E01019479,1720,854,866,0.4965116279069767,0.5034883720930232
E01019491,2232,1126,1106,0.5044802867383512,0.49551971326164873
E01019493,1573,781,792,0.4965034965034965,0.5034965034965035
E01019494,2026,998,1028,0.49259624876604147,0.5074037512339585
E01019492,1759,831,928,0.4724275156338829,0.5275724843661171
E01019495,1616,799,817,0.4944306930693069,0.505569306930693
E01019524,1364,676,688,0.49560117302052786,0.5043988269794721
E01019525,1482,740,742,0.4993252361673414,0.5006747638326585
E01019496,1392,699,693,0.5021551724137931,0.4978448275862069
E01019497,1414,687,727,0.48585572842998587,0.5141442715700142
E01019498,1791,859,932,0.4796203238414294,0.5203796761585706
E01019523,1054,513,541,0.48671726755218214,0.5132827324478179
E01019483,2097,1036,1061,0.4940391034811636,0.5059608965188365
E01019484,1950,975,975,0.5,0.5
E01019485,1194,561,633,0.46984924623115576,0.5301507537688442
E01019488,1446,744,702,0.5145228215767634,0.4854771784232365
E01019486,1099,513,586,0.46678798908098273,0.5332120109190173
E01019487,1553,735,818,0.4732775273663876,0.5267224726336124
E01019489,1204,568,636,0.4717607973421927,0.5282392026578073
E01019490,1130,565,565,0.5,0.5
E01019502,1503,728,775,0.48436460412508314,0.5156353958749168
E01019504,1292,641,651,0.49613003095975233,0.5038699690402477
E01019508,1957,967,990,0.49412365866121616,0.5058763413387839
E01019509,1215,576,639,0.4740740740740741,0.5259259259259259
E01019510,1283,602,681,0.4692127825409197,0.5307872174590803
E01019512,2590,1267,1323,0.4891891891891892,0.5108108108108108
E01019503,2305,1131,1174,0.4906724511930586,0.5093275488069414
E01019505,1526,768,758,0.5032765399737876,0.4967234600262123
E01019506,1345,669,676,0.49739776951672865,0.5026022304832714
E01019507,1683,812,871,0.48247177658942364,0.5175282234105764
E01019511,2157,1055,1102,0.4891052387575336,0.5108947612424664
E01019480,1536,760,776,0.4947916666666667,0.5052083333333334
E01019482,1492,736,756,0.4932975871313673,0.5067024128686327
E01019520,1762,871,891,0.49432463110102154,0.5056753688989785
E01019521,1547,766,781,0.4951519069166128,0.5048480930833872
E01019522,1531,732,799,0.47811887655127366,0.5218811234487263
E01019481,1361,668,693,0.4908155767817781,0.5091844232182219
E01019514,1564,794,770,0.5076726342710998,0.49232736572890023
E01019515,1642,837,805,0.5097442143727162,0.4902557856272838
E01019516,1465,725,740,0.4948805460750853,0.5051194539249146
E01019519,1845,897,948,0.4861788617886179,0.5138211382113821
E01019499,1296,655,641,0.5054012345679012,0.49459876543209874
E01019500,1439,726,713,0.5045170257123002,0.4954829742876998
E01019501,1467,738,729,0.5030674846625767,0.49693251533742333
E01019513,1291,636,655,0.49264136328427577,0.5073586367157242
E01019517,1551,785,766,0.5061250805931657,0.4938749194068343
E01019518,1584,822,762,0.5189393939393939,0.4810606060606061
E01019526,1387,691,696,0.498197548666186,0.501802451333814
E01019528,1559,754,805,0.4836433611289288,0.5163566388710712
E01019572,1322,652,670,0.49319213313161875,0.5068078668683812
E01019573,1520,747,773,0.49144736842105263,0.5085526315789474
E01019574,1339,657,682,0.49066467513069456,0.5093353248693054
E01019563,1692,817,875,0.48286052009456265,0.5171394799054374
E01019564,1523,757,766,0.4970453053184504,0.5029546946815495
E01019565,1422,692,730,0.4866385372714487,0.5133614627285513
E01019566,1634,806,828,0.49326805385556916,0.5067319461444308
E01019568,1531,766,765,0.5003265839320705,0.4996734160679295
E01019527,1465,709,756,0.48395904436860065,0.5160409556313993
E01019529,1492,766,726,0.5134048257372654,0.4865951742627346
E01019530,1443,728,715,0.5045045045045045,0.4954954954954955
E01019531,1487,719,768,0.4835238735709482,0.5164761264290518
E01019553,1788,891,897,0.4983221476510067,0.5016778523489933
E01019541,1553,745,808,0.47971667739858337,0.5202833226014166
E01019542,1629,798,831,0.48987108655616945,0.5101289134438306
E01019543,1557,785,772,0.50417469492614,0.49582530507385997
E01019544,1564,741,823,0.47378516624040923,0.5262148337595908
E01019571,1511,691,820,0.457313037723362,0.542686962276638
E01019532,1219,584,635,0.47908121410992616,0.5209187858900738
E01019533,1403,695,708,0.4953670705630791,0.5046329294369208
E01019534,1451,694,757,0.47829083390764987,0.5217091660923501
E01019535,1442,707,735,0.49029126213592233,0.5097087378640777
E01019536,1746,803,943,0.4599083619702176,0.5400916380297823
E01019549,1368,661,707,0.483187134502924,0.5168128654970761
E01019550,1633,792,841,0.484996938150643,0.515003061849357
E01019551,1576,776,800,0.49238578680203043,0.5076142131979695
E01019552,1328,659,669,0.49623493975903615,0.5037650602409639
E01019567,1727,822,905,0.47596988998262885,0.5240301100173712
E01019537,1477,704,773,0.4766418415707515,0.5233581584292485
E01019569,1585,867,718,0.5470031545741325,0.4529968454258675
E01019570,1263,604,659,0.4782264449722882,0.5217735550277118
E01019580,1451,722,729,0.49758787043418334,0.5024121295658167
E01019581,1410,717,693,0.5085106382978724,0.49148936170212765
E01019557,1477,727,750,0.4922139471902505,0.5077860528097495
E01019558,1433,701,732,0.4891835310537334,0.5108164689462665
E01019559,1167,575,592,0.49271636675235647,0.5072836332476436
E01019560,1384,689,695,0.49783236994219654,0.5021676300578035
E01019561,1324,640,684,0.48338368580060426,0.5166163141993958
E01019562,1207,584,623,0.48384424192212094,0.5161557580778791
E01019539,1646,803,843,0.48784933171324424,0.5121506682867558
E01019540,1416,695,721,0.490819209039548,0.509180790960452
E01019555,1536,725,811,0.4720052083333333,0.5279947916666666
E01019590,1818,890,928,0.48954895489548955,0.5104510451045104
E01019591,1557,741,816,0.47591522157996147,0.5240847784200385
E01019538,1667,863,804,0.5176964607078585,0.4823035392921416
E01019554,1377,702,675,0.5098039215686274,0.49019607843137253
E01019556,1464,739,725,0.5047814207650273,0.4952185792349727
E01019579,1702,870,832,0.5111633372502937,0.4888366627497062
E01033387,1171,617,554,0.5269000853970965,0.4730999146029035
E01033388,1367,666,701,0.48719824433065106,0.5128017556693489
E01019586,1349,684,665,0.5070422535211268,0.49295774647887325
E01019587,1498,737,761,0.49198931909212285,0.5080106809078772
E01019588,1424,708,716,0.49719101123595505,0.5028089887640449
E01019589,1397,642,755,0.4595561918396564,0.5404438081603435
E01019592,1668,761,907,0.45623501199040767,0.5437649880095923
E01019593,1101,548,553,0.4977293369663942,0.5022706630336058
E01019545,1388,680,708,0.4899135446685879,0.5100864553314121
E01019546,1483,718,765,0.48415374241402565,0.5158462575859744
E01019547,1425,659,766,0.4624561403508772,0.5375438596491228
E01019548,2319,1118,1201,0.4821043553255714,0.5178956446744286
E01019582,1429,703,726,0.4919524142757173,0.5080475857242828
E01019583,1430,681,749,0.4762237762237762,0.5237762237762238
E01019585,2257,1173,1084,0.5197164377492246,0.48028356225077534
E01019575,1687,794,893,0.4706579727326615,0.5293420272673385
E01019576,1574,781,793,0.49618805590851334,0.5038119440914867
E01019577,1545,771,774,0.49902912621359224,0.5009708737864078
E01019578,1604,796,808,0.49625935162094764,0.5037406483790524
E01019602,1843,916,927,0.49701573521432446,0.5029842647856755
E01019614,1713,890,823,0.5195563339171045,0.4804436660828955
E01019615,2183,1001,1182,0.4585432890517636,0.5414567109482363
E01019631,1827,901,926,0.4931581828133552,0.5068418171866448
E01019600,1655,798,857,0.48217522658610273,0.5178247734138973
E01019604,1801,864,937,0.47973348139922267,0.5202665186007773
E01019606,1670,793,877,0.4748502994011976,0.5251497005988024
E01019618,1636,823,813,0.5030562347188264,0.4969437652811736
E01019599,1469,681,788,0.4635806671204901,0.5364193328795098
E01019601,1639,717,922,0.43746186699206835,0.5625381330079317
E01019613,1682,833,849,0.495243757431629,0.504756242568371
E01019617,1595,772,823,0.48401253918495296,0.515987460815047
E01019608,1694,809,885,0.47756788665879574,0.5224321133412042
E01019610,1550,751,799,0.48451612903225805,0.515483870967742
E01019630,1874,907,967,0.483991462113127,0.516008537886873
E01019609,2169,1051,1118,0.48455509451360074,0.5154449054863992
E01019621,1258,622,636,0.4944356120826709,0.505564387917329
E01019622,1554,794,760,0.510939510939511,0.48906048906048905
E01019624,1217,608,609,0.49958915365653245,0.5004108463434676
E01019627,1197,612,585,0.5112781954887218,0.48872180451127817
E01019628,1163,557,606,0.47893379191745483,0.5210662080825451
E01019619,1433,717,716,0.5003489183531054,0.49965108164689465
E01019620,1556,785,771,0.5044987146529563,0.4955012853470437
E01019623,1293,625,668,0.4833720030935808,0.5166279969064191
E01019625,1592,764,828,0.4798994974874372,0.5201005025125628
E01019626,1466,713,753,0.4863574351978172,0.5136425648021828
E01019632,1710,837,873,0.48947368421052634,0.5105263157894737
E01019633,1552,794,758,0.5115979381443299,0.4884020618556701
E01019634,1505,752,753,0.49966777408637875,0.5003322259136213
E01019635,1213,600,613,0.494641384995878,0.505358615004122
E01019636,1543,764,779,0.4951393389500972,0.5048606610499028
E01019595,2055,1016,1039,0.4944038929440389,0.505596107055961
E01019605,1879,963,916,0.5125066524747206,0.4874933475252794
E01019611,1733,873,860,0.5037507212925563,0.49624927870744373
E01019616,1780,872,908,0.4898876404494382,0.5101123595505618
E01019594,1778,853,925,0.4797525309336333,0.5202474690663667
E01019596,1605,768,837,0.4785046728971963,0.5214953271028038
E01019597,1480,729,751,0.4925675675675676,0.5074324324324324
E01019598,1719,834,885,0.4851657940663176,0.5148342059336823
E01019603,1677,793,884,0.4728682170542636,0.5271317829457365
E01019607,1826,895,931,0.49014238773274915,0.5098576122672508
E01019612,2632,1590,1042,0.6041033434650456,0.3958966565349544
E01019629,1700,834,866,0.49058823529411766,0.5094117647058823
E01019644,1451,697,754,0.48035837353549277,0.5196416264645073
E01019646,1523,735,788,0.48260013131976365,0.5173998686802364
E01019663,1499,702,797,0.4683122081387592,0.5316877918612408
E01019664,1298,637,661,0.49075500770416025,0.5092449922958397
E01019665,1377,669,708,0.485838779956427,0.514161220043573
E01019657,1755,843,912,0.48034188034188036,0.5196581196581197
E01019660,1866,923,943,0.4946409431939979,0.5053590568060021
E01019661,1309,659,650,0.5034377387318564,0.4965622612681436
E01019662,1532,811,721,0.529373368146214,0.4706266318537859
E01019672,1714,835,879,0.4871645274212369,0.5128354725787632
E01019690,1219,627,592,0.5143560295324036,0.4856439704675964
E01019670,1821,895,926,0.4914881933003844,0.5085118066996156
E01019671,1795,865,930,0.4818941504178273,0.5181058495821727
E01019701,2100,1027,1073,0.48904761904761906,0.5109523809523809
E01019673,1324,652,672,0.49244712990936557,0.5075528700906344
E01019702,1926,927,999,0.48130841121495327,0.5186915887850467
E01019703,1579,764,815,0.4838505383153895,0.5161494616846105
E01019704,1475,716,759,0.48542372881355933,0.5145762711864407
E01019658,1856,947,909,0.5102370689655172,0.48976293103448276
E01019659,1745,858,887,0.49169054441260746,0.5083094555873926
E01019674,1183,596,587,0.503803888419273,0.49619611158072696
E01019688,1481,736,745,0.49696151249155973,0.5030384875084403
E01019689,1495,727,768,0.4862876254180602,0.5137123745819397
E01019666,1513,729,784,0.48182419035029744,0.5181758096497026
E01019667,1645,798,847,0.4851063829787234,0.5148936170212766
E01019668,1495,683,812,0.4568561872909699,0.5431438127090301
E01019669,1563,771,792,0.4932821497120921,0.5067178502879078
E01019656,1216,572,644,0.47039473684210525,0.5296052631578947
E01019691,1598,768,830,0.4806007509386733,0.5193992490613266
E01019692,1523,727,796,0.47734734077478663,0.5226526592252134
E01019693,1835,894,941,0.4871934604904632,0.5128065395095368
E01019694,1186,597,589,0.5033726812816189,0.4966273187183811
E01019696,1330,641,689,0.48195488721804514,0.5180451127819549
E01019683,1287,630,657,0.48951048951048953,0.5104895104895105
E01019684,1677,814,863,0.4853905784138342,0.5146094215861657
E01019685,1463,692,771,0.4730006835269993,0.5269993164730007
E01019686,1401,659,742,0.470378301213419,0.529621698786581
E01019687,1507,721,786,0.47843397478433974,0.5215660252156602
E01019648,1545,771,774,0.49902912621359224,0.5009708737864078
E01019649,1759,869,890,0.49403069926094373,0.5059693007390563
E01019650,1646,787,859,0.4781287970838396,0.5218712029161604
E01019651,1451,709,742,0.48862853204686424,0.5113714679531358
E01019695,1417,678,739,0.4784756527875794,0.5215243472124206
E01019641,1405,680,725,0.48398576512455516,0.5160142348754448
E01019652,1697,847,850,0.4991160872127283,0.5008839127872716
E01019653,1404,674,730,0.48005698005698005,0.51994301994302
E01019707,1473,736,737,0.49966055668703324,0.5003394433129668
E01019708,1635,813,822,0.4972477064220184,0.5027522935779817
E01019647,1900,930,970,0.48947368421052634,0.5105263157894737
E01019675,1570,795,775,0.5063694267515924,0.49363057324840764
E01019679,1715,875,840,0.5102040816326531,0.4897959183673469
E01019682,1520,762,758,0.5013157894736842,0.4986842105263158
E01019642,1445,684,761,0.473356401384083,0.5266435986159169
E01019643,1605,793,812,0.4940809968847352,0.5059190031152648
E01019654,1551,784,767,0.5054803352675693,0.4945196647324307
E01019655,1539,757,782,0.4918778427550357,0.5081221572449642
E01019676,1461,713,748,0.48802190280629704,0.5119780971937029
E01019677,1428,703,725,0.49229691876750703,0.507703081232493
E01019678,1594,813,781,0.5100376411543287,0.48996235884567124
E01019680,1549,764,785,0.4932214331826985,0.5067785668173015
E01019681,1493,752,741,0.5036838580040187,0.49631614199598123
E01019698,1364,675,689,0.49486803519061584,0.5051319648093842
E01019697,1495,740,755,0.49498327759197325,0.5050167224080268
E01019699,1512,707,805,0.4675925925925926,0.5324074074074074
E01019700,2258,1094,1164,0.4844995571302037,0.5155004428697962
E01019705,1789,886,903,0.49524874231414195,0.504751257685858
E01019706,1243,616,627,0.49557522123893805,0.504424778761062
E01019709,1259,629,630,0.4996028594122319,0.5003971405877681
E01019638,1356,661,695,0.48746312684365783,0.5125368731563422
E01019639,1103,550,553,0.4986400725294651,0.5013599274705349
E01019640,1481,741,740,0.50033760972316,0.49966239027683995
E01019645,1556,763,793,0.4903598971722365,0.5096401028277635
E01032614,1301,639,662,0.49116064565718676,0.5088393543428132
E01019733,1511,734,777,0.485771012574454,0.514228987425546
E01019752,1319,642,677,0.48673237300985595,0.513267626990144
E01019753,1477,727,750,0.4922139471902505,0.5077860528097495
E01019763,2101,1036,1065,0.4930985245121371,0.5069014754878629
E01019728,1221,554,667,0.4537264537264537,0.5462735462735463
E01019729,1310,637,673,0.4862595419847328,0.5137404580152671
E01019730,2003,958,1045,0.4782825761357963,0.5217174238642037
E01019731,1305,648,657,0.496551724137931,0.503448275862069
E01019732,1486,736,750,0.4952893674293405,0.5047106325706595
E01019738,1364,656,708,0.4809384164222874,0.5190615835777126
E01019739,1615,780,835,0.48297213622291024,0.5170278637770898
E01019740,1192,624,568,0.5234899328859061,0.47651006711409394
E01019750,1256,577,679,0.4593949044585987,0.5406050955414012
E01019751,2240,1129,1111,0.5040178571428572,0.49598214285714287
E01019768,2199,1088,1111,0.49477035015916326,0.5052296498408367
E01019727,1731,848,883,0.4898902368573079,0.5101097631426921
E01019749,1252,622,630,0.4968051118210863,0.5031948881789138
E01019754,1781,864,917,0.485120718697361,0.5148792813026389
E01019756,1828,927,901,0.5071115973741794,0.49288840262582057
E01019757,1340,634,706,0.47313432835820896,0.5268656716417911
E01019758,1559,786,773,0.504169339320077,0.49583066067992304
E01019746,1587,810,777,0.5103969754253308,0.4896030245746692
E01019747,1180,575,605,0.4872881355932203,0.5127118644067796
E01019748,1462,751,711,0.5136798905608755,0.48632010943912446
E01019755,2006,1002,1004,0.4995014955134596,0.5004985044865404
E01019766,1443,716,727,0.4961884961884962,0.5038115038115039
E01019711,1322,667,655,0.5045385779122542,0.49546142208774585
E01019734,2056,1019,1037,0.49562256809338523,0.5043774319066148
E01019743,1376,658,718,0.47819767441860467,0.5218023255813954
E01019744,1467,702,765,0.4785276073619632,0.5214723926380368
E01019745,1096,543,553,0.4954379562043796,0.5045620437956204
E01019712,1474,737,737,0.5,0.5
E01019713,1124,531,593,0.4724199288256228,0.5275800711743772
E01019764,1593,788,805,0.49466415568110483,0.5053358443188951
E01019765,1790,897,893,0.5011173184357542,0.4988826815642458
E01019767,1629,813,816,0.4990791896869245,0.5009208103130756
E01019710,1945,969,976,0.4982005141388175,0.5017994858611825
E01019715,1535,746,789,0.4859934853420195,0.5140065146579804
E01019717,1375,693,682,0.504,0.496
E01019722,1859,910,949,0.48951048951048953,0.5104895104895105
E01019723,1826,852,974,0.4665936473165389,0.5334063526834611
E01019716,1278,645,633,0.5046948356807511,0.4953051643192488
E01019724,1221,610,611,0.4995904995904996,0.5004095004095004
E01019759,1506,726,780,0.4820717131474104,0.5179282868525896
E01019760,1461,721,740,0.4934976043805613,0.5065023956194388
E01019761,1606,775,831,0.4825653798256538,0.5174346201743462
E01019714,2540,1266,1274,0.4984251968503937,0.5015748031496063
E01019725,1406,695,711,0.49431009957325744,0.5056899004267426
E01019726,1339,679,660,0.5070948469006722,0.49290515309932786
E01019762,1789,865,924,0.4835103409726104,0.5164896590273896
E01019718,2238,1087,1151,0.48570151921358357,0.5142984807864165
E01019719,1555,752,803,0.48360128617363346,0.5163987138263666
E01019720,1457,727,730,0.49897048730267674,0.5010295126973233
E01019721,1148,570,578,0.4965156794425087,0.5034843205574913
E01019735,1531,751,780,0.49052906596995427,0.5094709340300457
E01019736,1181,582,599,0.4928027095681626,0.5071972904318375
E01019737,1168,558,610,0.4777397260273973,0.5222602739726028
E01019741,1113,587,526,0.527403414195867,0.472596585804133
E01019742,1120,592,528,0.5285714285714286,0.4714285714285714
E01019801,1096,560,536,0.5109489051094891,0.48905109489051096
E01019802,1363,662,701,0.4856933235509905,0.5143066764490095
E01019803,1280,621,659,0.48515625,0.51484375
E01019804,1333,675,658,0.5063765941485371,0.49362340585146286
E01019805,1382,677,705,0.48986975397973953,0.5101302460202605
E01019806,1492,719,773,0.4819034852546917,0.5180965147453083
E01019807,1499,738,761,0.4923282188125417,0.5076717811874583
E01019778,1697,838,859,0.4938126104890984,0.5061873895109016
E01019779,1587,771,816,0.48582230623818523,0.5141776937618148
E01019790,1952,981,971,0.5025614754098361,0.4974385245901639
E01019816,1750,852,898,0.4868571428571429,0.5131428571428571
E01019780,1433,679,754,0.473831123517097,0.526168876482903
E01019781,1428,667,761,0.46708683473389356,0.5329131652661064
E01019782,1281,611,670,0.4769711163153786,0.5230288836846214
E01019786,1520,736,784,0.4842105263157895,0.5157894736842106
E01019827,1876,943,933,0.5026652452025586,0.4973347547974414
E01019770,1891,928,963,0.4907456372289794,0.5092543627710207
E01019787,1774,861,913,0.48534385569334837,0.5146561443066516
E01019788,1661,809,852,0.48705599036724867,0.5129440096327513
E01019794,1416,700,716,0.4943502824858757,0.5056497175141242
E01019783,1259,622,637,0.49404289118347894,0.505957108816521
E01019784,1257,611,646,0.48607796340493237,0.5139220365950676
E01019785,1292,659,633,0.510061919504644,0.48993808049535603
E01019793,1441,691,750,0.47952810548230396,0.520471894517696
E01019795,2215,1078,1137,0.4866817155756208,0.5133182844243792
E01019798,1401,682,719,0.48679514632405424,0.5132048536759457
E01019821,1376,655,721,0.47601744186046513,0.5239825581395349
E01019822,1582,775,807,0.48988621997471554,0.5101137800252844
E01019823,1118,543,575,0.4856887298747764,0.5143112701252236
E01019771,2131,1029,1102,0.48287189113092444,0.5171281088690756
E01019772,1545,788,757,0.510032362459547,0.4899676375404531
E01019828,1412,681,731,0.48229461756373937,0.5177053824362606
E01019829,1437,707,730,0.4919972164231037,0.5080027835768963
E01019796,1111,535,576,0.4815481548154815,0.5184518451845185
E01019797,1338,661,677,0.4940209267563528,0.5059790732436472
E01019799,1965,981,984,0.49923664122137407,0.500763358778626
E01019800,1767,890,877,0.5036785512167515,0.49632144878324846
E01019808,1593,757,836,0.47520401757689895,0.5247959824231011
E01019826,1417,715,702,0.5045871559633027,0.4954128440366973
E01019769,1905,937,968,0.49186351706036746,0.5081364829396325
E01019774,1567,758,809,0.4837268666241225,0.5162731333758774
E01019824,1175,581,594,0.49446808510638296,0.505531914893617
E01019830,1261,618,643,0.49008723235527357,0.5099127676447264
E01019831,1375,664,711,0.4829090909090909,0.517090909090909
E01019809,1135,564,571,0.49691629955947136,0.5030837004405286
E01019810,1434,717,717,0.5,0.5
E01019811,1564,769,795,0.49168797953964194,0.5083120204603581
E01019812,1783,892,891,0.5002804262478968,0.4997195737521032
E01019813,1704,835,869,0.49002347417840375,0.5099765258215962
E01019825,1400,683,717,0.4878571428571429,0.5121428571428571
E01019773,2378,1190,1188,0.5004205214465938,0.49957947855340623
E01019775,1762,865,897,0.4909194097616345,0.5090805902383655
E01019776,1366,679,687,0.4970717423133236,0.5029282576866764
E01019777,2381,1168,1213,0.49055018899622005,0.50944981100378
E01019814,1720,824,896,0.4790697674418605,0.5209302325581395
E01019817,1211,581,630,0.4797687861271676,0.5202312138728323
E01019818,1541,735,806,0.47696301103179756,0.5230369889682025
E01019819,1423,725,698,0.5094869992972593,0.4905130007027407
E01019820,1417,698,719,0.49258997882851097,0.507410021171489
E01019791,1760,833,927,0.4732954545454545,0.5267045454545455
E01019792,2031,977,1054,0.4810438207779419,0.5189561792220581
E01019815,2719,1388,1331,0.5104817947774917,0.4895182052225083
E01032586,1643,795,848,0.4838709677419355,0.5161290322580645
E01019839,1865,956,909,0.5126005361930295,0.4873994638069705
E01019845,1324,649,675,0.4901812688821752,0.5098187311178247
E01019846,1239,612,627,0.4939467312348668,0.5060532687651331
E01019866,2387,1118,1269,0.46837033933808125,0.5316296606619187
E01019840,1624,802,822,0.4938423645320197,0.5061576354679803
E01019841,1522,757,765,0.4973718791064389,0.5026281208935611
E01019847,1356,661,695,0.48746312684365783,0.5125368731563422
E01019848,2126,1066,1060,0.5014111006585137,0.49858889934148637
E01033532,1463,725,738,0.4955570745044429,0.504442925495557
E01033533,1696,844,852,0.49764150943396224,0.5023584905660378
E01033534,1073,556,517,0.5181733457595527,0.48182665424044735
E01019873,1461,739,722,0.5058179329226558,0.4941820670773443
E01019874,1449,726,723,0.5010351966873706,0.4989648033126294
E01019875,1418,714,704,0.5035260930888575,0.49647390691114246
E01019881,1359,652,707,0.4797645327446652,0.5202354672553348
E01019882,1565,772,793,0.49329073482428115,0.5067092651757189
E01019832,1713,859,854,0.5014594279042616,0.4985405720957385
E01019833,1826,891,935,0.4879518072289157,0.5120481927710844
E01019834,1506,747,759,0.4960159362549801,0.5039840637450199
E01019835,1621,818,803,0.5046267735965454,0.49537322640345466
E01019867,1552,756,796,0.48711340206185566,0.5128865979381443
E01019868,1723,831,892,0.4822983168891468,0.5177016831108532
E01019869,1662,873,789,0.5252707581227437,0.4747292418772563
E01019880,1607,827,780,0.5146235220908525,0.48537647790914745
E01019843,1540,736,804,0.4779220779220779,0.522077922077922
E01019853,1543,794,749,0.5145819831497084,0.4854180168502916
E01019854,1741,832,909,0.4778862722573234,0.5221137277426766
E01019855,1559,765,794,0.490699166132136,0.5093008338678641
E01019844,1548,749,799,0.4838501291989664,0.5161498708010336
E01019856,1496,734,762,0.49064171122994654,0.5093582887700535
E01019857,1275,641,634,0.5027450980392156,0.4972549019607843
E01019858,1621,780,841,0.4811844540407156,0.5188155459592844
E01019859,1674,826,848,0.4934289127837515,0.5065710872162486
E01019860,1322,663,659,0.5015128593040847,0.49848714069591527
E01019861,1783,904,879,0.50701065619742,0.4929893438025799
E01019862,1480,707,773,0.4777027027027027,0.5222972972972973
E01019863,1593,773,820,0.485247959824231,0.514752040175769
E01019864,1492,760,732,0.5093833780160858,0.4906166219839142
E01019865,1318,643,675,0.48786039453717756,0.5121396054628224
E01019876,1928,975,953,0.5057053941908713,0.49429460580912865
E01019877,1570,803,767,0.5114649681528662,0.48853503184713376
E01019878,1551,769,782,0.49580915538362347,0.5041908446163765
E01019879,1851,951,900,0.513776337115073,0.4862236628849271
E01019850,1562,796,766,0.5096030729833547,0.49039692701664533
E01019851,1639,799,840,0.48749237339841367,0.5125076266015863
E01019852,1792,892,900,0.49776785714285715,0.5022321428571429
E01019870,1596,770,826,0.4824561403508772,0.5175438596491229
E01019871,1768,863,905,0.48812217194570134,0.5118778280542986
E01019872,1898,934,964,0.49209694415173866,0.5079030558482613
E01019837,1931,924,1007,0.4785085447954428,0.5214914552045572
E01019838,1669,839,830,0.5026962252846016,0.49730377471539844
E01033531,1596,827,769,0.518170426065163,0.4818295739348371
E01033536,1648,834,814,0.5060679611650486,0.49393203883495146
E01033537,1685,823,862,0.4884272997032641,0.511572700296736
E01019842,1712,854,858,0.49883177570093457,0.5011682242990654
E01019883,2845,1409,1436,0.4952548330404218,0.5047451669595782
E01019885,1701,853,848,0.5014697236919459,0.4985302763080541
E01033535,1547,790,757,0.5106658047834518,0.48933419521654814
E01025631,1212,596,616,0.49174917491749176,0.5082508250825083
E01025632,1457,726,731,0.4982841455044612,0.5017158544955388
E01025633,1718,830,888,0.4831199068684517,0.5168800931315483
E01025635,1253,606,647,0.4836392657621708,0.5163607342378292
E01025634,1488,715,773,0.48051075268817206,0.519489247311828
E01025638,1442,696,746,0.4826629680998613,0.5173370319001387
E01025639,1244,584,660,0.4694533762057878,0.5305466237942122
E01025640,1572,735,837,0.4675572519083969,0.5324427480916031
E01025645,1145,569,576,0.496943231441048,0.503056768558952
E01025666,1466,702,764,0.47885402455661663,0.5211459754433834
E01025667,1180,564,616,0.47796610169491527,0.5220338983050847
E01025668,2359,1213,1146,0.5142009325985587,0.4857990674014413
E01025669,2101,1073,1028,0.5107091861018562,0.4892908138981437
E01025636,1341,657,684,0.4899328859060403,0.5100671140939598
E01025637,1310,656,654,0.500763358778626,0.49923664122137407
E01025652,1345,651,694,0.48401486988847586,0.5159851301115241
E01025653,1568,787,781,0.5019132653061225,0.49808673469387754
E01025654,1270,620,650,0.4881889763779528,0.5118110236220472
E01025655,1571,783,788,0.49840865690642905,0.501591343093571
E01025656,1339,665,674,0.49663928304705,0.5033607169529499
E01025625,1229,573,656,0.4662327095199349,0.5337672904800651
E01025626,1254,616,638,0.49122807017543857,0.5087719298245614
E01025627,2209,1059,1150,0.479402444545043,0.520597555454957
E01025651,1622,830,792,0.5117139334155364,0.4882860665844636
E01025657,1861,902,959,0.4846856528747985,0.5153143471252015
E01025660,1678,825,853,0.49165673420738976,0.5083432657926102
E01025641,1766,881,885,0.4988674971687429,0.5011325028312571
E01025642,1941,939,1002,0.48377125193199383,0.5162287480680062
E01025643,1594,797,797,0.5,0.5
E01025649,1573,781,792,0.4965034965034965,0.5034965034965035
E01025650,1574,772,802,0.49047013977128334,0.5095298602287166
E01025610,1564,759,805,0.4852941176470588,0.5147058823529411
E01025611,1532,741,791,0.48368146214099217,0.5163185378590078
E01025612,1609,790,819,0.49098819142324424,0.5090118085767558
E01025658,2347,1423,924,0.6063059224541969,0.39369407754580316
E01025659,1792,847,945,0.47265625,0.52734375
E01025615,1602,796,806,0.4968789013732834,0.5031210986267166
E01025646,1665,776,889,0.46606606606606604,0.533933933933934
E01025647,1586,759,827,0.478562421185372,0.521437578814628
E01025648,2060,1005,1055,0.4878640776699029,0.5121359223300971
E01025613,1410,670,740,0.475177304964539,0.524822695035461
E01025614,1749,846,903,0.483704974271012,0.516295025728988
E01025620,1097,518,579,0.47219690063810393,0.5278030993618961
E01025621,1051,537,514,0.510941960038059,0.489058039961941
E01025644,1418,678,740,0.4781382228490832,0.5218617771509168
E01025616,1642,816,826,0.49695493300852617,0.5030450669914738
E01025617,1696,830,866,0.4893867924528302,0.5106132075471698
E01025618,1666,795,871,0.4771908763505402,0.5228091236494598
E01025619,1643,797,846,0.4850882531953743,0.5149117468046257
E01025661,1764,864,900,0.4897959183673469,0.5102040816326531
E01025662,1535,757,778,0.49315960912052115,0.5068403908794789
E01025663,1436,704,732,0.49025069637883006,0.5097493036211699
E01025664,1226,611,615,0.49836867862969003,0.50163132137031
E01025665,1500,735,765,0.49,0.51
E01025622,1653,817,836,0.4942528735632184,0.5057471264367817
E01025623,1550,791,759,0.5103225806451613,0.4896774193548387
E01025624,1798,890,908,0.4949944382647386,0.5050055617352615
E01025629,1508,733,775,0.4860742705570292,0.5139257294429708
E01025630,1714,861,853,0.5023337222870479,0.49766627771295213
E01032603,1420,679,741,0.478169014084507,0.5218309859154929
E01025692,1996,986,1010,0.4939879759519038,0.5060120240480962
E01025693,1866,919,947,0.492497320471597,0.507502679528403
E01033386,2199,1109,1090,0.5043201455206913,0.4956798544793088
E01025699,1403,747,656,0.5324305060584462,0.46756949394155384
E01025700,1786,932,854,0.5218365061590146,0.47816349384098544
E01025701,1585,827,758,0.5217665615141955,0.4782334384858044
E01025703,2000,1061,939,0.5305,0.4695
E01025704,1443,744,699,0.5155925155925156,0.48440748440748443
E01025705,1372,679,693,0.49489795918367346,0.5051020408163265
E01025706,1689,853,836,0.5050325636471285,0.49496743635287155
E01025720,2088,1194,894,0.5718390804597702,0.4281609195402299
E01025721,1724,866,858,0.5023201856148491,0.4976798143851508
E01025722,1026,498,528,0.4853801169590643,0.5146198830409356
E01025723,2158,1211,947,0.5611677479147359,0.4388322520852641
E01025724,1570,846,724,0.5388535031847134,0.46114649681528663
E01025725,1316,642,674,0.4878419452887538,0.5121580547112462
E01025695,1492,783,709,0.524798927613941,0.47520107238605896
E01025696,1402,706,696,0.5035663338088445,0.4964336661911555
E01025697,1358,649,709,0.47790868924889546,0.5220913107511046
E01025698,1577,798,779,0.5060240963855421,0.4939759036144578
E01025744,1913,977,936,0.5107161526398327,0.4892838473601673
E01025745,1430,691,739,0.48321678321678324,0.5167832167832168
E01025746,1804,860,944,0.47671840354767187,0.5232815964523282
E01025747,1839,892,947,0.4850462207721588,0.5149537792278412
E01025740,1499,760,739,0.5070046697798533,0.49299533022014674
E01025741,1543,763,780,0.4944912508101102,0.5055087491898899
E01025742,1636,797,839,0.4871638141809291,0.5128361858190709
E01025743,1841,883,958,0.4796306355241716,0.5203693644758284
E01025689,2598,1427,1171,0.5492686682063126,0.45073133179368746
E01025690,3889,2234,1655,0.5744407302648495,0.4255592697351504
E01025707,1795,1019,776,0.5676880222841225,0.4323119777158774
E01025709,2380,1360,1020,0.5714285714285714,0.42857142857142855
E01025760,1347,665,682,0.49368968077208614,0.5063103192279139
E01025761,1808,886,922,0.49004424778761063,0.5099557522123894
E01025768,1440,699,741,0.48541666666666666,0.5145833333333333
E01025769,1561,784,777,0.5022421524663677,0.4977578475336323
E01025702,1230,602,628,0.4894308943089431,0.510569105691057
E01025715,1522,740,782,0.48620236530880423,0.5137976346911958
E01025716,1568,763,805,0.48660714285714285,0.5133928571428571
E01025717,2200,1074,1126,0.48818181818181816,0.5118181818181818
E01025718,1383,689,694,0.4981923355025307,0.5018076644974693
E01025719,1530,755,775,0.4934640522875817,0.5065359477124183
E01025708,1265,650,615,0.5138339920948617,0.48616600790513836
E01025710,1251,618,633,0.4940047961630695,0.5059952038369304
E01025711,1573,765,808,0.4863318499682136,0.5136681500317863
E01025712,1353,646,707,0.47745750184774577,0.5225424981522543
E01025713,1520,769,751,0.5059210526315789,0.49407894736842106
E01025714,2126,1043,1083,0.4905926622765757,0.5094073377234243
E01025674,1543,740,803,0.4795852235904083,0.5204147764095917
E01025675,1508,757,751,0.5019893899204244,0.4980106100795756
E01025676,2126,1015,1111,0.47742238946378174,0.5225776105362182
E01025677,1357,635,722,0.4679439941046426,0.5320560058953574
E01025732,1605,787,818,0.49034267912772583,0.5096573208722741
E01025733,1498,726,772,0.48464619492656874,0.5153538050734312
E01025734,1562,755,807,0.4833546734955186,0.5166453265044815
E01025735,1828,886,942,0.48468271334792123,0.5153172866520788
E01025748,2153,1066,1087,0.4951230840687413,0.5048769159312587
E01025749,1596,772,824,0.48370927318295737,0.5162907268170426
E01025750,1421,714,707,0.5024630541871922,0.4975369458128079
E01025751,2087,1033,1054,0.49496885481552466,0.5050311451844753
E01025726,1860,895,965,0.48118279569892475,0.5188172043010753
E01025727,1585,769,816,0.48517350157728706,0.5148264984227129
E01025728,1848,921,927,0.49837662337662336,0.5016233766233766
E01025729,1614,814,800,0.5043370508054523,0.49566294919454773
E01025737,1865,911,954,0.48847184986595177,0.5115281501340483
E01025739,1403,675,728,0.481111903064861,0.518888096935139
E01025685,1406,671,735,0.4772403982930299,0.5227596017069701
E01025686,1460,712,748,0.4876712328767123,0.5123287671232877
E01025730,1488,713,775,0.4791666666666667,0.5208333333333334
E01025731,1530,742,788,0.4849673202614379,0.515032679738562
E01025687,1575,762,813,0.4838095238095238,0.5161904761904762
E01025688,1847,967,880,0.523551705468327,0.476448294531673
E01025736,1466,719,747,0.49045020463847205,0.509549795361528
E01025738,1454,720,734,0.4951856946354883,0.5048143053645117
E01025756,1894,933,961,0.4926082365364308,0.5073917634635692
E01025757,1486,734,752,0.4939434724091521,0.506056527590848
E01025758,1796,839,957,0.4671492204899777,0.5328507795100222
E01025759,1385,668,717,0.48231046931407945,0.5176895306859206
E01025752,1958,987,971,0.5040858018386108,0.49591419816138915
E01025753,1520,694,826,0.45657894736842103,0.5434210526315789
E01025754,1270,632,638,0.49763779527559054,0.5023622047244094
E01025755,1495,749,746,0.5010033444816053,0.49899665551839467
E01025679,2501,1181,1320,0.4722111155537785,0.5277888844462215
E01025680,1666,823,843,0.4939975990396158,0.5060024009603842
E01025681,1597,779,818,0.48778960551033185,0.5122103944896681
E01025682,1457,696,761,0.4776938915579959,0.5223061084420041
E01025678,1735,835,900,0.4812680115273775,0.5187319884726225
E01025683,1687,805,882,0.47717842323651455,0.5228215767634855
E01025684,1878,915,963,0.48722044728434505,0.512779552715655
E01025762,1462,721,741,0.49316005471956226,0.5068399452804377
E01025763,1657,804,853,0.4852142426071213,0.5147857573928787
E01025764,1395,701,694,0.5025089605734767,0.4974910394265233
E01025765,1604,774,830,0.4825436408977556,0.5174563591022444
E01025766,2083,1019,1064,0.48919827172347574,0.5108017282765243
E01025767,1467,749,718,0.5105657805044308,0.4894342194955692
E01025670,1312,636,676,0.4847560975609756,0.5152439024390244
E01025671,1847,904,943,0.4894423389279913,0.5105576610720086
E01025672,1771,843,928,0.47600225861095424,0.5239977413890458
E01025673,1598,754,844,0.4718397997496871,0.5281602002503129
E01025770,1863,910,953,0.48845947396672035,0.5115405260332797
E01025809,2308,1122,1186,0.4861351819757366,0.5138648180242634
E01025815,2030,1021,1009,0.5029556650246305,0.4970443349753695
E01025781,1572,756,816,0.48091603053435117,0.5190839694656488
E01025782,1303,599,704,0.45970836531082115,0.5402916346891788
E01025783,1483,725,758,0.48887390424814564,0.5111260957518543
E01025785,2156,1030,1126,0.4777365491651206,0.5222634508348795
E01025786,1592,741,851,0.46545226130653267,0.5345477386934674
E01025787,1693,826,867,0.48789131718842293,0.5121086828115771
E01025772,2324,1151,1173,0.4952667814113597,0.5047332185886403
E01025773,1512,755,757,0.49933862433862436,0.5006613756613757
E01025774,1328,680,648,0.5120481927710844,0.4879518072289157
E01025775,1772,883,889,0.4983069977426637,0.5016930022573364
E01025776,2004,1008,996,0.5029940119760479,0.49700598802395207
E01025771,2557,1251,1306,0.4892452092295659,0.5107547907704341
E01025778,1953,961,992,0.49206349206349204,0.5079365079365079
E01025779,1609,809,800,0.5027967681789932,0.49720323182100684
E01025780,1332,667,665,0.5007507507507507,0.49924924924924924
E01025784,1382,677,705,0.48986975397973953,0.5101302460202605
E01025788,1212,589,623,0.485973597359736,0.514026402640264
E01025777,2200,1117,1083,0.5077272727272727,0.49227272727272725
E01025808,2587,1325,1262,0.5121762659451101,0.4878237340548898
E01025810,2348,1163,1185,0.49531516183986374,0.5046848381601363
E01025816,2281,1147,1134,0.5028496273564226,0.49715037264357737
E01025789,1737,1186,551,0.6827864133563616,0.31721358664363847
E01025794,1863,909,954,0.48792270531400966,0.5120772946859904
E01025797,1688,790,898,0.46800947867298576,0.5319905213270142
E01025802,1330,645,685,0.4849624060150376,0.5150375939849624
E01025803,1556,777,779,0.4993573264781491,0.5006426735218509
E01025805,1546,777,769,0.5025873221216042,0.4974126778783959
E01025795,1800,922,878,0.5122222222222222,0.48777777777777775
E01025796,1945,928,1017,0.477120822622108,0.522879177377892
E01025801,1269,614,655,0.4838455476753349,0.5161544523246651
E01025806,1518,714,804,0.47035573122529645,0.5296442687747036
E01025798,1764,852,912,0.48299319727891155,0.5170068027210885
E01025799,2137,1079,1058,0.5049134300421151,0.49508656995788486
E01025800,1154,553,601,0.47920277296360486,0.5207972270363952
E01025804,1939,943,996,0.48633316142341415,0.5136668385765859
E01025807,1402,668,734,0.4764621968616263,0.5235378031383737
E01025790,2328,1167,1161,0.5012886597938144,0.49871134020618557
E01025791,2227,1101,1126,0.4943870678042209,0.5056129321957791
E01025792,2297,1117,1180,0.4862864606007836,0.5137135393992164
E01025793,2501,1262,1239,0.5045981607357057,0.49540183926429426
E01025812,1729,813,916,0.470213996529786,0.529786003470214
E01025813,1604,796,808,0.49625935162094764,0.5037406483790524
E01025814,1524,759,765,0.49803149606299213,0.5019685039370079
E01032598,2123,1068,1055,0.503061705134244,0.496938294865756
E01025868,1482,735,747,0.4959514170040486,0.5040485829959515
E01025869,1478,702,776,0.4749661705006766,0.5250338294993234
E01025870,1516,715,801,0.4716358839050132,0.5283641160949868
E01025871,1205,609,596,0.5053941908713693,0.4946058091286307
E01025878,2605,1293,1312,0.4963531669865643,0.5036468330134357
E01025846,2029,992,1037,0.4889107934943322,0.5110892065056678
E01025847,1658,810,848,0.48854041013269,0.51145958986731
E01025848,1512,733,779,0.48478835978835977,0.5152116402116402
E01025845,1597,791,806,0.49530369442705074,0.5046963055729493
E01025877,1627,795,832,0.48862937922556854,0.5113706207744315
E01025879,1246,592,654,0.4751203852327448,0.5248796147672552
E01025880,1595,765,830,0.47962382445141066,0.5203761755485894
E01025819,1650,801,849,0.48545454545454547,0.5145454545454545
E01025820,1600,812,788,0.5075,0.4925
E01025837,2013,1017,996,0.5052160953800298,0.4947839046199702
E01025838,1479,705,774,0.4766734279918864,0.5233265720081136
E01025882,1631,789,842,0.483752299202943,0.5162477007970571
E01025872,1494,745,749,0.49866131191432395,0.501338688085676
E01025873,1564,772,792,0.4936061381074169,0.5063938618925832
E01025874,1552,762,790,0.49097938144329895,0.509020618556701
E01025875,1518,727,791,0.47891963109354413,0.5210803689064558
E01025876,1881,919,962,0.4885699096225412,0.5114300903774588
E01025839,1647,824,823,0.5003035822707954,0.4996964177292046
E01025840,1513,745,768,0.49239920687376076,0.5076007931262393
E01025841,1700,841,859,0.49470588235294116,0.5052941176470588
E01025842,1835,886,949,0.4828337874659401,0.5171662125340599
E01025843,1613,787,826,0.4879107253564786,0.5120892746435214
E01025844,1739,866,873,0.49798734905117886,0.5020126509488212
E01025821,1697,834,863,0.49145550972304064,0.5085444902769594
E01025822,1424,682,742,0.4789325842696629,0.5210674157303371
E01025823,1551,778,773,0.501611863313991,0.498388136686009
E01025824,1489,719,770,0.4828744123572868,0.5171255876427132
E01025825,1454,719,735,0.49449793672627235,0.5055020632737276
E01025826,1407,702,705,0.4989339019189765,0.5010660980810234
E01025817,1965,983,982,0.5002544529262086,0.4997455470737914
E01025818,1490,765,725,0.5134228187919463,0.4865771812080537
E01025864,1591,810,781,0.5091137649277184,0.4908862350722816
E01025881,1373,681,692,0.4959941733430444,0.5040058266569556
E01025859,1386,672,714,0.48484848484848486,0.5151515151515151
E01025860,1429,717,712,0.5017494751574527,0.4982505248425472
E01025861,1687,844,843,0.5002963841138115,0.4997036158861885
E01025862,1451,702,749,0.48380427291523087,0.5161957270847691
E01025850,1428,707,721,0.4950980392156863,0.5049019607843137
E01025852,1683,903,780,0.5365418894830659,0.46345811051693403
E01025858,1852,951,901,0.5134989200863931,0.4865010799136069
E01025863,1646,785,861,0.47691373025516404,0.523086269744836
E01025865,1766,880,886,0.4983012457531144,0.5016987542468856
E01025853,2790,1371,1419,0.4913978494623656,0.5086021505376344
E01025854,1749,886,863,0.5065751858204688,0.49342481417953116
E01025855,1410,692,718,0.4907801418439716,0.5092198581560283
E01025866,1592,775,817,0.48680904522613067,0.5131909547738693
E01025867,1531,756,775,0.4937949052906597,0.5062050947093403
E01025849,1633,818,815,0.5009185548071035,0.4990814451928965
E01025851,1297,647,650,0.49884348496530456,0.5011565150346955
E01025856,1307,619,688,0.47360367253251723,0.5263963274674828
E01025857,1453,726,727,0.49965588437715075,0.5003441156228493
E01025827,1408,657,751,0.4666193181818182,0.5333806818181818
E01025828,1420,694,726,0.4887323943661972,0.5112676056338028
E01025829,1442,688,754,0.47711511789181693,0.5228848821081831
E01025830,1436,694,742,0.4832869080779944,0.5167130919220055
E01025831,1292,634,658,0.4907120743034056,0.5092879256965944
E01025832,1585,812,773,0.5123028391167193,0.48769716088328074
E01025833,1608,765,843,0.47574626865671643,0.5242537313432836
E01025834,1497,731,766,0.48830995323981297,0.511690046760187
E01025835,1585,754,831,0.4757097791798107,0.5242902208201893
E01025836,1295,617,678,0.47644787644787645,0.5235521235521235
E01025885,1831,896,935,0.4893500819224468,0.5106499180775532
E01025886,1756,842,914,0.479498861047836,0.520501138952164
E01025887,1803,885,918,0.4908485856905158,0.5091514143094842
E01025890,1265,646,619,0.5106719367588933,0.4893280632411067
E01025891,1312,641,671,0.4885670731707317,0.5114329268292683
E01025892,1649,799,850,0.4845360824742268,0.5154639175257731
E01025901,1720,826,894,0.48023255813953486,0.5197674418604651
E01025902,1622,787,835,0.48520345252774355,0.5147965474722564
E01025903,1750,876,874,0.5005714285714286,0.49942857142857144
E01025904,2026,984,1042,0.4856860809476802,0.5143139190523198
E01025906,1788,871,917,0.48713646532438476,0.5128635346756152
E01025883,1568,761,807,0.48533163265306123,0.5146683673469388
E01025884,1718,826,892,0.4807916181606519,0.519208381839348
E01025888,1776,873,903,0.49155405405405406,0.5084459459459459
E01025909,1934,921,1013,0.47621509824198555,0.5237849017580145
E01025896,1624,813,811,0.500615763546798,0.49938423645320196
E01025897,2037,975,1062,0.4786450662739323,0.5213549337260678
E01025898,1341,647,694,0.482475764354959,0.517524235645041
E01025899,1155,589,566,0.5099567099567099,0.49004329004329006
E01025900,1499,709,790,0.47298198799199465,0.5270180120080054
E01025905,1727,837,890,0.4846554719166184,0.5153445280833816
E01025893,2067,1031,1036,0.4987905176584422,0.5012094823415578
E01025894,1508,758,750,0.5026525198938993,0.4973474801061008
E01025895,1712,850,862,0.49649532710280375,0.5035046728971962
E01025907,1781,879,902,0.493542953396968,0.506457046603032
E01025908,1801,881,920,0.48917268184342033,0.5108273181565797
E01025889,1747,874,873,0.5002862049227247,0.4997137950772753
E01025910,1756,902,854,0.5136674259681093,0.4863325740318907
E01025911,1575,744,831,0.4723809523809524,0.5276190476190477
E01025912,1528,795,733,0.5202879581151832,0.47971204188481675
E01025924,1029,509,520,0.4946550048590865,0.5053449951409135
E01025925,2533,1295,1238,0.511251480457955,0.488748519542045
E01025926,1577,797,780,0.5053899809765378,0.49461001902346224
E01025927,1619,816,803,0.5040148239654108,0.49598517603458925
E01025928,1525,771,754,0.5055737704918033,0.4944262295081967
E01025923,1370,676,694,0.49343065693430654,0.5065693430656935
E01025944,1511,755,756,0.499669093315685,0.500330906684315
E01025945,1533,743,790,0.4846705805609915,0.5153294194390085
E01025946,1681,808,873,0.4806662700773349,0.5193337299226651
E01025915,1293,654,639,0.505800464037123,0.494199535962877
E01025916,1469,739,730,0.5030633083730429,0.49693669162695714
E01025917,2042,1035,1007,0.5068560235063663,0.4931439764936337
E01025918,1559,740,819,0.4746632456703015,0.5253367543296985
E01025960,1473,744,729,0.505091649694501,0.49490835030549896
E01025961,1473,726,747,0.49287169042769857,0.5071283095723014
E01025962,1421,683,738,0.48064743138634763,0.5193525686136523
E01025965,1270,659,611,0.5188976377952756,0.4811023622047244
E01025955,1369,676,693,0.493791088385683,0.506208911614317
E01025956,1153,549,604,0.4761491760624458,0.5238508239375542
E01025963,1538,773,765,0.5026007802340702,0.49739921976592977
E01025964,1652,812,840,0.4915254237288136,0.5084745762711864
E01025914,1386,694,692,0.5007215007215007,0.49927849927849927
E01025919,1520,727,793,0.47828947368421054,0.5217105263157895
E01025920,1641,792,849,0.4826325411334552,0.5173674588665448
E01025921,1620,763,857,0.47098765432098766,0.5290123456790123
E01025966,1557,775,782,0.49775208734746307,0.5022479126525369
E01025967,1659,793,866,0.47799879445449067,0.5220012055455093
E01025968,1852,929,923,0.5016198704103672,0.49838012958963285
E01025969,1799,866,933,0.481378543635353,0.5186214563646471
E01025950,1683,836,847,0.49673202614379086,0.5032679738562091
E01025951,1789,875,914,0.4891000558971492,0.5108999441028508
E01025952,1450,697,753,0.4806896551724138,0.5193103448275862
E01025953,1121,552,569,0.49241748438893845,0.5075825156110616
E01025954,1516,761,755,0.5019788918205804,0.4980211081794195
E01025932,1491,728,763,0.48826291079812206,0.5117370892018779
E01025933,1360,698,662,0.513235294117647,0.48676470588235293
E01025934,1615,780,835,0.48297213622291024,0.5170278637770898
E01025935,1172,555,617,0.4735494880546075,0.5264505119453925
E01025936,1269,604,665,0.47596532702915684,0.5240346729708432
E01025929,2145,1073,1072,0.5002331002331002,0.49976689976689975
E01025930,1655,836,819,0.5051359516616314,0.49486404833836856
E01025931,1734,854,880,0.4925028835063437,0.5074971164936563
E01025957,1859,900,959,0.4841312533620226,0.5158687466379774
E01025937,1565,757,808,0.4837060702875399,0.51629392971246
E01025958,1622,802,820,0.49445129469790383,0.5055487053020962
E01025959,2116,1053,1063,0.4976370510396975,0.5023629489603024
E01033102,1621,827,794,0.5101789019123998,0.48982109808760027
E01033103,1752,870,882,0.4965753424657534,0.5034246575342466
E01025913,2252,1183,1069,0.5253108348134992,0.4746891651865009
E01025947,1799,908,891,0.5047248471372985,0.4952751528627015
E01025948,1736,895,841,0.5155529953917051,0.48444700460829493
E01025949,1674,838,836,0.5005973715651135,0.4994026284348865
E01025938,1239,614,625,0.49556093623890235,0.5044390637610977
E01025939,1988,977,1011,0.49144869215291753,0.5085513078470825
E01025940,1957,986,971,0.5038323965252938,0.4961676034747062
E01025941,1512,764,748,0.5052910052910053,0.4947089947089947
E01025942,1782,895,887,0.5022446689113356,0.49775533108866443
E01025943,1870,918,952,0.4909090909090909,0.509090909090909
E01025970,1414,674,740,0.4766619519094767,0.5233380480905233
E01025971,1248,588,660,0.47115384615384615,0.5288461538461539
E01025972,1291,608,683,0.47095274980635166,0.5290472501936483
E01025976,1359,652,707,0.4797645327446652,0.5202354672553348
E01025977,1351,644,707,0.47668393782383417,0.5233160621761658
E01025978,1515,720,795,0.4752475247524752,0.5247524752475248
E01025992,1569,684,885,0.4359464627151052,0.5640535372848948
E01025994,1536,768,768,0.5,0.5
E01025997,1477,682,795,0.4617467840216655,0.5382532159783344
E01025999,1426,705,721,0.4943899018232819,0.5056100981767181
E01026005,1766,823,943,0.46602491506228766,0.5339750849377124
E01025985,1312,631,681,0.4809451219512195,0.5190548780487805
E01025986,1479,712,767,0.48140635564570655,0.5185936443542934
E01025987,1488,731,757,0.49126344086021506,0.508736559139785
E01025988,1567,748,819,0.4773452456924059,0.5226547543075941
E01025989,1644,790,854,0.4805352798053528,0.5194647201946472
E01025990,1352,640,712,0.47337278106508873,0.5266272189349113
E01025991,1475,728,747,0.4935593220338983,0.5064406779661017
E01025993,1503,722,781,0.4803725881570193,0.5196274118429807
E01025998,1772,871,901,0.4915349887133183,0.5084650112866818
E01026000,1321,660,661,0.4996214988644966,0.5003785011355034
E01026001,1379,688,691,0.49891225525743294,0.5010877447425671
E01025995,1495,738,757,0.4936454849498328,0.5063545150501673
E01026003,1622,774,848,0.47718865598027127,0.5228113440197287
E01026004,1731,856,875,0.49451184286539573,0.5054881571346043
E01032600,1954,939,1015,0.4805527123848516,0.5194472876151485
E01032601,1453,707,746,0.4865794907088782,0.5134205092911218
E01025973,2816,1396,1420,0.49573863636363635,0.5042613636363636
E01025974,2320,1145,1175,0.49353448275862066,0.5064655172413793
E01025975,1471,729,742,0.495581237253569,0.504418762746431
E01025979,1400,671,729,0.47928571428571426,0.5207142857142857
E01025980,1399,679,720,0.4853466761972838,0.5146533238027162
E01025981,1624,807,817,0.49692118226600984,0.5030788177339901
E01025982,1934,966,968,0.49948293691830403,0.500517063081696
E01025983,1226,584,642,0.4763458401305057,0.5236541598694943
E01025984,1481,709,772,0.4787305874409183,0.5212694125590817
E01026007,1106,549,557,0.49638336347197104,0.5036166365280289
E01026008,1502,909,593,0.6051930758988016,0.3948069241011984
E01026009,1269,649,620,0.5114263199369582,0.48857368006304175
E01026023,1397,695,702,0.49749463135289906,0.5025053686471009
E01026024,2022,973,1049,0.4812067260138477,0.5187932739861523
E01026010,1478,702,776,0.4749661705006766,0.5250338294993234
E01026011,2990,1443,1547,0.4826086956521739,0.5173913043478261
E01026030,2200,1052,1148,0.4781818181818182,0.5218181818181818
E01026032,2031,1008,1023,0.4963072378138848,0.5036927621861153
E01026037,1322,638,684,0.4826021180030257,0.5173978819969742
E01026006,2558,1308,1250,0.5113369820172009,0.48866301798279904
E01026021,1763,851,912,0.4826999432785026,0.5173000567214975
E01026025,2182,1079,1103,0.49450045829514205,0.5054995417048579
E01026036,1628,813,815,0.49938574938574937,0.5006142506142506
E01026012,1150,540,610,0.46956521739130436,0.5304347826086957
E01026015,1460,714,746,0.48904109589041095,0.510958904109589
E01026026,1954,912,1042,0.46673490276356194,0.5332650972364381
E01026027,1847,894,953,0.4840281537628587,0.5159718462371413
E01026028,1818,840,978,0.46204620462046203,0.5379537953795379
E01026016,2312,1153,1159,0.4987024221453287,0.5012975778546713
E01026033,1987,992,995,0.49924509310518367,0.5007549068948163
E01026034,1786,876,910,0.49048152295632697,0.509518477043673
E01026017,1571,773,798,0.49204328453214513,0.5079567154678549
E01026018,1671,830,841,0.4967085577498504,0.5032914422501497
E01026019,2754,1290,1464,0.4684095860566449,0.5315904139433552
E01026020,2245,1088,1157,0.4846325167037862,0.5153674832962138
E01026041,1300,605,695,0.4653846153846154,0.5346153846153846
E01026013,1446,696,750,0.48132780082987553,0.5186721991701245
E01026014,1944,914,1030,0.47016460905349794,0.529835390946502
E01026022,2104,994,1110,0.47243346007604564,0.5275665399239544
E01026038,1256,577,679,0.4593949044585987,0.5406050955414012
E01026040,1253,624,629,0.4980047885075818,0.5019952114924182
E01026029,2617,1278,1339,0.48834543370271305,0.511654566297287
E01026031,1457,699,758,0.47975291695264244,0.5202470830473576
E01026035,2063,981,1082,0.47552108579738245,0.5244789142026175
E01026039,1194,597,597,0.5,0.5
E01026045,1831,900,931,0.4915346805024577,0.5084653194975424
E01026061,1201,595,606,0.4954204829308909,0.5045795170691091
E01026062,1227,598,629,0.4873675631621842,0.5126324368378158
E01026063,1263,634,629,0.5019794140934284,0.49802058590657167
E01026080,1933,935,998,0.4837040869115365,0.5162959130884636
E01026106,1194,563,631,0.4715242881072027,0.5284757118927973
E01026107,1255,621,634,0.49482071713147413,0.5051792828685259
E01026058,2181,1083,1098,0.4965612104539202,0.5034387895460798
E01026076,2194,1082,1112,0.49316317228805834,0.5068368277119416
E01026079,1963,965,998,0.4915944982170148,0.5084055017829853
E01026077,1133,544,589,0.4801412180052957,0.5198587819947044
E01026078,1141,556,585,0.48729184925503943,0.5127081507449606
E01026087,1183,552,631,0.46661031276415893,0.5333896872358411
E01026088,1347,633,714,0.46993318485523383,0.5300668151447662
E01026090,1345,630,715,0.4684014869888476,0.5315985130111525
E01026091,1080,517,563,0.4787037037037037,0.5212962962962963
E01026108,2404,1141,1263,0.4746256239600666,0.5253743760399334
E01026081,2350,1128,1222,0.48,0.52
E01026089,2005,948,1057,0.47281795511221947,0.5271820448877805
E01032986,1131,575,556,0.5083996463306808,0.4916003536693192
E01032987,1300,615,685,0.47307692307692306,0.5269230769230769
E01026072,1983,926,1057,0.4669692385274836,0.5330307614725164
E01026073,2005,973,1032,0.48528678304239403,0.514713216957606
E01026074,2028,982,1046,0.48422090729783035,0.5157790927021696
E01026099,2066,1041,1025,0.5038722168441433,0.4961277831558567
E01026103,2087,971,1116,0.4652611403929085,0.5347388596070916
E01026104,2269,1055,1214,0.4649625385632437,0.5350374614367562
E01026109,2159,1063,1096,0.49235757295044,0.50764242704956
E01026071,2128,1060,1068,0.4981203007518797,0.5018796992481203
E01026082,2270,1113,1157,0.49030837004405287,0.5096916299559472
E01026121,2469,1195,1274,0.4840016200891049,0.5159983799108951
E01026042,1530,708,822,0.4627450980392157,0.5372549019607843
E01026043,1635,776,859,0.4746177370030581,0.5253822629969419
E01026044,1366,665,701,0.4868228404099561,0.513177159590044
E01026113,2027,1025,1002,0.5056734089787864,0.4943265910212136
E01026117,1826,916,910,0.5016429353778752,0.49835706462212487
E01026060,1321,637,684,0.4822104466313399,0.5177895533686601
E01026068,2107,1043,1064,0.4950166112956811,0.5049833887043189
E01026070,1891,939,952,0.4965626652564781,0.5034373347435219
E01026105,2196,1084,1112,0.4936247723132969,0.5063752276867031
E01026048,1517,738,779,0.4864864864864865,0.5135135135135135
E01026049,1556,780,776,0.5012853470437018,0.4987146529562982
E01026050,1601,759,842,0.4740787008119925,0.5259212991880075
E01026069,2392,1199,1193,0.5012541806020067,0.4987458193979933
E01026064,1455,728,727,0.5003436426116838,0.49965635738831615
E01026065,1816,855,961,0.4708149779735683,0.5291850220264317
E01026066,1892,896,996,0.47357293868921774,0.5264270613107822
E01026067,1910,930,980,0.4869109947643979,0.5130890052356021
E01026084,1598,763,835,0.47747183979974966,0.5225281602002503
E01026085,2226,1039,1187,0.4667565139263252,0.5332434860736748
E01026115,1755,846,909,0.48205128205128206,0.517948717948718
E01026116,1700,795,905,0.4676470588235294,0.5323529411764706
E01026046,1141,542,599,0.4750219106047327,0.5249780893952674
E01026047,1199,581,618,0.4845704753961635,0.5154295246038365
E01026055,1117,568,549,0.5085049239033125,0.4914950760966876
E01026059,1174,589,585,0.5017035775127768,0.49829642248722317
E01026100,1782,840,942,0.4713804713804714,0.5286195286195287
E01026101,1263,590,673,0.4671417260490895,0.5328582739509106
E01026092,1431,711,720,0.4968553459119497,0.5031446540880503
E01026093,1741,899,842,0.5163699023549684,0.48363009764503156
E01026095,1207,575,632,0.4763877381938691,0.5236122618061309
E01026114,1482,731,751,0.4932523616734143,0.5067476383265856
E01026083,1770,837,933,0.4728813559322034,0.5271186440677966
E01026094,1668,766,902,0.4592326139088729,0.5407673860911271
E01026096,1512,701,811,0.4636243386243386,0.5363756613756614
E01026097,1489,688,801,0.4620550705171256,0.5379449294828744
E01026051,1244,637,607,0.5120578778135049,0.4879421221864952
E01026052,1496,752,744,0.5026737967914439,0.49732620320855614
E01026053,2042,1004,1038,0.49167482859941236,0.5083251714005876
E01026054,2161,1245,916,0.5761221656640444,0.42387783433595555
E01026118,1687,826,861,0.4896265560165975,0.5103734439834025
E01026119,1164,570,594,0.4896907216494845,0.5103092783505154
E01026120,1447,679,768,0.4692467173462336,0.5307532826537664
E01026056,1171,595,576,0.5081127241673783,0.4918872758326217
E01026110,1439,704,735,0.48922863099374564,0.5107713690062543
E01026111,1563,775,788,0.49584133077415227,0.5041586692258477
E01026112,1190,564,626,0.47394957983193275,0.5260504201680672
E01026057,1920,966,954,0.503125,0.496875
E01026075,2123,1034,1089,0.48704663212435234,0.5129533678756477
E01026098,1979,981,998,0.49570490146538654,0.5042950985346134
E01026102,2357,1162,1195,0.49299957573186254,0.5070004242681375
E01026149,1631,783,848,0.48007357449417537,0.5199264255058247
E01026150,1464,713,751,0.4870218579234973,0.5129781420765027
E01026166,1219,570,649,0.46759639048400325,0.5324036095159967
E01026168,1422,658,764,0.46272855133614627,0.5372714486638537
E01026153,2471,1200,1271,0.4856333468231485,0.5143666531768515
E01026155,1611,773,838,0.4798261949099938,0.5201738050900062
E01026157,1353,635,718,0.4693274205469327,0.5306725794530672
E01026165,1376,638,738,0.4636627906976744,0.5363372093023255
E01026125,1564,1005,559,0.6425831202046036,0.35741687979539644
E01026144,1503,782,721,0.520292747837658,0.479707252162342
E01026147,2301,1140,1161,0.4954367666232073,0.5045632333767927
E01026148,1767,843,924,0.4770797962648557,0.5229202037351444
E01026151,1842,892,950,0.48425624321389793,0.5157437567861021
E01026164,1460,646,814,0.44246575342465755,0.5575342465753425
E01026167,1517,724,793,0.4772577455504285,0.5227422544495716
E01026122,1890,983,907,0.5201058201058201,0.4798941798941799
E01026123,2291,1107,1184,0.48319511130510695,0.516804888694893
E01026124,1527,777,750,0.5088408644400786,0.4911591355599214
E01026126,1678,961,717,0.5727056019070322,0.4272943980929678
E01026152,1543,722,821,0.4679196370706416,0.5320803629293583
E01026154,1408,681,727,0.4836647727272727,0.5163352272727273
E01026156,1263,592,671,0.46872525732383213,0.5312747426761678
E01026132,2756,1289,1467,0.4677068214804064,0.5322931785195936
E01026143,2213,1062,1151,0.4798915499322187,0.5201084500677813
E01026145,1528,745,783,0.487565445026178,0.512434554973822
E01026146,1976,913,1063,0.46204453441295545,0.5379554655870445
E01026134,1533,752,781,0.49054142204827134,0.5094585779517287
E01026176,1672,853,819,0.5101674641148325,0.48983253588516745
E01026177,1884,934,950,0.49575371549893843,0.5042462845010616
E01026178,1670,873,797,0.5227544910179641,0.47724550898203594
E01026127,1386,677,709,0.4884559884559885,0.5115440115440115
E01026128,2646,1290,1356,0.4875283446712018,0.5124716553287982
E01026129,1771,828,943,0.4675324675324675,0.5324675324675324
E01026131,1389,673,716,0.4845212383009359,0.515478761699064
E01026133,3431,1710,1721,0.49839696881375695,0.501603031186243
E01026135,1657,837,820,0.5051297525648762,0.4948702474351237
E01026136,1434,705,729,0.4916317991631799,0.5083682008368201
E01026174,1396,678,718,0.48567335243553006,0.5143266475644699
E01026130,1328,648,680,0.4879518072289157,0.5120481927710844
E01026158,1468,693,775,0.4720708446866485,0.5279291553133515
E01026159,1491,695,796,0.466130114017438,0.533869885982562
E01026160,1352,642,710,0.47485207100591714,0.5251479289940828
E01026162,1485,728,757,0.49023569023569025,0.5097643097643098
E01026163,1362,706,656,0.5183553597650514,0.48164464023494863
E01026161,1382,661,721,0.47829232995658466,0.5217076700434153
E01026170,1449,687,762,0.474120082815735,0.525879917184265
E01026172,1423,708,715,0.49754040758959944,0.5024595924104006
E01026173,1562,772,790,0.4942381562099872,0.5057618437900128
E01026175,1823,912,911,0.5002742731760834,0.49972572682391664
E01026137,1225,594,631,0.48489795918367345,0.5151020408163265
E01026138,1479,737,742,0.4983096686950642,0.5016903313049358
E01026139,1180,556,624,0.4711864406779661,0.5288135593220339
E01026140,1260,604,656,0.4793650793650794,0.5206349206349207
E01026141,1490,714,776,0.4791946308724832,0.5208053691275167
E01026142,1269,632,637,0.4980299448384555,0.5019700551615445
E01026169,1628,761,867,0.46744471744471744,0.5325552825552825
E01026171,1442,679,763,0.470873786407767,0.529126213592233
E01026186,1556,757,799,0.4865038560411311,0.5134961439588689
E01026187,1932,958,974,0.49585921325051757,0.5041407867494824
E01026189,1754,837,917,0.4771949828962372,0.5228050171037628
E01026203,1769,863,906,0.4878462408140192,0.5121537591859808
E01026204,1665,830,835,0.4984984984984985,0.5015015015015015
E01026206,1892,914,978,0.48308668076109934,0.5169133192389006
E01026182,1425,692,733,0.4856140350877193,0.5143859649122807
E01026193,1439,723,716,0.5024322446143155,0.4975677553856845
E01026199,2310,1115,1195,0.48268398268398266,0.5173160173160173
E01026225,1606,794,812,0.4943960149439601,0.5056039850560399
E01026226,1859,894,965,0.48090371167294244,0.5190962883270576
E01032990,2346,1147,1199,0.48891730605285594,0.5110826939471441
E01032994,1295,627,668,0.48416988416988416,0.5158301158301158
E01026184,1872,1065,807,0.5689102564102564,0.4310897435897436
E01026185,1800,852,948,0.47333333333333333,0.5266666666666666
E01026188,2168,1038,1130,0.47878228782287824,0.5212177121771218
E01026190,1491,703,788,0.47149564050972503,0.528504359490275
E01026237,1107,518,589,0.4679313459801265,0.5320686540198736
E01026238,1343,645,698,0.4802680565897245,0.5197319434102755
E01026191,1689,827,862,0.4896388395500296,0.5103611604499704
E01026205,1461,690,771,0.4722792607802875,0.5277207392197125
E01026211,1923,949,974,0.49349973998959956,0.5065002600104004
E01026212,1578,765,813,0.4847908745247148,0.5152091254752852
E01026213,1693,805,888,0.4754873006497342,0.5245126993502658
E01026192,1196,588,608,0.4916387959866221,0.5083612040133779
E01026194,1887,883,1004,0.46793852676205616,0.5320614732379438
E01026195,1930,942,988,0.48808290155440415,0.5119170984455959
E01026196,1514,731,783,0.48282694848084545,0.5171730515191546
E01026180,1464,737,727,0.5034153005464481,0.49658469945355194
E01026183,2559,1240,1319,0.4845642829230168,0.5154357170769832
E01026210,2261,1097,1164,0.4851835471030517,0.5148164528969482
E01026224,1721,821,900,0.4770482277745497,0.5229517722254503
E01026179,1331,711,620,0.5341848234410218,0.4658151765589782
E01026197,1372,681,691,0.4963556851311953,0.5036443148688047
E01026198,1455,790,665,0.5429553264604811,0.4570446735395189
E01026223,2089,1026,1063,0.49114408808042126,0.5088559119195788
E01026209,2110,1001,1109,0.47440758293838864,0.5255924170616114
E01026221,2324,1135,1189,0.48838209982788294,0.5116179001721171
E01026222,1827,880,947,0.481663929939792,0.518336070060208
E01026227,1392,678,714,0.4870689655172414,0.5129310344827587
E01026230,1231,609,622,0.49471974004874086,0.5052802599512591
E01026231,2629,1301,1328,0.49486496766831495,0.505135032331685
E01026232,2218,1029,1189,0.46393146979260597,0.5360685302073941
E01026235,1594,757,837,0.4749058971141782,0.5250941028858218
E01026228,1489,729,760,0.4895903290799194,0.5104096709200806
E01026229,1543,762,781,0.4938431626701231,0.5061568373298768
E01026233,1717,811,906,0.47233546884100175,0.5276645311589983
E01026234,2700,1307,1393,0.4840740740740741,0.5159259259259259
E01026236,1158,566,592,0.48877374784110533,0.5112262521588946
E01026200,1566,776,790,0.4955300127713921,0.5044699872286079
E01026201,2000,979,1021,0.4895,0.5105
E01026202,1787,865,922,0.4840514829322888,0.5159485170677113
E01026207,1216,623,593,0.5123355263157895,0.4876644736842105
E01026208,1629,793,836,0.4868017188459177,0.5131982811540823
E01026220,2293,1107,1186,0.4827736589620584,0.5172263410379415
E01032988,1389,677,712,0.48740100791936647,0.5125989920806335
E01032989,1358,662,696,0.48748159057437407,0.5125184094256259
E01032993,1433,697,736,0.48639218422889047,0.5136078157711096
E01026214,1157,551,606,0.4762316335350043,0.5237683664649957
E01026215,1103,509,594,0.4614687216681777,0.5385312783318223
E01026218,1150,563,587,0.4895652173913044,0.5104347826086957
E01026219,1221,607,614,0.49713349713349714,0.5028665028665029
E01032991,1433,705,728,0.4919748778785764,0.5080251221214236
E01032992,1347,669,678,0.49665924276169265,0.5033407572383074
E01026242,1470,733,737,0.49863945578231295,0.501360544217687
E01026243,1335,625,710,0.4681647940074906,0.5318352059925093
E01026244,1339,653,686,0.4876773711725168,0.5123226288274833
E01026247,1927,926,1001,0.4805396990140114,0.5194603009859886
E01026276,2369,1189,1180,0.5018995356690586,0.49810046433094135
E01026246,2351,1176,1175,0.5002126754572522,0.49978732454274777
E01026248,2270,1119,1151,0.4929515418502203,0.5070484581497797
E01026257,1886,899,987,0.4766702014846235,0.5233297985153764
E01026250,1788,854,934,0.47762863534675615,0.5223713646532439
E01026251,1817,878,939,0.48321408915795266,0.5167859108420473
E01026252,1741,822,919,0.47214244686961515,0.5278575531303848
E01026253,1764,874,890,0.4954648526077097,0.5045351473922902
E01026281,1317,653,664,0.49582384206529995,0.5041761579347
E01026282,1737,842,895,0.48474381116868165,0.5152561888313184
E01026283,1726,864,862,0.5005793742757821,0.49942062572421786
E01026285,1439,696,743,0.4836692147324531,0.5163307852675469
E01026286,1273,648,625,0.5090337784760408,0.49096622152395913
E01026241,1961,1001,960,0.5104538500764916,0.4895461499235084
E01026258,1751,864,887,0.4934323243860651,0.5065676756139349
E01026259,1712,831,881,0.48539719626168226,0.5146028037383178
E01026260,1992,970,1022,0.48694779116465864,0.5130522088353414
E01026266,2002,993,1009,0.49600399600399603,0.503996003996004
E01026273,1688,827,861,0.48992890995260663,0.5100710900473934
E01026274,1932,930,1002,0.4813664596273292,0.5186335403726708
E01026275,2008,973,1035,0.4845617529880478,0.5154382470119522
E01032995,1391,676,715,0.48598130841121495,0.514018691588785
E01032996,1358,668,690,0.49189985272459497,0.508100147275405
E01026268,1971,935,1036,0.4743784880771182,0.5256215119228818
E01026269,2190,1048,1142,0.4785388127853881,0.5214611872146119
E01026270,1902,941,961,0.49474237644584645,0.5052576235541535
E01026271,1779,871,908,0.4896008993816751,0.5103991006183249
E01026272,1238,614,624,0.49596122778675283,0.5040387722132472
E01026254,1776,855,921,0.4814189189189189,0.518581081081081
E01026255,1972,947,1025,0.4802231237322515,0.5197768762677485
E01026256,1626,777,849,0.477859778597786,0.522140221402214
E01026277,1663,829,834,0.4984966927239928,0.5015033072760072
E01026278,1407,695,712,0.4939587775408671,0.5060412224591329
E01026279,1384,675,709,0.4877167630057804,0.5122832369942196
E01026262,1539,742,797,0.4821312540610786,0.5178687459389214
E01026263,1994,955,1039,0.4789368104312939,0.5210631895687061
E01026264,1546,750,796,0.4851228978007762,0.5148771021992238
E01026265,1362,661,701,0.4853157121879589,0.5146842878120411
E01026267,2822,1371,1451,0.4858256555634302,0.5141743444365698
E01026245,2136,1020,1116,0.47752808988764045,0.5224719101123596
E01026249,1871,928,943,0.49599144842330306,0.504008551576697
E01026280,2539,1269,1270,0.4998030720756203,0.5001969279243796
E01026239,1792,853,939,0.4760044642857143,0.5239955357142857
E01026240,2419,1222,1197,0.5051674245556015,0.4948325754443985
E01026284,1998,977,1021,0.488988988988989,0.511011011011011
E01026313,1536,747,789,0.486328125,0.513671875
E01026314,1294,630,664,0.4868624420401855,0.5131375579598145
E01026329,1887,918,969,0.4864864864864865,0.5135135135135135
E01026333,2522,1233,1289,0.4888977002379064,0.5111022997620935
E01026291,1952,954,998,0.4887295081967213,0.5112704918032787
E01026340,2200,1070,1130,0.4863636363636364,0.5136363636363637
E01026355,2383,1132,1251,0.47503147293327735,0.5249685270667226
E01026365,2309,1133,1176,0.49068860978778694,0.509311390212213
E01026325,1515,723,792,0.4772277227722772,0.5227722772277228
E01026326,1542,741,801,0.4805447470817121,0.519455252918288
E01026327,1336,625,711,0.46781437125748504,0.532185628742515
E01026328,1459,664,795,0.455106237148732,0.544893762851268
E01026352,1260,620,640,0.49206349206349204,0.5079365079365079
E01026353,1605,732,873,0.45607476635514016,0.5439252336448598
E01026354,1191,579,612,0.48614609571788414,0.5138539042821159
E01026320,1783,848,935,0.47560291643297814,0.5243970835670219
E01026321,1306,623,683,0.4770290964777948,0.5229709035222052
E01026322,1104,537,567,0.48641304347826086,0.5135869565217391
E01026323,1842,904,938,0.49077090119435396,0.509229098805646
E01026324,2242,1100,1142,0.49063336306868865,0.5093666369313113
E01026308,1484,732,752,0.49326145552560646,0.5067385444743935
E01026309,1567,755,812,0.48181238034460755,0.5181876196553925
E01026310,1235,611,624,0.49473684210526314,0.5052631578947369
E01026311,1637,778,859,0.4752596212583995,0.5247403787416005
E01026312,1409,662,747,0.46983676366217175,0.5301632363378282
E01026317,2062,1020,1042,0.49466537342386036,0.5053346265761397
E01026318,1926,930,996,0.48286604361370716,0.5171339563862928
E01026319,2088,1027,1061,0.4918582375478927,0.5081417624521073
E01026343,1808,898,910,0.49668141592920356,0.5033185840707964
E01026344,1503,752,751,0.5003326679973387,0.49966733200266134
E01026345,1576,751,825,0.47652284263959394,0.5234771573604061
E01026292,1422,708,714,0.4978902953586498,0.5021097046413502
E01026293,2057,1027,1030,0.4992707826932426,0.5007292173067575
E01026294,1654,820,834,0.4957678355501814,0.5042321644498187
E01026316,2417,1176,1241,0.48655357881671496,0.5134464211832851
E01026332,2224,1085,1139,0.48785971223021585,0.5121402877697842
E01026290,2258,1114,1144,0.4933569530558016,0.5066430469441984
E01026341,1479,706,773,0.47734956051386074,0.5226504394861393
E01026342,1459,727,732,0.49828649760109667,0.5017135023989033
E01026361,2633,1241,1392,0.4713254842385112,0.5286745157614888
E01026315,2084,1016,1068,0.4875239923224568,0.5124760076775432
E01026331,2424,1226,1198,0.5057755775577558,0.49422442244224424
E01026338,1237,618,619,0.4995957962813258,0.5004042037186742
E01026339,1207,583,624,0.48301574150787074,0.5169842584921293
E01026299,1694,798,896,0.47107438016528924,0.5289256198347108
E01026300,1516,754,762,0.4973614775725594,0.5026385224274407
E01026301,1631,762,869,0.46719803801348864,0.5328019619865113
E01026302,1214,606,608,0.49917627677100496,0.500823723228995
E01026296,1549,765,784,0.49386701097482244,0.5061329890251776
E01026297,1347,635,712,0.47141796585003715,0.5285820341499629
E01026298,1816,859,957,0.47301762114537443,0.5269823788546255
E01032997,1231,577,654,0.4687246141348497,0.5312753858651503
E01032998,1289,628,661,0.48719937936384794,0.5128006206361521
E01032999,1169,531,638,0.4542343883661249,0.5457656116338752
E01026330,2235,1091,1144,0.48814317673378077,0.5118568232662193
E01026360,2153,1100,1053,0.5109150023223409,0.48908499767765906
E01026362,1758,882,876,0.5017064846416383,0.49829351535836175
E01026363,1322,625,697,0.47276853252647505,0.527231467473525
E01026364,1731,831,900,0.4800693240901213,0.5199306759098787
E01026334,1586,767,819,0.48360655737704916,0.5163934426229508
E01026335,1555,717,838,0.46109324758842446,0.5389067524115756
E01026336,1588,790,798,0.49748110831234255,0.5025188916876574
E01026337,1534,754,780,0.4915254237288136,0.5084745762711864
E01026303,1393,671,722,0.48169418521177315,0.5183058147882269
E01026304,1454,721,733,0.4958734525447043,0.5041265474552957
E01026305,1373,655,718,0.4770575382374363,0.5229424617625638
E01026306,1543,698,845,0.4523655217109527,0.5476344782890473
E01026307,1288,626,662,0.4860248447204969,0.5139751552795031
E01026287,1448,720,728,0.4972375690607735,0.5027624309392266
E01026288,1632,755,877,0.46262254901960786,0.5373774509803921
E01026289,2033,989,1044,0.4864731923266109,0.5135268076733891
E01026346,1183,572,611,0.4835164835164835,0.5164835164835165
E01026347,1657,719,938,0.4339167169583585,0.5660832830416416
E01026348,1179,579,600,0.4910941475826972,0.5089058524173028
E01026349,1564,704,860,0.45012787723785164,0.5498721227621484
E01026350,1621,724,897,0.44663787785317705,0.5533621221468229
E01026351,1475,739,736,0.5010169491525424,0.49898305084745764
E01026356,1463,719,744,0.4914559125085441,0.508544087491456
E01026357,1426,686,740,0.48106591865357645,0.5189340813464236
E01026358,1421,668,753,0.47009148486981,0.52990851513019
E01026359,1599,763,836,0.47717323327079425,0.5228267667292058
E01026367,1641,821,820,0.5003046922608165,0.4996953077391834
E01026368,1593,772,821,0.48462021343377276,0.5153797865662273
E01026387,2664,1322,1342,0.49624624624624625,0.5037537537537538
E01026416,1306,638,668,0.4885145482388974,0.5114854517611026
E01032683,2221,1082,1139,0.4871679423683026,0.5128320576316975
E01026380,1832,899,933,0.49072052401746724,0.5092794759825328
E01026401,1578,760,818,0.4816223067173637,0.5183776932826363
E01026402,1825,900,925,0.4931506849315068,0.5068493150684932
E01026403,1361,669,692,0.49155033063923587,0.5084496693607642
E01026407,1383,669,714,0.4837310195227766,0.5162689804772235
E01026408,1325,632,693,0.4769811320754717,0.5230188679245283
E01026389,1681,832,849,0.49494348602022603,0.5050565139797739
E01026390,1815,900,915,0.49586776859504134,0.5041322314049587
E01026391,1921,933,988,0.48568453930244665,0.5143154606975534
E01026392,2978,1438,1540,0.4828744123572868,0.5171255876427132
E01026415,1057,528,529,0.49952696310312206,0.5004730368968779
E01026378,1702,817,885,0.4800235017626322,0.5199764982373678
E01026379,1643,802,841,0.4881314668289714,0.5118685331710287
E01026381,1683,796,887,0.47296494355317886,0.5270350564468211
E01026382,1665,822,843,0.4936936936936937,0.5063063063063064
E01026383,1185,649,536,0.5476793248945148,0.45232067510548524
E01026384,1767,859,908,0.48613469156762873,0.5138653084323712
E01026385,1154,572,582,0.49566724436741766,0.5043327556325823
E01026386,1373,694,679,0.5054624908958485,0.4945375091041515
E01026399,1477,734,743,0.4969532836831415,0.5030467163168585
E01026411,2452,1233,1219,0.5028548123980424,0.4971451876019576
E01026374,1449,707,742,0.48792270531400966,0.5120772946859904
E01026375,1585,745,840,0.47003154574132494,0.5299684542586751
E01026376,1802,832,970,0.46170921198668147,0.5382907880133185
E01026377,2195,1070,1125,0.4874715261958998,0.5125284738041003
E01026388,2140,1013,1127,0.4733644859813084,0.5266355140186916
E01026404,2222,1091,1131,0.490999099909991,0.509000900090009
E01026409,1168,598,570,0.511986301369863,0.488013698630137
E01026410,1622,780,842,0.4808877928483354,0.5191122071516646
E01026372,2464,1207,1257,0.4898538961038961,0.5101461038961039
E01026412,1670,787,883,0.47125748502994014,0.5287425149700599
E01026413,2248,1082,1166,0.48131672597864766,0.5186832740213523
E01026414,1686,818,868,0.4851720047449585,0.5148279952550415
E01026396,1229,574,655,0.467046379170057,0.532953620829943
E01026397,2358,1183,1175,0.501696352841391,0.498303647158609
E01026398,1489,727,762,0.4882471457353929,0.5117528542646071
E01026400,1719,866,853,0.5037812681791739,0.49621873182082604
E01026393,1428,675,753,0.4726890756302521,0.5273109243697479
E01026394,1865,889,976,0.4766756032171582,0.5233243967828418
E01026395,1417,657,760,0.4636556104446013,0.5363443895553988
E01026405,1380,661,719,0.4789855072463768,0.5210144927536232
E01026406,1268,610,658,0.4810725552050473,0.5189274447949527
E01026366,2057,972,1085,0.4725328147788041,0.527467185221196
E01026369,1096,506,590,0.46167883211678834,0.5383211678832117
E01026370,2092,1014,1078,0.4847036328871893,0.5152963671128107
E01026371,1233,619,614,0.5020275750202757,0.49797242497972427
E01026373,2086,1035,1051,0.49616490891658677,0.5038350910834132
E01026971,1727,861,866,0.49855240301100173,0.5014475969889982
E01026979,1398,691,707,0.49427753934191704,0.505722460658083
E01026980,1579,765,814,0.4844838505383154,0.5155161494616846
E01026982,1972,933,1039,0.4731237322515213,0.5268762677484787
E01026969,1644,793,851,0.48236009732360097,0.517639902676399
E01026970,1704,851,853,0.4994131455399061,0.5005868544600939
E01026972,1828,869,959,0.47538293216630195,0.524617067833698
E01026976,1347,669,678,0.49665924276169265,0.5033407572383074
E01026981,1203,606,597,0.5037406483790524,0.49625935162094764
E01026983,1107,569,538,0.5140018066847335,0.4859981933152665
E01026957,1542,792,750,0.5136186770428015,0.48638132295719844
E01026958,1813,918,895,0.5063430777716492,0.4936569222283508
E01026977,1909,931,978,0.48768988999476165,0.5123101100052383
E01026978,1442,731,711,0.5069348127600555,0.4930651872399445
E01026962,1391,657,734,0.4723220704529116,0.5276779295470885
E01026973,1422,691,731,0.4859353023909986,0.5140646976090014
E01026974,1139,557,582,0.4890254609306409,0.5109745390693591
E01026975,1356,645,711,0.4756637168141593,0.5243362831858407
E01026984,1715,840,875,0.4897959183673469,0.5102040816326531
E01026985,1484,728,756,0.49056603773584906,0.5094339622641509
E01026949,1300,672,628,0.5169230769230769,0.48307692307692307
E01026950,1550,764,786,0.49290322580645163,0.5070967741935484
E01026951,1270,617,653,0.4858267716535433,0.5141732283464567
E01026952,1179,579,600,0.4910941475826972,0.5089058524173028
E01026959,1415,674,741,0.4763250883392226,0.5236749116607774
E01026960,1506,735,771,0.48804780876494025,0.5119521912350598
E01026961,1292,656,636,0.5077399380804953,0.49226006191950467
E01026965,1034,506,528,0.48936170212765956,0.5106382978723404
E01026966,1393,689,704,0.4946159368269921,0.5053840631730079
E01026967,1724,846,878,0.49071925754060325,0.5092807424593968
E01026968,1374,640,734,0.4657933042212518,0.5342066957787481
E01026953,1345,678,667,0.504089219330855,0.49591078066914496
E01026954,1367,662,705,0.4842721287490856,0.5157278712509145
E01026955,1453,725,728,0.4989676531314522,0.5010323468685478
E01026956,1947,949,998,0.4874165382639959,0.5125834617360041
E01026963,1326,630,696,0.4751131221719457,0.5248868778280543
E01032963,1579,788,791,0.4990500316656111,0.5009499683343889
E01032964,1721,867,854,0.5037768739105172,0.4962231260894829
E01032965,1371,698,673,0.5091174325309993,0.4908825674690007
E01032966,1703,843,860,0.49500880798590724,0.5049911920140928
E01032967,1684,832,852,0.49406175771971494,0.505938242280285
E01027005,2100,1046,1054,0.4980952380952381,0.5019047619047619
E01027026,1969,977,992,0.49619095987811074,0.5038090401218893
E01027030,1775,895,880,0.504225352112676,0.49577464788732395
E01027000,1505,699,806,0.46445182724252493,0.5355481727574751
E01027001,1523,773,750,0.5075508864084045,0.49244911359159554
E01027002,1721,891,830,0.5177222545031959,0.4822777454968042
E01027003,1435,715,720,0.49825783972125437,0.5017421602787456
E01027022,1796,884,912,0.4922048997772829,0.5077951002227171
E01026994,1009,488,521,0.4836471754212091,0.5163528245787908
E01026999,1759,862,897,0.4900511654349062,0.5099488345650938
E01027006,1886,959,927,0.5084835630965006,0.49151643690349944
E01032968,3304,2171,1133,0.6570823244552058,0.3429176755447942
E01026998,1749,862,887,0.4928530588907947,0.5071469411092052
E01027015,1269,617,652,0.4862096138691883,0.5137903861308116
E01027016,1513,771,742,0.5095836087243887,0.4904163912756114
E01027021,1844,912,932,0.4945770065075922,0.5054229934924078
E01027027,2410,1148,1262,0.4763485477178423,0.5236514522821577
E01026997,1783,825,958,0.4627033090297252,0.5372966909702748
E01027018,1464,721,743,0.4924863387978142,0.5075136612021858
E01027019,1521,734,787,0.482577251808021,0.517422748191979
E01027020,1210,572,638,0.4727272727272727,0.5272727272727272
E01027023,2047,1009,1038,0.49291646311675624,0.5070835368832438
E01026987,1201,595,606,0.4954204829308909,0.5045795170691091
E01026989,1451,725,726,0.4996554100620262,0.5003445899379738
E01026990,2629,1325,1304,0.503993914035755,0.49600608596424495
E01027012,1747,866,881,0.4957069261591299,0.5042930738408701
E01027014,2214,1067,1147,0.48193315266486,0.51806684733514
E01026986,2898,1449,1449,0.5,0.5
E01026988,1572,755,817,0.4802798982188295,0.5197201017811705
E01026991,1569,760,809,0.4843849585723391,0.5156150414276609
E01026992,1906,931,975,0.48845750262329485,0.5115424973767051
E01027010,1177,598,579,0.508071367884452,0.491928632115548
E01027007,1409,680,729,0.48261178140525196,0.517388218594748
E01027008,1948,977,971,0.5015400410677618,0.4984599589322382
E01027009,1496,741,755,0.49532085561497324,0.5046791443850267
E01027013,1809,879,930,0.4859038142620232,0.5140961857379768
E01027011,1899,925,974,0.48709847288046343,0.5129015271195366
E01027017,1451,719,732,0.49552033080634045,0.5044796691936595
E01027024,1721,856,865,0.4973852411388727,0.5026147588611273
E01027025,1640,791,849,0.4823170731707317,0.5176829268292683
E01026993,1952,960,992,0.4918032786885246,0.5081967213114754
E01027004,1853,910,943,0.4910955207771182,0.5089044792228818
E01027028,2129,1064,1065,0.4997651479567872,0.5002348520432128
E01027029,1580,795,785,0.5031645569620253,0.49683544303797467
E01027033,1810,893,917,0.49337016574585635,0.5066298342541437
E01027043,1981,977,1004,0.49318525996971224,0.5068147400302877
E01027050,1912,970,942,0.5073221757322176,0.49267782426778245
E01027031,2123,1046,1077,0.49269901083372586,0.5073009891662741
E01027044,2059,1049,1010,0.509470616804274,0.4905293831957261
E01027046,1296,621,675,0.4791666666666667,0.5208333333333334
E01027047,1286,653,633,0.5077760497667185,0.49222395023328147
E01027048,2158,1116,1042,0.5171455050973123,0.48285449490268767
E01027049,995,472,523,0.4743718592964824,0.5256281407035176
E01027032,1869,932,937,0.4986623863028357,0.5013376136971642
E01027045,1898,949,949,0.5,0.5
E01027075,2101,1049,1052,0.49928605425987627,0.5007139457401237
E01027076,2157,1052,1105,0.48771441817338895,0.512285581826611
E01027077,1981,1001,980,0.5053003533568905,0.49469964664310956
E01027057,1743,876,867,0.5025817555938038,0.4974182444061962
E01027074,2183,1072,1111,0.49106733852496565,0.5089326614750344
E01027078,2116,1062,1054,0.501890359168242,0.498109640831758
E01027051,1755,870,885,0.49572649572649574,0.5042735042735043
E01027052,1422,713,709,0.5014064697609001,0.49859353023909986
E01027053,1525,766,759,0.5022950819672131,0.4977049180327869
E01027054,1243,624,619,0.50201126307321,0.49798873692679
E01027055,1139,570,569,0.5004389815627743,0.4995610184372256
E01027056,1557,760,797,0.4881181759794477,0.5118818240205524
E01027038,1622,811,811,0.5,0.5
E01027039,1805,884,921,0.48975069252077563,0.5102493074792244
E01027040,1617,823,794,0.5089672232529375,0.49103277674706247
E01027041,1617,787,830,0.4867037724180581,0.5132962275819418
E01027042,1874,946,928,0.5048025613660619,0.4951974386339381
E01027034,1652,752,900,0.4552058111380145,0.5447941888619855
E01027035,1386,680,706,0.4906204906204906,0.5093795093795094
E01027037,2205,1111,1094,0.5038548752834467,0.4961451247165533
E01033244,2397,1227,1170,0.5118898623279099,0.4881101376720901
E01033245,1009,502,507,0.4975222993062438,0.5024777006937562
E01027061,1777,854,923,0.4805852560495217,0.5194147439504784
E01027062,2245,1065,1180,0.47438752783964366,0.5256124721603563
E01027063,1820,918,902,0.5043956043956044,0.4956043956043956
E01027064,1612,811,801,0.5031017369727047,0.4968982630272953
E01027072,1649,798,851,0.4839296543359612,0.5160703456640389
E01027073,2033,968,1065,0.47614363010329563,0.5238563698967044
E01027058,1498,742,756,0.4953271028037383,0.5046728971962616
E01027059,1732,882,850,0.5092378752886836,0.4907621247113164
E01027060,1778,876,902,0.49268841394825647,0.5073115860517435
E01027065,1753,870,883,0.49629207073588133,0.5037079292641187
E01027069,1541,757,784,0.49123945489941595,0.508760545100584
E01027066,2218,1095,1123,0.49368800721370604,0.5063119927862939
E01027067,1584,765,819,0.48295454545454547,0.5170454545454546
E01027068,2907,1441,1466,0.4957000343997248,0.5042999656002752
E01027070,1641,842,799,0.5131017672151127,0.48689823278488725
E01027071,1484,758,726,0.5107816711590296,0.48921832884097033
E01027090,1462,726,736,0.49658002735978113,0.5034199726402189
E01027103,1629,784,845,0.4812768569674647,0.5187231430325353
E01027129,2185,1076,1109,0.49244851258581235,0.5075514874141877
E01027094,1552,752,800,0.4845360824742268,0.5154639175257731
E01027095,1451,741,710,0.5106822880771882,0.48931771192281187
E01027107,1269,627,642,0.4940898345153664,0.5059101654846335
E01027108,1313,639,674,0.48667174409748665,0.5133282559025133
E01027109,1268,630,638,0.4968454258675079,0.5031545741324921
E01032969,1287,627,660,0.48717948717948717,0.5128205128205128
E01032970,1482,710,772,0.47908232118758437,0.5209176788124157
E01032971,1075,525,550,0.4883720930232558,0.5116279069767442
E01027123,1595,762,833,0.47774294670846396,0.522257053291536
E01027124,2182,1060,1122,0.4857928505957837,0.5142071494042163
E01027125,1807,910,897,0.5035971223021583,0.49640287769784175
E01027126,2110,1020,1090,0.4834123222748815,0.5165876777251185
E01027079,1755,843,912,0.48034188034188036,0.5196581196581197
E01027080,1962,975,987,0.4969418960244648,0.5030581039755352
E01027087,1180,584,596,0.49491525423728816,0.5050847457627119
E01027088,1288,641,647,0.49767080745341613,0.5023291925465838
E01027089,2081,993,1088,0.4771744353676117,0.5228255646323883
E01027081,1450,689,761,0.47517241379310343,0.5248275862068965
E01027082,1593,803,790,0.5040803515379787,0.49591964846202136
E01027083,1415,716,699,0.5060070671378092,0.4939929328621908
E01027127,1869,902,967,0.4826110219368646,0.5173889780631353
E01027128,1720,865,855,0.502906976744186,0.49709302325581395
E01027105,2103,1111,992,0.5282929148834997,0.4717070851165002
E01027106,1935,1013,922,0.5235142118863049,0.4764857881136951
E01027111,2097,1046,1051,0.4988078206962327,0.5011921793037672
E01027112,2116,1072,1044,0.5066162570888468,0.4933837429111531
E01027104,2335,1162,1173,0.497644539614561,0.502355460385439
E01027110,1731,817,914,0.4719815135759676,0.5280184864240324
E01027113,2172,1038,1134,0.47790055248618785,0.5220994475138122
E01027115,1175,566,609,0.4817021276595745,0.5182978723404256
E01027116,2178,1112,1066,0.5105601469237833,0.48943985307621674
E01027117,1401,686,715,0.489650249821556,0.510349750178444
E01027096,1192,571,621,0.4790268456375839,0.5209731543624161
E01027097,1367,674,693,0.493050475493782,0.506949524506218
E01027098,1218,588,630,0.4827586206896552,0.5172413793103449
E01027099,1464,673,791,0.45969945355191255,0.5403005464480874
E01027122,1182,594,588,0.5025380710659898,0.49746192893401014
E01027100,1600,773,827,0.483125,0.516875
E01027114,1595,788,807,0.49404388714733544,0.5059561128526646
E01027130,1825,921,904,0.5046575342465753,0.49534246575342467
E01027131,2012,984,1028,0.48906560636182905,0.510934393638171
E01027084,1462,733,729,0.5013679890560876,0.49863201094391246
E01027085,1287,609,678,0.4731934731934732,0.5268065268065268
E01027086,1669,806,863,0.4829239065308568,0.5170760934691432
E01027120,1342,676,666,0.503725782414307,0.496274217585693
E01027121,1455,746,709,0.5127147766323024,0.4872852233676976
E01027091,1867,898,969,0.48098553829673274,0.5190144617032673
E01027092,1502,721,781,0.4800266311584554,0.5199733688415447
E01027101,2422,1160,1262,0.47894302229562347,0.5210569777043765
E01027102,1658,807,851,0.4867310012062726,0.5132689987937273
E01027119,1708,819,889,0.47950819672131145,0.5204918032786885
E01032972,1439,713,726,0.4954829742876998,0.5045170257123002
E01032973,1699,821,878,0.48322542672160096,0.516774573278399
E01032974,1287,598,689,0.46464646464646464,0.5353535353535354
E01027145,1402,686,716,0.4893009985734665,0.5106990014265336
E01027148,1453,717,736,0.49346180316586374,0.5065381968341363
E01027149,1457,732,725,0.5024021962937543,0.49759780370624573
E01027232,2540,1126,1414,0.44330708661417323,0.5566929133858268
E01027218,1563,746,817,0.47728726807421623,0.5227127319257837
E01027219,1703,795,908,0.46682325308279504,0.533176746917205
E01027221,1744,840,904,0.481651376146789,0.518348623853211
E01027222,1267,643,624,0.5074980268350434,0.4925019731649566
E01027143,1295,637,658,0.4918918918918919,0.5081081081081081
E01027144,1504,725,779,0.4820478723404255,0.5179521276595744
E01027146,1495,721,774,0.4822742474916388,0.5177257525083612
E01027147,1671,819,852,0.49012567324955114,0.5098743267504489
E01027195,1575,802,773,0.5092063492063492,0.4907936507936508
E01027245,1619,799,820,0.49351451513279804,0.506485484867202
E01027247,1565,757,808,0.4837060702875399,0.51629392971246
E01027248,1534,697,837,0.45436766623207303,0.545632333767927
E01027249,1826,906,920,0.49616648411829134,0.5038335158817087
E01027174,1317,660,657,0.5011389521640092,0.4988610478359909
E01027175,1539,726,813,0.47173489278752434,0.5282651072124757
E01027178,2047,962,1085,0.46995603321934537,0.5300439667806546
E01027200,1466,691,775,0.4713506139154161,0.5286493860845839
E01027246,1854,861,993,0.46440129449838186,0.5355987055016181
E01027171,1438,649,789,0.4513212795549374,0.5486787204450626
E01027172,1579,762,817,0.4825839138695377,0.5174160861304623
E01027182,1428,676,752,0.4733893557422969,0.5266106442577031
E01027183,1366,677,689,0.4956076134699854,0.5043923865300146
E01027196,1538,729,809,0.4739921976592978,0.5260078023407022
E01027197,1402,676,726,0.48216833095577744,0.5178316690442225
E01027198,1561,783,778,0.5016015374759769,0.4983984625240231
E01027199,1400,666,734,0.4757142857142857,0.5242857142857142
E01027190,1531,709,822,0.46309601567602876,0.5369039843239712
E01027191,1781,923,858,0.5182481751824818,0.48175182481751827
E01027193,1434,699,735,0.4874476987447699,0.5125523012552301
E01027194,1347,663,684,0.4922048997772829,0.5077951002227171
E01027192,1388,676,712,0.48703170028818443,0.5129682997118156
E01027229,1565,739,826,0.47220447284345046,0.5277955271565495
E01027230,1542,716,826,0.46433203631647213,0.5356679636835279
E01027231,1791,861,930,0.4807370184254606,0.5192629815745393
E01027179,1867,912,955,0.4884841992501339,0.5115158007498661
E01027180,1542,739,803,0.4792477302204929,0.5207522697795072
E01027181,1654,790,864,0.47762998790810157,0.5223700120918985
E01027140,1242,587,655,0.4726247987117552,0.5273752012882448
E01027142,1367,661,706,0.48354059985369424,0.5164594001463058
E01027176,1508,734,774,0.48673740053050396,0.513262599469496
E01027177,1543,716,827,0.46403110823071936,0.5359688917692806
E01027168,1668,825,843,0.49460431654676257,0.5053956834532374
E01027169,1644,833,811,0.5066909975669099,0.49330900243309
E01027170,1558,746,812,0.47881899871630296,0.521181001283697
E01027173,1611,788,823,0.489137181874612,0.5108628181253879
E01027136,1843,901,942,0.4888768312533912,0.5111231687466088
E01027186,1760,913,847,0.51875,0.48125
E01027188,1809,848,961,0.46876727473742397,0.531232725262576
E01027220,1320,646,674,0.4893939393939394,0.5106060606060606
E01027208,1465,724,741,0.49419795221843005,0.50580204778157
E01027209,1195,580,615,0.48535564853556484,0.5146443514644351
E01027211,1380,662,718,0.4797101449275362,0.5202898550724637
E01027212,1408,690,718,0.4900568181818182,0.5099431818181818
E01027184,1561,749,812,0.4798206278026906,0.5201793721973094
E01027185,1500,698,802,0.4653333333333333,0.5346666666666666
E01027187,1325,689,636,0.52,0.48
E01027189,1621,805,816,0.49660703269586676,0.5033929673041333
E01027137,1369,647,722,0.47260774287801316,0.5273922571219869
E01027138,1488,706,782,0.47446236559139787,0.5255376344086021
E01027139,1484,773,711,0.52088948787062,0.47911051212938005
E01027141,1456,700,756,0.4807692307692308,0.5192307692307693
E01027259,1568,770,798,0.49107142857142855,0.5089285714285714
E01027239,1687,815,872,0.4831061055127445,0.5168938944872555
E01027241,1741,884,857,0.5077541642734061,0.4922458357265939
E01027242,1575,746,829,0.47365079365079366,0.5263492063492063
E01027243,1546,715,831,0.46248382923674,0.53751617076326
E01027244,1624,774,850,0.4766009852216749,0.5233990147783252
E01027213,1541,770,771,0.49967553536664505,0.500324464633355
E01027214,1545,733,812,0.47443365695792883,0.5255663430420712
E01027216,1614,800,814,0.49566294919454773,0.5043370508054523
E01027240,1329,598,731,0.44996237772761477,0.5500376222723853
E01027207,1373,694,679,0.5054624908958485,0.4945375091041515
E01027210,1141,546,595,0.4785276073619632,0.5214723926380368
E01027215,1461,707,754,0.4839151266255989,0.5160848733744011
E01027217,2133,1010,1123,0.473511486169714,0.5264885138302859
E01027255,1347,662,685,0.4914625092798812,0.5085374907201188
E01027256,1493,708,785,0.4742129939718687,0.5257870060281313
E01027258,1431,749,682,0.5234102026554857,0.47658979734451434
E01027260,1422,706,716,0.4964838255977497,0.5035161744022504
E01027152,1738,894,844,0.5143843498273878,0.4856156501726122
E01027153,2007,1095,912,0.5455904334828101,0.45440956651718983
E01027154,1757,910,847,0.5179282868525896,0.4820717131474104
E01032978,1375,737,638,0.536,0.464
E01032979,1300,711,589,0.546923076923077,0.4530769230769231
E01027132,2023,1017,1006,0.5027187345526446,0.4972812654473554
E01027133,1708,882,826,0.5163934426229508,0.48360655737704916
E01027134,1766,874,892,0.49490373725934317,0.5050962627406569
E01027135,1788,934,854,0.5223713646532439,0.47762863534675615
E01027155,2191,1195,996,0.5454130534002738,0.45458694659972615
E01027225,1653,868,785,0.5251058681185723,0.4748941318814277
E01027227,1577,821,756,0.5206087507926442,0.47939124920735576
E01027228,1906,975,931,0.5115424973767051,0.48845750262329485
E01027151,1623,864,759,0.532347504621072,0.4676524953789279
E01027236,1583,743,840,0.4693619709412508,0.5306380290587492
E01027237,2012,957,1055,0.47564612326043737,0.5243538767395626
E01027238,1948,1001,947,0.5138603696098563,0.48613963039014374
E01027223,1983,1054,929,0.5315179021684316,0.46848209783156836
E01027224,1724,899,825,0.521461716937355,0.478538283062645
E01027226,1777,883,894,0.49690489589195275,0.5030951041080473
E01027257,1567,839,728,0.5354179961710275,0.4645820038289726
E01027233,1324,615,709,0.4645015105740181,0.5354984894259819
E01027234,1400,673,727,0.4807142857142857,0.5192857142857142
E01027235,1462,667,795,0.45622435020519836,0.5437756497948016
E01027252,1547,719,828,0.464770523594053,0.535229476405947
E01027156,1257,605,652,0.4813046937151949,0.5186953062848051
E01027159,1273,638,635,0.5011783189316575,0.4988216810683425
E01027160,1826,922,904,0.5049288061336255,0.4950711938663746
E01027161,1557,729,828,0.4682080924855491,0.5317919075144508
E01027158,1464,734,730,0.5013661202185792,0.49863387978142076
E01027201,2083,1004,1079,0.4819971195391263,0.5180028804608737
E01027202,1554,770,784,0.4954954954954955,0.5045045045045045
E01032980,1437,763,674,0.5309672929714684,0.46903270702853167
E01032981,1515,765,750,0.504950495049505,0.49504950495049505
E01027250,1371,679,692,0.49525893508388036,0.5047410649161196
E01027253,1829,898,931,0.490978676872608,0.509021323127392
E01027254,1766,864,902,0.48924122310305773,0.5107587768969423
E01032975,1720,868,852,0.5046511627906977,0.49534883720930234
E01032976,1251,575,676,0.4596322941646683,0.5403677058353318
E01032977,1780,872,908,0.4898876404494382,0.5101123595505618
E01027162,1556,782,774,0.5025706940874036,0.4974293059125964
E01027163,1407,699,708,0.4968017057569296,0.5031982942430704
E01027164,1513,748,765,0.4943820224719101,0.5056179775280899
E01027165,1333,674,659,0.5056264066016504,0.4943735933983496
E01027166,1613,798,815,0.49473031618102914,0.5052696838189709
E01027167,1406,666,740,0.47368421052631576,0.5263157894736842
E01027203,1619,767,852,0.4737492279184682,0.5262507720815318
E01027204,1708,823,885,0.4818501170960187,0.5181498829039812
E01027205,2259,1136,1123,0.5028773793714033,0.49712262062859675
E01027206,2947,1461,1486,0.495758398371225,0.5042416016287751
E01027282,1634,796,838,0.48714810281517745,0.5128518971848225
E01027283,1602,776,826,0.484394506866417,0.5156054931335831
E01027285,1709,841,868,0.49210064365125805,0.507899356348742
E01027286,1546,765,781,0.4948253557567917,0.5051746442432082
E01027287,1637,776,861,0.4740378741600489,0.5259621258399512
E01027273,1753,844,909,0.4814603536794067,0.5185396463205932
E01027274,1574,780,794,0.49555273189326554,0.5044472681067345
E01027275,1436,718,718,0.5,0.5
E01027308,1595,771,824,0.4833855799373041,0.516614420062696
E01027263,1785,866,919,0.48515406162464986,0.5148459383753501
E01027279,1643,780,863,0.47474132684114423,0.5252586731588558
E01027284,1996,1004,992,0.503006012024048,0.4969939879759519
E01027294,1875,944,931,0.5034666666666666,0.4965333333333333
E01032982,1277,625,652,0.4894283476898982,0.5105716523101018
E01032983,1527,763,764,0.4996725605762934,0.5003274394237066
E01032984,1600,805,795,0.503125,0.496875
E01032985,1552,758,794,0.4884020618556701,0.5115979381443299
E01027262,1609,805,804,0.5003107520198882,0.4996892479801119
E01027277,1833,919,914,0.5013638843426077,0.49863611565739224
E01027289,1675,816,859,0.4871641791044776,0.5128358208955224
E01027300,1406,703,703,0.5,0.5
E01027303,1461,745,716,0.5099247091033539,0.49007529089664614
E01027297,1681,846,835,0.5032718619869125,0.49672813801308746
E01027298,1302,662,640,0.5084485407066052,0.4915514592933948
E01027299,1488,719,769,0.4831989247311828,0.5168010752688172
E01027301,2155,1072,1083,0.4974477958236659,0.5025522041763341
E01027302,1440,687,753,0.47708333333333336,0.5229166666666667
E01027291,1484,712,772,0.4797843665768194,0.5202156334231806
E01027292,1149,571,578,0.4969538729329852,0.5030461270670148
E01027293,1199,567,632,0.47289407839866554,0.5271059216013344
E01027304,1743,886,857,0.5083189902467011,0.4916810097532989
E01027305,1886,903,983,0.47879109225874866,0.5212089077412513
E01027261,2028,991,1037,0.4886587771203156,0.5113412228796844
E01027295,2176,1109,1067,0.5096507352941176,0.49034926470588236
E01027306,1716,839,877,0.48892773892773894,0.5110722610722611
E01027276,2517,1280,1237,0.5085419149781486,0.4914580850218514
E01027280,2416,1180,1236,0.48841059602649006,0.5115894039735099
E01027281,1696,842,854,0.4964622641509434,0.5035377358490566
E01027307,2042,1034,1008,0.5063663075416258,0.49363369245837413
E01027265,1481,714,767,0.48210668467251855,0.5178933153274814
E01027266,1355,673,682,0.4966789667896679,0.5033210332103321
E01027270,1656,821,835,0.49577294685990336,0.5042270531400966
E01027271,1568,774,794,0.49362244897959184,0.5063775510204082
E01027272,1581,791,790,0.5003162555344719,0.49968374446552816
E01027264,1466,714,752,0.4870395634379263,0.5129604365620737
E01027267,1183,586,597,0.49535080304311074,0.5046491969568893
E01027268,1265,647,618,0.5114624505928854,0.48853754940711464
E01027269,1463,756,707,0.5167464114832536,0.48325358851674644
E01027288,2116,1020,1096,0.4820415879017013,0.5179584120982986
E01027290,2214,1103,1111,0.498193315266486,0.501806684733514
E01027296,1998,999,999,0.5,0.5
E01027326,1485,746,739,0.5023569023569023,0.49764309764309766
E01027327,1480,742,738,0.5013513513513513,0.49864864864864866
E01027328,1344,665,679,0.4947916666666667,0.5052083333333334
E01027338,2263,1118,1145,0.49403446752098984,0.5059655324790102
E01027330,1667,795,872,0.47690461907618475,0.5230953809238152
E01027331,1392,677,715,0.4863505747126437,0.5136494252873564
E01027332,1496,723,773,0.4832887700534759,0.5167112299465241
E01027333,2342,1176,1166,0.502134927412468,0.49786507258753204
E01027334,1375,649,726,0.472,0.528
E01027343,1480,726,754,0.4905405405405405,0.5094594594594595
E01027344,1379,660,719,0.47860768672951415,0.5213923132704859
E01027345,1371,691,680,0.5040116703136397,0.4959883296863603
E01027346,1477,756,721,0.5118483412322274,0.4881516587677725
E01027347,1940,948,992,0.488659793814433,0.511340206185567
E01027313,1634,803,831,0.49143206854345167,0.5085679314565483
E01027314,1931,1006,925,0.520973588814086,0.47902641118591405
E01027315,2255,1141,1114,0.5059866962305987,0.49401330376940134
E01027316,1501,750,751,0.4996668887408394,0.5003331112591606
E01027339,1347,635,712,0.47141796585003715,0.5285820341499629
E01027340,1484,697,787,0.4696765498652291,0.5303234501347709
E01027341,1530,737,793,0.48169934640522877,0.5183006535947713
E01027342,1457,685,772,0.47014413177762526,0.5298558682223747
E01027349,1583,825,758,0.5211623499684144,0.47883765003158557
E01027350,1453,715,738,0.49208534067446663,0.5079146593255334
E01027351,1561,756,805,0.484304932735426,0.515695067264574
E01027352,1450,709,741,0.4889655172413793,0.5110344827586207
E01027309,1497,720,777,0.48096192384769537,0.5190380761523046
E01027310,1505,708,797,0.47043189368770766,0.5295681063122923
E01027311,1323,627,696,0.47392290249433106,0.5260770975056689
E01027312,1418,668,750,0.4710860366713681,0.5289139633286318
E01027317,1509,694,815,0.4599072233267064,0.5400927766732936
E01027318,1487,709,778,0.47679892400806995,0.5232010759919301
E01027319,1530,758,772,0.4954248366013072,0.5045751633986928
E01027320,2137,1173,964,0.5489003275620028,0.4510996724379972
E01027321,1576,787,789,0.4993654822335025,0.5006345177664975
E01027322,1161,572,589,0.4926787252368648,0.5073212747631353
E01027323,1482,721,761,0.4865047233468286,0.5134952766531714
E01027324,1186,580,606,0.48903878583473864,0.5109612141652614
E01027325,1558,745,813,0.4781771501925546,0.5218228498074454
E01027329,1747,877,870,0.5020034344590727,0.4979965655409273
E01027353,1731,847,884,0.48931253610629694,0.510687463893703
E01027335,1474,741,733,0.5027137042062415,0.4972862957937585
E01027336,1481,708,773,0.47805536799459825,0.5219446320054018
E01027337,1790,892,898,0.4983240223463687,0.5016759776536313
E01027348,2052,1012,1040,0.49317738791423,0.50682261208577
E01027354,2378,1173,1205,0.4932716568544996,0.5067283431455004
E01027355,1657,833,824,0.5027157513578757,0.49728424864212434
E01027979,1516,711,805,0.46899736147757254,0.5310026385224275
E01027980,1555,760,795,0.4887459807073955,0.5112540192926045
E01027981,1560,788,772,0.5051282051282051,0.4948717948717949
E01027983,1515,757,758,0.4996699669966997,0.5003300330033004
E01027970,1406,694,712,0.49359886201991465,0.5064011379800853
E01027971,1387,709,678,0.5111751982696467,0.48882480173035325
E01027982,1441,702,739,0.4871616932685635,0.5128383067314365
E01027984,1494,740,754,0.49531459170013387,0.5046854082998661
E01027966,1406,683,723,0.48577524893314367,0.5142247510668563
E01027986,1338,683,655,0.5104633781763827,0.48953662182361735
E01027987,1813,870,943,0.4798676227247656,0.5201323772752344
E01027990,1831,897,934,0.4898962315674495,0.5101037684325506
E01027967,1668,858,810,0.5143884892086331,0.4856115107913669
E01027972,2239,1083,1156,0.48369807949977667,0.5163019205002233
E01027977,1930,957,973,0.4958549222797927,0.5041450777202072
E01027978,1838,942,896,0.5125136017410229,0.48748639825897716
E01027985,1856,909,947,0.48976293103448276,0.5102370689655172
E01027964,1547,728,819,0.47058823529411764,0.5294117647058824
E01027965,1445,638,807,0.44152249134948096,0.558477508650519
E01027968,1248,587,661,0.4703525641025641,0.5296474358974359
E01027974,1670,830,840,0.49700598802395207,0.5029940119760479
E01027976,1608,778,830,0.48383084577114427,0.5161691542288557
E01027969,1405,698,707,0.496797153024911,0.503202846975089
E01027975,1663,819,844,0.4924834636199639,0.5075165363800361
E01027988,1588,775,813,0.4880352644836272,0.5119647355163728
E01027989,1598,798,800,0.49937421777221525,0.5006257822277848
E01027991,1253,643,610,0.5131683958499601,0.4868316041500399
E01027992,2220,1105,1115,0.49774774774774777,0.5022522522522522
E01027949,1559,722,837,0.46311738293778065,0.5368826170622194
E01027951,1595,767,828,0.4808777429467085,0.5191222570532915
E01027953,1496,742,754,0.4959893048128342,0.5040106951871658
E01027954,1647,825,822,0.5009107468123861,0.4990892531876138
E01027973,1715,866,849,0.5049562682215744,0.49504373177842564
E01027952,1875,941,934,0.5018666666666667,0.4981333333333333
E01027955,1265,634,631,0.5011857707509881,0.49881422924901186
E01027956,1500,707,793,0.4713333333333333,0.5286666666666666
E01027958,1432,700,732,0.4888268156424581,0.5111731843575419
E01027947,1683,813,870,0.483065953654189,0.5169340463458111
E01027948,1867,913,954,0.48901981788966253,0.5109801821103375
E01027950,1999,999,1000,0.49974987493746875,0.5002501250625313
E01027957,1263,626,637,0.49564528899445764,0.5043547110055424
E01027959,1491,756,735,0.5070422535211268,0.49295774647887325
E01027995,1574,766,808,0.4866581956797967,0.5133418043202033
E01027996,2037,1020,1017,0.5007363770250368,0.4992636229749632
E01027997,1664,824,840,0.4951923076923077,0.5048076923076923
E01027998,1834,890,944,0.48527808069792805,0.514721919302072
E01027960,1649,811,838,0.49181322013341416,0.5081867798665858
E01027961,1849,928,921,0.5018929150892374,0.49810708491076255
E01027962,1498,746,752,0.4979973297730307,0.5020026702269693
E01027963,1757,844,913,0.4803642572566875,0.5196357427433125
E01027945,1707,835,872,0.48916227299355597,0.510837727006444
E01027946,1451,717,734,0.4941419710544452,0.5058580289455548
E01027993,1526,749,777,0.4908256880733945,0.5091743119266054
E01027994,1427,686,741,0.48072880168185006,0.5192711983181499
E01027929,2416,1152,1264,0.4768211920529801,0.5231788079470199
E01027931,2015,1012,1003,0.5022332506203474,0.4977667493796526
E01027934,1379,693,686,0.5025380710659898,0.49746192893401014
E01027935,1275,629,646,0.49333333333333335,0.5066666666666667
E01027936,1485,690,795,0.46464646464646464,0.5353535353535354
E01027927,2055,992,1063,0.4827250608272506,0.5172749391727494
E01027928,1878,878,1000,0.46751863684771033,0.5324813631522897
E01027932,2164,1077,1087,0.49768946395563773,0.5023105360443623
E01027933,1479,725,754,0.49019607843137253,0.5098039215686274
E01027937,1348,648,700,0.4807121661721068,0.5192878338278932
E01027925,1862,926,936,0.49731471535982813,0.5026852846401718
E01027938,1325,666,659,0.5026415094339622,0.49735849056603776
E01027940,1329,662,667,0.49811888638073737,0.5018811136192626
E01027943,1380,662,718,0.4797101449275362,0.5202898550724637
E01027944,1531,738,793,0.48203788373612017,0.5179621162638798
E01027926,1450,715,735,0.49310344827586206,0.506896551724138
E01027930,1561,790,771,0.5060858424087123,0.49391415759128765
E01027939,1516,710,806,0.4683377308707124,0.5316622691292876
E01027941,1298,648,650,0.49922958397534667,0.5007704160246533
E01027942,1353,683,670,0.5048041389504804,0.49519586104951957
E01028000,2232,1119,1113,0.5013440860215054,0.4986559139784946
E01028024,1839,893,946,0.4855899945622621,0.5144100054377378
E01028025,1510,727,783,0.4814569536423841,0.5185430463576159
E01028026,1530,757,773,0.4947712418300654,0.5052287581699346
E01028027,1480,711,769,0.4804054054054054,0.5195945945945946
E01028028,1589,795,794,0.500314663310258,0.49968533668974197
E01027999,2285,1138,1147,0.49803063457330415,0.5019693654266958
E01028005,1892,944,948,0.4989429175475687,0.5010570824524313
E01028031,1093,555,538,0.5077767612076852,0.4922232387923147
E01028032,1374,681,693,0.49563318777292575,0.5043668122270742
E01028035,2289,1113,1176,0.48623853211009177,0.5137614678899083
E01028023,2283,1142,1141,0.5002190100744635,0.4997809899255366
E01028034,2417,1181,1236,0.4886222589987588,0.5113777410012412
E01028036,3109,2061,1048,0.6629141202959151,0.33708587970408493
E01028001,1292,600,692,0.46439628482972134,0.5356037151702786
E01028002,1422,690,732,0.48523206751054854,0.5147679324894515
E01028003,1380,673,707,0.48768115942028983,0.5123188405797101
E01028004,1529,713,816,0.46631785480706345,0.5336821451929366
E01028029,1176,581,595,0.49404761904761907,0.5059523809523809
E01028030,1296,652,644,0.5030864197530864,0.49691358024691357
E01028013,1823,847,976,0.4646187602852441,0.5353812397147559
E01028014,1512,733,779,0.48478835978835977,0.5152116402116402
E01028015,1491,755,736,0.5063715627095908,0.4936284372904091
E01028016,1336,640,696,0.47904191616766467,0.5209580838323353
E01028046,1557,758,799,0.48683365446371224,0.5131663455362877
E01028047,2209,1121,1088,0.5074694431869624,0.4925305568130376
E01028048,1663,824,839,0.4954900781719784,0.5045099218280217
E01028049,1714,830,884,0.48424737456242706,0.5157526254375729
E01028050,1907,966,941,0.5065547981122182,0.49344520188778185
E01028008,1396,619,777,0.44340974212034384,0.5565902578796562
E01028009,1399,715,684,0.5110793423874196,0.4889206576125804
E01028010,1371,685,686,0.49963530269876005,0.50036469730124
E01028011,1592,789,803,0.4956030150753769,0.5043969849246231
E01028012,1357,653,704,0.4812085482682388,0.5187914517317612
E01028022,1507,751,756,0.49834107498341074,0.5016589250165893
E01028055,1514,755,759,0.4986789960369881,0.5013210039630119
E01028056,1251,608,643,0.4860111910471623,0.5139888089528377
E01028058,1816,896,920,0.4933920704845815,0.5066079295154186
E01028059,1822,918,904,0.5038419319429198,0.4961580680570801
E01028017,1300,653,647,0.5023076923076923,0.4976923076923077
E01028018,1470,716,754,0.48707482993197276,0.5129251700680272
E01028019,1445,710,735,0.4913494809688581,0.5086505190311419
E01028020,1843,930,913,0.5046120455778622,0.49538795442213784
E01028021,1508,721,787,0.4781167108753316,0.5218832891246684
E01028057,1250,627,623,0.5016,0.4984
E01028065,1732,793,939,0.4578521939953811,0.542147806004619
E01028066,1702,855,847,0.5023501762632198,0.49764982373678024
E01028068,1807,881,926,0.48754842280022137,0.5124515771997786
E01028060,1697,840,857,0.4949911608721273,0.5050088391278728
E01028061,1487,726,761,0.488231338264963,0.511768661735037
E01028062,1937,910,1027,0.4697986577181208,0.5302013422818792
E01028067,1513,744,769,0.4917382683410443,0.5082617316589557
E01028040,1020,498,522,0.48823529411764705,0.5117647058823529
E01028041,1072,514,558,0.47947761194029853,0.5205223880597015
E01028043,1450,691,759,0.476551724137931,0.523448275862069
E01028063,1779,895,884,0.5030916245081506,0.49690837549184935
E01028064,1478,768,710,0.5196211096075778,0.4803788903924222
E01028006,1371,738,633,0.5382932166301969,0.4617067833698031
E01028007,1114,553,561,0.4964093357271095,0.5035906642728905
E01028033,2296,1250,1046,0.544425087108014,0.45557491289198604
E01028037,1661,830,831,0.4996989765201686,0.5003010234798314
E01028038,1450,708,742,0.4882758620689655,0.5117241379310344
E01028039,1163,570,593,0.4901117798796217,0.5098882201203784
E01028042,1436,726,710,0.5055710306406686,0.49442896935933145
E01028044,1526,732,794,0.4796854521625164,0.5203145478374837
E01028045,1913,925,988,0.483533716675379,0.516466283324621
E01028051,1524,689,835,0.4520997375328084,0.5479002624671916
E01028052,1664,789,875,0.47415865384615385,0.5258413461538461
E01028053,1514,719,795,0.4749009247027741,0.5250990752972259
E01028054,1487,734,753,0.49361129791526565,0.5063887020847344
E01028092,1321,630,691,0.4769114307342922,0.5230885692657078
E01028093,1006,499,507,0.4960238568588469,0.5039761431411531
E01028107,1565,808,757,0.51629392971246,0.4837060702875399
E01028108,1485,729,756,0.4909090909090909,0.509090909090909
E01028114,1515,721,794,0.4759075907590759,0.524092409240924
E01028110,1461,725,736,0.49623545516769335,0.5037645448323066
E01028111,1428,683,745,0.47829131652661067,0.5217086834733894
E01028112,1547,768,779,0.4964447317388494,0.5035552682611506
E01028113,1491,732,759,0.4909456740442656,0.5090543259557344
E01028109,1697,849,848,0.5002946375957572,0.4997053624042428
E01028115,1501,719,782,0.47901399067288475,0.5209860093271153
E01028116,1559,781,778,0.50096215522771,0.4990378447722899
E01028117,1534,786,748,0.5123859191655802,0.4876140808344198
E01028118,1639,800,839,0.4881025015253203,0.5118974984746797
E01028102,1370,666,704,0.48613138686131385,0.5138686131386861
E01028103,1147,573,574,0.4995640802092415,0.5004359197907585
E01028104,1446,709,737,0.4903181189488243,0.5096818810511756
E01028122,1584,752,832,0.47474747474747475,0.5252525252525253
E01028123,1901,926,975,0.48711204629142557,0.5128879537085744
E01028124,1528,762,766,0.4986910994764398,0.5013089005235603
E01028087,1598,794,804,0.49687108886107634,0.5031289111389237
E01028088,1472,726,746,0.49320652173913043,0.5067934782608695
E01028089,1341,675,666,0.5033557046979866,0.4966442953020134
E01028090,1382,661,721,0.47829232995658466,0.5217076700434153
E01028091,1477,732,745,0.4955991875423155,0.5044008124576845
E01028125,1632,805,827,0.49325980392156865,0.5067401960784313
E01028126,1444,689,755,0.47714681440443213,0.5228531855955678
E01028127,1696,848,848,0.5,0.5
E01028134,1466,708,758,0.4829467939972715,0.5170532060027285
E01028076,1239,610,629,0.4923325262308313,0.5076674737691687
E01028077,1456,732,724,0.5027472527472527,0.49725274725274726
E01028078,1593,802,791,0.5034526051475204,0.4965473948524796
E01028079,1365,695,670,0.5091575091575091,0.4908424908424908
E01028084,1797,880,917,0.48970506399554814,0.5102949360044519
E01028128,1742,866,876,0.4971297359357061,0.5028702640642939
E01028129,1499,711,788,0.4743162108072048,0.5256837891927952
E01028130,1757,891,866,0.5071143995446784,0.4928856004553216
E01028131,1491,742,749,0.49765258215962443,0.5023474178403756
E01028132,1057,507,550,0.4796594134342479,0.5203405865657521
E01028133,1457,718,739,0.49279341111873715,0.5072065888812629
E01028073,1528,745,783,0.487565445026178,0.512434554973822
E01028074,1610,844,766,0.5242236024844721,0.47577639751552797
E01028075,1661,849,812,0.5111378687537628,0.48886213124623723
E01028085,2025,1040,985,0.5135802469135803,0.48641975308641977
E01028086,1515,719,796,0.4745874587458746,0.5254125412541254
E01028080,1786,905,881,0.5067189249720044,0.4932810750279955
E01028081,1168,584,584,0.5,0.5
E01028082,1257,631,626,0.5019888623707239,0.49801113762927607
E01028083,1305,666,639,0.5103448275862069,0.4896551724137931
E01028097,1446,719,727,0.4972337482710927,0.5027662517289073
E01028098,1759,860,899,0.48891415577032404,0.511085844229676
E01028099,1508,802,706,0.5318302387267905,0.46816976127320953
E01028100,1683,792,891,0.47058823529411764,0.5294117647058824
E01028101,1427,670,757,0.4695164681149264,0.5304835318850736
E01028069,1183,591,592,0.4995773457311919,0.5004226542688082
E01028070,1145,564,581,0.4925764192139738,0.5074235807860262
E01028094,1772,841,931,0.47460496613995484,0.5253950338600452
E01028095,1452,734,718,0.5055096418732782,0.49449035812672176
E01028096,1817,885,932,0.4870665932856357,0.5129334067143644
E01028135,1403,673,730,0.4796863863150392,0.5203136136849608
E01028136,1714,843,871,0.4918319719953326,0.5081680280046674
E01028137,2473,1205,1268,0.4872624342903356,0.5127375657096643
E01028138,1205,569,636,0.4721991701244813,0.5278008298755187
E01028139,1443,721,722,0.49965349965349964,0.5003465003465003
E01028105,1238,606,632,0.4894991922455573,0.5105008077544426
E01028106,1458,721,737,0.4945130315500686,0.5054869684499315
E01028119,2175,1114,1061,0.512183908045977,0.487816091954023
E01028120,1589,792,797,0.4984266834487099,0.5015733165512901
E01028121,1474,739,735,0.5013568521031208,0.49864314789687925
E01033412,2378,1158,1220,0.48696383515559294,0.5130361648444071
E01033413,2204,1126,1078,0.5108892921960072,0.48911070780399274
E01028189,2300,1155,1145,0.5021739130434782,0.49782608695652175
E01028198,1397,669,728,0.47888332140300643,0.5211166785969935
E01028199,1457,704,753,0.48318462594371997,0.51681537405628
E01028200,1616,785,831,0.48576732673267325,0.5142326732673267
E01028201,1159,579,580,0.4995685936151855,0.5004314063848145
E01028150,1355,643,712,0.4745387453874539,0.5254612546125461
E01028151,1166,556,610,0.47684391080617494,0.5231560891938251
E01028152,1538,729,809,0.4739921976592978,0.5260078023407022
E01028153,1295,604,691,0.4664092664092664,0.5335907335907336
E01028154,1722,840,882,0.4878048780487805,0.5121951219512195
E01028213,1872,968,904,0.5170940170940171,0.4829059829059829
E01028143,1293,624,669,0.48259860788863107,0.5174013921113689
E01028205,1266,615,651,0.48578199052132703,0.514218009478673
E01028206,1462,716,746,0.4897400820793434,0.5102599179206566
E01028207,1320,617,703,0.4674242424242424,0.5325757575757576
E01028208,1110,528,582,0.4756756756756757,0.5243243243243243
E01028173,1033,449,584,0.4346563407550823,0.5653436592449177
E01028174,1562,749,813,0.4795134443021767,0.5204865556978233
E01028175,1798,864,934,0.48053392658509453,0.5194660734149055
E01028209,1444,688,756,0.47645429362880887,0.5235457063711911
E01028144,1579,728,851,0.461051298290057,0.538948701709943
E01028165,1473,706,767,0.4792939579090292,0.5207060420909708
E01028166,1705,834,871,0.48914956011730204,0.510850439882698
E01028167,1836,917,919,0.49945533769063183,0.5005446623093682
E01028179,1451,700,751,0.4824259131633356,0.5175740868366644
E01028180,1474,719,755,0.48778833107191316,0.5122116689280869
E01028181,1362,640,722,0.4698972099853157,0.5301027900146843
E01028182,1593,797,796,0.5003138731952291,0.49968612680477087
E01028183,1252,587,665,0.46884984025559107,0.5311501597444089
E01028148,1990,968,1022,0.4864321608040201,0.5135678391959799
E01028149,1623,776,847,0.47812692544670365,0.5218730745532963
E01028178,2164,1058,1106,0.488909426987061,0.511090573012939
E01028176,1542,751,791,0.48702983138780803,0.5129701686121919
E01028177,1552,722,830,0.4652061855670103,0.5347938144329897
E01028214,1464,723,741,0.49385245901639346,0.5061475409836066
E01028215,1347,660,687,0.48997772828507796,0.5100222717149221
E01028216,1290,632,658,0.48992248062015503,0.5100775193798449
E01028217,1337,649,688,0.48541510845175767,0.5145848915482424
E01028218,1502,745,757,0.4960053262316911,0.503994673768309
E01028193,1354,645,709,0.47636632200886264,0.5236336779911374
E01028194,1488,733,755,0.49260752688172044,0.5073924731182796
E01028195,1396,678,718,0.48567335243553006,0.5143266475644699
E01028196,1428,705,723,0.49369747899159666,0.5063025210084033
E01028197,1379,703,676,0.5097897026831038,0.4902102973168963
E01028204,1339,675,664,0.5041075429424944,0.4958924570575056
E01028172,1142,557,585,0.48774080560420313,0.5122591943957968
E01028190,1594,777,817,0.4874529485570891,0.5125470514429109
E01028202,1456,711,745,0.4883241758241758,0.5116758241758241
E01028203,1391,686,705,0.4931703810208483,0.5068296189791517
E01028212,1626,781,845,0.48031980319803197,0.519680196801968
E01028168,1321,649,672,0.4912944738834216,0.5087055261165784
E01028169,1456,698,758,0.4793956043956044,0.5206043956043956
E01028170,1438,700,738,0.48678720445062584,0.5132127955493742
E01028171,1460,702,758,0.4808219178082192,0.5191780821917809
E01028191,1824,929,895,0.5093201754385965,0.4906798245614035
E01028192,1556,779,777,0.5006426735218509,0.4993573264781491
E01028160,1519,746,773,0.4911125740618828,0.5088874259381172
E01028161,1496,724,772,0.4839572192513369,0.516042780748663
E01028162,1496,754,742,0.5040106951871658,0.4959893048128342
E01028163,1482,764,718,0.5155195681511471,0.4844804318488529
E01028211,1372,692,680,0.5043731778425656,0.4956268221574344
E01028155,1414,715,699,0.5056577086280056,0.49434229137199437
E01028156,1308,682,626,0.5214067278287462,0.4785932721712538
E01028157,1299,662,637,0.5096227867590454,0.49037721324095457
E01028158,1559,769,790,0.4932649134060295,0.5067350865939705
E01028159,1301,612,689,0.4704073789392775,0.5295926210607225
E01028164,1285,639,646,0.4972762645914397,0.5027237354085603
E01028210,1382,650,732,0.4703328509406657,0.5296671490593343
E01028184,1166,570,596,0.4888507718696398,0.5111492281303602
E01028185,1852,892,960,0.4816414686825054,0.5183585313174947
E01028186,1515,756,759,0.499009900990099,0.500990099009901
E01028187,1420,671,749,0.4725352112676056,0.5274647887323943
E01028188,1445,706,739,0.4885813148788927,0.5114186851211072
E01028142,1969,956,1013,0.4855256475368207,0.5144743524631793
E01028146,1503,738,765,0.49101796407185627,0.5089820359281437
E01028147,1057,479,578,0.4531693472090823,0.5468306527909177
E01032622,1354,669,685,0.49409158050221563,0.5059084194977843
E01028224,1466,710,756,0.4843110504774898,0.5156889495225102
E01028257,1625,799,826,0.4916923076923077,0.5083076923076923
E01028258,1651,825,826,0.4996971532404603,0.5003028467595396
E01028259,1495,737,758,0.49297658862876254,0.5070234113712374
E01028223,1035,507,528,0.48985507246376814,0.5101449275362319
E01028225,1581,775,806,0.49019607843137253,0.5098039215686274
E01028226,1484,700,784,0.4716981132075472,0.5283018867924528
E01028260,1662,826,836,0.4969915764139591,0.5030084235860409
E01028251,1645,828,817,0.5033434650455927,0.4966565349544073
E01028252,1944,950,994,0.4886831275720165,0.5113168724279835
E01028253,1684,828,856,0.4916864608076009,0.5083135391923991
E01028277,1207,593,614,0.49130074565037285,0.5086992543496272
E01028278,1411,694,717,0.49184975194897235,0.5081502480510276
E01028271,1669,852,817,0.5104853205512283,0.4895146794487717
E01028279,1382,684,698,0.49493487698986977,0.5050651230101303
E01028280,1340,664,676,0.4955223880597015,0.5044776119402985
E01028281,1474,695,779,0.47150610583446406,0.5284938941655359
E01028283,1853,926,927,0.4997301672962763,0.5002698327037237
E01028242,1504,775,729,0.5152925531914894,0.48470744680851063
E01028250,1471,716,755,0.486743711760707,0.513256288239293
E01028272,1666,811,855,0.48679471788715484,0.5132052821128451
E01028273,1483,731,752,0.49291975724882,0.50708024275118
E01028229,1442,704,738,0.4882108183079057,0.5117891816920943
E01028232,1513,738,775,0.48777263714474556,0.5122273628552545
E01028267,1947,944,1003,0.48484848484848486,0.5151515151515151
E01028282,1140,526,614,0.4614035087719298,0.5385964912280702
E01033392,2240,1099,1141,0.490625,0.509375
E01028237,1561,754,807,0.48302370275464446,0.5169762972453555
E01028238,1584,789,795,0.4981060606060606,0.5018939393939394
E01028239,1598,759,839,0.47496871088861076,0.5250312891113892
E01028240,1479,740,739,0.5003380662609872,0.49966193373901285
E01028241,2283,1097,1186,0.4805081033727551,0.5194918966272448
E01028243,1843,863,980,0.4682582745523603,0.5317417254476398
E01028227,1365,654,711,0.47912087912087914,0.5208791208791209
E01028228,1189,572,617,0.48107653490328006,0.5189234650967199
E01028247,1683,882,801,0.5240641711229946,0.47593582887700536
E01028268,1758,926,832,0.5267349260523322,0.4732650739476678
E01028269,1451,720,731,0.4962095106822881,0.503790489317712
E01028284,1664,827,837,0.4969951923076923,0.5030048076923077
E01028233,1883,917,966,0.48698884758364314,0.5130111524163569
E01028234,1726,796,930,0.46118192352259557,0.5388180764774044
E01028274,1400,731,669,0.5221428571428571,0.47785714285714287
E01028275,1604,782,822,0.48753117206982544,0.5124688279301746
E01028276,1558,783,775,0.5025673940949936,0.49743260590500643
E01028230,1432,705,727,0.49231843575418993,0.50768156424581
E01028231,1430,644,786,0.45034965034965035,0.5496503496503496
E01028244,1486,735,751,0.4946164199192463,0.5053835800807537
E01028245,1312,635,677,0.4839939024390244,0.5160060975609756
E01028246,1684,848,836,0.503562945368171,0.49643705463182897
E01028248,1476,710,766,0.481029810298103,0.518970189701897
E01028249,1354,651,703,0.4807976366322009,0.5192023633677991
E01028235,1572,789,783,0.5019083969465649,0.49809160305343514
E01028236,1724,857,867,0.4970997679814385,0.5029002320185615
E01028262,1496,746,750,0.49866310160427807,0.5013368983957219
E01028264,1911,942,969,0.49293563579277866,0.5070643642072213
E01028254,1378,686,692,0.49782293178519593,0.502177068214804
E01028256,1606,828,778,0.5155666251556662,0.48443337484433374
E01028261,1732,852,880,0.49191685912240185,0.5080831408775982
E01028263,1607,783,824,0.48724331051649034,0.5127566894835096
E01028219,1389,667,722,0.48020158387329015,0.5197984161267099
E01028220,1791,912,879,0.509212730318258,0.490787269681742
E01028222,1562,738,824,0.47247119078104993,0.5275288092189501
E01028255,1316,643,673,0.4886018237082067,0.5113981762917933
E01028270,1509,721,788,0.4777998674618953,0.5222001325381047
E01033389,1329,642,687,0.48306997742663654,0.5169300225733634
E01033390,1548,764,784,0.4935400516795866,0.5064599483204134
E01033391,1179,581,598,0.49279050042408823,0.5072094995759118
E01028301,1928,963,965,0.4994813278008299,0.5005186721991701
E01028302,1583,777,806,0.490840176879343,0.509159823120657
E01028338,1599,751,848,0.46966854283927456,0.5303314571607255
E01028339,1795,896,899,0.4991643454038997,0.5008356545961002
E01028340,1501,723,778,0.4816788807461692,0.5183211192538307
E01028341,1617,810,807,0.5009276437847866,0.49907235621521334
E01028313,1991,948,1043,0.47614264188849825,0.5238573581115018
E01028314,2674,1307,1367,0.4887808526551982,0.5112191473448018
E01028321,1574,759,815,0.4822109275730623,0.5177890724269377
E01028322,1964,955,1009,0.4862525458248472,0.5137474541751528
E01028323,1650,817,833,0.4951515151515152,0.5048484848484849
E01028303,1527,775,752,0.5075311067452521,0.49246889325474785
E01028312,2255,1114,1141,0.49401330376940134,0.5059866962305987
E01028337,1529,747,782,0.48855461085676916,0.5114453891432309
E01028349,1504,729,775,0.48470744680851063,0.5152925531914894
E01028350,1171,581,590,0.4961571306575576,0.5038428693424424
E01028315,1448,714,734,0.4930939226519337,0.5069060773480663
E01028316,1484,715,769,0.48180592991913745,0.5181940700808625
E01028317,1639,830,809,0.5064063453325198,0.4935936546674802
E01028353,2771,1353,1418,0.4882713821725009,0.5117286178274991
E01028295,2005,1024,981,0.5107231920199501,0.48927680798004985
E01028297,1934,959,975,0.49586349534643226,0.5041365046535677
E01028327,1599,792,807,0.49530956848030017,0.5046904315196998
E01028328,1700,828,872,0.48705882352941177,0.5129411764705882
E01028329,1688,820,868,0.48578199052132703,0.514218009478673
E01028296,1330,681,649,0.51203007518797,0.48796992481203005
E01028298,1598,769,829,0.4812265331664581,0.518773466833542
E01028299,1281,650,631,0.507416081186573,0.492583918813427
E01028300,1578,759,819,0.48098859315589354,0.5190114068441065
E01028342,1508,729,779,0.48342175066313,0.51657824933687
E01028343,2057,976,1081,0.4744773942634905,0.5255226057365094
E01028344,1420,698,722,0.4915492957746479,0.5084507042253521
E01028294,1731,861,870,0.49740034662045063,0.5025996533795494
E01028304,1466,753,713,0.5136425648021828,0.4863574351978172
E01028305,1374,671,703,0.4883551673944687,0.5116448326055313
E01028306,1614,807,807,0.5,0.5
E01028307,1264,627,637,0.49604430379746833,0.5039556962025317
E01028310,1683,883,800,0.5246583481877599,0.47534165181224003
E01028311,1515,763,752,0.5036303630363036,0.49636963696369635
E01028345,2153,988,1165,0.458894565722248,0.5411054342777519
E01028346,2133,1036,1097,0.4857008907641819,0.5142991092358181
E01028347,1534,748,786,0.4876140808344198,0.5123859191655802
E01028348,1477,646,831,0.43737305348679756,0.5626269465132024
E01028292,2324,1131,1193,0.4866609294320138,0.5133390705679862
E01028293,1906,926,980,0.4858342077649528,0.5141657922350472
E01028333,1344,644,700,0.4791666666666667,0.5208333333333334
E01028334,1583,764,819,0.4826279216677195,0.5173720783322805
E01028335,1715,855,860,0.49854227405247814,0.5014577259475219
E01028308,1608,758,850,0.47139303482587064,0.5286069651741293
E01028309,1402,715,687,0.5099857346647646,0.4900142653352354
E01028318,1568,737,831,0.4700255102040816,0.5299744897959183
E01028319,1919,902,1017,0.4700364773319437,0.5299635226680562
E01028320,1684,783,901,0.4649643705463183,0.5350356294536817
E01028285,1226,597,629,0.48694942903752036,0.5130505709624796
E01028286,1250,619,631,0.4952,0.5048
E01028287,1450,688,762,0.47448275862068967,0.5255172413793103
E01028288,1501,712,789,0.4743504330446369,0.5256495669553631
E01028289,1326,672,654,0.5067873303167421,0.49321266968325794
E01028290,1455,698,757,0.47972508591065294,0.5202749140893471
E01028291,1549,749,800,0.4835377663008393,0.5164622336991608
E01028325,1205,603,602,0.5004149377593361,0.4995850622406639
E01028326,1274,626,648,0.4913657770800628,0.5086342229199372
E01028336,1122,552,570,0.4919786096256685,0.5080213903743316
E01028352,1214,599,615,0.49341021416803954,0.5065897858319605
E01033393,2190,1112,1078,0.5077625570776255,0.4922374429223744
E01033394,1278,598,680,0.4679186228482003,0.5320813771517997
E01028330,1630,789,841,0.4840490797546012,0.5159509202453988
E01028331,2251,1527,724,0.6783651710350955,0.3216348289649045
E01028332,1733,855,878,0.4933641084824005,0.5066358915175996
E01028351,1264,613,651,0.4849683544303797,0.5150316455696202
E01028371,2768,1764,1004,0.6372832369942196,0.3627167630057804
E01028403,2190,1042,1148,0.4757990867579909,0.5242009132420091
E01028411,2077,1043,1034,0.502166586422725,0.4978334135772749
E01028357,1488,737,751,0.4952956989247312,0.5047043010752689
E01028358,1329,633,696,0.4762979683972912,0.5237020316027088
E01028359,1696,812,884,0.47877358490566035,0.5212264150943396
E01028360,1799,880,919,0.48916064480266813,0.5108393551973318
E01028361,1404,672,732,0.47863247863247865,0.5213675213675214
E01028362,1415,684,731,0.4833922261484099,0.5166077738515901
E01028393,1137,553,584,0.48636763412489004,0.51363236587511
E01028394,1491,681,810,0.4567404426559356,0.5432595573440644
E01028395,1440,719,721,0.49930555555555556,0.5006944444444444
E01028413,1669,773,896,0.463151587777112,0.5368484122228879
E01028414,1582,763,819,0.4823008849557522,0.5176991150442478
E01028415,1559,780,779,0.5003207184092366,0.4996792815907633
E01028354,1555,783,772,0.5035369774919615,0.4964630225080386
E01028355,1516,739,777,0.487467018469657,0.512532981530343
E01028384,1728,867,861,0.5017361111111112,0.4982638888888889
E01028385,1751,890,861,0.508280982295831,0.49171901770416904
E01028386,1642,841,801,0.5121802679658952,0.4878197320341047
E01028396,1537,744,793,0.4840598568640208,0.5159401431359791
E01028398,1440,694,746,0.48194444444444445,0.5180555555555556
E01028399,1378,681,697,0.4941944847605225,0.5058055152394775
E01028416,1565,832,733,0.531629392971246,0.468370607028754
E01028417,1565,807,758,0.5156549520766773,0.48434504792332267
E01028418,1506,768,738,0.5099601593625498,0.4900398406374502
E01028356,1493,714,779,0.478231748158071,0.521768251841929
E01028375,1798,874,924,0.4860956618464961,0.5139043381535039
E01028376,1584,779,805,0.4917929292929293,0.5082070707070707
E01028377,1955,961,994,0.49156010230179026,0.5084398976982097
E01028397,1743,850,893,0.4876649454962708,0.5123350545037292
E01028363,1489,757,732,0.5083948959032908,0.4916051040967092
E01028364,1787,867,920,0.485170677112479,0.514829322887521
E01028365,1658,842,816,0.5078407720144753,0.49215922798552475
E01028391,1965,948,1017,0.48244274809160304,0.517557251908397
E01028392,1947,869,1078,0.4463276836158192,0.5536723163841808
E01028372,1188,574,614,0.4831649831649832,0.5168350168350169
E01028373,1404,697,707,0.4964387464387464,0.5035612535612536
E01028374,1316,603,713,0.4582066869300912,0.5417933130699089
E01028400,1612,823,789,0.510545905707196,0.48945409429280395
E01028401,1308,655,653,0.5007645259938838,0.49923547400611623
E01028366,1327,635,692,0.47852298417483047,0.5214770158251696
E01028367,1474,709,765,0.48100407055630934,0.5189959294436907
E01028368,1491,743,748,0.4983232729711603,0.5016767270288397
E01028369,1467,707,760,0.48193592365371507,0.5180640763462849
E01028370,1444,708,736,0.4903047091412742,0.5096952908587258
E01028402,1888,950,938,0.503177966101695,0.4968220338983051
E01028419,2438,1219,1219,0.5,0.5
E01028420,1379,674,705,0.4887599709934735,0.5112400290065264
E01028404,1598,758,840,0.47434292866082606,0.5256570713391739
E01028405,1943,923,1020,0.4750386001029336,0.5249613998970664
E01028406,1650,820,830,0.49696969696969695,0.503030303030303
E01028407,2025,994,1031,0.4908641975308642,0.5091358024691358
E01028379,1637,824,813,0.5033598045204642,0.49664019547953575
E01028412,1883,944,939,0.501327668613914,0.498672331386086
E01028421,2221,1097,1124,0.49392165691130124,0.5060783430886988
E01028380,1238,602,636,0.4862681744749596,0.5137318255250404
E01028381,1342,648,694,0.4828614008941878,0.5171385991058122
E01028382,1435,690,745,0.4808362369337979,0.519163763066202
E01028383,1081,511,570,0.4727104532839963,0.5272895467160037
E01028378,1994,971,1023,0.48696088264794385,0.5130391173520562
E01028387,1746,845,901,0.48396334478808706,0.516036655211913
E01028408,2639,1213,1426,0.4596438044713907,0.5403561955286094
E01028388,1677,833,844,0.49672033392963627,0.5032796660703638
E01028389,1447,676,771,0.4671734623358673,0.5328265376641327
E01028390,1610,766,844,0.47577639751552797,0.5242236024844721
E01028409,1301,626,675,0.4811683320522675,0.5188316679477325
E01028410,1280,622,658,0.4859375,0.5140625
E01013998,1329,647,682,0.48683220466516175,0.5131677953348383
E01014051,1715,848,867,0.4944606413994169,0.5055393586005831
E01014052,1496,754,742,0.5040106951871658,0.4959893048128342
E01014096,1503,737,766,0.490352628077179,0.5096473719228211
E01014041,1515,728,787,0.48052805280528055,0.5194719471947195
E01014042,1662,808,854,0.4861612515042118,0.5138387484957883
E01014043,1125,535,590,0.47555555555555556,0.5244444444444445
E01014044,1473,721,752,0.4894772572980312,0.5105227427019687
E01014045,1571,768,803,0.48886059834500317,0.5111394016549968
E01014046,1450,722,728,0.4979310344827586,0.5020689655172413
E01014047,1439,695,744,0.4829742876997915,0.5170257123002084
E01014048,1456,718,738,0.49313186813186816,0.5068681318681318
E01013999,1488,743,745,0.4993279569892473,0.5006720430107527
E01014017,1475,720,755,0.488135593220339,0.511864406779661
E01014024,1286,631,655,0.4906687402799378,0.5093312597200622
E01014025,1410,689,721,0.48865248226950353,0.5113475177304965
E01014055,1583,802,781,0.5066329753632344,0.4933670246367656
E01014097,1315,650,665,0.49429657794676807,0.5057034220532319
E01014000,1396,705,691,0.5050143266475645,0.49498567335243554
E01014001,1434,718,716,0.500697350069735,0.499302649930265
E01014002,1397,644,753,0.4609878310665712,0.5390121689334287
E01014003,1512,770,742,0.5092592592592593,0.49074074074074076
E01014004,1419,701,718,0.4940098661028894,0.5059901338971107
E01014005,1552,777,775,0.5006443298969072,0.4993556701030928
E01014015,1639,800,839,0.4881025015253203,0.5118974984746797
E01014008,1596,802,794,0.5025062656641605,0.4974937343358396
E01014009,1498,745,753,0.49732977303070763,0.5026702269692924
E01014033,1729,826,903,0.4777327935222672,0.5222672064777328
E01014034,1511,708,803,0.4685638649900728,0.5314361350099271
E01014056,1541,770,771,0.49967553536664505,0.500324464633355
E01014006,1579,786,793,0.49778340721975933,0.5022165927802407
E01014012,1676,811,865,0.48389021479713606,0.516109785202864
E01014013,1936,991,945,0.5118801652892562,0.4881198347107438
E01014016,1510,714,796,0.4728476821192053,0.5271523178807948
E01014100,1547,758,789,0.48998060762766643,0.5100193923723335
E01014101,1075,533,542,0.4958139534883721,0.5041860465116279
E01014022,2051,1046,1005,0.5099951243295954,0.4900048756704047
E01014023,1760,889,871,0.5051136363636364,0.4948863636363636
E01014081,1441,717,724,0.49757113115891743,0.5024288688410826
E01014082,1892,946,946,0.5,0.5
E01014027,1253,620,633,0.4948124501197127,0.5051875498802874
E01014028,1445,704,741,0.48719723183391006,0.5128027681660899
E01014029,1514,703,811,0.46433289299867897,0.535667107001321
E01014030,1388,689,699,0.49639769452449567,0.5036023054755043
E01014083,1606,786,820,0.48941469489414696,0.5105853051058531
E01014084,1542,756,786,0.490272373540856,0.5097276264591439
E01014085,1420,715,705,0.5035211267605634,0.4964788732394366
E01014087,1471,778,693,0.5288919102651257,0.4711080897348742
E01014088,1414,701,713,0.4957567185289958,0.5042432814710043
E01014089,1476,696,780,0.4715447154471545,0.5284552845528455
E01013987,1627,789,838,0.4849416103257529,0.5150583896742471
E01013988,1864,893,971,0.4790772532188841,0.5209227467811158
E01014007,1730,839,891,0.48497109826589596,0.5150289017341041
E01014095,1494,703,791,0.4705488621151272,0.5294511378848729
E01013986,1702,841,861,0.49412455934195065,0.5058754406580493
E01013989,1566,793,773,0.5063856960408685,0.49361430395913153
E01014010,1626,905,721,0.5565805658056581,0.44341943419434193
E01014011,1513,733,780,0.48446794448116326,0.5155320555188367
E01014086,1448,729,719,0.5034530386740331,0.4965469613259669
E01014092,1808,904,904,0.5,0.5
E01014075,1703,829,874,0.4867880211391662,0.5132119788608338
E01014076,2181,1095,1086,0.5020632737276479,0.49793672627235214
E01014077,1555,770,785,0.49517684887459806,0.5048231511254019
E01014078,1461,744,717,0.5092402464065708,0.49075975359342916
E01014090,1499,727,772,0.4849899933288859,0.5150100066711141
E01014091,1498,720,778,0.48064085447263016,0.5193591455273698
E01014093,1441,667,774,0.4628730048577377,0.5371269951422624
E01014094,1525,738,787,0.4839344262295082,0.5160655737704918
E01014068,1472,728,744,0.4945652173913043,0.5054347826086957
E01014070,2247,1111,1136,0.49443702714730753,0.5055629728526925
E01014072,2061,1018,1043,0.49393498301795247,0.5060650169820475
E01014073,1938,951,987,0.4907120743034056,0.5092879256965944
E01014074,1594,813,781,0.5100376411543287,0.48996235884567124
E01013996,1545,768,777,0.4970873786407767,0.5029126213592233
E01013997,1983,1014,969,0.5113464447806354,0.4886535552193646
E01014079,1614,787,827,0.4876084262701363,0.5123915737298637
E01014080,1382,690,692,0.4992764109985528,0.5007235890014472
E01013992,1434,733,701,0.5111576011157601,0.4888423988842399
E01013993,1598,757,841,0.4737171464330413,0.5262828535669587
E01013994,1568,724,844,0.461734693877551,0.5382653061224489
E01013995,1709,812,897,0.4751316559391457,0.5248683440608543
E01014071,1448,717,731,0.4951657458563536,0.5048342541436464
E01013990,1750,831,919,0.47485714285714287,0.5251428571428571
E01013991,1332,654,678,0.49099099099099097,0.509009009009009
E01014014,1811,929,882,0.5129762562120376,0.4870237437879624
E01014054,1354,684,670,0.5051698670605613,0.4948301329394387
E01014035,1741,840,901,0.48248133256748993,0.5175186674325101
E01014036,1573,746,827,0.47425301970756517,0.5257469802924348
E01014037,1467,667,800,0.4546693933197001,0.5453306066803
E01014038,1465,729,736,0.4976109215017065,0.5023890784982935
E01014039,1791,873,918,0.48743718592964824,0.5125628140703518
E01014040,1599,789,810,0.49343339587242024,0.5065666041275797
E01014018,1497,730,767,0.4876419505678023,0.5123580494321978
E01014019,1560,776,784,0.49743589743589745,0.5025641025641026
E01014020,1568,800,768,0.5102040816326531,0.4897959183673469
E01014021,1448,705,743,0.48687845303867405,0.513121546961326
E01014026,2116,1082,1034,0.5113421550094518,0.4886578449905482
E01014059,2008,1005,1003,0.5004980079681275,0.4995019920318725
E01014060,1597,779,818,0.48778960551033185,0.5122103944896681
E01014069,1859,913,946,0.4911242603550296,0.5088757396449705
E01014098,1569,780,789,0.497131931166348,0.502868068833652
E01014099,1803,900,903,0.49916805324459235,0.5008319467554077
E01014061,1548,720,828,0.46511627906976744,0.5348837209302325
E01014062,1622,773,849,0.47657213316892727,0.5234278668310728
E01014063,1777,829,948,0.4665166010129432,0.5334833989870569
E01014064,1600,815,785,0.509375,0.490625
E01014065,1464,707,757,0.48292349726775957,0.5170765027322405
E01014066,1123,527,596,0.4692787177203918,0.5307212822796082
E01014067,1448,697,751,0.481353591160221,0.518646408839779
E01014031,1567,746,821,0.47606892150606256,0.5239310784939375
E01014032,1638,843,795,0.5146520146520146,0.48534798534798534
E01014049,1598,757,841,0.4737171464330413,0.5262828535669587
E01014050,1759,879,880,0.49971574758385445,0.5002842524161455
E01014053,1790,894,896,0.4994413407821229,0.5005586592178771
E01014057,1701,848,853,0.4985302763080541,0.5014697236919459
E01014058,1589,792,797,0.4984266834487099,0.5015733165512901
E01028853,1503,739,764,0.4916833000665336,0.5083166999334664
E01028854,1519,743,776,0.489137590520079,0.510862409479921
E01028855,1511,749,762,0.4956982131039047,0.5043017868960953
E01028856,1241,623,618,0.5020145044319098,0.49798549556809024
E01028857,1724,857,867,0.4970997679814385,0.5029002320185615
E01028826,1655,811,844,0.4900302114803625,0.5099697885196375
E01028827,1537,721,816,0.4690956408588159,0.5309043591411842
E01028844,1993,1315,678,0.6598093326643252,0.3401906673356749
E01028845,1939,936,1003,0.48272305312016506,0.5172769468798349
E01028838,1440,703,737,0.48819444444444443,0.5118055555555555
E01028839,1323,661,662,0.4996220710506425,0.5003779289493575
E01028840,1304,639,665,0.49003067484662577,0.5099693251533742
E01028841,1542,753,789,0.4883268482490272,0.5116731517509727
E01028850,2233,1115,1118,0.4993282579489476,0.5006717420510524
E01028851,1654,777,877,0.469770253929867,0.530229746070133
E01028852,1654,787,867,0.4758162031438936,0.5241837968561064
E01028830,1457,725,732,0.49759780370624573,0.5024021962937543
E01028831,1531,732,799,0.47811887655127366,0.5218811234487263
E01028836,1485,735,750,0.494949494949495,0.5050505050505051
E01028837,1468,729,739,0.49659400544959126,0.5034059945504087
E01028832,1643,812,831,0.49421789409616557,0.5057821059038344
E01028833,1473,690,783,0.4684317718940937,0.5315682281059063
E01028834,1561,774,787,0.49583600256245997,0.50416399743754
E01028835,1461,730,731,0.4996577686516085,0.5003422313483915
E01028828,1686,851,835,0.5047449584816133,0.49525504151838673
E01028829,1311,649,662,0.4950419527078566,0.5049580472921434
E01028842,1620,795,825,0.49074074074074076,0.5092592592592593
E01028847,1469,739,730,0.5030633083730429,0.49693669162695714
E01028859,1657,811,846,0.4894387447193724,0.5105612552806277
E01028843,1732,855,877,0.49364896073903003,0.50635103926097
E01028846,1751,902,849,0.5151342090234152,0.48486579097658483
E01028848,1644,808,836,0.49148418491484186,0.5085158150851582
E01028849,1961,958,1003,0.4885262621111678,0.5114737378888322
E01028858,2123,1095,1028,0.5157795572303344,0.4842204427696656
E01028891,1701,851,850,0.5002939447383892,0.4997060552616108
E01028892,1397,687,710,0.4917680744452398,0.5082319255547602
E01028894,1534,767,767,0.5,0.5
E01028895,1707,851,856,0.4985354422964265,0.5014645577035736
E01028896,2072,1021,1051,0.49276061776061775,0.5072393822393823
E01028897,1460,693,767,0.47465753424657536,0.5253424657534247
E01028880,1633,807,826,0.4941824862216779,0.5058175137783221
E01028881,1262,625,637,0.49524564183835185,0.5047543581616482
E01028882,1554,784,770,0.5045045045045045,0.4954954954954955
E01028893,1533,761,772,0.4964122635355512,0.5035877364644488
E01028899,1521,758,763,0.4983563445101907,0.5016436554898094
E01028864,1477,727,750,0.4922139471902505,0.5077860528097495
E01028865,1726,833,893,0.48261877172653533,0.5173812282734647
E01028866,1333,648,685,0.48612153038259565,0.5138784696174044
E01028867,1297,625,672,0.4818812644564379,0.518118735543562
E01028872,1630,860,770,0.5276073619631901,0.4723926380368098
E01028873,1793,887,906,0.4947016174010039,0.5052983825989961
E01028874,1326,619,707,0.46681749622926094,0.5331825037707391
E01028875,2501,1216,1285,0.48620551779288285,0.5137944822071171
E01028876,1733,840,893,0.4847085978072706,0.5152914021927294
E01028877,1298,628,670,0.48382126348228044,0.5161787365177196
E01028878,1565,775,790,0.4952076677316294,0.5047923322683706
E01028879,1557,785,772,0.50417469492614,0.49582530507385997
E01028886,1688,809,879,0.4792654028436019,0.5207345971563981
E01028887,1380,629,751,0.4557971014492754,0.5442028985507247
E01028889,1401,658,743,0.4696645253390435,0.5303354746609564
E01028890,1401,709,692,0.5060670949321913,0.4939329050678087
E01028868,1563,762,801,0.4875239923224568,0.5124760076775432
E01028869,1445,752,693,0.5204152249134948,0.4795847750865052
E01028871,1210,604,606,0.4991735537190083,0.5008264462809917
E01028885,2890,1804,1086,0.6242214532871972,0.37577854671280275
E01028860,1887,928,959,0.4917859035506094,0.5082140964493905
E01028862,1587,784,803,0.49401386263390046,0.5059861373660995
E01028863,1403,716,687,0.5103349964362082,0.4896650035637919
E01028888,1641,818,823,0.4984765386959171,0.5015234613040829
E01028898,1424,708,716,0.49719101123595505,0.5028089887640449
E01028861,1238,629,609,0.5080775444264943,0.49192245557350567
E01028870,1561,774,787,0.49583600256245997,0.50416399743754
E01028883,1652,932,720,0.5641646489104116,0.4358353510895884
E01028884,1522,733,789,0.4816031537450723,0.5183968462549278
E01028910,1542,790,752,0.5123216601815823,0.4876783398184176
E01028911,1295,643,652,0.4965250965250965,0.5034749034749034
E01028912,1179,554,625,0.46988973706530957,0.5301102629346904
E01028920,1279,622,657,0.48631743549648165,0.5136825645035183
E01028921,1577,789,788,0.5003170577045022,0.49968294229549776
E01028925,1465,628,837,0.4286689419795222,0.5713310580204778
E01028926,1385,676,709,0.488086642599278,0.511913357400722
E01028902,1097,523,574,0.47675478577939834,0.5232452142206017
E01028903,1271,577,694,0.45397324940991346,0.5460267505900865
E01028904,1486,715,771,0.48115746971736206,0.5188425302826379
E01028905,1749,831,918,0.4751286449399657,0.5248713550600344
E01028909,1427,684,743,0.4793272599859846,0.5206727400140154
E01033528,2545,1219,1326,0.47897838899803535,0.5210216110019646
E01028906,1243,651,592,0.5237329042638778,0.4762670957361223
E01028907,1733,795,938,0.45874206578188115,0.5412579342181189
E01028908,1499,770,729,0.513675783855904,0.48632421614409604
E01028916,1544,725,819,0.469559585492228,0.530440414507772
E01028917,1511,786,725,0.5201853077432164,0.4798146922567836
E01028924,1638,821,817,0.5012210012210012,0.4987789987789988
E01028913,1546,761,785,0.4922380336351876,0.5077619663648124
E01028918,1475,712,763,0.48271186440677966,0.5172881355932203
E01028919,1379,711,668,0.5155910079767948,0.4844089920232052
E01028927,1056,528,528,0.5,0.5
E01028928,1536,750,786,0.48828125,0.51171875
E01028914,1079,551,528,0.5106580166821131,0.4893419833178869
E01028915,1363,662,701,0.4856933235509905,0.5143066764490095
E01028922,1287,650,637,0.5050505050505051,0.494949494949495
E01028923,1579,779,800,0.493350221659278,0.506649778340722
E01028929,1464,722,742,0.4931693989071038,0.5068306010928961
E01028969,1482,695,787,0.4689608636977058,0.5310391363022942
E01028970,1336,637,699,0.47679640718562877,0.5232035928143712
E01028971,2118,1044,1074,0.49291784702549574,0.5070821529745042
E01028978,1539,751,788,0.48797920727745286,0.5120207927225471
E01028979,1235,618,617,0.5004048582995951,0.49959514170040487
E01028933,1611,774,837,0.48044692737430167,0.5195530726256983
E01028934,1615,786,829,0.486687306501548,0.513312693498452
E01028956,1538,757,781,0.49219765929778936,0.5078023407022106
E01028957,1637,817,820,0.499083689676237,0.5009163103237629
E01028958,1839,894,945,0.48613376835236544,0.5138662316476346
E01028932,1898,962,936,0.5068493150684932,0.4931506849315068
E01028981,1621,799,822,0.49290561381863046,0.5070943861813695
E01028982,1612,791,821,0.49069478908188585,0.5093052109181141
E01028983,2011,999,1012,0.49676777722526105,0.5032322227747389
E01028930,1670,800,870,0.47904191616766467,0.5209580838323353
E01028931,2003,981,1022,0.48976535197204196,0.510234648027958
E01028944,1663,831,832,0.49969933854479853,0.5003006614552015
E01028945,2045,1003,1042,0.4904645476772616,0.5095354523227383
E01028965,1437,683,754,0.47529575504523314,0.5247042449547669
E01028966,1264,649,615,0.5134493670886076,0.4865506329113924
E01028967,1573,758,815,0.4818817546090273,0.5181182453909726
E01028968,1363,632,731,0.46368305209097577,0.5363169479090242
E01028988,1664,791,873,0.4753605769230769,0.5246394230769231
E01028989,1721,845,876,0.49099360836722833,0.5090063916327716
E01028946,2309,1394,915,0.6037245560848852,0.39627544391511477
E01028972,1711,833,878,0.48684979544126245,0.5131502045587376
E01028973,1945,942,1003,0.48431876606683805,0.515681233933162
E01028987,2071,1050,1021,0.5070014485755674,0.49299855142443266
E01028941,1889,852,1037,0.4510322922181048,0.5489677077818952
E01028942,1480,751,729,0.5074324324324324,0.4925675675675676
E01028943,2122,1056,1066,0.49764373232799247,0.5023562676720076
E01028951,1528,757,771,0.4954188481675393,0.5045811518324608
E01028953,1501,722,779,0.4810126582278481,0.5189873417721519
E01028947,1444,689,755,0.47714681440443213,0.5228531855955678
E01028948,1463,718,745,0.49077238550922764,0.5092276144907724
E01028949,1489,744,745,0.49966420416386836,0.5003357958361316
E01028985,1314,625,689,0.4756468797564688,0.5243531202435312
E01028938,1662,813,849,0.4891696750902527,0.5108303249097473
E01028939,1540,755,785,0.4902597402597403,0.5097402597402597
E01028984,1390,659,731,0.4741007194244604,0.5258992805755396
E01028986,1515,744,771,0.4910891089108911,0.5089108910891089
E01028940,1610,755,855,0.468944099378882,0.531055900621118
E01028952,1717,801,916,0.46651135701805474,0.5334886429819452
E01028962,1665,831,834,0.4990990990990991,0.5009009009009009
E01028963,1673,792,881,0.4734010759115362,0.5265989240884639
E01028964,1673,806,867,0.48176927674835623,0.5182307232516438
E01028974,1755,1071,684,0.6102564102564103,0.38974358974358975
E01028935,1489,737,752,0.4949630624580255,0.5050369375419744
E01028936,2086,1030,1056,0.4937679769894535,0.5062320230105465
E01028937,1504,721,783,0.47938829787234044,0.5206117021276596
E01028959,2533,1283,1250,0.5065140150019739,0.49348598499802604
E01028954,1266,645,621,0.509478672985782,0.490521327014218
E01028955,1090,527,563,0.4834862385321101,0.5165137614678899
E01028975,1777,884,893,0.4974676420934159,0.5025323579065841
E01028976,1769,900,869,0.5087620124364047,0.49123798756359527
E01028977,1937,941,996,0.4858027878162106,0.5141972121837893
E01028950,2318,1106,1212,0.4771354616048318,0.5228645383951682
E01028960,1322,657,665,0.4969742813918306,0.5030257186081695
E01028961,1691,871,820,0.5150798344175045,0.48492016558249557
E01028980,2175,1066,1109,0.4901149425287356,0.5098850574712643
E01028991,1238,617,621,0.4983844911147011,0.5016155088852988
E01028992,1585,762,823,0.4807570977917981,0.5192429022082019
E01033529,1042,531,511,0.5095969289827256,0.4904030710172745
E01033530,2007,1044,963,0.5201793721973094,0.4798206278026906
E01028990,1207,609,598,0.5045567522783762,0.49544324772162385
E01028997,2283,1072,1211,0.4695575996495839,0.5304424003504161
E01028998,2388,1137,1251,0.47613065326633164,0.5238693467336684
E01028993,1540,742,798,0.4818181818181818,0.5181818181818182
E01029004,1045,520,525,0.49760765550239233,0.5023923444976076
E01029013,1675,852,823,0.5086567164179104,0.49134328358208956
E01029014,1217,604,613,0.49630238290879214,0.5036976170912079
E01029015,1399,726,673,0.5189421015010722,0.4810578984989278
E01028994,1305,652,653,0.49961685823754787,0.5003831417624521
E01029003,2317,1172,1145,0.5058264997842037,0.4941735002157963
E01029005,1247,628,619,0.5036086607858862,0.4963913392141139
E01029016,1373,670,703,0.4879825200291333,0.5120174799708667
E01029006,1619,760,859,0.4694255713403335,0.5305744286596664
E01029007,1139,526,613,0.4618086040386304,0.5381913959613697
E01029009,1144,549,595,0.4798951048951049,0.5201048951048951
E01029010,1390,698,692,0.5021582733812949,0.497841726618705
E01029011,1473,718,755,0.4874405974202308,0.5125594025797692
E01029012,1918,958,960,0.4994786235662148,0.5005213764337852
E01033526,1011,497,514,0.49159248269040556,0.5084075173095944
E01033527,1245,584,661,0.46907630522088356,0.5309236947791165
E01028995,1560,773,787,0.49551282051282053,0.5044871794871795
E01028996,1318,630,688,0.4779969650986343,0.5220030349013657
E01028999,1560,781,779,0.5006410256410256,0.49935897435897436
E01029000,1141,588,553,0.5153374233128835,0.48466257668711654
E01029001,1968,973,995,0.49441056910569103,0.505589430894309
E01029002,1320,667,653,0.5053030303030303,0.4946969696969697
E01014257,1472,736,736,0.5,0.5
E01014258,1517,753,764,0.4963744232036915,0.5036255767963085
E01014259,1462,687,775,0.46990424076607384,0.5300957592339262
E01014260,1338,649,689,0.4850523168908819,0.5149476831091181
E01014264,1925,960,965,0.4987012987012987,0.5012987012987012
E01014357,1572,728,844,0.4631043256997455,0.5368956743002544
E01014358,1417,695,722,0.49047282992237123,0.5095271700776288
E01014359,1829,913,916,0.4991798797156916,0.5008201202843083
E01014360,2011,966,1045,0.4803580308304326,0.5196419691695674
E01014261,1404,666,738,0.47435897435897434,0.5256410256410257
E01014262,1359,660,699,0.4856512141280353,0.5143487858719646
E01014263,1699,795,904,0.4679223072395527,0.5320776927604474
E01014333,1460,718,742,0.4917808219178082,0.5082191780821917
E01014334,1428,662,766,0.4635854341736695,0.5364145658263305
E01014331,1538,772,766,0.5019505851755527,0.4980494148244473
E01014332,1673,792,881,0.4734010759115362,0.5265989240884639
E01014335,1721,840,881,0.48808832074375363,0.5119116792562464
E01014336,1611,802,809,0.4978274363749224,0.5021725636250776
E01014337,1715,819,896,0.4775510204081633,0.5224489795918368
E01014354,1772,836,936,0.4717832957110609,0.5282167042889391
E01014355,1921,952,969,0.49557522123893805,0.504424778761062
E01014356,1765,857,908,0.4855524079320113,0.5144475920679886
E01014361,1588,804,784,0.5062972292191436,0.49370277078085645
E01014241,1601,780,821,0.4871955028107433,0.5128044971892567
E01014242,1465,729,736,0.4976109215017065,0.5023890784982935
E01014243,1415,690,725,0.4876325088339223,0.5123674911660777
E01014244,1573,749,824,0.4761602034329307,0.5238397965670692
E01014245,1749,875,874,0.5002858776443682,0.4997141223556318
E01014248,1474,756,718,0.5128900949796472,0.4871099050203528
E01014214,1455,727,728,0.49965635738831615,0.5003436426116838
E01014215,1520,757,763,0.4980263157894737,0.5019736842105263
E01014216,1406,666,740,0.47368421052631576,0.5263157894736842
E01014265,1538,754,784,0.49024707412223667,0.5097529258777633
E01014267,2383,1180,1203,0.4951741502308015,0.5048258497691985
E01014272,1448,703,745,0.48549723756906077,0.5145027624309392
E01014246,1604,789,815,0.4918952618453865,0.5081047381546134
E01014266,1214,581,633,0.4785831960461285,0.5214168039538715
E01014268,2093,995,1098,0.47539417104634496,0.524605828953655
E01014270,1541,777,764,0.5042180402336145,0.49578195976638545
E01014271,1525,733,792,0.48065573770491804,0.519344262295082
E01014247,1737,891,846,0.5129533678756477,0.48704663212435234
E01014250,1137,605,532,0.5321020228671943,0.4678979771328056
E01014251,1850,964,886,0.5210810810810811,0.4789189189189189
E01014252,1682,876,806,0.5208085612366231,0.47919143876337694
E01014255,2030,994,1036,0.4896551724137931,0.5103448275862069
E01014269,1629,816,813,0.5009208103130756,0.4990791896869245
E01014324,1453,706,747,0.4858912594631796,0.5141087405368203
E01014325,1335,679,656,0.5086142322097378,0.49138576779026216
E01014326,1483,775,708,0.5225893459204316,0.47741065407956845
E01014249,1736,914,822,0.5264976958525346,0.4735023041474654
E01014253,1551,744,807,0.4796905222437137,0.5203094777562862
E01014254,1572,840,732,0.5343511450381679,0.46564885496183206
E01014256,1621,814,807,0.5021591610117212,0.49784083898827886
E01014210,1490,721,769,0.48389261744966444,0.5161073825503356
E01014211,1484,687,797,0.46293800539083557,0.5370619946091644
E01014212,1311,632,679,0.4820747520976354,0.5179252479023646
E01014213,1238,633,605,0.5113085621970921,0.4886914378029079
E01014217,1435,677,758,0.47177700348432056,0.5282229965156794
E01014323,1274,615,659,0.4827315541601256,0.5172684458398744
E01014327,1452,704,748,0.48484848484848486,0.5151515151515151
E01014328,1441,739,702,0.5128383067314365,0.4871616932685635
E01014329,1532,763,769,0.4980417754569191,0.5019582245430809
E01014330,1595,894,701,0.5605015673981191,0.4394984326018809
E01014218,1511,729,782,0.4824619457313038,0.5175380542686963
E01014219,1272,610,662,0.47955974842767296,0.5204402515723271
E01014225,1476,715,761,0.48441734417344173,0.5155826558265583
E01014226,1456,668,788,0.45879120879120877,0.5412087912087912
E01014228,1311,657,654,0.5011441647597255,0.4988558352402746
E01014230,1494,747,747,0.5,0.5
E01014281,1752,1018,734,0.5810502283105022,0.4189497716894977
E01014285,2209,1183,1026,0.5355364418288818,0.4644635581711182
E01014286,1457,801,656,0.5497597803706246,0.45024021962937544
E01014287,1708,924,784,0.5409836065573771,0.45901639344262296
E01014231,1488,824,664,0.553763440860215,0.44623655913978494
E01014282,1685,933,752,0.5537091988130564,0.44629080118694364
E01014283,2041,1254,787,0.6144047035766781,0.3855952964233219
E01014284,1470,881,589,0.5993197278911565,0.40068027210884355
E01033216,2395,1255,1140,0.524008350730689,0.4759916492693111
E01014220,1637,796,841,0.4862553451435553,0.5137446548564447
E01014221,1588,769,819,0.48425692695214106,0.5157430730478589
E01014222,1527,731,796,0.47871643745907005,0.5212835625409299
E01014223,1613,808,805,0.5009299442033478,0.4990700557966522
E01014224,1604,758,846,0.47256857855361595,0.527431421446384
E01014229,1778,835,943,0.46962879640044997,0.53037120359955
E01014288,1596,778,818,0.487468671679198,0.5125313283208021
E01014289,1567,766,801,0.48883216336949586,0.5111678366305041
E01014290,1525,762,763,0.499672131147541,0.5003278688524591
E01014291,1393,700,693,0.5025125628140703,0.49748743718592964
E01014292,1622,816,806,0.5030826140567201,0.4969173859432799
E01014294,1327,649,678,0.48907309721175585,0.5109269027882442
E01014293,1678,897,781,0.534564958283671,0.465435041716329
E01014295,1706,840,866,0.492379835873388,0.5076201641266119
E01014339,1659,857,802,0.5165762507534659,0.48342374924653403
E01014340,1892,932,960,0.492600422832981,0.507399577167019
E01014345,1718,930,788,0.5413271245634459,0.4586728754365541
E01014274,1837,858,979,0.46706586826347307,0.5329341317365269
E01014275,1423,687,736,0.48278285312719604,0.517217146872804
E01014276,1573,782,791,0.4971392244119517,0.5028607755880483
E01014277,1558,783,775,0.5025673940949936,0.49743260590500643
E01014279,1732,868,864,0.5011547344110855,0.49884526558891457
E01014273,1280,651,629,0.50859375,0.49140625
E01014278,1354,680,674,0.5022156573116692,0.4977843426883309
E01014280,1313,660,653,0.5026656511805027,0.49733434881949734
E01014297,1305,644,661,0.4934865900383142,0.5065134099616858
E01014296,1423,703,720,0.49402670414617006,0.5059732958538299
E01014298,1593,771,822,0.4839924670433145,0.5160075329566854
E01014300,1427,672,755,0.47091800981079185,0.5290819901892081
E01014302,1822,932,890,0.5115257958287596,0.4884742041712404
E01014338,1487,774,713,0.5205110961667787,0.47948890383322124
E01014341,1760,898,862,0.5102272727272728,0.48977272727272725
E01014342,1516,745,771,0.49142480211081796,0.508575197889182
E01014343,1770,892,878,0.503954802259887,0.496045197740113
E01014344,1512,755,757,0.49933862433862436,0.5006613756613757
E01014363,1350,670,680,0.4962962962962963,0.5037037037037037
E01014364,1496,736,760,0.4919786096256685,0.5080213903743316
E01014365,1478,722,756,0.4884979702300406,0.5115020297699594
E01014369,1298,635,663,0.48921417565485364,0.5107858243451464
E01014299,1431,712,719,0.4975541579315164,0.5024458420684835
E01014301,1753,878,875,0.5008556759840274,0.49914432401597264
E01014303,1596,798,798,0.5,0.5
E01014304,1458,724,734,0.49657064471879286,0.5034293552812071
E01014362,1420,714,706,0.5028169014084507,0.4971830985915493
E01014233,1411,678,733,0.4805102763997165,0.5194897236002834
E01014234,1584,776,808,0.4898989898989899,0.51010101010101
E01014239,1484,732,752,0.49326145552560646,0.5067385444743935
E01014240,1529,722,807,0.4722040549378679,0.5277959450621321
E01014308,1668,821,847,0.4922062350119904,0.5077937649880095
E01014309,1285,613,672,0.47704280155642026,0.5229571984435798
E01014311,1363,659,704,0.483492296404989,0.516507703595011
E01014313,1568,739,829,0.47130102040816324,0.5286989795918368
E01014321,1425,731,694,0.5129824561403509,0.4870175438596491
E01014366,1899,975,924,0.5134281200631912,0.48657187993680884
E01014367,1460,705,755,0.4828767123287671,0.5171232876712328
E01014368,1597,771,826,0.482780212899186,0.5172197871008141
E01014305,1395,737,658,0.5283154121863799,0.47168458781362005
E01014306,1419,690,729,0.48625792811839325,0.5137420718816068
E01014307,1383,690,693,0.49891540130151846,0.5010845986984815
E01014312,1425,693,732,0.4863157894736842,0.5136842105263157
E01014346,1577,772,805,0.4895370957514268,0.5104629042485732
E01014348,1366,658,708,0.4816983894582723,0.5183016105417276
E01014349,1429,707,722,0.4947515745276417,0.5052484254723583
E01014353,1710,820,890,0.47953216374269003,0.52046783625731
E01014310,2062,1019,1043,0.494180407371484,0.5058195926285161
E01014314,1413,708,705,0.5010615711252654,0.4989384288747346
E01014316,1566,777,789,0.49616858237547895,0.5038314176245211
E01014317,1557,726,831,0.4662813102119461,0.5337186897880539
E01014322,1662,802,860,0.4825511432009627,0.5174488567990373
E01014235,1587,767,820,0.48330182734719596,0.516698172652804
E01014236,2344,1150,1194,0.4906143344709898,0.5093856655290102
E01014237,1592,825,767,0.5182160804020101,0.48178391959798994
E01014238,1525,762,763,0.499672131147541,0.5003278688524591
E01014315,1331,661,670,0.4966190833959429,0.5033809166040571
E01014318,1448,746,702,0.5151933701657458,0.48480662983425415
E01014319,1510,737,773,0.4880794701986755,0.5119205298013245
E01014320,1291,641,650,0.4965143299767622,0.5034856700232379
E01014347,1413,699,714,0.49469214437367304,0.505307855626327
E01014350,1370,684,686,0.4992700729927007,0.5007299270072992
E01014351,1585,750,835,0.47318611987381703,0.526813880126183
E01014352,1386,699,687,0.5043290043290043,0.49567099567099565
E01014171,1419,721,698,0.5081042988019733,0.4918957011980268
E01014172,1407,697,710,0.4953802416488984,0.5046197583511016
E01014173,1550,763,787,0.492258064516129,0.5077419354838709
E01014174,1627,809,818,0.4972341733251383,0.5027658266748617
E01014112,1673,825,848,0.4931261207411835,0.5068738792588166
E01014131,2242,1148,1094,0.512042818911686,0.487957181088314
E01014132,1080,536,544,0.4962962962962963,0.5037037037037037
E01014135,1235,616,619,0.4987854251012146,0.5012145748987854
E01014175,1140,570,570,0.5,0.5
E01014176,1495,720,775,0.4816053511705686,0.5183946488294314
E01014177,1384,681,703,0.4920520231213873,0.5079479768786127
E01014178,1514,777,737,0.5132100396301189,0.4867899603698811
E01014111,1550,763,787,0.492258064516129,0.5077419354838709
E01014167,1949,962,987,0.4935864545920985,0.5064135454079015
E01014168,1389,693,696,0.49892008639308855,0.5010799136069114
E01014170,1482,710,772,0.47908232118758437,0.5209176788124157
E01014125,1563,809,754,0.5175943698016635,0.48240563019833654
E01014126,1459,707,752,0.4845784784098698,0.5154215215901302
E01014127,1726,852,874,0.4936268829663963,0.5063731170336037
E01014128,2135,1062,1073,0.497423887587822,0.502576112412178
E01014169,1737,834,903,0.48013816925734026,0.5198618307426598
E01014129,1029,524,505,0.5092322643343051,0.49076773566569487
E01014130,1413,692,721,0.4897381457891012,0.5102618542108988
E01014179,1192,594,598,0.4983221476510067,0.5016778523489933
E01014180,1334,639,695,0.4790104947526237,0.5209895052473763
E01014189,1537,761,776,0.4951203643461288,0.5048796356538712
E01014190,1702,834,868,0.4900117508813161,0.5099882491186839
E01014102,1823,883,940,0.4843664289632474,0.5156335710367526
E01014103,1235,610,625,0.4939271255060729,0.5060728744939271
E01014138,1486,716,770,0.48183041722745623,0.5181695827725438
E01014140,1463,718,745,0.49077238550922764,0.5092276144907724
E01014205,1382,666,716,0.48191027496382055,0.5180897250361794
E01014206,1322,658,664,0.4977307110438729,0.5022692889561271
E01014207,1291,644,647,0.4988381099922541,0.5011618900077459
E01014208,1226,583,643,0.47553017944535075,0.5244698205546493
E01014209,1458,732,726,0.5020576131687243,0.49794238683127573
E01014137,1533,762,771,0.49706457925636005,0.50293542074364
E01014139,1396,679,717,0.4863896848137536,0.5136103151862464
E01014141,2799,1391,1408,0.4969632011432655,0.5030367988567346
E01014142,1402,662,740,0.47218259629101283,0.5278174037089871
E01014143,1486,740,746,0.4979811574697174,0.5020188425302826
E01014136,1639,812,827,0.49542403904820015,0.5045759609517999
E01014148,1493,774,719,0.5184192900200938,0.4815807099799062
E01014149,1089,549,540,0.5041322314049587,0.49586776859504134
E01014202,2389,1227,1162,0.513604018417748,0.486395981582252
E01014203,1542,773,769,0.5012970168612192,0.4987029831387808
E01014204,1981,996,985,0.502776375567895,0.497223624432105
E01014104,1700,848,852,0.4988235294117647,0.5011764705882353
E01014105,1935,951,984,0.49147286821705427,0.5085271317829457
E01014113,1635,835,800,0.5107033639143731,0.4892966360856269
E01014114,1456,744,712,0.510989010989011,0.489010989010989
E01014133,1813,880,933,0.4853833425261997,0.5146166574738004
E01014134,1308,615,693,0.4701834862385321,0.5298165137614679
E01014144,1530,740,790,0.48366013071895425,0.5163398692810458
E01014145,1768,886,882,0.501131221719457,0.498868778280543
E01014185,1641,771,870,0.46983546617915906,0.5301645338208409
E01014186,1434,695,739,0.48465829846582986,0.5153417015341701
E01014187,1471,742,729,0.504418762746431,0.495581237253569
E01014188,1538,780,758,0.5071521456436932,0.4928478543563069
E01014150,1644,827,817,0.5030413625304136,0.49695863746958635
E01014151,1504,752,752,0.5,0.5
E01014152,1307,607,700,0.46442234123947973,0.5355776587605203
E01014153,1761,879,882,0.4991482112436116,0.5008517887563884
E01014154,1681,861,820,0.5121951219512195,0.4878048780487805
E01014155,1648,819,829,0.4969660194174757,0.5030339805825242
E01014181,2003,1020,983,0.509236145781328,0.49076385421867197
E01014182,1265,634,631,0.5011857707509881,0.49881422924901186
E01014183,1559,791,768,0.5073765234124439,0.4926234765875561
E01014184,1498,736,762,0.49132176234979974,0.5086782376502003
E01014146,2212,1078,1134,0.4873417721518987,0.5126582278481012
E01014147,2080,1035,1045,0.49759615384615385,0.5024038461538461
E01014156,2160,1058,1102,0.4898148148148148,0.5101851851851852
E01014157,1506,786,720,0.5219123505976095,0.47808764940239046
E01014158,1561,782,779,0.5009609224855862,0.49903907751441384
E01014124,1684,845,839,0.5017814726840855,0.4982185273159145
E01014163,1459,711,748,0.4873200822481151,0.5126799177518848
E01014164,1647,819,828,0.4972677595628415,0.5027322404371585
E01014165,1419,725,694,0.51092318534179,0.48907681465821
E01014166,1581,777,804,0.49146110056925996,0.50853889943074
E01014191,1742,934,808,0.5361653272101033,0.46383467278989665
E01014192,1443,733,710,0.507969507969508,0.49203049203049204
E01014193,1686,814,872,0.48279952550415184,0.5172004744958482
E01014194,1520,752,768,0.49473684210526314,0.5052631578947369
E01014195,1447,722,725,0.49896337249481687,0.5010366275051832
E01014196,1543,744,799,0.48217757615035645,0.5178224238496435
E01014119,1658,806,852,0.48612786489746684,0.5138721351025332
E01014120,1756,879,877,0.5005694760820045,0.4994305239179954
E01014121,1388,663,725,0.4776657060518732,0.5223342939481268
E01014122,1566,788,778,0.5031928480204342,0.49680715197956576
E01014123,1532,776,756,0.5065274151436031,0.4934725848563969
E01014106,1584,784,800,0.494949494949495,0.5050505050505051
E01014107,1180,607,573,0.514406779661017,0.48559322033898306
E01014108,1467,757,710,0.5160190865712339,0.4839809134287662
E01014109,1193,578,615,0.4844928751047779,0.5155071248952221
E01014110,1499,726,773,0.48432288192128087,0.5156771180787192
E01014197,1523,748,775,0.4911359159553513,0.5088640840446487
E01014198,1091,522,569,0.4784601283226398,0.5215398716773603
E01014199,1673,780,893,0.46622833233711897,0.5337716676628811
E01014200,1307,613,694,0.46901300688599845,0.5309869931140015
E01014201,1304,619,685,0.4746932515337423,0.5253067484662577
E01014159,1231,598,633,0.48578391551584077,0.5142160844841592
E01014160,1318,651,667,0.4939301972685888,0.5060698027314112
E01014161,1146,589,557,0.5139616055846422,0.4860383944153578
E01014162,1634,801,833,0.49020807833537333,0.5097919216646267
E01014115,1341,678,663,0.5055928411633109,0.49440715883668906
E01014116,1663,784,879,0.4714371617558629,0.5285628382441371
E01014117,1185,587,598,0.49535864978902955,0.5046413502109705
E01014118,1215,613,602,0.5045267489711934,0.49547325102880657
E01029368,1226,619,607,0.5048939641109299,0.49510603588907015
E01029369,1250,625,625,0.5,0.5
E01029370,1393,701,692,0.5032304379038047,0.49676956209619527
E01029371,1550,795,755,0.5129032258064516,0.4870967741935484
E01029402,1985,951,1034,0.47909319899244335,0.5209068010075567
E01029372,1358,664,694,0.4889543446244477,0.5110456553755522
E01029373,2306,1149,1157,0.49826539462272335,0.5017346053772767
E01029401,1605,782,823,0.48722741433021804,0.5127725856697819
E01029403,1504,743,761,0.4940159574468085,0.5059840425531915
E01029404,1496,741,755,0.49532085561497324,0.5046791443850267
E01029345,1656,804,852,0.4855072463768116,0.5144927536231884
E01029346,1699,780,919,0.45909358446144793,0.5409064155385521
E01029347,1432,710,722,0.4958100558659218,0.5041899441340782
E01029348,1751,877,874,0.500856653340948,0.49914334665905197
E01029374,2349,1151,1198,0.4899957428693061,0.5100042571306939
E01029383,1570,794,776,0.5057324840764331,0.4942675159235669
E01029385,1479,749,730,0.506423258958756,0.4935767410412441
E01029388,1375,674,701,0.49018181818181816,0.5098181818181818
E01029390,1124,564,560,0.501779359430605,0.498220640569395
E01029384,1936,959,977,0.49535123966942146,0.5046487603305785
E01029386,1436,718,718,0.5,0.5
E01029387,1478,754,724,0.510148849797023,0.489851150202977
E01029389,1645,840,805,0.5106382978723404,0.48936170212765956
E01029379,1767,871,896,0.49292586304470853,0.5070741369552915
E01029398,1682,842,840,0.5005945303210464,0.4994054696789536
E01029399,1589,802,787,0.5047199496538703,0.49528005034612965
E01029400,1706,849,857,0.4976553341148886,0.5023446658851114
E01029354,1548,754,794,0.4870801033591731,0.5129198966408268
E01029355,1571,763,808,0.4856779121578612,0.5143220878421387
E01029356,1497,762,735,0.5090180360721442,0.4909819639278557
E01029357,1354,686,668,0.5066469719350074,0.4933530280649926
E01029358,1316,625,691,0.4749240121580547,0.5250759878419453
E01029349,1280,633,647,0.49453125,0.50546875
E01029350,1526,753,773,0.49344692005242463,0.5065530799475754
E01029351,1503,739,764,0.4916833000665336,0.5083166999334664
E01029352,1351,679,672,0.5025906735751295,0.49740932642487046
E01029393,1671,841,830,0.5032914422501497,0.4967085577498504
E01029380,1539,778,761,0.5055230669265757,0.4944769330734243
E01029381,1506,764,742,0.5073041168658698,0.49269588313413015
E01029382,1645,801,844,0.4869300911854103,0.5130699088145897
E01029391,1666,828,838,0.4969987995198079,0.503001200480192
E01029392,1963,968,995,0.49312277126846665,0.5068772287315334
E01029375,2504,1251,1253,0.4996006389776358,0.5003993610223643
E01029376,1974,946,1028,0.47922998986828774,0.5207700101317123
E01029377,1449,696,753,0.4803312629399586,0.5196687370600414
E01029378,1701,844,857,0.49617871840094063,0.5038212815990594
E01029353,1403,678,725,0.4832501781895937,0.5167498218104063
E01029364,1601,761,840,0.47532792004996877,0.5246720799500312
E01029365,1530,748,782,0.4888888888888889,0.5111111111111111
E01029366,1687,819,868,0.4854771784232365,0.5145228215767634
E01029367,2178,1046,1132,0.480257116620753,0.519742883379247
E01029359,1619,802,817,0.49536751080914143,0.5046324891908586
E01029360,1538,724,814,0.47074122236671,0.52925877763329
E01029361,1547,777,770,0.502262443438914,0.497737556561086
E01029362,1565,751,814,0.47987220447284346,0.5201277955271566
E01029363,1404,705,699,0.5021367521367521,0.49786324786324787
E01029394,1462,714,748,0.4883720930232558,0.5116279069767442
E01029395,1577,797,780,0.5053899809765378,0.49461001902346224
E01029396,1712,851,861,0.49707943925233644,0.5029205607476636
E01029397,2728,1334,1394,0.48900293255131966,0.5109970674486803
E01029405,1635,813,822,0.4972477064220184,0.5027522935779817
E01029406,1230,628,602,0.510569105691057,0.4894308943089431
E01029422,1351,704,647,0.5210954848260547,0.4789045151739452
E01029423,1569,758,811,0.48311026131293816,0.5168897386870618
E01029467,2052,1007,1045,0.49074074074074076,0.5092592592592593
E01029430,1493,735,758,0.49229738780977894,0.5077026121902211
E01029431,1622,779,843,0.4802712700369914,0.5197287299630087
E01029432,1475,716,759,0.48542372881355933,0.5145762711864407
E01029433,1608,809,799,0.5031094527363185,0.4968905472636816
E01029459,1574,775,799,0.4923761118170267,0.5076238881829733
E01029460,1732,865,867,0.49942263279445726,0.5005773672055427
E01029461,1940,983,957,0.506701030927835,0.493298969072165
E01029462,1645,799,846,0.4857142857142857,0.5142857142857142
E01029443,1677,820,857,0.48896839594514013,0.5110316040548599
E01029444,1590,764,826,0.48050314465408805,0.519496855345912
E01029463,1261,608,653,0.4821570182394925,0.5178429817605076
E01029464,1573,768,805,0.4882390336935791,0.5117609663064209
E01029465,1503,749,754,0.49833666001330673,0.5016633399866933
E01029466,1560,780,780,0.5,0.5
E01029454,1638,808,830,0.4932844932844933,0.5067155067155067
E01029455,1827,891,936,0.4876847290640394,0.5123152709359606
E01029456,1519,709,810,0.46675444371296904,0.533245556287031
E01029457,1370,660,710,0.48175182481751827,0.5182481751824818
E01029458,1495,728,767,0.48695652173913045,0.5130434782608696
E01029411,1287,656,631,0.5097125097125097,0.4902874902874903
E01029412,1351,631,720,0.4670614359733531,0.532938564026647
E01029424,1029,480,549,0.46647230320699706,0.5335276967930029
E01029425,2360,1598,762,0.6771186440677966,0.3228813559322034
E01029473,1414,697,717,0.4929278642149929,0.5070721357850071
E01029474,1207,567,640,0.46975973487986744,0.5302402651201326
E01029434,1567,756,811,0.4824505424377792,0.5175494575622208
E01029435,1496,715,781,0.47794117647058826,0.5220588235294118
E01029436,1859,936,923,0.5034965034965035,0.4965034965034965
E01029437,2317,1080,1237,0.46611998273629696,0.533880017263703
E01029438,1512,719,793,0.4755291005291005,0.5244708994708994
E01029426,1747,852,895,0.48769318832283914,0.5123068116771609
E01029427,1521,736,785,0.4838921761998685,0.5161078238001315
E01029428,1584,789,795,0.4981060606060606,0.5018939393939394
E01029429,1350,692,658,0.5125925925925926,0.4874074074074074
E01029445,1932,995,937,0.5150103519668737,0.4849896480331263
E01029446,1730,849,881,0.4907514450867052,0.5092485549132948
E01029447,1739,891,848,0.5123634272570443,0.48763657274295574
E01029448,1660,774,886,0.46626506024096387,0.5337349397590362
E01029468,1655,813,842,0.49123867069486404,0.508761329305136
E01029469,1846,895,951,0.4848320693391116,0.5151679306608884
E01029470,1562,778,784,0.4980793854033291,0.5019206145966709
E01029471,1772,852,920,0.48081264108352145,0.5191873589164786
E01029472,1631,789,842,0.483752299202943,0.5162477007970571
E01029407,1454,750,704,0.515818431911967,0.48418156808803303
E01029408,2118,1093,1025,0.516052880075543,0.48394711992445705
E01029409,1681,902,779,0.5365853658536586,0.4634146341463415
E01029410,1556,784,772,0.5038560411311054,0.4961439588688946
E01032896,1092,605,487,0.5540293040293041,0.445970695970696
E01032897,1173,594,579,0.5063938618925832,0.4936061381074169
E01032898,1256,655,601,0.5214968152866242,0.4785031847133758
E01029418,2106,1061,1045,0.5037986704653371,0.4962013295346629
E01029419,1547,759,788,0.4906270200387847,0.5093729799612152
E01029420,1732,809,923,0.46709006928406466,0.5329099307159353
E01029413,1488,743,745,0.4993279569892473,0.5006720430107527
E01029414,1658,828,830,0.49939686369119424,0.5006031363088058
E01029415,1622,802,820,0.49445129469790383,0.5055487053020962
E01029416,1245,616,629,0.4947791164658635,0.5052208835341365
E01029417,1218,589,629,0.48357963875205257,0.5164203612479474
E01029449,1650,798,852,0.48363636363636364,0.5163636363636364
E01029450,1502,774,728,0.5153129161118508,0.48468708388814913
E01029451,1745,813,932,0.4659025787965616,0.5340974212034384
E01029452,1574,790,784,0.5019059720457433,0.49809402795425667
E01029453,1506,720,786,0.47808764940239046,0.5219123505976095
E01029439,1445,704,741,0.48719723183391006,0.5128027681660899
E01029440,1293,652,641,0.5042536736272235,0.4957463263727765
E01029441,1513,707,806,0.46728354263053534,0.5327164573694646
E01029442,1342,641,701,0.47764530551415796,0.522354694485842
E01029480,1809,921,888,0.5091210613598673,0.49087893864013266
E01029481,1882,915,967,0.4861849096705632,0.5138150903294367
E01029482,1644,791,853,0.4811435523114355,0.5188564476885644
E01029498,1799,898,901,0.4991662034463591,0.5008337965536409
E01029477,1547,763,784,0.49321266968325794,0.5067873303167421
E01029478,1582,755,827,0.47724399494311,0.52275600505689
E01029479,2818,1387,1431,0.4921930447125621,0.5078069552874379
E01029509,1679,815,864,0.4854079809410363,0.5145920190589637
E01029486,1419,735,684,0.5179704016913319,0.4820295983086681
E01029507,1690,849,841,0.5023668639053255,0.4976331360946746
E01029508,2313,1166,1147,0.5041072200605274,0.49589277993947256
E01029515,1823,881,942,0.4832693362589139,0.5167306637410861
E01029492,2006,974,1032,0.48554336989032904,0.514456630109671
E01029499,1758,879,879,0.5,0.5
E01029501,1539,733,806,0.4762833008447043,0.5237166991552956
E01029526,1604,798,806,0.4975062344139651,0.5024937655860349
E01032899,1524,707,817,0.46391076115485563,0.5360892388451444
E01032900,2055,1009,1046,0.49099756690997565,0.5090024330900244
E01029483,1553,762,791,0.49066323245331617,0.5093367675466839
E01029484,1796,890,906,0.4955456570155902,0.5044543429844098
E01029485,1495,739,756,0.494314381270903,0.505685618729097
E01029500,1740,892,848,0.5126436781609195,0.48735632183908045
E01029520,1579,787,792,0.49841671944268523,0.5015832805573147
E01029524,1700,848,852,0.4988235294117647,0.5011764705882353
E01029525,1747,864,883,0.49456210646823123,0.5054378935317687
E01029487,1635,795,840,0.48623853211009177,0.5137614678899083
E01029493,1971,984,987,0.4992389649923896,0.5007610350076104
E01029494,1553,755,798,0.4861558274307791,0.5138441725692209
E01029495,1658,805,853,0.485524728588661,0.514475271411339
E01029497,1975,970,1005,0.4911392405063291,0.5088607594936709
E01029491,1774,856,918,0.48252536640360766,0.5174746335963923
E01029511,1601,773,828,0.48282323547782635,0.5171767645221736
E01029512,1918,911,1007,0.4749739311783107,0.5250260688216892
E01029518,2706,1310,1396,0.48410938654841096,0.515890613451589
E01029519,2124,1060,1064,0.4990583804143126,0.5009416195856874
E01029516,1938,949,989,0.48968008255933954,0.5103199174406605
E01029517,1648,829,819,0.5030339805825242,0.4969660194174757
E01029530,1743,890,853,0.51061388410786,0.48938611589214
E01029531,1721,836,885,0.48576409064497383,0.5142359093550262
E01029475,2037,1003,1034,0.49239077074128623,0.5076092292587138
E01029476,1384,670,714,0.4841040462427746,0.5158959537572254
E01029489,1595,792,803,0.496551724137931,0.503448275862069
E01029490,1458,737,721,0.5054869684499315,0.4945130315500686
E01029505,1571,789,782,0.5022278803309994,0.49777211966900065
E01029506,1841,943,898,0.512221618685497,0.48777838131450296
E01029496,1910,922,988,0.4827225130890052,0.5172774869109947
E01029527,1282,634,648,0.49453978159126366,0.5054602184087363
E01029528,1294,646,648,0.4992272024729521,0.500772797527048
E01029529,1281,656,625,0.5120999219359875,0.4879000780640125
E01029513,1364,665,699,0.4875366568914956,0.5124633431085044
E01029514,1556,745,811,0.4787917737789203,0.5212082262210797
E01029521,1689,836,853,0.49496743635287155,0.5050325636471285
E01029522,1637,768,869,0.4691508857666463,0.5308491142333537
E01029523,1546,755,791,0.4883570504527814,0.5116429495472187
E01029488,2332,1494,838,0.6406518010291595,0.35934819897084047
E01029502,1692,851,841,0.5029550827423168,0.49704491725768324
E01029503,1585,769,816,0.48517350157728706,0.5148264984227129
E01029504,1534,764,770,0.4980443285528031,0.5019556714471969
E01029562,1353,648,705,0.4789356984478936,0.5210643015521065
E01029565,1260,634,626,0.5031746031746032,0.49682539682539684
E01029581,1577,812,765,0.5149017121116043,0.4850982878883957
E01029582,1829,925,904,0.5057408419901586,0.49425915800984144
E01029586,1223,608,615,0.4971381847914963,0.5028618152085037
E01029587,1244,613,631,0.4927652733118971,0.5072347266881029
E01029561,1477,699,778,0.4732566012186865,0.5267433987813135
E01029563,1391,694,697,0.49892163910855497,0.501078360891445
E01029564,1346,686,660,0.5096582466567607,0.4903417533432392
E01029588,1540,778,762,0.5051948051948052,0.4948051948051948
E01029540,1430,691,739,0.48321678321678324,0.5167832167832168
E01029541,1573,748,825,0.4755244755244755,0.5244755244755245
E01029542,1336,651,685,0.48727544910179643,0.5127245508982036
E01029543,1302,649,653,0.49846390168970817,0.5015360983102919
E01029595,1234,628,606,0.5089141004862237,0.49108589951377635
E01029597,1481,752,729,0.5077650236326806,0.4922349763673194
E01029536,1517,763,754,0.5029663810151616,0.4970336189848385
E01029544,1362,681,681,0.5,0.5
E01029545,1559,801,758,0.5137908915971777,0.48620910840282233
E01029546,1434,729,705,0.5083682008368201,0.4916317991631799
E01029596,1160,570,590,0.49137931034482757,0.5086206896551724
E01029532,1469,738,731,0.5023825731790333,0.49761742682096666
E01029533,1526,754,772,0.4941022280471822,0.5058977719528178
E01029534,1518,748,770,0.4927536231884058,0.5072463768115942
E01029535,1414,695,719,0.4915134370579915,0.5084865629420084
E01029556,2510,1252,1258,0.49880478087649405,0.501195219123506
E01029537,1571,773,798,0.49204328453214513,0.5079567154678549
E01029538,1750,840,910,0.48,0.52
E01029539,1565,787,778,0.5028753993610223,0.4971246006389776
E01029552,1479,739,740,0.49966193373901285,0.5003380662609872
E01029558,1667,823,844,0.4937012597480504,0.5062987402519497
E01029547,1455,697,758,0.47903780068728524,0.5209621993127148
E01029548,1475,690,785,0.46779661016949153,0.5322033898305085
E01029559,1428,745,683,0.5217086834733894,0.47829131652661067
E01029560,1599,767,832,0.4796747967479675,0.5203252032520326
E01029568,1464,735,729,0.5020491803278688,0.4979508196721312
E01029583,1452,697,755,0.4800275482093664,0.5199724517906336
E01029584,1190,595,595,0.5,0.5
E01029585,1464,752,712,0.5136612021857924,0.48633879781420764
E01029609,1666,819,847,0.49159663865546216,0.5084033613445378
E01029611,1612,794,818,0.49255583126550867,0.5074441687344913
E01029577,1552,775,777,0.4993556701030928,0.5006443298969072
E01029579,1643,804,839,0.4893487522824102,0.5106512477175897
E01029580,1430,721,709,0.5041958041958042,0.4958041958041958
E01029610,1321,652,669,0.49356548069644207,0.5064345193035579
E01029612,1247,611,636,0.48997594226142743,0.5100240577385726
E01029553,1433,698,735,0.4870900209351012,0.5129099790648988
E01029554,1203,605,598,0.5029093931837074,0.4970906068162926
E01029566,1232,579,653,0.4699675324675325,0.5300324675324676
E01029567,1617,798,819,0.4935064935064935,0.5064935064935064
E01029598,1796,867,929,0.482739420935412,0.517260579064588
E01029599,1441,695,746,0.4823039555863983,0.5176960444136016
E01029555,1772,880,892,0.4966139954853273,0.5033860045146726
E01029578,1611,829,782,0.5145872129112352,0.48541278708876473
E01029602,1920,950,970,0.4947916666666667,0.5052083333333334
E01029603,1481,776,705,0.5239702903443619,0.47602970965563807
E01029604,1662,856,806,0.5150421179302046,0.48495788206979545
E01029576,4460,2225,2235,0.49887892376681614,0.5011210762331838
E01029593,1785,896,889,0.5019607843137255,0.4980392156862745
E01029594,1832,892,940,0.4868995633187773,0.5131004366812227
E01029557,1254,614,640,0.48963317384370014,0.5103668261562998
E01029573,1498,725,773,0.48397863818424564,0.5160213618157543
E01029574,1375,663,712,0.48218181818181816,0.5178181818181818
E01029575,1018,481,537,0.4724950884086444,0.5275049115913556
E01029549,1684,833,851,0.49465558194774345,0.5053444180522565
E01029551,1616,797,819,0.4931930693069307,0.5068069306930693
E01029591,1511,712,799,0.47121111846459296,0.528788881535407
E01029600,1423,692,731,0.4862965565706254,0.5137034434293746
E01029605,1264,631,633,0.49920886075949367,0.5007911392405063
E01029607,1416,679,737,0.4795197740112994,0.5204802259887006
E01029589,1209,571,638,0.47229114971050457,0.5277088502894954
E01029590,1353,635,718,0.4693274205469327,0.5306725794530672
E01029601,1484,708,776,0.477088948787062,0.522911051212938
E01029606,1499,739,760,0.49299533022014674,0.5070046697798533
E01029608,1480,731,749,0.4939189189189189,0.5060810810810811
E01033257,2499,1209,1290,0.4837935174069628,0.5162064825930373
E01029569,1441,735,706,0.5100624566273422,0.4899375433726579
E01029570,2468,1232,1236,0.4991896272285251,0.5008103727714749
E01029571,1375,676,699,0.49163636363636365,0.5083636363636364
E01029572,1664,834,830,0.5012019230769231,0.4987980769230769
E01029655,1972,951,1021,0.48225152129817445,0.5177484787018256
E01029656,1823,924,899,0.5068568294020844,0.4931431705979155
E01029657,1789,890,899,0.4974846282839575,0.5025153717160424
E01029658,1332,632,700,0.4744744744744745,0.5255255255255256
E01029659,1384,669,715,0.4833815028901734,0.5166184971098265
E01029660,2049,1039,1010,0.5070766227428014,0.49292337725719865
E01029621,1479,733,746,0.495605138607167,0.504394861392833
E01029646,1433,708,725,0.49406838799720865,0.5059316120027914
E01029647,2210,1077,1133,0.48733031674208144,0.5126696832579185
E01029648,1494,748,746,0.500669344042838,0.499330655957162
E01029617,1675,844,831,0.5038805970149254,0.4961194029850746
E01029618,1540,687,853,0.4461038961038961,0.5538961038961039
E01029668,1258,605,653,0.4809220985691574,0.5190779014308426
E01029669,1290,630,660,0.4883720930232558,0.5116279069767442
E01029670,1579,794,785,0.5028499050031665,0.49715009499683344
E01029620,1286,626,660,0.4867807153965785,0.5132192846034215
E01029622,1520,761,759,0.5006578947368421,0.4993421052631579
E01029623,1196,588,608,0.4916387959866221,0.5083612040133779
E01029624,1517,749,768,0.4937376400791035,0.5062623599208965
E01029625,1124,561,563,0.4991103202846975,0.5008896797153025
E01029641,1681,846,835,0.5032718619869125,0.49672813801308746
E01029642,1513,762,751,0.5036351619299405,0.4963648380700595
E01029638,2010,978,1032,0.48656716417910445,0.5134328358208955
E01029639,1424,704,720,0.4943820224719101,0.5056179775280899
E01029640,1483,741,742,0.4996628455832771,0.5003371544167229
E01029643,1501,715,786,0.4763491005996003,0.5236508994003998
E01029644,1448,718,730,0.4958563535911602,0.5041436464088398
E01029616,1475,719,756,0.48745762711864404,0.512542372881356
E01029619,1883,951,932,0.5050451407328731,0.4949548592671269
E01029636,1440,716,724,0.49722222222222223,0.5027777777777778
E01029637,2558,1668,890,0.6520719311962471,0.34792806880375293
E01029632,1816,872,944,0.4801762114537445,0.5198237885462555
E01029633,1727,854,873,0.4944991314418066,0.5055008685581934
E01029634,1414,691,723,0.4886845827439887,0.5113154172560113
E01029635,1743,828,915,0.4750430292598967,0.5249569707401033
E01029613,1384,692,692,0.5,0.5
E01029614,1730,817,913,0.4722543352601156,0.5277456647398844
E01029615,1216,560,656,0.4605263157894737,0.5394736842105263
E01029627,1415,642,773,0.45371024734982335,0.5462897526501767
E01029626,1443,709,734,0.49133749133749133,0.5086625086625086
E01029628,1192,558,634,0.46812080536912754,0.5318791946308725
E01029629,1218,574,644,0.47126436781609193,0.5287356321839081
E01029630,1454,703,751,0.48349381017881704,0.5165061898211829
E01029631,1443,709,734,0.49133749133749133,0.5086625086625086
E01029654,2246,1106,1140,0.4924309884238646,0.5075690115761353
E01029661,1990,981,1009,0.492964824120603,0.507035175879397
E01029663,1456,710,746,0.4876373626373626,0.5123626373626373
E01029665,1810,895,915,0.494475138121547,0.505524861878453
E01029662,2279,1132,1147,0.49670908293111016,0.5032909170688898
E01029664,1595,775,820,0.48589341692789967,0.5141065830721003
E01029666,1556,729,827,0.4685089974293059,0.531491002570694
E01029671,1490,740,750,0.4966442953020134,0.5033557046979866
E01029673,1659,791,868,0.4767932489451477,0.5232067510548524
E01029676,1057,494,563,0.467360454115421,0.532639545884579
E01029679,1454,686,768,0.4718019257221458,0.5281980742778541
E01029680,1536,748,788,0.4869791666666667,0.5130208333333334
E01029645,2033,979,1054,0.4815543531726513,0.5184456468273487
E01029667,2225,1124,1101,0.5051685393258427,0.4948314606741573
E01029672,1568,783,785,0.49936224489795916,0.5006377551020408
E01029674,1849,942,907,0.5094645754461872,0.4905354245538129
E01029675,1476,689,787,0.46680216802168023,0.5331978319783198
E01029677,1314,635,679,0.4832572298325723,0.5167427701674278
E01029678,1752,895,857,0.5108447488584474,0.4891552511415525
E01029649,1158,535,623,0.4620034542314335,0.5379965457685665
E01029650,1527,758,769,0.49639816633922723,0.5036018336607727
E01029651,1545,719,826,0.46537216828478967,0.5346278317152103
E01029652,1730,846,884,0.4890173410404624,0.5109826589595375
E01029653,1265,608,657,0.4806324110671937,0.5193675889328063
E01029702,1530,750,780,0.49019607843137253,0.5098039215686274
E01029703,1549,751,798,0.48482892188508714,0.5151710781149128
E01029704,1386,666,720,0.4805194805194805,0.5194805194805194
E01029705,1466,744,722,0.5075034106412005,0.4924965893587995
E01029681,1207,594,613,0.49212924606462305,0.507870753935377
E01029682,1651,785,866,0.47546941247728647,0.5245305875227135
E01029683,1312,609,703,0.4641768292682927,0.5358231707317073
E01029748,1358,698,660,0.5139911634756995,0.48600883652430044
E01029749,1642,792,850,0.4823386114494519,0.5176613885505481
E01029740,1675,792,883,0.4728358208955224,0.5271641791044777
E01029744,2356,1125,1231,0.47750424448217316,0.5224957555178268
E01029745,1686,846,840,0.501779359430605,0.498220640569395
E01029746,1533,751,782,0.48988910632746246,0.5101108936725375
E01029753,1305,641,664,0.49118773946360156,0.5088122605363985
E01029756,1779,884,895,0.49690837549184935,0.5030916245081506
E01029733,1954,963,991,0.49283520982599793,0.5071647901740021
E01029739,1610,796,814,0.49440993788819876,0.5055900621118012
E01029741,1705,841,864,0.49325513196480936,0.5067448680351906
E01029754,1330,654,676,0.4917293233082707,0.5082706766917293
E01029755,1406,667,739,0.4743954480796586,0.5256045519203414
E01029695,2002,966,1036,0.4825174825174825,0.5174825174825175
E01029696,1508,768,740,0.5092838196286472,0.4907161803713528
E01029697,1614,699,915,0.43308550185873607,0.5669144981412639
E01029698,1533,738,795,0.48140900195694714,0.5185909980430529
E01029747,1453,746,707,0.5134205092911218,0.4865794907088782
E01029690,1550,777,773,0.5012903225806452,0.49870967741935485
E01029718,1962,994,968,0.5066258919469928,0.49337410805300713
E01029743,1396,683,713,0.4892550143266476,0.5107449856733525
E01029751,1563,769,794,0.49200255918106206,0.5079974408189379
E01029719,1559,763,796,0.4894162924951892,0.5105837075048107
E01029720,1630,806,824,0.49447852760736194,0.505521472392638
E01029721,1624,777,847,0.47844827586206895,0.521551724137931
E01029750,1558,755,803,0.48459563543003853,0.5154043645699615
E01029752,1288,585,703,0.45419254658385094,0.5458074534161491
E01029687,1870,926,944,0.49518716577540106,0.5048128342245989
E01029710,1434,699,735,0.4874476987447699,0.5125523012552301
E01029711,1514,745,769,0.49207397622192867,0.5079260237780714
E01029712,1917,926,991,0.48304642670839854,0.5169535732916014
E01029713,1580,775,805,0.49050632911392406,0.509493670886076
E01029692,1592,773,819,0.48555276381909546,0.5144472361809045
E01029693,1696,1024,672,0.6037735849056604,0.39622641509433965
E01029722,1655,854,801,0.516012084592145,0.48398791540785496
E01029725,2244,1628,616,0.7254901960784313,0.27450980392156865
E01029689,1671,892,779,0.5338120885697187,0.46618791143028127
E01029691,1213,652,561,0.5375103050288541,0.4624896949711459
E01029694,1445,799,646,0.5529411764705883,0.4470588235294118
E01029699,1966,990,976,0.503560528992879,0.49643947100712105
E01029701,1940,1077,863,0.5551546391752578,0.44484536082474224
E01029686,1421,674,747,0.47431386347642507,0.525686136523575
E01029700,1276,612,664,0.47962382445141066,0.5203761755485894
E01029723,1586,839,747,0.5290037831021438,0.47099621689785626
E01029724,1771,881,890,0.49745906267645396,0.502540937323546
E01029732,2423,1506,917,0.6215435410647957,0.3784564589352043
E01029714,1589,785,804,0.49402139710509757,0.5059786028949025
E01029736,1585,756,829,0.4769716088328076,0.5230283911671925
E01029737,1577,772,805,0.4895370957514268,0.5104629042485732
E01029738,1378,667,711,0.48403483309143686,0.5159651669085631
E01029742,2080,1081,999,0.5197115384615385,0.48028846153846155
E01029715,1631,762,869,0.46719803801348864,0.5328019619865113
E01029716,1592,782,810,0.49120603015075376,0.5087939698492462
E01029717,1779,844,935,0.4744238336143901,0.5255761663856099
E01029727,1552,768,784,0.4948453608247423,0.5051546391752577
E01029728,1429,688,741,0.4814555633310007,0.5185444366689993
E01029684,1488,723,765,0.48588709677419356,0.5141129032258065
E01029685,1568,741,827,0.4725765306122449,0.5274234693877551
E01029730,1082,534,548,0.49353049907578556,0.5064695009242144
E01029731,1637,806,831,0.4923640806353085,0.5076359193646915
E01029757,1604,797,807,0.49688279301745636,0.5031172069825436
E01029758,1535,748,787,0.48729641693811077,0.5127035830618892
E01029759,1715,849,866,0.49504373177842564,0.5049562682215744
E01029760,1570,765,805,0.4872611464968153,0.5127388535031847
E01029688,2275,1139,1136,0.5006593406593407,0.49934065934065935
E01029706,1547,785,762,0.5074337427278603,0.49256625727213965
E01029707,1456,714,742,0.49038461538461536,0.5096153846153846
E01029708,1909,970,939,0.5081194342587743,0.4918805657412258
E01029709,1483,724,759,0.4881995954146999,0.5118004045853001
E01029726,1723,852,871,0.4944863609982589,0.5055136390017412
E01029729,1604,812,792,0.5062344139650873,0.4937655860349127
E01029734,2242,1081,1161,0.48215878679750224,0.5178412132024978
E01029735,2345,1162,1183,0.4955223880597015,0.5044776119402985
E01029797,1553,781,772,0.5028976175144881,0.4971023824855119
E01029806,1499,718,781,0.4789859906604403,0.5210140093395597
E01029808,1424,691,733,0.48525280898876405,0.514747191011236
E01029809,1458,683,775,0.46844993141289437,0.5315500685871056
E01029810,1384,686,698,0.4956647398843931,0.5043352601156069
E01029767,1640,829,811,0.5054878048780488,0.4945121951219512
E01029769,1664,828,836,0.49759615384615385,0.5024038461538461
E01029770,1925,978,947,0.5080519480519481,0.49194805194805197
E01029802,1809,922,887,0.5096738529574351,0.49032614704256494
E01029763,1630,754,876,0.4625766871165644,0.5374233128834356
E01029764,1848,882,966,0.4772727272727273,0.5227272727272727
E01029765,1390,670,720,0.48201438848920863,0.5179856115107914
E01029766,1510,727,783,0.4814569536423841,0.5185430463576159
E01029774,1980,955,1025,0.4823232323232323,0.5176767676767676
E01029768,1374,672,702,0.4890829694323144,0.5109170305676856
E01029771,1641,753,888,0.45886654478976235,0.5411334552102377
E01029772,1752,883,869,0.5039954337899544,0.4960045662100457
E01029773,1538,769,769,0.5,0.5
E01029804,1763,874,889,0.49574588769143507,0.504254112308565
E01029807,1143,532,611,0.4654418197725284,0.5345581802274716
E01029811,1557,770,787,0.4945407835581246,0.5054592164418754
E01029812,2009,997,1012,0.4962667994026879,0.5037332005973121
E01029814,1685,836,849,0.49614243323442137,0.5038575667655787
E01029792,2395,1187,1208,0.49561586638830896,0.504384133611691
E01029793,1628,816,812,0.5012285012285013,0.4987714987714988
E01029805,1719,808,911,0.4700407213496219,0.5299592786503782
E01029813,2165,1069,1096,0.49376443418013855,0.5062355658198614
E01029815,1526,734,792,0.48099606815203144,0.5190039318479686
E01029816,1436,678,758,0.47214484679665736,0.5278551532033426
E01029801,1840,947,893,0.5146739130434783,0.48532608695652174
E01029803,1798,897,901,0.4988876529477197,0.5011123470522804
E01029817,1848,927,921,0.5016233766233766,0.49837662337662336
E01029762,1591,785,806,0.49340037712130735,0.5065996228786926
E01029775,1534,757,777,0.4934810951760104,0.5065189048239895
E01029776,1815,887,928,0.4887052341597796,0.5112947658402204
E01029777,1532,737,795,0.4810704960835509,0.5189295039164491
E01029779,1616,770,846,0.47648514851485146,0.5235148514851485
E01029780,1637,815,822,0.49786194257788635,0.5021380574221136
E01029794,1421,704,717,0.4954257565095003,0.5045742434904996
E01029818,1531,739,792,0.48269105160026127,0.5173089483997387
E01029819,1670,837,833,0.5011976047904192,0.49880239520958086
E01029761,1377,689,688,0.5003631082062454,0.49963689179375453
E01029782,2036,1041,995,0.5112966601178782,0.48870333988212183
E01029795,1662,831,831,0.5,0.5
E01029796,1480,718,762,0.4851351351351351,0.5148648648648648
E01029781,1524,765,759,0.5019685039370079,0.49803149606299213
E01029783,1416,679,737,0.4795197740112994,0.5204802259887006
E01029786,1463,723,740,0.49419002050580996,0.50580997949419
E01029787,1716,837,879,0.48776223776223776,0.5122377622377622
E01029778,1720,866,854,0.5034883720930232,0.4965116279069767
E01029789,1029,514,515,0.49951409135082603,0.500485908649174
E01029798,1698,840,858,0.49469964664310956,0.5053003533568905
E01029799,1841,925,916,0.5024443237370994,0.4975556762629006
E01029800,1556,744,812,0.4781491002570694,0.5218508997429306
E01029784,2201,1111,1090,0.5047705588368924,0.4952294411631077
E01029785,1809,877,932,0.4847982310668878,0.5152017689331122
E01029788,1356,697,659,0.5140117994100295,0.4859882005899705
E01029790,1955,977,978,0.4997442455242967,0.5002557544757034
E01029791,1389,672,717,0.4838012958963283,0.5161987041036717
E01029846,1267,619,648,0.48855564325177586,0.5114443567482242
E01029847,1342,659,683,0.4910581222056632,0.5089418777943369
E01029848,1231,611,620,0.49634443541835904,0.503655564581641
E01029852,1743,814,929,0.4670109007458405,0.5329890992541595
E01029853,1721,789,932,0.45845438698431146,0.5415456130156886
E01029854,1513,743,770,0.4910773298083278,0.5089226701916721
E01029835,1661,803,858,0.48344370860927155,0.5165562913907285
E01029836,1278,625,653,0.4890453834115806,0.5109546165884195
E01029849,1470,703,767,0.4782312925170068,0.5217687074829932
E01029850,1310,639,671,0.48778625954198473,0.5122137404580153
E01029851,2132,1031,1101,0.48358348968105064,0.5164165103189493
E01029820,1558,785,773,0.5038510911424904,0.4961489088575096
E01029821,1470,727,743,0.49455782312925173,0.5054421768707483
E01029822,1576,788,788,0.5,0.5
E01029824,1832,873,959,0.47652838427947597,0.523471615720524
E01029841,1451,734,717,0.5058580289455548,0.4941419710544452
E01029823,1483,717,766,0.48347943358057993,0.5165205664194201
E01029831,1494,742,752,0.4966532797858099,0.5033467202141901
E01029832,1636,788,848,0.48166259168704156,0.5183374083129584
E01029834,1541,750,791,0.48669695003244645,0.5133030499675535
E01029844,1244,617,627,0.4959807073954984,0.5040192926045016
E01029833,1693,865,828,0.5109273479031305,0.48907265209686945
E01029837,1591,793,798,0.4984286612193589,0.5015713387806411
E01029838,1568,803,765,0.5121173469387755,0.48788265306122447
E01029839,1235,623,612,0.5044534412955466,0.49554655870445347
E01029825,1338,675,663,0.5044843049327354,0.49551569506726456
E01029826,1546,768,778,0.49676584734799484,0.5032341526520052
E01029827,1457,705,752,0.4838709677419355,0.5161290322580645
E01029828,1328,636,692,0.4789156626506024,0.5210843373493976
E01029830,1190,568,622,0.4773109243697479,0.5226890756302521
E01029840,1360,670,690,0.49264705882352944,0.5073529411764706
E01029842,1354,644,710,0.4756277695716396,0.5243722304283605
E01029843,1497,728,769,0.4863059452237809,0.5136940547762191
E01029845,1113,506,607,0.4546271338724169,0.5453728661275831
E01029859,1846,906,940,0.49079089924160346,0.5092091007583965
E01029855,1543,738,805,0.4782890473104342,0.5217109526895658
E01029856,1465,739,726,0.5044368600682594,0.4955631399317406
E01029857,1418,711,707,0.501410437235543,0.498589562764457
E01029858,1590,768,822,0.4830188679245283,0.5169811320754717
E01029865,1676,831,845,0.4958233890214797,0.5041766109785203
E01029860,1329,679,650,0.510910458991723,0.4890895410082769
E01029861,1348,639,709,0.47403560830860536,0.5259643916913946
E01029862,1340,660,680,0.4925373134328358,0.5074626865671642
E01029863,1753,888,865,0.50656018254421,0.4934398174557901
E01029864,1605,799,806,0.49781931464174456,0.5021806853582554
E01029829,1995,1004,991,0.5032581453634085,0.4967418546365915
E01029867,1675,829,846,0.4949253731343284,0.5050746268656716
E01029868,1430,711,719,0.4972027972027972,0.5027972027972027
E01029869,1618,805,813,0.49752781211372066,0.5024721878862793
E01032901,1607,790,817,0.4915992532669571,0.5084007467330429
E01032902,1352,656,696,0.48520710059171596,0.514792899408284
E01031035,1977,965,1012,0.48811330298431965,0.5118866970156803
E01031036,1527,758,769,0.49639816633922723,0.5036018336607727
E01031037,1500,738,762,0.492,0.508
E01031038,2017,996,1021,0.49380267724343085,0.5061973227565691
E01031039,1692,844,848,0.4988179669030733,0.5011820330969267
E01031040,1773,881,892,0.49689791314156795,0.503102086858432
E01031016,1571,765,806,0.486950986632718,0.513049013367282
E01031025,1601,780,821,0.4871955028107433,0.5128044971892567
E01031026,1614,800,814,0.49566294919454773,0.5043370508054523
E01031031,2583,1299,1284,0.502903600464576,0.49709639953542395
E01031032,1339,667,672,0.4981329350261389,0.5018670649738611
E01031009,2192,1096,1096,0.5,0.5
E01031010,1753,891,862,0.5082715345122647,0.4917284654877353
E01031011,1966,960,1006,0.4883011190233978,0.5116988809766022
E01031012,1442,680,762,0.47156726768377255,0.5284327323162274
E01031013,1043,504,539,0.48322147651006714,0.5167785234899329
E01031014,1204,606,598,0.5033222591362126,0.49667774086378735
E01031015,1403,693,710,0.49394155381325733,0.5060584461867427
E01031023,1578,801,777,0.5076045627376425,0.4923954372623574
E01031024,1617,815,802,0.5040197897340755,0.49598021026592454
E01031033,1851,883,968,0.4770394381415451,0.5229605618584549
E01031034,1879,945,934,0.5029270888770623,0.4970729111229377
E01031005,1429,711,718,0.49755073477956613,0.5024492652204339
E01031008,1353,666,687,0.49223946784922396,0.5077605321507761
E01031017,1283,647,636,0.5042868277474669,0.49571317225253314
E01031018,1137,556,581,0.4890061565523307,0.5109938434476693
E01031029,1503,720,783,0.47904191616766467,0.5209580838323353
E01031030,2235,1078,1157,0.4823266219239374,0.5176733780760626
E01031019,1709,839,870,0.4909303686366296,0.5090696313633704
E01031020,1524,733,791,0.4809711286089239,0.5190288713910761
E01031021,1572,741,831,0.4713740458015267,0.5286259541984732
E01031022,1676,813,863,0.4850835322195704,0.5149164677804295
E01031041,1711,835,876,0.4880187025131502,0.5119812974868498
E01031042,1733,848,885,0.4893248701673399,0.5106751298326602
E01031006,1471,734,737,0.4989802855200544,0.5010197144799456
E01031007,1218,613,605,0.5032840722495895,0.4967159277504105
E01031027,1472,742,730,0.5040760869565217,0.49592391304347827
E01031028,1866,961,905,0.515005359056806,0.484994640943194
E01031110,1525,723,802,0.4740983606557377,0.5259016393442623
E01031111,1122,569,553,0.5071301247771836,0.4928698752228164
E01031112,1636,794,842,0.48533007334963324,0.5146699266503667
E01031113,1466,712,754,0.48567530695770805,0.514324693042292
E01031114,1507,723,784,0.47976111479761113,0.5202388852023888
E01031073,1884,925,959,0.49097664543524416,0.5090233545647559
E01031074,1550,788,762,0.5083870967741936,0.4916129032258065
E01031075,1646,773,873,0.46962332928311057,0.5303766707168894
E01032890,2241,1043,1198,0.465417224453369,0.5345827755466309
E01031100,1357,695,662,0.5121591746499632,0.48784082535003687
E01031101,1442,720,722,0.49930651872399445,0.5006934812760055
E01031102,1364,685,679,0.5021994134897361,0.49780058651026393
E01031103,1333,685,648,0.5138784696174044,0.48612153038259565
E01031104,1447,667,780,0.4609536973047685,0.5390463026952315
E01031081,1693,828,865,0.48907265209686945,0.5109273479031305
E01031082,1386,721,665,0.5202020202020202,0.4797979797979798
E01031083,1552,780,772,0.5025773195876289,0.49742268041237114
E01031084,2227,1087,1140,0.48810058374494836,0.5118994162550516
E01031085,1375,690,685,0.5018181818181818,0.49818181818181817
E01031043,1647,868,779,0.5270188221007893,0.4729811778992107
E01031044,1680,822,858,0.48928571428571427,0.5107142857142857
E01031045,1729,855,874,0.4945054945054945,0.5054945054945055
E01031046,1728,865,863,0.5005787037037037,0.4994212962962963
E01031047,1934,964,970,0.4984488107549121,0.5015511892450879
E01031057,1566,785,781,0.5012771392081737,0.4987228607918263
E01031058,1453,702,751,0.4831383344803854,0.5168616655196145
E01031059,1470,734,736,0.4993197278911565,0.5006802721088436
E01031060,1442,718,724,0.49791955617198336,0.5020804438280166
E01031061,1521,748,773,0.4917817225509533,0.5082182774490467
E01031090,1447,703,744,0.48583275742916376,0.5141672425708362
E01031091,1455,688,767,0.47285223367697593,0.5271477663230241
E01031092,1466,734,732,0.5006821282401092,0.49931787175989084
E01031093,1348,679,669,0.5037091988130564,0.49629080118694363
E01031094,1162,575,587,0.49483648881239245,0.5051635111876076
E01031048,1265,623,642,0.4924901185770751,0.5075098814229249
E01031049,2258,1109,1149,0.49114260407440213,0.5088573959255979
E01031050,1838,948,890,0.515778019586507,0.4842219804134929
E01031051,1375,654,721,0.47563636363636363,0.5243636363636364
E01031115,1762,867,895,0.49205448354143017,0.5079455164585698
E01031116,1690,795,895,0.47041420118343197,0.5295857988165681
E01031117,1502,704,798,0.46870838881491345,0.5312916111850865
E01031118,1202,573,629,0.4767054908485857,0.5232945091514143
E01031119,1631,846,785,0.5187001839362354,0.48129981606376454
E01031052,1512,728,784,0.48148148148148145,0.5185185185185185
E01031053,1441,672,769,0.46634281748785567,0.5336571825121443
E01031054,1569,767,802,0.4888463989802422,0.5111536010197578
E01031055,1654,817,837,0.4939540507859734,0.5060459492140266
E01031056,1500,729,771,0.486,0.514
E01031120,1395,678,717,0.4860215053763441,0.513978494623656
E01031121,1203,593,610,0.4929343308395677,0.5070656691604323
E01031122,1482,716,766,0.48313090418353577,0.5168690958164642
E01031123,1260,642,618,0.5095238095238095,0.49047619047619045
E01031124,1537,764,773,0.4970722186076773,0.5029277813923227
E01031105,1434,700,734,0.4881450488145049,0.5118549511854951
E01031106,1437,714,723,0.4968684759916493,0.5031315240083507
E01031107,1158,579,579,0.5,0.5
E01031108,1389,705,684,0.5075593952483801,0.4924406047516199
E01031109,1623,802,821,0.4941466420209489,0.5058533579790512
E01031062,1237,607,630,0.49070331447049315,0.5092966855295069
E01031063,1310,644,666,0.4916030534351145,0.5083969465648855
E01031064,1202,571,631,0.4750415973377704,0.5249584026622296
E01031065,1525,727,798,0.47672131147540986,0.5232786885245901
E01031066,1392,647,745,0.46479885057471265,0.5352011494252874
E01031067,1487,733,754,0.4929388029589778,0.5070611970410221
E01031068,1692,830,862,0.4905437352245863,0.5094562647754137
E01031069,1476,720,756,0.4878048780487805,0.5121951219512195
E01031070,1491,719,772,0.48222669349429914,0.5177733065057009
E01031095,1247,626,621,0.5020048115477145,0.49799518845228546
E01031096,1380,680,700,0.4927536231884058,0.5072463768115942
E01031097,1653,816,837,0.49364791288566245,0.5063520871143375
E01031098,1493,736,757,0.49296718017414604,0.507032819825854
E01031099,2270,1144,1126,0.5039647577092511,0.4960352422907489
E01031086,1873,938,935,0.5008008542445275,0.49919914575547253
E01031087,2211,1080,1131,0.48846675712347354,0.5115332428765265
E01031088,1942,933,1009,0.48043254376931,0.51956745623069
E01031089,1447,671,776,0.4637180373185902,0.5362819626814098
E01031077,1448,690,758,0.47651933701657456,0.5234806629834254
E01031078,2077,1015,1062,0.4886856042368801,0.5113143957631199
E01031079,1476,732,744,0.4959349593495935,0.5040650406504065
E01031080,1623,743,880,0.45779420825631545,0.5422057917436846
E01032588,1382,666,716,0.48191027496382055,0.5180897250361794
E01031129,1148,549,599,0.47822299651567945,0.5217770034843205
E01031159,1642,816,826,0.49695493300852617,0.5030450669914738
E01031160,2134,1097,1037,0.514058106841612,0.485941893158388
E01031182,2410,1327,1083,0.5506224066390042,0.44937759336099586
E01032891,1684,859,825,0.5100950118764845,0.48990498812351546
E01032892,2086,1009,1077,0.48370086289549374,0.5162991371045063
E01031137,1167,581,586,0.49785775492716366,0.5021422450728363
E01031138,1196,577,619,0.48244147157190637,0.5175585284280937
E01031139,1844,918,926,0.49783080260303686,0.5021691973969631
E01031140,1369,677,692,0.49452154857560265,0.5054784514243974
E01031141,1799,892,907,0.49583101723179546,0.5041689827682045
E01031142,1672,824,848,0.49282296650717705,0.507177033492823
E01031171,1505,760,745,0.5049833887043189,0.4950166112956811
E01031172,1667,809,858,0.48530293941211755,0.5146970605878824
E01031173,1858,971,887,0.5226049515608181,0.4773950484391819
E01031174,1724,886,838,0.5139211136890951,0.48607888631090485
E01031151,1561,805,756,0.515695067264574,0.484304932735426
E01031152,1104,548,556,0.4963768115942029,0.5036231884057971
E01031153,1456,713,743,0.4896978021978022,0.5103021978021978
E01031154,1751,869,882,0.49628783552255856,0.5037121644774415
E01031181,1813,913,900,0.5035852178709321,0.49641478212906787
E01031130,1764,903,861,0.5119047619047619,0.4880952380952381
E01031131,1642,879,763,0.5353227771010962,0.4646772228989038
E01031132,1942,1003,939,0.5164778578784758,0.4835221421215242
E01031133,1589,826,763,0.5198237885462555,0.4801762114537445
E01031167,1378,686,692,0.49782293178519593,0.502177068214804
E01031168,2766,1327,1439,0.47975415762834417,0.5202458423716558
E01031169,2003,1040,963,0.5192211682476285,0.48077883175237146
E01031170,1613,822,791,0.5096094234345939,0.4903905765654061
E01031125,1472,748,724,0.5081521739130435,0.49184782608695654
E01031127,1580,786,794,0.49746835443037973,0.5025316455696203
E01031164,2003,998,1005,0.4982526210683974,0.5017473789316026
E01031165,1595,802,793,0.5028213166144201,0.4971786833855799
E01032893,1872,923,949,0.4930555555555556,0.5069444444444444
E01032894,1362,668,694,0.49045521292217326,0.5095447870778267
E01032895,1440,721,719,0.5006944444444444,0.49930555555555556
E01031155,1408,692,716,0.4914772727272727,0.5085227272727273
E01031156,1466,719,747,0.49045020463847205,0.509549795361528
E01031157,1956,970,986,0.49591002044989774,0.5040899795501023
E01031158,1085,554,531,0.5105990783410138,0.4894009216589862
E01031143,1526,779,747,0.5104849279161205,0.4895150720838794
E01031144,1288,632,656,0.4906832298136646,0.5093167701863354
E01031145,1526,788,738,0.5163826998689384,0.4836173001310616
E01031146,1525,737,788,0.48327868852459016,0.5167213114754098
E01031161,2006,1024,982,0.5104685942173479,0.48953140578265203
E01031162,1727,854,873,0.4944991314418066,0.5055008685581934
E01031163,1543,760,783,0.49254698639014904,0.507453013609851
E01031179,1730,861,869,0.4976878612716763,0.5023121387283237
E01031180,2018,1002,1016,0.4965312190287413,0.5034687809712587
E01031134,1685,799,886,0.47418397626112757,0.5258160237388724
E01031135,1607,765,842,0.4760423148724331,0.5239576851275669
E01031136,1719,794,925,0.4618964514252472,0.5381035485747527
E01031175,1460,700,760,0.4794520547945205,0.5205479452054794
E01031176,1490,729,761,0.489261744966443,0.5107382550335571
E01031177,1442,684,758,0.47434119278779474,0.5256588072122053
E01031178,1398,681,717,0.4871244635193133,0.5128755364806867
E01031147,1576,759,817,0.4815989847715736,0.5184010152284264
E01031148,1730,843,887,0.48728323699421966,0.5127167630057804
E01031149,1486,735,751,0.4946164199192463,0.5053835800807537
E01031150,1159,571,588,0.4926660914581536,0.5073339085418465
E01031166,1908,920,988,0.48218029350104824,0.5178197064989518
E01031213,1858,930,928,0.5005382131324004,0.49946178686759957
E01031243,1960,982,978,0.5010204081632653,0.4989795918367347
E01031244,1861,886,975,0.47608812466415906,0.5239118753358409
E01031195,2274,1081,1193,0.47537379067722074,0.5246262093227793
E01031202,1557,751,806,0.48233782915863843,0.5176621708413616
E01031203,1507,713,794,0.47312541473125413,0.5268745852687459
E01031204,1318,637,681,0.48330804248861914,0.5166919575113809
E01031239,1570,773,797,0.4923566878980892,0.5076433121019108
E01031240,1364,649,715,0.47580645161290325,0.5241935483870968
E01031241,1433,708,725,0.49406838799720865,0.5059316120027914
E01031242,1512,729,783,0.48214285714285715,0.5178571428571429
E01031219,1507,744,763,0.4936960849369608,0.5063039150630392
E01031220,1529,744,785,0.486592544146501,0.513407455853499
E01031221,1532,711,821,0.4640992167101828,0.5359007832898173
E01031222,1999,1007,992,0.503751875937969,0.496248124062031
E01031223,1347,693,654,0.5144766146993318,0.48552338530066813
E01031224,1144,567,577,0.4956293706293706,0.5043706293706294
E01031197,1202,591,611,0.49168053244592347,0.5083194675540765
E01031198,1283,626,657,0.48791893998441155,0.5120810600155885
E01031199,1476,735,741,0.49796747967479676,0.5020325203252033
E01031200,1583,790,793,0.4990524320909665,0.5009475679090335
E01031201,1566,747,819,0.47701149425287354,0.5229885057471264
E01031210,1258,613,645,0.4872813990461049,0.5127186009538951
E01031211,1074,514,560,0.478584729981378,0.521415270018622
E01031183,1648,803,845,0.48725728155339804,0.5127427184466019
E01031184,1519,756,763,0.4976958525345622,0.5023041474654378
E01031185,1370,645,725,0.4708029197080292,0.5291970802919708
E01031186,1546,728,818,0.47089262613195343,0.5291073738680466
E01031187,1886,917,969,0.48621420996818665,0.5137857900318133
E01031188,2228,1095,1133,0.4914721723518851,0.5085278276481149
E01031208,2068,1011,1057,0.4888781431334623,0.5111218568665378
E01031217,1201,582,619,0.4845961698584513,0.5154038301415487
E01031218,1200,617,583,0.5141666666666667,0.48583333333333334
E01031249,1201,549,652,0.4571190674437968,0.5428809325562032
E01031250,1476,709,767,0.4803523035230352,0.5196476964769647
E01031251,1199,575,624,0.47956630525437866,0.5204336947456214
E01031252,1365,639,726,0.46813186813186813,0.5318681318681319
E01031253,1522,729,793,0.47897503285151116,0.5210249671484888
E01031228,1589,787,802,0.49528005034612965,0.5047199496538703
E01031229,1822,857,965,0.4703622392974753,0.5296377607025247
E01031230,2406,1209,1197,0.5024937655860349,0.4975062344139651
E01031231,2146,1055,1091,0.4916123019571295,0.5083876980428704
E01031236,1605,798,807,0.497196261682243,0.502803738317757
E01031238,1333,671,662,0.5033758439609902,0.4966241560390098
E01031225,1641,781,860,0.47592931139549055,0.5240706886045094
E01031227,2007,943,1064,0.46985550572994517,0.5301444942700548
E01033250,1394,699,695,0.5014347202295553,0.49856527977044474
E01033251,1154,577,577,0.5,0.5
E01033252,1291,624,667,0.4833462432223083,0.5166537567776918
E01031232,2440,1155,1285,0.4733606557377049,0.5266393442622951
E01031233,1622,769,853,0.47410604192355116,0.5258939580764488
E01031234,1756,764,992,0.43507972665148065,0.5649202733485194
E01031235,1818,827,991,0.45489548954895487,0.5451045104510451
E01031237,1421,702,719,0.494018296973962,0.505981703026038
E01031189,1546,760,786,0.49159120310478654,0.5084087968952135
E01031190,1750,855,895,0.48857142857142855,0.5114285714285715
E01031191,1851,922,929,0.49810913019989195,0.501890869800108
E01031192,1904,908,996,0.47689075630252103,0.523109243697479
E01031248,2172,1059,1113,0.48756906077348067,0.5124309392265194
E01031194,2412,1209,1203,0.5012437810945274,0.4987562189054726
E01031205,1585,790,795,0.49842271293375395,0.501577287066246
E01031206,1476,713,763,0.4830623306233062,0.5169376693766937
E01031207,1259,622,637,0.49404289118347894,0.505957108816521
E01031247,2287,1115,1172,0.48753825972890247,0.5124617402710975
E01031196,2402,1198,1204,0.4987510407993339,0.5012489592006661
E01031212,2648,1274,1374,0.4811178247734139,0.5188821752265861
E01031245,1219,569,650,0.4667760459392945,0.5332239540607056
E01031246,1089,544,545,0.4995408631772268,0.5004591368227732
E01031193,2143,1036,1107,0.48343443770415306,0.5165655622958469
E01031209,2116,1028,1088,0.48582230623818523,0.5141776937618148
E01031214,1827,893,934,0.48877941981390255,0.5112205801860974
E01031215,1736,815,921,0.4694700460829493,0.5305299539170507
E01031216,1475,693,782,0.46983050847457625,0.5301694915254237
E01031254,1508,737,771,0.4887267904509284,0.5112732095490716
E01031255,1487,733,754,0.4929388029589778,0.5070611970410221
E01031256,1625,799,826,0.4916923076923077,0.5083076923076923
E01031257,1434,685,749,0.4776847977684798,0.5223152022315202
E01031258,1511,711,800,0.47054930509596293,0.5294506949040371
E01031296,1645,794,851,0.4826747720364742,0.5173252279635259
E01031297,1949,1000,949,0.513083632632119,0.48691636736788096
E01031298,1654,781,873,0.47218863361547764,0.5278113663845224
E01031299,1424,703,721,0.4936797752808989,0.5063202247191011
E01031300,1716,837,879,0.48776223776223776,0.5122377622377622
E01031303,1498,715,783,0.4773030707610147,0.5226969292389854
E01031304,1505,749,756,0.49767441860465117,0.5023255813953489
E01031305,1521,734,787,0.482577251808021,0.517422748191979
E01031306,1494,757,737,0.5066934404283802,0.4933065595716198
E01031307,1445,713,732,0.4934256055363322,0.5065743944636678
E01031281,1485,753,732,0.5070707070707071,0.49292929292929294
E01031282,1469,737,732,0.5017018379850239,0.4982981620149762
E01031283,1278,634,644,0.49608763693270735,0.5039123630672926
E01031284,1232,607,625,0.4926948051948052,0.5073051948051948
E01031277,1557,762,795,0.48940269749518306,0.5105973025048169
E01031278,1461,712,749,0.487337440109514,0.5126625598904859
E01031279,1359,645,714,0.4746136865342163,0.5253863134657837
E01031280,1313,639,674,0.48667174409748665,0.5133282559025133
E01031301,1420,699,721,0.4922535211267606,0.5077464788732394
E01031302,1022,507,515,0.49608610567514677,0.5039138943248532
E01031308,3496,1758,1738,0.5028604118993135,0.4971395881006865
E01031273,1326,709,617,0.5346907993966817,0.46530920060331826
E01031274,1504,700,804,0.4654255319148936,0.5345744680851063
E01031275,1252,608,644,0.48562300319488816,0.5143769968051118
E01031276,1542,762,780,0.49416342412451364,0.5058365758754864
E01031272,1806,903,903,0.5,0.5
E01031285,2086,1012,1074,0.4851390220517737,0.5148609779482263
E01031286,1463,703,760,0.4805194805194805,0.5194805194805194
E01031287,1561,762,799,0.48814862267777065,0.5118513773222293
E01031288,1710,827,883,0.48362573099415207,0.5163742690058479
E01031289,1525,731,794,0.479344262295082,0.520655737704918
E01033253,1446,782,664,0.5408022130013831,0.45919778699861685
E01033256,1265,708,557,0.5596837944664032,0.44031620553359685
E01031309,1726,885,841,0.5127462340672074,0.48725376593279257
E01031310,1344,676,668,0.5029761904761905,0.49702380952380953
E01031311,1360,652,708,0.47941176470588237,0.5205882352941177
E01031312,1192,575,617,0.4823825503355705,0.5176174496644296
E01031313,1358,688,670,0.5066273932253313,0.49337260677466865
E01031314,1338,661,677,0.4940209267563528,0.5059790732436472
E01031290,1666,878,788,0.5270108043217286,0.4729891956782713
E01031291,1563,833,730,0.5329494561740243,0.46705054382597566
E01031292,1495,728,767,0.48695652173913045,0.5130434782608696
E01031293,1679,797,882,0.47468731387730795,0.5253126861226921
E01031294,1581,777,804,0.49146110056925996,0.50853889943074
E01031295,1182,582,600,0.49238578680203043,0.5076142131979695
E01031271,1749,852,897,0.48713550600343053,0.5128644939965694
E01031332,1398,693,705,0.4957081545064378,0.5042918454935622
E01031333,1353,677,676,0.500369549150037,0.49963045084996305
E01031334,1522,706,816,0.46386333771353483,0.5361366622864652
E01031335,1475,776,699,0.5261016949152543,0.4738983050847458
E01031336,2143,1146,997,0.5347643490433971,0.4652356509566029
E01031337,1502,795,707,0.5292942743009321,0.47070572569906793
E01031321,1332,678,654,0.509009009009009,0.49099099099099097
E01031322,1862,943,919,0.5064446831364124,0.49355531686358756
E01031323,1588,773,815,0.48677581863979846,0.5132241813602015
E01031324,2021,1030,991,0.5096486887679367,0.4903513112320633
E01031325,1402,653,749,0.4657631954350927,0.5342368045649073
E01033254,1440,718,722,0.4986111111111111,0.5013888888888889
E01033255,1659,833,826,0.5021097046413502,0.4978902953586498
E01031315,2201,1115,1086,0.5065879145842799,0.4934120854157201
E01031316,1445,678,767,0.4692041522491349,0.5307958477508651
E01031317,1510,729,781,0.4827814569536424,0.5172185430463576
E01031318,1920,957,963,0.4984375,0.5015625
E01031319,1996,987,1009,0.49448897795591185,0.5055110220440882
E01031320,1420,744,676,0.523943661971831,0.476056338028169
E01031261,1547,842,705,0.5442792501616031,0.4557207498383969
E01031262,1430,761,669,0.5321678321678321,0.46783216783216786
E01031263,1868,1024,844,0.5481798715203426,0.4518201284796574
E01031264,1699,856,843,0.503825779870512,0.4961742201294879
E01031265,1439,735,704,0.5107713690062543,0.48922863099374564
E01031266,1948,1108,840,0.5687885010266941,0.43121149897330596
E01031259,1370,681,689,0.49708029197080295,0.502919708029197
E01031260,1188,593,595,0.49915824915824913,0.5008417508417509
E01031267,1776,879,897,0.49493243243243246,0.5050675675675675
E01031268,2732,1346,1386,0.49267935578330896,0.5073206442166911
E01031269,1663,801,862,0.481659651232712,0.5183403487672881
E01031327,1531,742,789,0.4846505551926845,0.5153494448073155
E01031328,2208,1072,1136,0.4855072463768116,0.5144927536231884
E01031329,2561,1307,1254,0.5103475204998048,0.48965247950019525
E01031330,1486,728,758,0.4899057873485868,0.5100942126514132
E01031331,1786,852,934,0.47704367301231804,0.522956326987682
E01009417,1493,752,741,0.5036838580040187,0.49631614199598123
E01009418,1471,674,797,0.4581917063222298,0.5418082936777702
E01009419,1322,644,678,0.48714069591527986,0.5128593040847201
E01009433,1759,832,927,0.47299602046617395,0.527003979533826
E01009415,1638,796,842,0.48595848595848595,0.514041514041514
E01009422,1912,918,994,0.4801255230125523,0.5198744769874477
E01009423,1677,772,905,0.4603458556946929,0.5396541443053071
E01009425,1693,789,904,0.46603662138216184,0.5339633786178382
E01009416,2669,1293,1376,0.4844511052828775,0.5155488947171225
E01009420,1537,753,784,0.48991541964866625,0.5100845803513337
E01009426,1449,694,755,0.47895100069013113,0.5210489993098689
E01009429,1497,736,761,0.4916499665998664,0.5083500334001336
E01009431,1583,789,794,0.4984207201516109,0.5015792798483891
E01009421,1635,791,844,0.4837920489296636,0.5162079510703363
E01009424,1520,727,793,0.47828947368421054,0.5217105263157895
E01009427,1494,733,761,0.49062918340026773,0.5093708165997323
E01009428,1644,792,852,0.48175182481751827,0.5182481751824818
E01009430,1631,786,845,0.4819129368485592,0.5180870631514408
E01009468,1513,716,797,0.47323198942498346,0.5267680105750165
E01009445,1682,770,912,0.4577883472057075,0.5422116527942925
E01009446,2432,1161,1271,0.47738486842105265,0.5226151315789473
E01009447,1601,786,815,0.4909431605246721,0.5090568394753279
E01009448,1631,773,858,0.4739423666462293,0.5260576333537706
E01009452,1657,766,891,0.4622812311406156,0.5377187688593844
E01009455,1323,642,681,0.4852607709750567,0.5147392290249433
E01009432,1508,748,760,0.4960212201591512,0.5039787798408488
E01009435,1826,880,946,0.4819277108433735,0.5180722891566265
E01009437,1785,851,934,0.47675070028011207,0.523249299719888
E01009444,1538,759,779,0.49349804941482445,0.5065019505851756
E01009454,1511,764,747,0.5056254136333554,0.4943745863666446
E01009221,1483,728,755,0.4908968307484828,0.5091031692515172
E01009464,1385,704,681,0.5083032490974729,0.49169675090252707
E01009465,1381,692,689,0.501086169442433,0.498913830557567
E01009467,1559,731,828,0.46889031430404104,0.531109685695959
E01009220,1560,757,803,0.48525641025641025,0.5147435897435897
E01009222,1576,744,832,0.4720812182741117,0.5279187817258884
E01009224,1469,670,799,0.4560925799863853,0.5439074200136147
E01009233,1534,722,812,0.4706649282920469,0.529335071707953
E01009449,1829,885,944,0.4838709677419355,0.5161290322580645
E01009451,1431,715,716,0.4996505939902166,0.5003494060097834
E01009453,1467,736,731,0.501704158145876,0.49829584185412407
E01009466,1632,807,825,0.4944852941176471,0.5055147058823529
E01009471,1817,859,958,0.472757292239956,0.527242707760044
E01009135,1450,716,734,0.49379310344827587,0.5062068965517241
E01009469,1437,721,716,0.5017397355601948,0.49826026443980515
E01009470,1439,704,735,0.48922863099374564,0.5107713690062543
E01009472,1659,814,845,0.49065702230259195,0.5093429776974081
E01009473,1595,769,826,0.48213166144200625,0.5178683385579937
E01009474,1600,754,846,0.47125,0.52875
E01009127,1571,733,838,0.46658179503500957,0.5334182049649905
E01009128,1374,674,700,0.49053857350800584,0.5094614264919942
E01009130,1505,740,765,0.49169435215946844,0.5083056478405316
E01009131,1448,718,730,0.4958563535911602,0.5041436464088398
E01009133,1492,711,781,0.4765415549597855,0.5234584450402144
E01009134,1589,741,848,0.46633102580239144,0.5336689741976086
E01009137,1606,774,832,0.48194271481942713,0.5180572851805728
E01009434,1567,768,799,0.4901084875558392,0.5098915124441609
E01009436,1441,729,712,0.5058986814712005,0.49410131852879946
E01009438,1450,688,762,0.47448275862068967,0.5255172413793103
E01009440,1580,734,846,0.46455696202531643,0.5354430379746835
E01009450,1635,807,828,0.4935779816513762,0.5064220183486239
E01009223,1527,721,806,0.4721676489849378,0.5278323510150622
E01009225,1640,743,897,0.4530487804878049,0.5469512195121952
E01009227,1618,792,826,0.4894932014833127,0.5105067985166872
E01009228,1657,809,848,0.48823174411587206,0.5117682558841279
E01009121,2306,1057,1249,0.45836947094535996,0.54163052905464
E01009122,1626,784,842,0.4821648216482165,0.5178351783517835
E01009129,1628,778,850,0.47788697788697787,0.5221130221130221
E01009132,1560,729,831,0.4673076923076923,0.5326923076923077
E01009136,1651,775,876,0.46941247728649305,0.530587522713507
E01009457,1519,766,753,0.5042791310072416,0.4957208689927584
E01009459,1649,795,854,0.48211036992116435,0.5178896300788357
E01009461,1332,644,688,0.48348348348348347,0.5165165165165165
E01009463,1493,713,780,0.477561955793704,0.522438044206296
E01009235,1607,768,839,0.477909147479776,0.522090852520224
E01009243,1518,739,779,0.4868247694334651,0.5131752305665349
E01009245,1453,706,747,0.4858912594631796,0.5141087405368203
E01009246,1581,776,805,0.49082858950031627,0.5091714104996837
E01009247,1504,719,785,0.47805851063829785,0.5219414893617021
E01009226,1486,721,765,0.4851951547779273,0.5148048452220727
E01009229,1578,759,819,0.48098859315589354,0.5190114068441065
E01009230,1512,757,755,0.5006613756613757,0.49933862433862436
E01009231,1879,928,951,0.49387972325705165,0.5061202767429483
E01009001,1529,759,770,0.49640287769784175,0.5035971223021583
E01009003,1680,858,822,0.5107142857142857,0.48928571428571427
E01009456,1690,810,880,0.47928994082840237,0.5207100591715976
E01009458,1485,687,798,0.4626262626262626,0.5373737373737374
E01009460,1652,817,835,0.49455205811138014,0.5054479418886199
E01009462,1680,819,861,0.4875,0.5125
E01009234,1520,733,787,0.48223684210526313,0.5177631578947368
E01009236,1551,748,803,0.48226950354609927,0.5177304964539007
E01009244,1436,678,758,0.47214484679665736,0.5278551532033426
E01009248,1767,845,922,0.47821165817770234,0.5217883418222977
E01009403,1506,711,795,0.4721115537848606,0.5278884462151394
E01009404,1552,770,782,0.4961340206185567,0.5038659793814433
E01009405,1406,689,717,0.4900426742532006,0.5099573257467994
E01009406,1648,811,837,0.49211165048543687,0.5078883495145631
E01009407,1717,838,879,0.48806057076295867,0.5119394292370414
E01009439,1384,696,688,0.5028901734104047,0.49710982658959535
E01009441,1445,705,740,0.48788927335640137,0.5121107266435986
E01009442,1472,721,751,0.4898097826086957,0.5101902173913043
E01009443,1220,571,649,0.4680327868852459,0.5319672131147541
E01009123,1437,669,768,0.46555323590814196,0.534446764091858
E01009124,1607,715,892,0.44492843808338517,0.5550715619166148
E01009125,1757,825,932,0.4695503699487763,0.5304496300512237
E01009232,1571,750,821,0.47740292807129214,0.5225970719287079
E01009002,1470,675,795,0.45918367346938777,0.5408163265306123
E01009006,1522,747,775,0.4908015768725361,0.5091984231274639
E01009007,1604,822,782,0.5124688279301746,0.48753117206982544
E01033632,2286,1112,1174,0.4864391951006124,0.5135608048993876
E01009237,1468,713,755,0.48569482288828336,0.5143051771117166
E01009238,1632,790,842,0.4840686274509804,0.5159313725490197
E01009240,1580,767,813,0.4854430379746835,0.5145569620253164
E01009241,1707,823,884,0.48213239601640306,0.517867603983597
E01009242,1786,876,910,0.49048152295632697,0.509518477043673
E01009005,1336,670,666,0.5014970059880239,0.49850299401197606
E01009009,1472,717,755,0.48709239130434784,0.5129076086956522
E01009098,2091,1016,1075,0.48589191774270685,0.5141080822572932
E01009100,2064,945,1119,0.4578488372093023,0.5421511627906976
E01009105,1613,778,835,0.4823310601363918,0.5176689398636082
E01009126,1412,695,717,0.4922096317280453,0.5077903682719547
E01009408,1711,837,874,0.489187609585038,0.510812390414962
E01009409,1641,806,835,0.49116392443631934,0.5088360755636807
E01009410,1780,874,906,0.4910112359550562,0.5089887640449439
E01009008,1484,702,782,0.47304582210242585,0.5269541778975741
E01009011,1760,896,864,0.509090909090909,0.4909090909090909
E01009012,1457,734,723,0.5037748798901853,0.4962251201098147
E01009102,1491,732,759,0.4909456740442656,0.5090543259557344
E01009104,1585,743,842,0.46876971608832807,0.5312302839116719
E01009096,1651,778,873,0.47122955784373105,0.5287704421562689
E01009097,2040,916,1124,0.44901960784313727,0.5509803921568628
E01009099,1777,797,980,0.4485087225661227,0.5514912774338773
E01009101,1616,710,906,0.43935643564356436,0.5606435643564357
E01009103,1536,722,814,0.4700520833333333,0.5299479166666666
E01009106,1351,659,692,0.4877868245743893,0.5122131754256106
E01008915,1374,683,691,0.49708879184861715,0.5029112081513828
E01009411,1818,879,939,0.4834983498349835,0.5165016501650165
E01009412,1753,866,887,0.4940102681118083,0.5059897318881916
E01009413,1655,855,800,0.5166163141993958,0.48338368580060426
E01009414,1912,970,942,0.5073221757322176,0.49267782426778245
E01008998,1827,877,950,0.48002189381499727,0.5199781061850027
E01008999,1580,784,796,0.4962025316455696,0.5037974683544304
E01009000,1710,853,857,0.4988304093567251,0.5011695906432748
E01009013,1902,938,964,0.4931650893796004,0.5068349106203995
E01009400,1452,702,750,0.4834710743801653,0.5165289256198347
E01009401,1668,843,825,0.5053956834532374,0.49460431654676257
E01033630,1139,587,552,0.5153643546971027,0.48463564530289727
E01033646,1624,855,769,0.5264778325123153,0.4735221674876847
E01009049,1631,825,806,0.5058246474555488,0.4941753525444513
E01009056,2026,1039,987,0.5128331688055281,0.48716683119447185
E01009263,1629,800,829,0.4910988336402701,0.5089011663597299
E01009264,1415,678,737,0.4791519434628975,0.5208480565371024
E01009265,1752,871,881,0.4971461187214612,0.5028538812785388
E01009051,1621,858,763,0.5293028994447871,0.47069710055521286
E01009053,1481,772,709,0.5212694125590817,0.4787305874409183
E01009054,1654,820,834,0.4957678355501814,0.5042321644498187
E01009058,1668,863,805,0.5173860911270983,0.4826139088729017
E01009061,1816,926,890,0.5099118942731278,0.4900881057268722
E01009239,1875,861,1014,0.4592,0.5408
E01009266,1711,856,855,0.5002922267679719,0.49970777323202803
E01009269,1535,762,773,0.49641693811074916,0.5035830618892508
E01009270,1966,1017,949,0.517293997965412,0.482706002034588
E01009271,1522,738,784,0.48488830486202367,0.5151116951379764
E01009273,1603,825,778,0.5146600124766063,0.48533998752339363
E01009050,1826,976,850,0.5345016429353778,0.4654983570646221
E01009057,2064,1090,974,0.5281007751937985,0.47189922480620156
E01009059,1800,948,852,0.5266666666666666,0.47333333333333333
E01009060,1597,814,783,0.5097056981840952,0.49029430181590483
E01033621,2874,1423,1451,0.49512874043145444,0.5048712595685456
E01009268,1517,752,765,0.4957152274225445,0.5042847725774555
E01009272,1401,643,758,0.45895788722341185,0.5410421127765882
E01009274,2143,1081,1062,0.5044330377974802,0.49556696220251983
E01009349,1679,817,862,0.4865991661703395,0.5134008338296605
E01009351,1693,836,857,0.49379799173065564,0.5062020082693444
E01009354,1471,722,749,0.4908225696804895,0.5091774303195106
E01008899,1237,611,626,0.4939369442198868,0.5060630557801131
E01008901,1686,854,832,0.5065243179122183,0.49347568208778175
E01008916,1531,767,764,0.5009797517962117,0.4990202482037884
E01033636,3385,1717,1668,0.5072378138847858,0.49276218611521416
E01009079,1629,819,810,0.5027624309392266,0.4972375690607735
E01009080,1113,509,604,0.4573225516621743,0.5426774483378257
E01009081,1301,658,643,0.5057647963105304,0.49423520368946966
E01009083,1488,653,835,0.4388440860215054,0.5611559139784946
E01009275,1576,823,753,0.5222081218274112,0.47779187817258884
E01009350,1562,797,765,0.5102432778489117,0.48975672215108834
E01009352,1715,895,820,0.521865889212828,0.478134110787172
E01009353,1615,811,804,0.5021671826625387,0.4978328173374613
E01009355,1575,813,762,0.5161904761904762,0.4838095238095238
E01033635,2889,1473,1416,0.509865005192108,0.490134994807892
E01008905,1701,835,866,0.49088771310993534,0.5091122868900647
E01008907,1675,879,796,0.5247761194029851,0.4752238805970149
E01009047,1804,937,867,0.5194013303769401,0.48059866962305986
E01009048,1762,966,796,0.5482406356413166,0.4517593643586833
E01009062,1729,837,892,0.48409485251590517,0.5159051474840949
E01008909,1633,754,879,0.46172688303735454,0.5382731169626455
E01033628,2430,1232,1198,0.5069958847736625,0.49300411522633747
E01033637,2838,1367,1471,0.48167723749119096,0.518322762508809
E01009084,1742,816,926,0.46842709529276694,0.5315729047072331
E01009085,1977,944,1033,0.47749114820435,0.52250885179565
E01009087,1514,768,746,0.5072655217965654,0.49273447820343463
E01009089,1527,764,763,0.5003274394237066,0.4996725605762934
E01009090,1857,882,975,0.47495961227786754,0.5250403877221325
E01009201,1720,820,900,0.47674418604651164,0.5232558139534884
E01009202,1503,712,791,0.4737192282102462,0.5262807717897539
E01009203,2837,1394,1443,0.4913641170250264,0.5086358829749735
E01009082,1411,672,739,0.47625797306874557,0.5237420269312544
E01009086,1881,932,949,0.4954811270600744,0.5045188729399256
E01009480,1756,862,894,0.4908883826879271,0.5091116173120729
E01009481,2289,1115,1174,0.4871122761031018,0.5128877238968982
E01009486,2018,1008,1010,0.49950445986124875,0.5004955401387512
E01009487,2205,1057,1148,0.4793650793650794,0.5206349206349207
E01009088,1610,752,858,0.4670807453416149,0.5329192546583851
E01009091,1554,725,829,0.46653796653796653,0.5334620334620335
E01009305,1610,800,810,0.4968944099378882,0.5031055900621118
E01009307,1529,707,822,0.4623937213865271,0.5376062786134729
E01009309,1418,637,781,0.44922425952045136,0.5507757404795487
E01009304,1807,863,944,0.47758716104039844,0.5224128389596016
E01009306,1550,750,800,0.4838709677419355,0.5161290322580645
E01009308,1943,877,1066,0.45136387030365416,0.5486361296963459
E01009310,1861,852,1009,0.4578183772165502,0.5421816227834497
E01009348,1969,953,1016,0.48400203148806503,0.515997968511935
E01009358,2053,1089,964,0.5304432537749635,0.4695567462250365
E01009359,1968,1017,951,0.5167682926829268,0.48323170731707316
E01009360,2435,1146,1289,0.4706365503080082,0.5293634496919918
E01009361,2109,1044,1065,0.4950213371266003,0.5049786628733998
E01009478,1835,910,925,0.49591280653950953,0.5040871934604905
E01009479,2206,1113,1093,0.5045330915684497,0.49546690843155033
E01009482,1721,850,871,0.4938988959907031,0.5061011040092969
E01009484,1755,903,852,0.5145299145299145,0.48547008547008547
E01009485,1835,917,918,0.4997275204359673,0.5002724795640326
E01008906,1780,891,889,0.500561797752809,0.499438202247191
E01008911,1609,788,821,0.4897451833436917,0.5102548166563082
E01009347,1766,844,922,0.47791619479048697,0.522083805209513
E01033559,1263,720,543,0.5700712589073634,0.42992874109263657
E01033638,1750,865,885,0.4942857142857143,0.5057142857142857
E01008910,1812,932,880,0.5143487858719646,0.4856512141280353
E01008913,1481,769,712,0.5192437542201216,0.48075624577987847
E01008914,2715,1441,1274,0.5307550644567219,0.46924493554327806
E01033561,2939,1475,1464,0.5018713848247703,0.49812861517522966
E01033617,2962,1402,1560,0.47332883187035785,0.5266711681296421
E01009194,2846,1452,1394,0.5101897399859452,0.4898102600140548
E01009483,1851,943,908,0.5094543490005402,0.49054565099945974
E01009488,2163,1055,1108,0.4877484974572353,0.5122515025427646
E01009489,2001,1016,985,0.5077461269365318,0.49225387306346824
E01009491,1794,913,881,0.5089186176142698,0.49108138238573024
E01009192,2749,1376,1373,0.5005456529647144,0.4994543470352856
E01009199,1415,700,715,0.49469964664310956,0.5053003533568905
E01009204,1793,907,886,0.5058561070831009,0.49414389291689903
E01033644,2998,1491,1507,0.4973315543695797,0.5026684456304202
E01009151,2007,946,1061,0.471350274040857,0.528649725959143
E01009152,2163,1151,1012,0.5321312991215904,0.4678687008784096
E01009153,2147,1073,1074,0.4997671169073125,0.5002328830926874
E01009345,2377,1479,898,0.6222128733697938,0.37778712663020614
E01009346,1682,797,885,0.47384066587395957,0.5261593341260404
E01009092,1675,745,930,0.44477611940298506,0.5552238805970149
E01009093,1603,739,864,0.4610106051154086,0.5389893948845914
E01009094,1434,679,755,0.4735006973500697,0.5264993026499303
E01009298,1578,760,818,0.4816223067173637,0.5183776932826363
E01009311,1658,806,852,0.48612786489746684,0.5138721351025332
E01009511,1486,727,759,0.4892328398384926,0.5107671601615074
E01009475,2072,977,1095,0.4715250965250965,0.5284749034749034
E01009476,1889,985,904,0.5214399152991,0.47856008470089995
E01009477,1692,807,885,0.4769503546099291,0.5230496453900709
E01009490,1927,962,965,0.49922158796056043,0.5007784120394395
E01009492,1754,885,869,0.5045610034207526,0.49543899657924745
E01009095,1700,845,855,0.4970588235294118,0.5029411764705882
E01009507,1551,803,748,0.5177304964539007,0.48226950354609927
E01009508,1548,746,802,0.4819121447028424,0.5180878552971576
E01009509,1747,864,883,0.49456210646823123,0.5054378935317687
E01009510,1606,767,839,0.4775840597758406,0.5224159402241594
E01009297,1606,762,844,0.47447073474470736,0.5255292652552926
E01009299,1637,769,868,0.46976175931582165,0.5302382406841784
E01009300,1803,858,945,0.47587354409317806,0.5241264559068219
E01009301,1604,748,856,0.46633416458852867,0.5336658354114713
E01009303,1479,726,753,0.4908722109533469,0.5091277890466531
E01009195,2600,1341,1259,0.5157692307692308,0.48423076923076924
E01009197,1679,804,875,0.478856462179869,0.521143537820131
E01009198,1761,894,867,0.5076660988074957,0.49233390119250425
E01033647,1398,677,721,0.4842632331902718,0.5157367668097281
E01033649,1801,878,923,0.4875069405885619,0.5124930594114381
E01009138,1646,824,822,0.5006075334143378,0.4993924665856622
E01009139,1583,814,769,0.5142135186355022,0.4857864813644978
E01009140,1915,1018,897,0.5315926892950391,0.46840731070496083
E01009145,1981,1031,950,0.5204442200908632,0.4795557799091368
E01009147,1683,908,775,0.5395127748068924,0.46048722519310753
E01009512,1616,783,833,0.484529702970297,0.5154702970297029
E01009514,1510,708,802,0.4688741721854305,0.5311258278145695
E01009516,1412,679,733,0.48087818696883855,0.5191218130311614
E01009517,1709,836,873,0.489174956114687,0.510825043885313
E01009325,1797,911,886,0.5069560378408459,0.49304396215915414
E01009342,1738,856,882,0.49252013808975836,0.5074798619102416
E01009343,1706,844,862,0.4947245017584994,0.5052754982415005
E01033642,3105,1544,1561,0.4972624798711755,0.5027375201288244
E01008986,1801,964,837,0.535258189894503,0.4647418101054969
E01008987,1540,751,789,0.4876623376623377,0.5123376623376623
E01008988,2037,1132,905,0.5557191948944527,0.44428080510554735
E01008989,1742,933,809,0.5355912743972445,0.4644087256027555
E01008990,1171,533,638,0.4551665243381725,0.5448334756618275
E01008991,1515,732,783,0.48316831683168315,0.5168316831683168
E01008882,1747,842,905,0.48196908986834575,0.5180309101316543
E01008896,1575,765,810,0.4857142857142857,0.5142857142857142
E01008898,1674,789,885,0.471326164874552,0.5286738351254481
E01009326,1919,952,967,0.49609171443460137,0.5039082855653987
E01009341,1558,762,796,0.4890885750962773,0.5109114249037228
E01009513,1720,836,884,0.48604651162790696,0.513953488372093
E01008881,1599,778,821,0.48655409631019386,0.5134459036898061
E01008897,1686,847,839,0.5023724792408066,0.49762752075919336
E01009515,1564,763,801,0.48785166240409206,0.5121483375959079
E01009518,1608,794,814,0.4937810945273632,0.5062189054726368
E01009521,1640,827,813,0.5042682926829268,0.49573170731707317
E01009302,1507,730,777,0.48440610484406105,0.5155938951559389
E01009314,1586,746,840,0.4703656998738966,0.5296343001261034
E01009321,1840,854,986,0.4641304347826087,0.5358695652173913
E01009322,1386,689,697,0.4971139971139971,0.5028860028860029
E01009323,1471,706,765,0.4799456152277362,0.5200543847722637
E01009329,2341,1209,1132,0.5164459632635626,0.48355403673643743
E01009334,1889,936,953,0.49550026469031233,0.5044997353096876
E01009337,1788,907,881,0.5072706935123042,0.49272930648769575
E01009338,1569,789,780,0.502868068833652,0.497131931166348
E01009380,1700,874,826,0.5141176470588236,0.4858823529411765
E01009362,1316,682,634,0.5182370820668692,0.4817629179331307
E01009363,1554,803,751,0.5167310167310167,0.48326898326898327
E01009364,1338,683,655,0.5104633781763827,0.48953662182361735
E01009365,1719,929,790,0.5404304828388597,0.4595695171611402
E01009379,1669,860,809,0.5152786099460755,0.4847213900539245
E01009312,1576,753,823,0.47779187817258884,0.5222081218274112
E01009324,1641,782,859,0.4765386959171237,0.5234613040828763
E01009519,1519,763,756,0.5023041474654378,0.4976958525345622
E01009520,1752,887,865,0.5062785388127854,0.4937214611872146
E01009066,1508,746,762,0.4946949602122016,0.5053050397877984
E01009070,1678,763,915,0.4547079856972586,0.5452920143027413
E01009252,1538,766,772,0.4980494148244473,0.5019505851755527
E01009260,1535,751,784,0.48925081433224754,0.5107491856677524
E01009261,1607,770,837,0.4791537025513379,0.5208462974486621
E01008984,2090,1046,1044,0.5004784688995215,0.4995215311004785
E01008994,1695,849,846,0.5008849557522124,0.49911504424778763
E01008996,1571,773,798,0.49204328453214513,0.5079567154678549
E01008997,1445,705,740,0.48788927335640137,0.5121107266435986
E01009065,1716,885,831,0.5157342657342657,0.48426573426573427
E01009067,1480,690,790,0.46621621621621623,0.5337837837837838
E01009068,1543,698,845,0.4523655217109527,0.5476344782890473
E01009069,1564,747,817,0.47762148337595906,0.5223785166240409
E01009072,1599,745,854,0.4659161976235147,0.5340838023764853
E01008885,1308,630,678,0.481651376146789,0.518348623853211
E01008886,1564,762,802,0.48721227621483376,0.5127877237851662
E01008888,1658,850,808,0.5126658624849216,0.4873341375150784
E01009313,1571,771,800,0.4907702100572883,0.5092297899427116
E01009368,1468,769,699,0.523841961852861,0.476158038147139
E01009371,1777,957,820,0.5385481148002251,0.4614518851997749
E01009397,1759,860,899,0.48891415577032404,0.511085844229676
E01033650,2596,1292,1304,0.49768875192604006,0.50231124807396
E01008883,1816,889,927,0.4895374449339207,0.5104625550660793
E01008884,1870,906,964,0.4844919786096257,0.5155080213903743
E01008887,1478,719,759,0.486468200270636,0.513531799729364
E01008889,1775,916,859,0.516056338028169,0.483943661971831
E01008982,1475,743,732,0.5037288135593221,0.49627118644067797
E01008992,1800,859,941,0.4772222222222222,0.5227777777777778
E01009283,1476,745,731,0.5047425474254743,0.49525745257452575
E01033631,4965,2436,2529,0.4906344410876133,0.5093655589123867
E01009249,1586,740,846,0.4665825977301387,0.5334174022698613
E01009250,1615,788,827,0.48792569659442725,0.5120743034055728
E01009251,1499,740,759,0.49366244162775186,0.5063375583722481
E01009253,1540,724,816,0.4701298701298701,0.5298701298701298
E01009255,1553,739,814,0.47585318737926596,0.524146812620734
E01009257,1522,727,795,0.4776609724047306,0.5223390275952694
E01009315,1594,817,777,0.5125470514429109,0.4874529485570891
E01009316,1647,778,869,0.4723740133576199,0.5276259866423801
E01009317,1670,821,849,0.49161676646706587,0.5083832335329341
E01009318,1533,760,773,0.4957599478147423,0.5042400521852577
E01009319,1634,855,779,0.5232558139534884,0.47674418604651164
E01009320,1544,786,758,0.5090673575129534,0.49093264248704666
E01009372,1822,905,917,0.49670691547749724,0.5032930845225028
E01009373,1838,897,941,0.4880304678998912,0.5119695321001088
E01009396,2153,1113,1040,0.5169530887134232,0.4830469112865769
E01033643,3095,1571,1524,0.5075928917609047,0.49240710823909534
E01009367,1642,859,783,0.523142509135201,0.476857490864799
E01009375,1932,972,960,0.5031055900621118,0.4968944099378882
E01009377,1370,687,683,0.5014598540145986,0.4985401459854015
E01009383,1452,768,684,0.5289256198347108,0.47107438016528924
E01009399,1590,809,781,0.5088050314465409,0.4911949685534591
E01009366,1581,794,787,0.502213788741303,0.49778621125869704
E01009374,1147,563,584,0.4908456843940715,0.5091543156059285
E01009376,1674,861,813,0.514336917562724,0.48566308243727596
E01033648,2715,1374,1341,0.5060773480662983,0.49392265193370166
E01009073,1614,742,872,0.459727385377943,0.540272614622057
E01009074,1672,817,855,0.48863636363636365,0.5113636363636364
E01009254,1558,745,813,0.4781771501925546,0.5218228498074454
E01009256,1565,748,817,0.4779552715654952,0.5220447284345048
E01009258,1526,716,810,0.4692005242463958,0.5307994757536042
E01009071,1615,808,807,0.5003095975232198,0.4996904024767802
E01009075,1634,808,826,0.4944920440636475,0.5055079559363526
E01009078,1433,711,722,0.4961618981158409,0.5038381018841591
E01033562,2504,1260,1244,0.5031948881789138,0.4968051118210863
E01009183,1604,818,786,0.5099750623441397,0.49002493765586036
E01009186,1701,887,814,0.5214579659024103,0.47854203409758966
E01033645,3485,1765,1720,0.5064562410329986,0.4935437589670014
E01008890,1734,862,872,0.497116493656286,0.5028835063437139
E01008891,1560,785,775,0.5032051282051282,0.4967948717948718
E01008892,1527,736,791,0.4819908316961362,0.5180091683038638
E01008893,1716,912,804,0.5314685314685315,0.46853146853146854
E01008894,1412,686,726,0.48583569405099153,0.5141643059490085
E01008895,1822,891,931,0.48902305159165754,0.5109769484083425
E01009015,1736,850,886,0.48963133640552997,0.5103686635944701
E01009014,2023,991,1032,0.4898665348492338,0.5101334651507662
E01009018,1673,848,825,0.5068738792588166,0.4931261207411835
E01009026,1578,775,803,0.491128010139417,0.508871989860583
E01009028,1790,854,936,0.4770949720670391,0.5229050279329609
E01009029,1548,728,820,0.4702842377260982,0.5297157622739018
E01009182,1624,867,757,0.5338669950738916,0.4661330049261084
E01009184,1606,869,737,0.541095890410959,0.4589041095890411
E01009187,1572,786,786,0.5,0.5
E01009188,1523,728,795,0.4780039395929087,0.5219960604070912
E01009384,1334,705,629,0.5284857571214393,0.4715142428785607
E01009385,1297,707,590,0.5451040863531226,0.4548959136468774
E01009185,1634,789,845,0.4828641370869033,0.5171358629130967
E01009389,1761,879,882,0.4991482112436116,0.5008517887563884
E01009390,1564,870,694,0.5562659846547314,0.4437340153452685
E01009394,1730,881,849,0.5092485549132948,0.4907514450867052
E01008918,1726,789,937,0.45712630359212053,0.5428736964078795
E01008920,1389,670,719,0.48236141108711306,0.5176385889128869
E01008921,1426,696,730,0.48807854137447404,0.511921458625526
E01008931,1439,660,779,0.4586518415566366,0.5413481584433635
E01009259,1607,739,868,0.4598630989421282,0.5401369010578718
E01008919,1577,756,821,0.47939124920735576,0.5206087507926442
E01009064,1477,718,759,0.4861205145565335,0.5138794854434665
E01009077,1706,807,899,0.4730363423212192,0.5269636576787807
E01009291,1537,711,826,0.46258945998698764,0.5374105400130124
E01009500,1536,709,827,0.4615885416666667,0.5384114583333334
E01009284,2287,1042,1245,0.45561871447310887,0.5443812855268911
E01009286,2212,1069,1143,0.4832730560578662,0.5167269439421338
E01009289,2097,948,1149,0.4520743919885551,0.547925608011445
E01009290,2000,951,1049,0.4755,0.5245
E01033634,4054,1885,2169,0.46497286630488405,0.5350271336951159
E01009017,1669,785,884,0.4703415218693829,0.5296584781306172
E01009043,1971,951,1020,0.4824961948249619,0.517503805175038
E01009044,1624,813,811,0.500615763546798,0.49938423645320196
E01009045,1712,838,874,0.4894859813084112,0.5105140186915887
E01009046,1800,872,928,0.48444444444444446,0.5155555555555555
E01009395,1681,860,821,0.5116002379535991,0.48839976204640095
E01009016,1559,777,782,0.49839640795381657,0.5016035920461834
E01009022,1749,850,899,0.48599199542595767,0.5140080045740423
E01009023,1673,831,842,0.4967124925283921,0.5032875074716079
E01009030,1475,727,748,0.4928813559322034,0.5071186440677966
E01009281,1429,623,806,0.4359692092372288,0.5640307907627712
E01009292,1648,829,819,0.5030339805825242,0.4969660194174757
E01009294,1837,907,930,0.49373979314099076,0.5062602068590093
E01009295,1770,820,950,0.4632768361581921,0.536723163841808
E01009280,1317,650,667,0.4935459377372817,0.5064540622627183
E01009282,1648,891,757,0.5406553398058253,0.45934466019417475
E01009288,1234,592,642,0.47974068071312803,0.520259319286872
E01009293,1516,777,739,0.512532981530343,0.487467018469657
E01009296,1499,761,738,0.5076717811874583,0.4923282188125417
E01008924,1427,693,734,0.48563419761737914,0.5143658023826209
E01009501,1564,716,848,0.4578005115089514,0.5421994884910486
E01009502,1508,709,799,0.47015915119363394,0.5298408488063661
E01009503,1541,738,803,0.4789097988319273,0.5210902011680727
E01009505,1662,807,855,0.4855595667870036,0.5144404332129964
E01008917,1335,661,674,0.4951310861423221,0.5048689138576778
E01008923,1347,637,710,0.4729027468448404,0.5270972531551597
E01008925,1301,642,659,0.49346656418139895,0.5065334358186011
E01008927,1390,668,722,0.4805755395683453,0.5194244604316547
E01008928,1485,654,831,0.4404040404040404,0.5595959595959596
E01009019,1611,794,817,0.4928615766604593,0.5071384233395406
E01009020,1511,709,802,0.4692256783587028,0.5307743216412971
E01009021,1620,757,863,0.46728395061728395,0.532716049382716
E01009024,1623,775,848,0.47751078250154033,0.5224892174984597
E01009025,1514,710,804,0.46895640686922063,0.5310435931307794
E01009033,1770,884,886,0.4994350282485876,0.5005649717514125
E01009175,1470,757,713,0.5149659863945578,0.4850340136054422
E01009177,1578,769,809,0.4873257287705957,0.5126742712294043
E01009178,1594,794,800,0.4981179422835634,0.5018820577164367
E01009179,1720,841,879,0.488953488372093,0.5110465116279069
E01009189,1496,720,776,0.48128342245989303,0.5187165775401069
E01008933,1556,768,788,0.493573264781491,0.506426735218509
E01008934,1405,672,733,0.4782918149466192,0.5217081850533808
E01009031,1655,829,826,0.5009063444108761,0.4990936555891239
E01009037,1620,780,840,0.48148148148148145,0.5185185185185185
E01009176,1650,805,845,0.48787878787878786,0.5121212121212121
E01008929,1479,697,782,0.47126436781609193,0.5287356321839081
E01008930,1498,700,798,0.4672897196261682,0.5327102803738317
E01009495,1225,573,652,0.46775510204081633,0.5322448979591837
E01033629,2593,1210,1383,0.46664095642113385,0.5333590435788662
E01008953,1564,755,809,0.4827365728900256,0.5172634271099744
E01008963,1371,658,713,0.4799416484318016,0.5200583515681984
E01008964,1473,687,786,0.4663951120162933,0.5336048879837068
E01008965,1529,739,790,0.4833224329627207,0.5166775670372793
E01008966,1688,824,864,0.4881516587677725,0.5118483412322274
E01009032,1794,897,897,0.5,0.5
E01009034,1691,829,862,0.49024246008279126,0.5097575399172087
E01009035,1812,886,926,0.488962472406181,0.5110375275938189
E01009036,1514,753,761,0.49735799207397624,0.5026420079260238
E01009494,1626,710,916,0.43665436654366546,0.5633456334563346
E01009496,1481,716,765,0.4834571235651587,0.5165428764348413
E01009497,1767,848,919,0.47990945104697225,0.5200905489530278
E01009504,1471,707,764,0.4806254248810333,0.5193745751189667
E01009506,1494,752,742,0.5033467202141901,0.4966532797858099
E01008967,1687,822,865,0.4872554831061055,0.5127445168938944
E01008968,1707,847,860,0.4961921499707089,0.5038078500292912
E01008970,1541,742,799,0.48150551589876706,0.518494484101233
E01008981,1538,737,801,0.47919375812743825,0.5208062418725617
E01008932,1544,727,817,0.47085492227979275,0.5291450777202072
E01008935,1675,801,874,0.47820895522388057,0.5217910447761194
E01008936,1568,751,817,0.4789540816326531,0.5210459183673469
E01008938,1593,775,818,0.48650345260514755,0.5134965473948525
E01008939,1543,719,824,0.4659753726506805,0.5340246273493195
E01008951,1427,679,748,0.4758234057463209,0.524176594253679
E01008952,1595,778,817,0.4877742946708464,0.5122257053291536
E01008955,1533,768,765,0.5009784735812133,0.49902152641878667
E01008956,1513,698,815,0.46133509583608723,0.5386649041639128
E01008957,1658,792,866,0.4776839565741858,0.5223160434258143
E01008950,1431,655,776,0.45772187281621246,0.5422781271837875
E01008954,1357,671,686,0.49447310243183495,0.505526897568165
E01008958,1554,683,871,0.4395109395109395,0.5604890604890604
E01009493,1470,801,669,0.5448979591836735,0.45510204081632655
E01008937,1426,672,754,0.47124824684431976,0.5287517531556802
E01008940,1538,732,806,0.4759427828348505,0.5240572171651495
E01008941,1522,735,787,0.48291721419185285,0.5170827858081471
E01008944,1716,823,893,0.4796037296037296,0.5203962703962703
E01008959,1759,785,974,0.44627629334849345,0.5537237066515065
E01008960,1606,780,826,0.48567870485678705,0.5143212951432129
E01008961,1495,760,735,0.5083612040133779,0.4916387959866221
E01008962,1907,906,1001,0.47509176717357104,0.524908232826429
E01008942,1599,787,812,0.49218261413383363,0.5078173858661663
E01008943,1458,693,765,0.47530864197530864,0.5246913580246914
E01008969,1646,793,853,0.48177399756986633,0.5182260024301336
E01008971,1691,798,893,0.47191011235955055,0.5280898876404494
E01008972,1790,830,960,0.46368715083798884,0.5363128491620112
E01008973,1906,918,988,0.48163693599160545,0.5183630640083945
E01008974,2881,1455,1426,0.5050329746615758,0.4949670253384242
E01008975,1549,775,774,0.500322788896062,0.49967721110393803
E01009172,1420,676,744,0.476056338028169,0.523943661971831
E01009173,1733,863,870,0.4979803808424697,0.5020196191575302
E01009174,1255,602,653,0.4796812749003984,0.5203187250996016
E01009498,1636,759,877,0.4639364303178484,0.5360635696821516
E01009499,1740,807,933,0.46379310344827585,0.5362068965517242
E01009205,1531,776,755,0.5068582625734814,0.4931417374265186
E01009206,1624,824,800,0.5073891625615764,0.49261083743842365
E01009211,1442,742,700,0.5145631067961165,0.4854368932038835
E01009218,1527,755,772,0.49443352979698757,0.5055664702030125
E01009219,1564,751,813,0.48017902813299235,0.5198209718670077
E01008976,1541,719,822,0.46658014276443865,0.5334198572355613
E01008978,1393,699,694,0.501794687724336,0.49820531227566406
E01008979,1605,767,838,0.4778816199376947,0.5221183800623053
E01008980,1626,801,825,0.492619926199262,0.507380073800738
E01008945,1835,888,947,0.48392370572207083,0.5160762942779291
E01008946,1485,756,729,0.509090909090909,0.4909090909090909
E01008947,1392,678,714,0.4870689655172414,0.5129310344827587
E01008948,1459,707,752,0.4845784784098698,0.5154215215901302
E01008949,1262,641,621,0.5079239302694136,0.4920760697305864
E01008977,1574,744,830,0.4726810673443456,0.5273189326556544
E01009109,1368,617,751,0.4510233918128655,0.5489766081871345
E01009119,1439,690,749,0.4794996525364837,0.5205003474635164
E01009120,1438,676,762,0.47009735744089015,0.5299026425591099
E01009162,1602,745,857,0.46504369538077406,0.5349563046192259
E01009207,1659,817,842,0.4924653405666064,0.5075346594333936
E01009208,1531,754,777,0.4924885695623775,0.5075114304376225
E01009209,2128,1060,1068,0.4981203007518797,0.5018796992481203
E01009213,1486,704,782,0.4737550471063257,0.5262449528936743
E01009155,1356,667,689,0.4918879056047198,0.5081120943952803
E01009157,1510,729,781,0.4827814569536424,0.5172185430463576
E01009160,1586,774,812,0.4880201765447667,0.5119798234552333
E01009161,1412,683,729,0.48371104815864024,0.5162889518413598
E01033633,2353,1122,1231,0.4768380790480238,0.5231619209519762
E01009117,2060,957,1103,0.4645631067961165,0.5354368932038835
E01009210,1855,897,958,0.48355795148247976,0.5164420485175202
E01009212,1678,794,884,0.4731823599523242,0.5268176400476758
E01009214,1652,798,854,0.4830508474576271,0.5169491525423728
E01009215,1650,811,839,0.4915151515151515,0.5084848484848485
E01009108,1341,648,693,0.48322147651006714,0.5167785234899329
E01009111,1387,694,693,0.5003604902667628,0.4996395097332372
E01009112,1508,727,781,0.48209549071618035,0.5179045092838196
E01009116,1426,683,743,0.4789621318373071,0.5210378681626928
E01009118,1469,701,768,0.4771953710006807,0.5228046289993192
E01009107,1741,821,920,0.47156806433084436,0.5284319356691557
E01009110,1565,750,815,0.4792332268370607,0.5207667731629393
E01009113,1518,721,797,0.4749670619235837,0.5250329380764164
E01009114,1571,748,823,0.4761298535964354,0.5238701464035647
E01009115,1417,686,731,0.48412138320395204,0.515878616796048
E01009158,1897,913,984,0.4812862414338429,0.5187137585661571
E01009163,1452,673,779,0.4634986225895317,0.5365013774104683
E01009165,1352,666,686,0.492603550295858,0.507396449704142
E01009169,1680,817,863,0.4863095238095238,0.5136904761904761
E01009159,1775,856,919,0.48225352112676056,0.5177464788732394
E01009164,1484,711,773,0.47911051212938005,0.52088948787062
E01009167,1550,762,788,0.4916129032258065,0.5083870967741936
E01009171,1597,759,838,0.47526612398246715,0.5247338760175329
E01009166,1319,637,682,0.4829416224412434,0.5170583775587566
E01009168,1489,761,728,0.5110812625923439,0.4889187374076561
E01009170,1483,725,758,0.48887390424814564,0.5111260957518543
E01009216,1991,949,1042,0.4766449020592667,0.5233550979407333
E01009217,1630,819,811,0.5024539877300613,0.49754601226993866
E01009039,1705,846,859,0.4961876832844575,0.5038123167155425
E01009040,1747,863,884,0.4939896966227819,0.5060103033772181
E01009041,1661,827,834,0.49789283564118003,0.50210716435882
E01009042,1379,681,698,0.4938361131254532,0.5061638868745467
E01032589,1411,657,754,0.46562721474131824,0.5343727852586818
E01009262,1756,847,909,0.48234624145785876,0.5176537585421412
E01009267,1756,856,900,0.4874715261958998,0.5125284738041003
E01009276,1618,766,852,0.47342398022249693,0.5265760197775031
E01009278,1729,839,890,0.4852515905147484,0.5147484094852516
E01009279,1528,758,770,0.49607329842931935,0.5039267015706806
E01032591,1645,824,821,0.5009118541033435,0.4990881458966565
E01008995,1816,928,888,0.5110132158590308,0.4889867841409692
E01033557,2059,1025,1034,0.49781447304516757,0.5021855269548324
E01033624,1033,501,532,0.4849951597289448,0.5150048402710552
E01033626,1069,566,503,0.529466791393826,0.470533208606174
E01033640,1296,663,633,0.5115740740740741,0.48842592592592593
E01009378,2065,1159,906,0.5612590799031477,0.4387409200968523
E01033567,1172,660,512,0.5631399317406144,0.43686006825938567
E01033615,1019,620,399,0.6084396467124632,0.3915603532875368
E01033616,1012,686,326,0.6778656126482213,0.3221343873517787
E01009143,1419,758,661,0.5341789992952783,0.46582100070472165
E01009146,1923,1098,825,0.5709828393135725,0.4290171606864275
E01033564,1231,710,521,0.5767668562144598,0.4232331437855402
E01033639,1803,912,891,0.5058236272878536,0.49417637271214643
E01009141,1760,881,879,0.5005681818181819,0.4994318181818182
E01033565,1021,599,422,0.5866797257590598,0.41332027424094026
E01033618,1191,693,498,0.5818639798488665,0.4181360201511335
E01033619,1134,599,535,0.5282186948853616,0.47178130511463845
E01033627,1078,601,477,0.5575139146567718,0.4424860853432282
E01033620,1020,597,423,0.5852941176470589,0.4147058823529412
E01033622,1713,955,758,0.5575014594279043,0.44249854057209576
E01033623,1120,712,408,0.6357142857142857,0.36428571428571427
E01033625,1694,976,718,0.5761511216056671,0.42384887839433294
E01009200,1712,871,841,0.5087616822429907,0.4912383177570093
E01009327,1633,798,835,0.488671157379057,0.511328842620943
E01009328,2366,1197,1169,0.5059171597633136,0.4940828402366864
E01009331,2145,1080,1065,0.5034965034965035,0.4965034965034965
E01009332,1706,847,859,0.49648300117233296,0.5035169988276671
E01009333,1654,813,841,0.4915356711003628,0.5084643288996372
E01009335,1882,909,973,0.48299681190223165,0.5170031880977684
E01009344,1615,820,795,0.5077399380804953,0.49226006191950467
E01009339,1521,771,750,0.5069033530571992,0.4930966469428008
E01009340,2708,1362,1346,0.5029542097488922,0.49704579025110784
E01009382,1836,929,907,0.5059912854030502,0.4940087145969499
E01009391,1622,847,775,0.5221948212083847,0.47780517879161527
E01009392,1774,890,884,0.5016910935738444,0.4983089064261556
E01009393,1645,858,787,0.521580547112462,0.478419452887538
E01033641,3296,1673,1623,0.5075849514563107,0.49241504854368934
E01009589,1425,713,712,0.5003508771929824,0.49964912280701756
E01032536,1897,944,953,0.4976278334211914,0.5023721665788087
E01032537,1950,940,1010,0.48205128205128206,0.517948717948718
E01032538,2180,1047,1133,0.48027522935779815,0.5197247706422018
E01009590,1388,687,701,0.49495677233429397,0.5050432276657061
E01009591,1540,762,778,0.4948051948051948,0.5051948051948052
E01009593,1654,832,822,0.5030229746070133,0.4969770253929867
E01009598,1619,800,819,0.49413218035824585,0.5058678196417542
E01009604,1459,732,727,0.5017135023989033,0.49828649760109667
E01009605,1499,725,774,0.4836557705136758,0.5163442294863242
E01009607,1495,764,731,0.5110367892976588,0.4889632107023411
E01009608,1581,771,810,0.4876660341555977,0.5123339658444023
E01009610,1464,731,733,0.4993169398907104,0.5006830601092896
E01009564,1657,800,857,0.4828002414001207,0.5171997585998793
E01009575,1310,609,701,0.4648854961832061,0.5351145038167939
E01009606,1478,711,767,0.4810554803788904,0.5189445196211097
E01009609,1589,751,838,0.4726242920075519,0.527375707992448
E01009524,1504,692,812,0.4601063829787234,0.5398936170212766
E01009525,1435,689,746,0.4801393728222996,0.5198606271777003
E01009527,1610,813,797,0.5049689440993789,0.49503105590062113
E01009594,1377,680,697,0.49382716049382713,0.5061728395061729
E01009577,1293,615,678,0.4756380510440835,0.5243619489559165
E01009579,1681,791,890,0.47055324211778704,0.529446757882213
E01009581,1569,720,849,0.4588910133843212,0.5411089866156787
E01009584,1422,681,741,0.47890295358649787,0.5210970464135021
E01009585,1062,477,585,0.4491525423728814,0.5508474576271186
E01009709,1065,498,567,0.4676056338028169,0.532394366197183
E01009576,1575,754,821,0.47873015873015873,0.5212698412698412
E01009578,1425,711,714,0.49894736842105264,0.5010526315789474
E01009582,1740,816,924,0.4689655172413793,0.5310344827586206
E01009583,1608,761,847,0.4732587064676617,0.5267412935323383
E01009586,1671,831,840,0.49730700179533216,0.5026929982046678
E01009565,1715,857,858,0.49970845481049564,0.5002915451895044
E01009566,1581,806,775,0.5098039215686274,0.49019607843137253
E01009567,1838,939,899,0.5108813928182807,0.48911860718171923
E01009568,1788,902,886,0.5044742729306487,0.4955257270693512
E01009523,1532,741,791,0.48368146214099217,0.5163185378590078
E01009526,1615,795,820,0.49226006191950467,0.5077399380804953
E01009528,1595,796,799,0.4990595611285266,0.5009404388714733
E01009531,1539,731,808,0.47498375568551005,0.5250162443144899
E01009587,1535,768,767,0.5003257328990228,0.4996742671009772
E01009624,1628,770,858,0.47297297297297297,0.527027027027027
E01009625,2346,1131,1215,0.4820971867007673,0.5179028132992327
E01009626,1638,806,832,0.49206349206349204,0.5079365079365079
E01009622,1782,809,973,0.45398428731762064,0.5460157126823794
E01009623,1523,744,779,0.4885095206828628,0.5114904793171372
E01009627,1561,764,797,0.4894298526585522,0.5105701473414478
E01009628,1511,722,789,0.47782925215089345,0.5221707478491066
E01009599,1240,600,640,0.4838709677419355,0.5161290322580645
E01009663,1438,691,747,0.480528511821975,0.519471488178025
E01009710,1393,704,689,0.5053840631730079,0.4946159368269921
E01009711,1411,707,704,0.5010630758327428,0.49893692416725727
E01009522,1434,670,764,0.46722454672245467,0.5327754532775453
E01009529,1541,763,778,0.49513303049967555,0.5048669695003245
E01009530,1385,671,714,0.4844765342960289,0.5155234657039711
E01009645,1474,721,753,0.4891451831750339,0.510854816824966
E01009569,1309,639,670,0.4881588999236058,0.5118411000763942
E01009570,1802,936,866,0.5194228634850167,0.48057713651498335
E01009571,1623,851,772,0.5243376463339495,0.47566235366605053
E01009572,2176,1119,1057,0.5142463235294118,0.48575367647058826
E01009573,1544,798,746,0.5168393782383419,0.483160621761658
E01009574,1600,814,786,0.50875,0.49125
E01009655,1853,903,950,0.4873178629249865,0.5126821370750135
E01009656,1604,806,798,0.5024937655860349,0.4975062344139651
E01009659,1724,874,850,0.5069605568445475,0.49303944315545245
E01009662,1440,747,693,0.51875,0.48125
E01009664,1511,768,743,0.5082726671078756,0.49172733289212445
E01009643,1499,735,764,0.4903268845897265,0.5096731154102735
E01009644,1657,787,870,0.4749547374773687,0.5250452625226313
E01009647,1751,810,941,0.46259280411193604,0.537407195888064
E01009648,1545,759,786,0.4912621359223301,0.5087378640776699
E01009652,1446,710,736,0.49100968188105115,0.5089903181189488
E01009653,1574,762,812,0.4841168996188056,0.5158831003811944
E01009613,1309,636,673,0.48586707410236823,0.5141329258976318
E01009657,1672,814,858,0.4868421052631579,0.5131578947368421
E01009712,1597,775,822,0.4852849092047589,0.514715090795241
E01009714,1539,741,798,0.48148148148148145,0.5185185185185185
E01009716,1743,844,899,0.48422260470453243,0.5157773952954676
E01009580,1213,584,629,0.4814509480626546,0.5185490519373455
E01009713,1397,673,724,0.4817465998568361,0.5182534001431639
E01009715,1377,665,712,0.4829339143064633,0.5170660856935366
E01009717,1458,738,720,0.5061728395061729,0.49382716049382713
E01009718,1687,857,830,0.5080023710729105,0.4919976289270895
E01009629,2758,1431,1327,0.518854242204496,0.481145757795504
E01009630,1685,781,904,0.4635014836795252,0.5364985163204747
E01009631,1329,635,694,0.4778028592927013,0.5221971407072987
E01009632,1642,944,698,0.5749086479902558,0.42509135200974424
E01009650,1600,914,686,0.57125,0.42875
E01009614,1457,681,776,0.4673987645847632,0.5326012354152367
E01009654,1764,853,911,0.48356009070294786,0.5164399092970522
E01009658,1509,774,735,0.5129224652087475,0.4870775347912525
E01009660,1773,950,823,0.535815002820079,0.464184997179921
E01009646,1524,761,763,0.49934383202099736,0.5006561679790026
E01009692,1274,591,683,0.4638932496075353,0.5361067503924647
E01009693,1500,715,785,0.4766666666666667,0.5233333333333333
E01009694,1428,692,736,0.484593837535014,0.5154061624649859
E01009695,1546,767,779,0.4961190168175938,0.5038809831824063
E01009696,1516,752,764,0.49604221635883905,0.503957783641161
E01009704,1475,715,760,0.4847457627118644,0.5152542372881356
E01009705,1459,714,745,0.4893762851267992,0.5106237148732008
E01009636,2270,1202,1068,0.5295154185022026,0.47048458149779737
E01009637,1488,747,741,0.5020161290322581,0.49798387096774194
E01009638,1503,839,664,0.5582168995342648,0.4417831004657352
E01009639,1746,888,858,0.5085910652920962,0.49140893470790376
E01009640,1871,955,916,0.5104222340994121,0.48957776590058794
E01009641,2875,1531,1344,0.5325217391304348,0.46747826086956523
E01009697,1454,737,717,0.5068775790921596,0.4931224209078404
E01009698,1526,758,768,0.4967234600262123,0.5032765399737876
E01009703,2591,1240,1351,0.4785796989579313,0.5214203010420687
E01009706,1491,732,759,0.4909456740442656,0.5090543259557344
E01009649,1418,711,707,0.501410437235543,0.498589562764457
E01009684,1405,674,731,0.4797153024911032,0.5202846975088968
E01009685,1642,794,848,0.4835566382460414,0.5164433617539586
E01009686,1674,812,862,0.4850657108721625,0.5149342891278376
E01009687,1407,710,697,0.5046197583511016,0.4953802416488984
E01009615,1778,917,861,0.515748031496063,0.484251968503937
E01009616,1559,733,826,0.47017318794098784,0.5298268120590122
E01009617,1272,626,646,0.4921383647798742,0.5078616352201258
E01009618,1526,755,771,0.4947575360419397,0.5052424639580603
E01009620,1466,713,753,0.4863574351978172,0.5136425648021828
E01009621,1366,677,689,0.4956076134699854,0.5043923865300146
E01009633,1781,950,831,0.5334081976417743,0.4665918023582257
E01009634,1641,880,761,0.5362583790371724,0.46374162096282756
E01009635,3207,1834,1373,0.5718740255690676,0.4281259744309323
E01009661,1824,946,878,0.518640350877193,0.48135964912280704
E01009674,1590,757,833,0.4761006289308176,0.5238993710691824
E01009699,1430,714,716,0.4993006993006993,0.5006993006993007
E01009700,1614,790,824,0.48946716232961585,0.5105328376703842
E01009701,1519,716,803,0.47136273864384465,0.5286372613561554
E01009702,1444,700,744,0.48476454293628807,0.5152354570637119
E01009688,1479,784,695,0.5300878972278567,0.46991210277214335
E01009689,1475,810,665,0.5491525423728814,0.45084745762711864
E01009690,1471,731,740,0.4969408565601632,0.5030591434398368
E01009691,1360,706,654,0.5191176470588236,0.4808823529411765
E01009548,2273,1198,1075,0.5270567531896172,0.47294324681038274
E01009553,2099,1208,891,0.5755121486422106,0.42448785135778944
E01009642,2766,1677,1089,0.6062906724511931,0.39370932754880694
E01009651,1648,902,746,0.5473300970873787,0.4526699029126214
E01009676,1482,712,770,0.48043184885290147,0.5195681511470985
E01009681,1286,653,633,0.5077760497667185,0.49222395023328147
E01009682,1531,771,760,0.503592423252776,0.496407576747224
E01009683,1354,645,709,0.47636632200886264,0.5236336779911374
E01009532,1338,638,700,0.476831091180867,0.523168908819133
E01009535,1330,657,673,0.493984962406015,0.5060150375939849
E01009536,1472,743,729,0.5047554347826086,0.4952445652173913
E01009543,1761,882,879,0.5008517887563884,0.4991482112436116
E01009707,1869,919,950,0.4917067950775816,0.5082932049224184
E01009708,1486,709,777,0.4771197846567968,0.5228802153432033
E01009554,1321,669,652,0.5064345193035579,0.49356548069644207
E01009555,1452,746,706,0.5137741046831956,0.48622589531680444
E01009556,1522,740,782,0.48620236530880423,0.5137976346911958
E01009557,1329,658,671,0.49510910458991725,0.5048908954100828
E01009558,1490,775,715,0.5201342281879194,0.4798657718120805
E01009559,1401,674,727,0.48108493932905066,0.5189150606709493
E01009537,1494,717,777,0.4799196787148594,0.5200803212851406
E01009538,1447,687,760,0.474775397373877,0.525224602626123
E01009611,2138,1016,1122,0.4752104770813845,0.5247895229186156
E01009612,1402,679,723,0.4843081312410842,0.5156918687589158
E01032527,1571,752,819,0.47867600254614895,0.521323997453851
E01032528,1521,712,809,0.46811308349769887,0.5318869165023011
E01009679,1463,739,724,0.5051264524948735,0.49487354750512647
E01032531,2600,1242,1358,0.4776923076923077,0.5223076923076924
E01032532,1320,645,675,0.48863636363636365,0.5113636363636364
E01032533,1857,945,912,0.5088852988691438,0.4911147011308562
E01009549,1619,795,824,0.49104385423100677,0.5089561457689932
E01009550,1854,913,941,0.4924487594390507,0.5075512405609492
E01009552,1595,770,825,0.4827586206896552,0.5172413793103449
E01032534,1906,895,1011,0.4695697796432319,0.5304302203567681
E01032535,1185,581,604,0.490295358649789,0.509704641350211
E01009544,1543,794,749,0.5145819831497084,0.4854180168502916
E01009619,1885,1031,854,0.5469496021220159,0.45305039787798407
E01032529,1238,583,655,0.47092084006462037,0.5290791599353797
E01032530,1849,924,925,0.49972958355868036,0.5002704164413196
E01009539,1587,783,804,0.4933837429111531,0.5066162570888468
E01009540,1926,919,1007,0.4771547248182762,0.5228452751817237
E01009541,1532,742,790,0.48433420365535246,0.5156657963446475
E01009542,1774,970,804,0.5467869222096956,0.4532130777903044
E01009560,1539,776,763,0.5042235217673814,0.49577647823261856
E01009561,1587,766,821,0.48267170762444866,0.5173282923755513
E01009562,1642,819,823,0.4987819732034105,0.5012180267965896
E01009563,1672,808,864,0.48325358851674644,0.5167464114832536
E01009672,2086,1020,1066,0.48897411313518696,0.5110258868648131
E01009666,1310,647,663,0.49389312977099237,0.5061068702290077
E01009667,1356,645,711,0.4756637168141593,0.5243362831858407
E01009668,1643,793,850,0.48265368228849664,0.5173463177115033
E01009670,1664,847,817,0.5090144230769231,0.4909855769230769
E01009665,1188,601,587,0.5058922558922558,0.4941077441077441
E01009669,1288,638,650,0.4953416149068323,0.5046583850931677
E01009671,4248,2171,2077,0.5110640301318268,0.4889359698681733
E01033058,2674,1374,1300,0.5138369483919222,0.48616305160807777
E01009588,1538,731,807,0.4752925877763329,0.5247074122236671
E01009592,1633,768,865,0.47030006123698714,0.5296999387630129
E01009596,1524,752,772,0.49343832020997375,0.5065616797900262
E01009597,1788,854,934,0.47762863534675615,0.5223713646532439
E01032587,1747,861,886,0.4928448769318832,0.5071551230681167
E01009763,1857,891,966,0.4798061389337641,0.5201938610662359
E01009764,1425,711,714,0.49894736842105264,0.5010526315789474
E01009767,1468,701,767,0.4775204359673024,0.5224795640326976
E01009769,1579,788,791,0.4990500316656111,0.5009499683343889
E01009770,1453,710,743,0.48864418444597385,0.5113558155540262
E01009773,1543,739,804,0.47893713545042127,0.5210628645495787
E01009777,1451,739,712,0.5093039283252929,0.4906960716747071
E01009778,1550,784,766,0.5058064516129033,0.4941935483870968
E01009895,1407,673,734,0.4783226723525231,0.5216773276474769
E01009896,1486,710,776,0.477792732166891,0.522207267833109
E01009897,1455,732,723,0.5030927835051546,0.49690721649484537
E01009898,1477,707,770,0.4786729857819905,0.5213270142180095
E01009901,1397,675,722,0.4831782390837509,0.5168217609162491
E01009902,1269,615,654,0.4846335697399527,0.5153664302600472
E01009765,1604,799,805,0.4981296758104738,0.5018703241895262
E01009766,1584,784,800,0.494949494949495,0.5050505050505051
E01009768,1387,659,728,0.47512617159336695,0.524873828406633
E01009771,1392,667,725,0.4791666666666667,0.5208333333333334
E01009775,1600,779,821,0.486875,0.513125
E01009776,1534,758,776,0.4941329856584094,0.5058670143415906
E01009758,1703,831,872,0.4879624192601292,0.5120375807398708
E01009760,1317,652,665,0.49506454062262717,0.5049354593773728
E01009772,1343,607,736,0.45197319434102756,0.5480268056589724
E01009774,1577,760,817,0.4819277108433735,0.5180722891566265
E01009788,1578,776,802,0.4917617237008872,0.5082382762991128
E01009756,1411,658,753,0.4663359319631467,0.5336640680368533
E01009757,1652,804,848,0.48668280871670705,0.513317191283293
E01009759,1291,663,628,0.5135553834237025,0.48644461657629745
E01009762,1398,646,752,0.46208869814020026,0.5379113018597997
E01033187,2338,1109,1229,0.4743370402053037,0.5256629597946963
E01009781,1899,940,959,0.49499736703528174,0.5050026329647183
E01009786,1497,732,765,0.48897795591182364,0.5110220440881763
E01009789,1459,723,736,0.49554489376285127,0.5044551062371487
E01009790,1545,780,765,0.5048543689320388,0.49514563106796117
E01009779,1359,661,698,0.4863870493009566,0.5136129506990434
E01009782,1557,751,806,0.48233782915863843,0.5176621708413616
E01009783,1467,737,730,0.5023858214042263,0.49761417859577367
E01009785,1448,717,731,0.4951657458563536,0.5048342541436464
E01009899,1436,704,732,0.49025069637883006,0.5097493036211699
E01009900,1464,711,753,0.48565573770491804,0.514344262295082
E01009780,2071,1021,1050,0.49299855142443266,0.5070014485755674
E01009784,1669,823,846,0.49310964649490713,0.5068903535050928
E01009787,1571,785,786,0.4996817313812858,0.5003182686187142
E01009880,1603,785,818,0.4897067997504679,0.5102932002495322
E01009882,1415,712,703,0.5031802120141343,0.49681978798586574
E01009891,1729,835,894,0.48293811451706187,0.5170618854829381
E01009892,1508,745,763,0.49403183023872677,0.5059681697612732
E01009893,1716,817,899,0.4761072261072261,0.5238927738927739
E01009894,1757,835,922,0.4752418895845191,0.5247581104154809
E01009844,1499,751,748,0.5010006671114076,0.4989993328885924
E01009879,2049,995,1054,0.48560273304050755,0.5143972669594924
E01009881,2077,1116,961,0.5373134328358209,0.4626865671641791
E01009885,1561,790,771,0.5060858424087123,0.49391415759128765
E01009816,1473,720,753,0.48879837067209775,0.5112016293279023
E01009817,1283,605,678,0.4715510522213562,0.5284489477786438
E01009819,1560,766,794,0.491025641025641,0.5089743589743589
E01009820,1548,741,807,0.4786821705426357,0.5213178294573644
E01009748,1636,796,840,0.48655256723716384,0.5134474327628362
E01009839,1646,825,821,0.5012150668286756,0.49878493317132444
E01009883,1368,670,698,0.489766081871345,0.5102339181286549
E01009884,1548,789,759,0.5096899224806202,0.4903100775193798
E01009886,1592,792,800,0.49748743718592964,0.5025125628140703
E01009814,1329,631,698,0.4747930775018811,0.5252069224981188
E01009815,1325,653,672,0.4928301886792453,0.5071698113207547
E01009818,1139,564,575,0.495171202809482,0.504828797190518
E01009821,1400,681,719,0.48642857142857143,0.5135714285714286
E01009822,1504,722,782,0.4800531914893617,0.5199468085106383
E01009887,1783,868,915,0.4868199663488503,0.5131800336511497
E01009888,1615,798,817,0.49411764705882355,0.5058823529411764
E01009889,1838,921,917,0.501088139281828,0.49891186071817195
E01009890,1693,820,873,0.48434731246308327,0.5156526875369167
E01009749,1454,729,725,0.5013755158184319,0.4986244841815681
E01009750,1521,771,750,0.5069033530571992,0.4930966469428008
E01009823,1401,714,687,0.5096359743040685,0.49036402569593146
E01009824,1648,813,835,0.4933252427184466,0.5066747572815534
E01009751,1498,733,765,0.4893190921228304,0.5106809078771696
E01009752,1504,745,759,0.4953457446808511,0.504654255319149
E01009753,1578,754,824,0.47782002534854245,0.5221799746514575
E01009754,1641,792,849,0.4826325411334552,0.5173674588665448
E01009841,1605,780,825,0.48598130841121495,0.514018691588785
E01009840,1435,696,739,0.48501742160278744,0.5149825783972125
E01009842,1837,968,869,0.5269461077844312,0.47305389221556887
E01009843,1569,759,810,0.4837476099426386,0.5162523900573613
E01009871,1844,952,892,0.5162689804772235,0.4837310195227766
E01009875,1594,769,825,0.48243412797992474,0.5175658720200753
E01009825,1435,710,725,0.49477351916376305,0.5052264808362369
E01009826,1469,725,744,0.49353301565690944,0.5064669843430906
E01009827,1600,777,823,0.485625,0.514375
E01009828,1378,685,693,0.49709724238026126,0.5029027576197388
E01009829,1547,764,783,0.49385908209437623,0.5061409179056238
E01009830,1607,775,832,0.48226509023024267,0.5177349097697573
E01009872,1499,760,739,0.5070046697798533,0.49299533022014674
E01009873,1509,732,777,0.4850894632206759,0.5149105367793241
E01009874,1615,825,790,0.5108359133126935,0.4891640866873065
E01009876,1668,822,846,0.49280575539568344,0.5071942446043165
E01009877,1566,763,803,0.4872286079182631,0.5127713920817369
E01009911,1354,679,675,0.5014771048744461,0.4985228951255539
E01009912,1708,821,887,0.4806791569086651,0.5193208430913349
E01009913,1544,775,769,0.5019430051813472,0.49805699481865284
E01009914,1429,688,741,0.4814555633310007,0.5185444366689993
E01009915,1721,834,887,0.484601975595584,0.5153980244044161
E01009916,1695,850,845,0.5014749262536873,0.49852507374631266
E01009741,2291,1219,1072,0.5320820602357049,0.4679179397642951
E01009744,1871,930,941,0.49706039551042225,0.5029396044895778
E01009746,1661,845,816,0.5087296809151114,0.4912703190848886
E01009747,1492,741,751,0.49664879356568364,0.5033512064343163
E01009731,1566,780,786,0.49808429118773945,0.5019157088122606
E01009740,1682,808,874,0.4803804994054697,0.5196195005945303
E01009742,1568,744,824,0.4744897959183674,0.5255102040816326
E01009743,1795,862,933,0.48022284122562675,0.5197771587743732
E01009745,1713,841,872,0.4909515469935785,0.5090484530064214
E01009917,1266,628,638,0.4960505529225908,0.5039494470774092
E01009918,1424,664,760,0.46629213483146065,0.5337078651685393
E01009919,1240,624,616,0.5032258064516129,0.4967741935483871
E01009920,1409,708,701,0.5024840312278211,0.49751596877217885
E01009864,1636,795,841,0.48594132029339854,0.5140586797066015
E01009865,1491,722,769,0.4842387659289068,0.5157612340710932
E01009866,1652,808,844,0.4891041162227603,0.5108958837772397
E01009867,1734,861,873,0.49653979238754326,0.5034602076124568
E01009878,2023,980,1043,0.4844290657439446,0.5155709342560554
E01009791,1509,765,744,0.5069582504970179,0.49304174950298213
E01009792,1583,777,806,0.490840176879343,0.509159823120657
E01009795,1657,798,859,0.4815932407966204,0.5184067592033796
E01009796,1510,738,772,0.48874172185430464,0.5112582781456954
E01009798,1702,847,855,0.49764982373678024,0.5023501762632198
E01009719,1443,720,723,0.498960498960499,0.501039501039501
E01009722,1370,665,705,0.4854014598540146,0.5145985401459854
E01009727,1353,674,679,0.49815225424981524,0.5018477457501848
E01009728,1351,701,650,0.5188749074759438,0.4811250925240563
E01009729,1570,787,783,0.5012738853503185,0.49872611464968153
E01009720,1416,694,722,0.4901129943502825,0.5098870056497176
E01009723,1258,637,621,0.5063593004769475,0.49364069952305245
E01009724,1497,732,765,0.48897795591182364,0.5110220440881763
E01009730,1488,743,745,0.4993279569892473,0.5006720430107527
E01009903,1458,698,760,0.4787379972565158,0.5212620027434842
E01009904,1447,693,754,0.47892190739460955,0.5210780926053905
E01009909,1362,632,730,0.46402349486049926,0.5359765051395007
E01009910,1579,772,807,0.4889170360987967,0.5110829639012033
E01009793,1387,683,704,0.4924297043979812,0.5075702956020187
E01009794,1477,720,757,0.48747461069735953,0.5125253893026405
E01009797,1348,620,728,0.4599406528189911,0.5400593471810089
E01009801,1664,815,849,0.48978365384615385,0.5102163461538461
E01009721,1898,910,988,0.4794520547945205,0.5205479452054794
E01009725,1439,680,759,0.47255038220986795,0.527449617790132
E01009726,1332,681,651,0.5112612612612613,0.48873873873873874
E01009834,1605,774,831,0.4822429906542056,0.5177570093457944
E01009833,1392,689,703,0.4949712643678161,0.5050287356321839
E01009835,1563,772,791,0.49392194497760716,0.5060780550223928
E01009869,1590,767,823,0.48238993710691824,0.5176100628930818
E01009870,1460,779,681,0.5335616438356164,0.46643835616438356
E01009809,1628,776,852,0.47665847665847666,0.5233415233415234
E01009813,1600,780,820,0.4875,0.5125
E01009861,1549,741,808,0.47837314396384767,0.5216268560361523
E01009862,1759,848,911,0.48209209778283113,0.5179079022171689
E01009863,1844,901,943,0.4886117136659436,0.5113882863340564
E01009868,1560,763,797,0.4891025641025641,0.5108974358974359
E01009734,1528,756,772,0.49476439790575916,0.5052356020942408
E01009735,1495,751,744,0.5023411371237458,0.49765886287625416
E01009736,1395,684,711,0.49032258064516127,0.5096774193548387
E01009737,1479,713,766,0.48208248816768084,0.5179175118323192
E01009738,1558,750,808,0.4813863928112965,0.5186136071887034
E01009856,1983,1008,975,0.5083207261724659,0.491679273827534
E01009905,1389,671,718,0.48308135349172066,0.5169186465082793
E01009906,1621,866,755,0.5342381246144355,0.46576187538556446
E01009907,1468,707,761,0.4816076294277929,0.5183923705722071
E01009908,1652,814,838,0.4927360774818402,0.5072639225181598
E01009800,1567,737,830,0.47032546266751757,0.5296745373324825
E01009802,1619,788,831,0.48672019765287217,0.5132798023471279
E01009803,1631,803,828,0.49233599019006746,0.5076640098099325
E01009804,1328,662,666,0.49849397590361444,0.5015060240963856
E01009831,1469,748,721,0.5091899251191286,0.49081007488087136
E01009836,1834,910,924,0.4961832061068702,0.5038167938931297
E01009837,1604,811,793,0.5056109725685786,0.49438902743142144
E01009838,1668,845,823,0.5065947242206235,0.4934052757793765
E01009847,1465,724,741,0.49419795221843005,0.50580204778157
E01009848,1430,698,732,0.4881118881118881,0.5118881118881119
E01009849,1541,751,790,0.4873458792991564,0.5126541207008436
E01009851,1438,689,749,0.47913769123783034,0.5208623087621697
E01009732,1744,861,883,0.49369266055045874,0.5063073394495413
E01009733,1779,887,892,0.4985947161326588,0.5014052838673412
E01009739,1537,756,781,0.49186727391021473,0.5081327260897853
E01009799,1497,723,774,0.48296593186372744,0.5170340681362725
E01009805,1402,689,713,0.4914407988587732,0.5085592011412268
E01009806,1451,713,738,0.4913852515506547,0.5086147484493453
E01009854,1533,751,782,0.48988910632746246,0.5101108936725375
E01009857,1613,785,828,0.4866707997520149,0.5133292002479851
E01009858,1565,912,653,0.5827476038338658,0.4172523961661342
E01009859,1616,790,826,0.48886138613861385,0.5111386138613861
E01009845,1521,755,766,0.49638395792241946,0.5036160420775806
E01009846,1473,719,754,0.4881194840461643,0.5118805159538357
E01009850,1480,710,770,0.4797297297297297,0.5202702702702703
E01009852,1493,720,773,0.4822505023442733,0.5177494976557268
E01009832,1650,780,870,0.4727272727272727,0.5272727272727272
E01009853,1387,668,719,0.4816149963950973,0.5183850036049027
E01009855,1632,780,852,0.47794117647058826,0.5220588235294118
E01009860,1533,768,765,0.5009784735812133,0.49902152641878667
E01009807,1801,876,925,0.4863964464186563,0.5136035535813437
E01009808,1452,695,757,0.4786501377410468,0.5213498622589532
E01009810,1741,842,899,0.48363009764503156,0.5163699023549684
E01009811,1536,752,784,0.4895833333333333,0.5104166666666666
E01009812,1530,754,776,0.4928104575163399,0.5071895424836601
E01010085,1606,777,829,0.4838107098381071,0.5161892901618929
E01010086,1742,869,873,0.49885189437428246,0.5011481056257175
E01010087,1718,853,865,0.49650756693830034,0.5034924330616997
E01010088,1547,770,777,0.497737556561086,0.502262443438914
E01010089,1867,887,980,0.4750937332619175,0.5249062667380825
E01009969,1944,904,1040,0.46502057613168724,0.5349794238683128
E01009970,1498,745,753,0.49732977303070763,0.5026702269692924
E01009971,1617,749,868,0.46320346320346323,0.5367965367965368
E01009973,2439,1194,1245,0.48954489544895446,0.5104551045510455
E01009960,1585,778,807,0.4908517350157729,0.5091482649842272
E01009961,1238,599,639,0.48384491114701134,0.5161550888529887
E01009966,1217,588,629,0.48315529991783074,0.5168447000821693
E01009967,1807,870,937,0.48146098505810736,0.5185390149418926
E01010092,1907,920,987,0.4824331410592554,0.5175668589407446
E01009962,1336,614,722,0.4595808383233533,0.5404191616766467
E01009963,1347,626,721,0.4647364513734224,0.5352635486265775
E01009964,1524,736,788,0.48293963254593175,0.5170603674540682
E01009965,1419,715,704,0.5038759689922481,0.49612403100775193
E01010090,1704,837,867,0.49119718309859156,0.5088028169014085
E01010091,1516,742,774,0.4894459102902375,0.5105540897097626
E01010096,1479,711,768,0.48073022312373226,0.5192697768762677
E01010097,1766,862,904,0.4881087202718007,0.5118912797281994
E01009968,1471,730,741,0.49626104690686607,0.5037389530931339
E01009972,1817,896,921,0.49312052834342324,0.5068794716565768
E01009974,1492,717,775,0.48056300268096513,0.5194369973190348
E01009975,1640,819,821,0.499390243902439,0.500609756097561
E01010030,1505,743,762,0.493687707641196,0.506312292358804
E01010034,1408,711,697,0.5049715909090909,0.4950284090909091
E01010035,1368,704,664,0.5146198830409356,0.4853801169590643
E01010036,1651,817,834,0.49485160508782555,0.5051483949121744
E01009982,1561,757,804,0.4849455477258168,0.5150544522741832
E01009983,1460,705,755,0.4828767123287671,0.5171232876712328
E01010029,1399,666,733,0.4760543245175125,0.5239456754824875
E01010037,1097,537,560,0.48951686417502277,0.5104831358249772
E01009991,2204,1054,1150,0.4782214156079855,0.5217785843920145
E01009994,1545,767,778,0.4964401294498382,0.5035598705501618
E01009995,1622,794,828,0.48951911220715166,0.5104808877928483
E01009996,1579,768,811,0.4863837872070931,0.5136162127929069
E01009997,1734,847,887,0.4884659746251442,0.5115340253748558
E01009998,1966,936,1030,0.4760935910478128,0.5239064089521872
E01010008,1588,776,812,0.48866498740554154,0.5113350125944585
E01010010,1342,643,699,0.4791356184798808,0.5208643815201193
E01010011,1645,824,821,0.5009118541033435,0.4990881458966565
E01010012,1400,680,720,0.4857142857142857,0.5142857142857142
E01010007,1281,621,660,0.4847775175644028,0.5152224824355972
E01010009,1423,687,736,0.48278285312719604,0.517217146872804
E01010013,1247,606,641,0.4859663191659984,0.5140336808340016
E01010014,1632,780,852,0.47794117647058826,0.5220588235294118
E01010093,1095,555,540,0.5068493150684932,0.4931506849315068
E01010094,1465,710,755,0.48464163822525597,0.515358361774744
E01010095,1382,703,679,0.5086830680173662,0.4913169319826339
E01010098,1712,823,889,0.4807242990654206,0.5192757009345794
E01010099,1636,806,830,0.49266503667481665,0.5073349633251834
E01010100,1763,854,909,0.4844015882019285,0.5155984117980714
E01009978,1736,901,835,0.5190092165898618,0.48099078341013823
E01010031,1566,794,772,0.5070242656449553,0.4929757343550447
E01010032,1448,688,760,0.47513812154696133,0.5248618784530387
E01010033,1539,812,727,0.5276153346328785,0.4723846653671215
E01010074,2335,1122,1213,0.48051391862955034,0.5194860813704497
E01010066,1498,724,774,0.4833110814419226,0.5166889185580774
E01010067,1528,812,716,0.5314136125654451,0.468586387434555
E01010068,1636,754,882,0.460880195599022,0.539119804400978
E01010070,1589,753,836,0.47388294524858404,0.526117054751416
E01010075,1458,732,726,0.5020576131687243,0.49794238683127573
E01010076,1287,619,668,0.48096348096348096,0.519036519036519
E01009976,2510,1225,1285,0.48804780876494025,0.5119521912350598
E01009977,1763,896,867,0.5082246171298922,0.49177538287010775
E01009979,1561,758,803,0.4855861627162076,0.5144138372837924
E01009980,2283,1124,1159,0.49233464739378013,0.5076653526062199
E01010069,1832,917,915,0.5005458515283843,0.49945414847161573
E01010071,1728,870,858,0.5034722222222222,0.4965277777777778
E01009947,1937,947,990,0.48890036138358284,0.5110996386164172
E01009992,1701,837,864,0.49206349206349204,0.5079365079365079
E01009993,1876,898,978,0.47867803837953093,0.5213219616204691
E01010103,1891,952,939,0.5034373347435219,0.4965626652564781
E01010104,1645,821,824,0.4990881458966565,0.5009118541033435
E01010105,1483,755,728,0.5091031692515172,0.4908968307484828
E01009981,1797,899,898,0.5002782415136339,0.4997217584863662
E01009985,1719,856,863,0.49796393251890636,0.5020360674810936
E01032887,2757,1438,1319,0.5215814290895902,0.47841857091040985
E01009986,1367,699,668,0.5113386978785662,0.48866130212143377
E01009987,1233,644,589,0.5223033252230332,0.47769667477696676
E01009989,1645,855,790,0.5197568389057751,0.48024316109422494
E01010106,1557,813,744,0.5221579961464354,0.47784200385356457
E01009988,1778,878,900,0.4938132733408324,0.5061867266591676
E01010101,1883,981,902,0.5209771640998406,0.4790228359001593
E01010102,1754,892,862,0.508551881413911,0.49144811858608894
E01010107,1751,944,807,0.53912050256996,0.46087949743004
E01010015,1686,850,836,0.5041518386714117,0.4958481613285884
E01010016,1626,785,841,0.482779827798278,0.517220172201722
E01010018,2068,1021,1047,0.4937137330754352,0.5062862669245648
E01010072,2290,1130,1160,0.49344978165938863,0.5065502183406113
E01010073,1502,729,773,0.48535286284953394,0.5146471371504661
E01010077,1531,725,806,0.47354670150228606,0.5264532984977139
E01010079,1523,767,756,0.5036112934996717,0.4963887065003283
E01010080,1793,897,896,0.5002788622420524,0.4997211377579476
E01010081,1517,768,749,0.5062623599208965,0.4937376400791035
E01010082,2303,1172,1131,0.508901432913591,0.49109856708640903
E01010083,1704,827,877,0.48532863849765256,0.5146713615023474
E01010084,1599,751,848,0.46966854283927456,0.5303314571607255
E01010046,2067,1027,1040,0.4968553459119497,0.5031446540880503
E01010047,1872,920,952,0.49145299145299143,0.5085470085470085
E01010048,1678,882,796,0.5256257449344458,0.47437425506555425
E01010049,1624,831,793,0.5116995073891626,0.4883004926108374
E01010050,1521,785,736,0.5161078238001315,0.4838921761998685
E01010052,1410,682,728,0.4836879432624113,0.5163120567375886
E01010053,1974,963,1011,0.4878419452887538,0.5121580547112462
E01010017,1895,952,943,0.5023746701846966,0.49762532981530344
E01010019,1729,890,839,0.5147484094852516,0.4852515905147484
E01010020,1887,920,967,0.48754636989931105,0.5124536301006889
E01010021,1700,833,867,0.49,0.51
E01010039,1374,660,714,0.48034934497816595,0.519650655021834
E01010043,1464,738,726,0.5040983606557377,0.4959016393442623
E01010044,1395,679,716,0.4867383512544803,0.5132616487455197
E01010078,1275,625,650,0.49019607843137253,0.5098039215686274
E01010059,1926,959,967,0.4979231568016615,0.5020768431983386
E01010061,1828,951,877,0.5202407002188184,0.4797592997811816
E01010062,1594,778,816,0.4880803011292346,0.5119196988707654
E01010063,2145,1108,1037,0.5165501165501165,0.48344988344988343
E01010064,1800,847,953,0.47055555555555556,0.5294444444444445
E01010065,2690,1311,1379,0.48736059479553906,0.5126394052044609
E01009934,1455,700,755,0.48109965635738833,0.5189003436426117
E01009935,1916,961,955,0.5015657620041754,0.49843423799582465
E01009936,1638,811,827,0.49511599511599513,0.5048840048840049
E01010004,1558,787,771,0.5051347881899871,0.49486521181001286
E01010054,1906,930,976,0.4879328436516264,0.5120671563483735
E01010055,1697,857,840,0.5050088391278728,0.4949911608721273
E01010056,1600,776,824,0.485,0.515
E01010057,1965,955,1010,0.4860050890585242,0.5139949109414759
E01010060,1972,987,985,0.5005070993914807,0.49949290060851925
E01010038,1789,862,927,0.48183342649524874,0.5181665735047513
E01010040,1429,690,739,0.4828551434569629,0.5171448565430371
E01010041,1690,808,882,0.47810650887573963,0.5218934911242603
E01010045,1599,756,843,0.4727954971857411,0.5272045028142589
E01010000,1572,790,782,0.5025445292620865,0.49745547073791346
E01010002,2112,1082,1030,0.5123106060606061,0.4876893939393939
E01010003,1499,748,751,0.4989993328885924,0.5010006671114076
E01010005,1510,762,748,0.5046357615894039,0.495364238410596
E01010006,1653,828,825,0.5009074410163339,0.49909255898366606
E01009938,1703,841,862,0.4938344098649442,0.5061655901350558
E01009943,1471,692,779,0.47042828008157717,0.5295717199184229
E01009944,1503,713,790,0.4743845642049235,0.5256154357950765
E01010051,1232,567,665,0.4602272727272727,0.5397727272727273
E01010058,1641,789,852,0.48080438756855576,0.5191956124314442
E01009937,1590,766,824,0.4817610062893082,0.5182389937106918
E01009939,1761,862,899,0.4894946053378762,0.5105053946621237
E01009940,1489,724,765,0.4862323707186031,0.513767629281397
E01009941,1538,749,789,0.4869960988296489,0.5130039011703511
E01009942,1648,782,866,0.47451456310679613,0.5254854368932039
E01009929,1708,828,880,0.4847775175644028,0.5152224824355972
E01009930,1521,741,780,0.48717948717948717,0.5128205128205128
E01009931,2242,1107,1135,0.4937555753791258,0.5062444246208743
E01009932,1691,820,871,0.48492016558249557,0.5150798344175045
E01009999,1377,683,694,0.49600580973129993,0.5039941902687001
E01009921,1579,805,774,0.5098163394553515,0.4901836605446485
E01009922,1267,596,671,0.47040252565114443,0.5295974743488555
E01009924,1375,656,719,0.47709090909090907,0.5229090909090909
E01009925,1349,653,696,0.4840622683469237,0.5159377316530763
E01009926,1413,657,756,0.46496815286624205,0.535031847133758
E01009927,1564,797,767,0.5095907928388747,0.4904092071611253
E01009928,1759,841,918,0.47811256395679363,0.5218874360432064
E01009933,1494,733,761,0.49062918340026773,0.5093708165997323
E01009952,1963,1006,957,0.5124808965868568,0.48751910341314314
E01009955,1929,996,933,0.5163297045101088,0.48367029548989116
E01009956,1571,784,787,0.4990451941438574,0.5009548058561426
E01009959,1438,723,715,0.5027816411682893,0.4972183588317107
E01010042,1787,864,923,0.4834918858421936,0.5165081141578064
E01009923,1446,700,746,0.48409405255878285,0.5159059474412172
E01010024,1513,723,790,0.47785855915399866,0.5221414408460013
E01010026,1727,804,923,0.46554719166184133,0.5344528083381587
E01010027,1519,746,773,0.4911125740618828,0.5088874259381172
E01010001,1743,819,924,0.46987951807228917,0.5301204819277109
E01010022,1550,750,800,0.4838709677419355,0.5161290322580645
E01010023,1752,844,908,0.4817351598173516,0.5182648401826484
E01010025,1546,750,796,0.4851228978007762,0.5148771021992238
E01010028,1394,683,711,0.4899569583931133,0.5100430416068866
E01009953,1676,848,828,0.5059665871121718,0.49403341288782815
E01009954,1737,815,922,0.46919976971790445,0.5308002302820956
E01009957,1658,751,907,0.4529553679131484,0.5470446320868516
E01009958,1593,789,804,0.4952919020715631,0.504708097928437
E01009946,1683,804,879,0.47771836007130125,0.5222816399286988
E01009948,1472,721,751,0.4898097826086957,0.5101902173913043
E01009949,1563,765,798,0.4894433781190019,0.510556621880998
E01009950,1658,833,825,0.5024125452352232,0.49758745476477684
E01009951,1897,993,904,0.5234580917237743,0.4765419082762256
E01032592,1759,834,925,0.47413303013075614,0.5258669698692439
E01010118,1290,632,658,0.48992248062015503,0.5100775193798449
E01010120,1293,579,714,0.44779582366589327,0.5522041763341067
E01010121,1416,715,701,0.5049435028248588,0.4950564971751412
E01010122,1380,673,707,0.48768115942028983,0.5123188405797101
E01010235,1495,727,768,0.4862876254180602,0.5137123745819397
E01010236,1512,699,813,0.4623015873015873,0.5376984126984127
E01010239,1568,747,821,0.4764030612244898,0.5235969387755102
E01010240,1334,627,707,0.4700149925037481,0.5299850074962519
E01010117,1386,686,700,0.494949494949495,0.5050505050505051
E01010119,1506,732,774,0.4860557768924303,0.5139442231075697
E01010123,1420,696,724,0.49014084507042255,0.5098591549295775
E01010124,1526,770,756,0.5045871559633027,0.4954128440366973
E01010146,1616,714,902,0.44183168316831684,0.5581683168316832
E01010234,1268,592,676,0.4668769716088328,0.5331230283911672
E01010237,1891,898,993,0.4748810153358012,0.5251189846641988
E01010238,1408,687,721,0.48792613636363635,0.5120738636363636
E01010145,1514,752,762,0.4966974900924703,0.5033025099075297
E01010147,1463,708,755,0.4839371155160629,0.5160628844839371
E01010148,1831,846,985,0.4620425996723102,0.5379574003276898
E01010149,1444,722,722,0.5,0.5
E01010125,1482,726,756,0.4898785425101215,0.5101214574898786
E01010129,1516,713,803,0.4703166226912929,0.5296833773087071
E01010139,1082,520,562,0.4805914972273567,0.5194085027726433
E01010141,1363,729,634,0.5348495964783566,0.46515040352164344
E01010140,1520,710,810,0.46710526315789475,0.5328947368421053
E01010142,1433,692,741,0.4829030006978367,0.5170969993021632
E01010143,1424,681,743,0.4782303370786517,0.5217696629213483
E01010144,1657,800,857,0.4828002414001207,0.5171997585998793
E01010111,1465,734,731,0.5010238907849829,0.49897610921501706
E01010126,1468,710,758,0.48365122615803813,0.5163487738419619
E01010127,1763,902,861,0.5116279069767442,0.4883720930232558
E01010128,1451,691,760,0.47622329427980703,0.523776705720193
E01010130,1785,864,921,0.48403361344537815,0.5159663865546219
E01010131,1395,664,731,0.4759856630824373,0.5240143369175627
E01010109,1392,699,693,0.5021551724137931,0.4978448275862069
E01010110,1644,827,817,0.5030413625304136,0.49695863746958635
E01010112,1554,747,807,0.4806949806949807,0.5193050193050193
E01010113,1332,630,702,0.47297297297297297,0.527027027027027
E01010114,1811,866,945,0.4781888459414688,0.5218111540585312
E01010157,1416,705,711,0.4978813559322034,0.5021186440677966
E01010159,1413,673,740,0.47629157820240625,0.5237084217975938
E01010162,1513,741,772,0.4897554527428949,0.5102445472571051
E01010163,1465,716,749,0.4887372013651877,0.5112627986348123
E01010132,1432,657,775,0.45879888268156427,0.5412011173184358
E01010133,1521,742,779,0.4878369493754109,0.5121630506245891
E01010134,1426,693,733,0.48597475455820477,0.5140252454417953
E01010135,1498,733,765,0.4893190921228304,0.5106809078771696
E01010138,1400,721,679,0.515,0.485
E01010136,1284,627,657,0.4883177570093458,0.5116822429906542
E01010137,1312,631,681,0.4809451219512195,0.5190548780487805
E01010158,1513,692,821,0.4573694646397885,0.5426305353602116
E01010160,1507,737,770,0.48905109489051096,0.5109489051094891
E01010161,1525,764,761,0.5009836065573771,0.49901639344262294
E01010174,1634,791,843,0.48408812729498163,0.5159118727050184
E01010175,1711,844,867,0.49327878433664524,0.5067212156633548
E01010177,1350,657,693,0.4866666666666667,0.5133333333333333
E01010178,1862,925,937,0.4967776584317938,0.5032223415682062
E01010172,1544,760,784,0.49222797927461137,0.5077720207253886
E01010173,1451,710,741,0.48931771192281187,0.5106822880771882
E01010176,1383,666,717,0.48156182212581344,0.5184381778741866
E01010179,1584,737,847,0.4652777777777778,0.5347222222222222
E01010115,1498,730,768,0.48731642189586116,0.5126835781041389
E01010116,1467,725,742,0.4942058623040218,0.5057941376959781
E01010227,1891,906,985,0.479111581173982,0.520888418826018
E01010228,1636,789,847,0.48227383863080686,0.5177261613691931
E01010232,2045,958,1087,0.4684596577017115,0.5315403422982885
E01010195,1592,781,811,0.4905778894472362,0.5094221105527639
E01010226,1604,703,901,0.4382793017456359,0.5617206982543641
E01010229,1494,750,744,0.5020080321285141,0.4979919678714859
E01010230,1795,838,957,0.4668523676880223,0.5331476323119777
E01010231,1705,831,874,0.4873900293255132,0.5126099706744868
E01010233,1818,911,907,0.5011001100110011,0.4988998899889989
E01010108,1976,969,1007,0.49038461538461536,0.5096153846153846
E01010164,1587,802,785,0.5053560176433523,0.49464398235664775
E01010165,1473,695,778,0.47182620502376105,0.528173794976239
E01010167,1519,754,765,0.49637919684002635,0.5036208031599737
E01010199,1863,922,941,0.4949006977992485,0.5050993022007515
E01010200,1471,683,788,0.46430999320190347,0.5356900067980965
E01010201,1652,826,826,0.5,0.5
E01010204,1248,599,649,0.47996794871794873,0.5200320512820513
E01010205,1493,718,775,0.48091091761553917,0.5190890823844608
E01010206,1691,813,878,0.4807806031933767,0.5192193968066233
E01010192,1626,820,806,0.5043050430504306,0.4956949569495695
E01010196,1675,829,846,0.4949253731343284,0.5050746268656716
E01010197,1676,813,863,0.4850835322195704,0.5149164677804295
E01010198,1584,761,823,0.48042929292929293,0.5195707070707071
E01010218,1321,629,692,0.4761544284632854,0.5238455715367146
E01010219,1605,754,851,0.46978193146417446,0.5302180685358255
E01010221,1438,681,757,0.47357440890125174,0.5264255910987483
E01010222,1479,717,762,0.4847870182555781,0.5152129817444219
E01010191,1844,892,952,0.4837310195227766,0.5162689804772235
E01010202,1567,763,804,0.48691767708998085,0.5130823229100191
E01010203,1733,845,888,0.4875937680323139,0.5124062319676861
E01010209,1748,851,897,0.4868421052631579,0.5131578947368421
E01010213,1700,799,901,0.47,0.53
E01010208,1535,731,804,0.4762214983713355,0.5237785016286645
E01010210,1570,727,843,0.46305732484076434,0.5369426751592357
E01010211,1402,634,768,0.4522111269614836,0.5477888730385164
E01010217,1518,765,753,0.5039525691699605,0.49604743083003955
E01010190,1698,818,880,0.4817432273262662,0.5182567726737338
E01010193,1376,685,691,0.49781976744186046,0.5021802325581395
E01010194,1642,794,848,0.4835566382460414,0.5164433617539586
E01010207,1450,702,748,0.48413793103448277,0.5158620689655172
E01010166,1454,707,747,0.4862448418156809,0.5137551581843192
E01010168,1871,934,937,0.4991982896846606,0.5008017103153394
E01010169,1622,813,809,0.501233045622688,0.49876695437731194
E01010170,1524,746,778,0.489501312335958,0.510498687664042
E01010171,1344,651,693,0.484375,0.515625
E01010151,1574,708,866,0.4498094027954257,0.5501905972045743
E01010152,1378,681,697,0.4941944847605225,0.5058055152394775
E01010153,1544,745,799,0.48251295336787564,0.5174870466321243
E01010154,1665,777,888,0.4666666666666667,0.5333333333333333
E01010155,1556,785,771,0.5044987146529563,0.4955012853470437
E01010156,1558,749,809,0.48074454428754815,0.5192554557124519
E01010212,1419,715,704,0.5038759689922481,0.49612403100775193
E01010214,1217,576,641,0.4732949876746097,0.5267050123253904
E01010215,1623,794,829,0.48921749845964263,0.5107825015403573
E01010216,1524,738,786,0.484251968503937,0.515748031496063
E01010150,1625,799,826,0.4916923076923077,0.5083076923076923
E01010184,1429,689,740,0.4821553533939818,0.5178446466060181
E01010185,1557,754,803,0.4842646114322415,0.5157353885677585
E01010186,1923,913,1010,0.4747789911596464,0.5252210088403536
E01010187,1516,771,745,0.508575197889182,0.49142480211081796
E01010188,1747,872,875,0.499141385231826,0.5008586147681741
E01010180,1269,624,645,0.491725768321513,0.508274231678487
E01010181,1951,963,988,0.4935930292157868,0.5064069707842133
E01010183,1362,693,669,0.5088105726872246,0.4911894273127753
E01010189,1604,800,804,0.49875311720698257,0.5012468827930174
E01032885,1197,644,553,0.5380116959064327,0.4619883040935672
E01032886,1974,1017,957,0.5151975683890577,0.4848024316109423
E01010220,1649,809,840,0.49060036385688294,0.509399636143117
E01010223,1212,568,644,0.46864686468646866,0.5313531353135313
E01010225,1491,725,766,0.4862508383635144,0.5137491616364855
E01032590,1748,850,898,0.4862700228832952,0.5137299771167048
E01010301,1480,726,754,0.4905405405405405,0.5094594594594595
E01010303,1541,756,785,0.49059052563270605,0.509409474367294
E01010306,1962,968,994,0.49337410805300713,0.5066258919469928
E01010307,1770,857,913,0.48418079096045197,0.515819209039548
E01010302,1502,746,756,0.4966711051930759,0.5033288948069241
E01010304,1708,850,858,0.49765807962529274,0.5023419203747073
E01010305,1422,724,698,0.509142053445851,0.4908579465541491
E01010308,1291,670,621,0.5189775367931836,0.4810224632068164
E01010345,1082,550,532,0.5083179297597042,0.49168207024029575
E01010346,1393,700,693,0.5025125628140703,0.49748743718592964
E01010347,1497,733,764,0.48964595858383436,0.5103540414161657
E01010350,1463,709,754,0.48462064251537934,0.5153793574846206
E01010249,1774,891,883,0.5022547914317925,0.4977452085682074
E01010250,1436,686,750,0.4777158774373259,0.5222841225626741
E01010252,1767,854,913,0.4833050367855122,0.5166949632144878
E01010254,1491,744,747,0.49899396378269617,0.5010060362173038
E01010348,1442,685,757,0.4750346740638003,0.5249653259361997
E01010349,1259,610,649,0.48451151707704526,0.5154884829229547
E01010351,1700,836,864,0.49176470588235294,0.508235294117647
E01010352,1632,809,823,0.4957107843137255,0.5042892156862745
E01010284,1524,701,823,0.4599737532808399,0.5400262467191601
E01010285,1716,861,855,0.5017482517482518,0.4982517482517482
E01010286,1703,835,868,0.4903112155020552,0.5096887844979449
E01010290,1621,798,823,0.4922887106724244,0.5077112893275756
E01010251,1412,711,701,0.5035410764872521,0.4964589235127479
E01010253,1243,610,633,0.4907481898632341,0.5092518101367659
E01010255,1337,630,707,0.4712041884816754,0.5287958115183246
E01010256,1529,740,789,0.4839764551994768,0.5160235448005233
E01010257,1218,594,624,0.4876847290640394,0.5123152709359606
E01010292,1621,821,800,0.5064774830351635,0.4935225169648365
E01010294,1527,741,786,0.48526522593320237,0.5147347740667977
E01010296,1464,700,764,0.4781420765027322,0.5218579234972678
E01010297,1439,717,722,0.4982626824183461,0.501737317581654
E01010291,1418,669,749,0.4717912552891396,0.5282087447108603
E01010293,1511,724,787,0.47915287888815355,0.5208471211118465
E01010298,1172,582,590,0.49658703071672355,0.5034129692832765
E01010299,1601,755,846,0.47158026233604,0.52841973766396
E01010300,1493,714,779,0.478231748158071,0.521768251841929
E01010319,1402,701,701,0.5,0.5
E01010321,1593,779,814,0.48901443816698054,0.5109855618330195
E01010353,1461,704,757,0.48186173853524983,0.5181382614647502
E01010354,1534,767,767,0.5,0.5
E01010395,1376,680,696,0.4941860465116279,0.5058139534883721
E01010397,1656,794,862,0.47946859903381644,0.5205314009661836
E01010398,1652,811,841,0.49092009685230026,0.5090799031476998
E01010399,1582,784,798,0.49557522123893805,0.504424778761062
E01010282,1317,658,659,0.4996203492786636,0.5003796507213364
E01010287,1516,709,807,0.46767810026385226,0.5323218997361477
E01010288,1725,838,887,0.48579710144927535,0.5142028985507247
E01010289,1653,816,837,0.49364791288566245,0.5063520871143375
E01010277,1617,803,814,0.4965986394557823,0.5034013605442177
E01010283,1936,976,960,0.5041322314049587,0.49586776859504134
E01032889,1965,965,1000,0.4910941475826972,0.5089058524173028
E01010393,1497,745,752,0.49766199064796257,0.5023380093520374
E01010394,1448,717,731,0.4951657458563536,0.5048342541436464
E01010396,1602,778,824,0.48564294631710364,0.5143570536828964
E01010400,1884,900,984,0.47770700636942676,0.5222929936305732
E01010241,2219,1053,1166,0.47453808021631366,0.5254619197836864
E01010242,1655,820,835,0.4954682779456193,0.5045317220543807
E01010243,1511,714,797,0.47253474520185307,0.5274652547981469
E01010244,1508,710,798,0.4708222811671088,0.5291777188328912
E01010320,1342,641,701,0.47764530551415796,0.522354694485842
E01010322,1527,729,798,0.4774066797642436,0.5225933202357563
E01010323,1487,736,751,0.4949562878278413,0.5050437121721587
E01010324,1562,739,823,0.4731113956466069,0.5268886043533931
E01010271,1803,907,896,0.5030504714364947,0.49694952856350527
E01010272,1518,769,749,0.5065876152832675,0.49341238471673254
E01010273,1547,765,782,0.4945054945054945,0.5054945054945055
E01010295,1474,704,770,0.47761194029850745,0.5223880597014925
E01010279,1679,815,864,0.4854079809410363,0.5145920190589637
E01010374,1808,898,910,0.49668141592920356,0.5033185840707964
E01010375,2208,1090,1118,0.4936594202898551,0.5063405797101449
E01032888,2636,1300,1336,0.4931714719271624,0.5068285280728376
E01010378,1261,631,630,0.500396510705789,0.49960348929421095
E01010379,1324,653,671,0.493202416918429,0.506797583081571
E01010382,1540,762,778,0.4948051948051948,0.5051948051948052
E01010383,1422,651,771,0.4578059071729958,0.5421940928270043
E01010376,1364,701,663,0.5139296187683284,0.48607038123167157
E01010377,1547,760,787,0.491273432449903,0.5087265675500969
E01010380,1505,732,773,0.4863787375415282,0.5136212624584717
E01010381,1486,760,726,0.5114401076716016,0.48855989232839836
E01010267,1710,839,871,0.49064327485380116,0.5093567251461988
E01010268,1783,894,889,0.501402131239484,0.498597868760516
E01010274,1579,745,834,0.47181760607979734,0.5281823939202026
E01010275,1522,749,773,0.4921156373193167,0.5078843626806833
E01010245,1541,745,796,0.4834523036988968,0.5165476963011032
E01010246,1567,786,781,0.5015954052329291,0.49840459476707083
E01010247,1659,804,855,0.484629294755877,0.515370705244123
E01010248,1638,794,844,0.48473748473748474,0.5152625152625152
E01010388,1442,711,731,0.4930651872399445,0.5069348127600555
E01010258,1746,791,955,0.45303550973654066,0.5469644902634594
E01010259,1633,772,861,0.47274954072259645,0.5272504592774035
E01010260,1594,751,843,0.4711417816813049,0.5288582183186951
E01010266,1398,650,748,0.46494992846924177,0.5350500715307582
E01010317,1600,794,806,0.49625,0.50375
E01010318,1540,752,788,0.4883116883116883,0.5116883116883116
E01010325,1675,862,813,0.5146268656716418,0.4853731343283582
E01010369,1830,968,862,0.5289617486338798,0.4710382513661202
E01010401,1463,706,757,0.4825700615174299,0.51742993848257
E01010403,1738,845,893,0.4861910241657077,0.5138089758342923
E01010404,1814,884,930,0.48732083792723263,0.5126791620727673
E01010407,1658,781,877,0.47104945717732205,0.528950542822678
E01010408,1548,766,782,0.49483204134366926,0.5051679586563308
E01010269,1654,831,823,0.5024183796856106,0.49758162031438935
E01010270,1782,885,897,0.49663299663299665,0.5033670033670034
E01010362,1758,839,919,0.47724687144482364,0.5227531285551763
E01010363,1887,958,929,0.5076841547429782,0.4923158452570217
E01010402,1704,859,845,0.5041079812206573,0.49589201877934275
E01010405,1683,826,857,0.49079025549613786,0.5092097445038621
E01010406,2573,1280,1293,0.49747376603186944,0.5025262339681306
E01010409,1602,771,831,0.4812734082397004,0.5187265917602997
E01010385,1560,805,755,0.5160256410256411,0.483974358974359
E01010386,1605,768,837,0.4785046728971963,0.5214953271028038
E01010387,1569,760,809,0.4843849585723391,0.5156150414276609
E01010392,1551,756,795,0.4874274661508704,0.5125725338491296
E01010326,1641,808,833,0.49238269347958563,0.5076173065204144
E01010327,1700,825,875,0.4852941176470588,0.5147058823529411
E01010328,1472,750,722,0.5095108695652174,0.4904891304347826
E01010330,1490,742,748,0.49798657718120803,0.5020134228187919
E01010368,1891,1007,884,0.5325224748810153,0.46747752511898466
E01010370,1833,939,894,0.5122749590834698,0.4877250409165303
E01010371,2282,1256,1026,0.5503943908851884,0.44960560911481157
E01010372,1593,818,775,0.5134965473948525,0.48650345260514755
E01010373,1899,860,1039,0.4528699315429173,0.5471300684570827
E01010361,1508,762,746,0.5053050397877984,0.4946949602122016
E01010364,1533,743,790,0.4846705805609915,0.5153294194390085
E01010365,1496,749,747,0.5006684491978609,0.49933155080213903
E01010366,1760,873,887,0.4960227272727273,0.5039772727272728
E01010367,1724,852,872,0.494199535962877,0.505800464037123
E01010384,1491,724,767,0.48558014755197854,0.5144198524480215
E01010389,1487,744,743,0.5003362474781439,0.4996637525218561
E01010390,1728,816,912,0.4722222222222222,0.5277777777777778
E01010391,1984,968,1016,0.4879032258064516,0.5120967741935484
E01010261,1609,777,832,0.4829086389061529,0.5170913610938471
E01010263,1687,870,817,0.5157083580320095,0.4842916419679905
E01010264,1644,787,857,0.4787104622871046,0.5212895377128953
E01010265,1853,936,917,0.5051268213707502,0.49487317862924984
E01010336,1618,815,803,0.5037082818294191,0.496291718170581
E01010340,1759,873,886,0.496304718590108,0.503695281409892
E01010341,1713,852,861,0.4973730297723292,0.5026269702276708
E01010342,1645,805,840,0.48936170212765956,0.5106382978723404
E01010343,1589,811,778,0.5103838892385147,0.4896161107614852
E01010344,1703,836,867,0.4908984145625367,0.5091015854374633
E01010331,1682,841,841,0.5,0.5
E01010332,1846,903,943,0.4891657638136511,0.5108342361863488
E01010333,1614,798,816,0.4944237918215613,0.5055762081784386
E01010334,1561,750,811,0.48046124279308133,0.5195387572069187
E01010262,1585,781,804,0.4927444794952681,0.5072555205047319
E01010309,1890,939,951,0.49682539682539684,0.5031746031746032
E01010311,1647,814,833,0.4942319368548877,0.5057680631451124
E01010316,1677,817,860,0.48717948717948717,0.5128205128205128
E01010335,1709,820,889,0.47981275599765943,0.5201872440023405
E01010337,1420,671,749,0.4725352112676056,0.5274647887323943
E01010338,1844,929,915,0.5037960954446855,0.49620390455531455
E01010339,1532,731,801,0.47715404699738906,0.5228459530026109
E01010310,1750,886,864,0.5062857142857143,0.4937142857142857
E01010312,1747,873,874,0.4997137950772753,0.5002862049227247
E01010313,1510,726,784,0.48079470198675495,0.519205298013245
E01010314,1566,779,787,0.49744572158365263,0.5025542784163474
E01010315,1285,637,648,0.49571984435797667,0.5042801556420233
E01010329,1590,769,821,0.48364779874213837,0.5163522012578616
E01010355,1465,704,761,0.4805460750853242,0.5194539249146758
E01010356,1551,763,788,0.49194068343004516,0.5080593165699548
E01010357,1868,920,948,0.4925053533190578,0.5074946466809421
E01010358,1465,702,763,0.47918088737201364,0.5208191126279863
E01010359,1566,735,831,0.46934865900383144,0.5306513409961686
E01010360,1505,734,771,0.4877076411960133,0.5122923588039867
E01010434,1683,806,877,0.47890671420083186,0.5210932857991681
E01010436,1436,697,739,0.4853760445682451,0.5146239554317549
E01010437,1226,617,609,0.5032626427406199,0.4967373572593801
E01010438,1373,678,695,0.493809176984705,0.5061908230152949
E01010439,1365,650,715,0.47619047619047616,0.5238095238095238
E01010440,1560,739,821,0.4737179487179487,0.5262820512820513
E01010441,1384,659,725,0.4761560693641618,0.5238439306358381
E01010495,1679,797,882,0.47468731387730795,0.5253126861226921
E01010497,1211,598,613,0.49380677126341865,0.5061932287365813
E01010499,1409,685,724,0.48616039744499645,0.5138396025550035
E01010500,1416,669,747,0.4724576271186441,0.527542372881356
E01010496,1463,674,789,0.4606971975393028,0.5393028024606972
E01010498,1453,729,724,0.5017205781142464,0.49827942188575364
E01010541,1461,710,751,0.485968514715948,0.5140314852840521
E01010543,1449,693,756,0.4782608695652174,0.5217391304347826
E01010456,1469,670,799,0.4560925799863853,0.5439074200136147
E01010457,1583,791,792,0.4996841440303222,0.5003158559696779
E01010462,1585,750,835,0.47318611987381703,0.526813880126183
E01010481,1595,756,839,0.47398119122257054,0.5260188087774295
E01010555,1499,733,766,0.48899266177451634,0.5110073382254836
E01010556,1481,732,749,0.49426063470627957,0.5057393652937204
E01010557,1440,725,715,0.5034722222222222,0.4965277777777778
E01010559,1412,682,730,0.4830028328611898,0.5169971671388102
E01010560,1670,823,847,0.492814371257485,0.5071856287425149
E01010435,1405,678,727,0.4825622775800712,0.5174377224199288
E01010501,1488,688,800,0.46236559139784944,0.5376344086021505
E01010502,1356,656,700,0.4837758112094395,0.5162241887905604
E01010503,1331,655,676,0.49211119459053343,0.5078888054094666
E01010482,1349,639,710,0.47368421052631576,0.5263157894736842
E01010483,1432,661,771,0.4615921787709497,0.5384078212290503
E01010484,1379,657,722,0.47643219724437996,0.52356780275562
E01010485,1669,750,919,0.44937088076692633,0.5506291192330737
E01010458,1729,814,915,0.4707923655292076,0.5292076344707923
E01010459,1635,813,822,0.4972477064220184,0.5027522935779817
E01010460,1632,805,827,0.49325980392156865,0.5067401960784313
E01010461,1574,746,828,0.47395171537484115,0.5260482846251588
E01010566,1795,838,957,0.4668523676880223,0.5331476323119777
E01010539,1602,773,829,0.48252184769038703,0.517478152309613
E01010540,1443,689,754,0.4774774774774775,0.5225225225225225
E01010542,1527,741,786,0.48526522593320237,0.5147347740667977
E01010544,1497,744,753,0.4969939879759519,0.503006012024048
E01010545,1673,844,829,0.5044829647340108,0.4955170352659892
E01010554,1404,675,729,0.4807692307692308,0.5192307692307693
E01010558,1689,834,855,0.4937833037300178,0.5062166962699822
E01010562,1563,795,768,0.508637236084453,0.491362763915547
E01010563,1493,735,758,0.49229738780977894,0.5077026121902211
E01010567,1510,737,773,0.4880794701986755,0.5119205298013245
E01010478,1395,726,669,0.5204301075268817,0.47956989247311826
E01010479,1579,724,855,0.4585180493983534,0.5414819506016466
E01010480,1261,631,630,0.500396510705789,0.49960348929421095
E01010486,1788,848,940,0.4742729306487696,0.5257270693512305
E01010474,1625,767,858,0.472,0.528
E01010561,1604,790,814,0.4925187032418953,0.5074812967581047
E01010564,1951,1021,930,0.5233213736545361,0.4766786263454639
E01010565,1868,900,968,0.4817987152034261,0.5182012847965739
E01010522,1743,898,845,0.5152036718301779,0.48479632816982215
E01010523,1588,831,757,0.5232997481108312,0.47670025188916876
E01010524,1535,803,732,0.5231270358306189,0.47687296416938113
E01010525,1422,669,753,0.4704641350210971,0.5295358649789029
E01010546,1518,717,801,0.4723320158102767,0.5276679841897233
E01010547,1538,744,794,0.4837451235370611,0.5162548764629389
E01010548,1415,647,768,0.45724381625441696,0.542756183745583
E01010549,1515,738,777,0.4871287128712871,0.5128712871287129
E01010553,1570,764,806,0.48662420382165605,0.513375796178344
E01010471,1719,922,797,0.5363583478766725,0.46364165212332753
E01010472,1895,910,985,0.48021108179419525,0.5197889182058048
E01010473,2458,1391,1067,0.565907241659886,0.4340927583401139
E01010475,1639,831,808,0.5070164734594265,0.49298352654057354
E01010476,1833,958,875,0.5226404800872886,0.4773595199127114
E01010477,1706,817,889,0.47889800703399765,0.5211019929660023
E01010526,1487,732,755,0.49226630800269,0.50773369199731
E01010527,1874,1031,843,0.5501600853788687,0.44983991462113126
E01010528,1864,1059,805,0.5681330472103004,0.43186695278969955
E01010529,1618,917,701,0.5667490729295427,0.43325092707045737
E01010506,1659,959,700,0.5780590717299579,0.4219409282700422
E01010508,1413,826,587,0.5845718329794763,0.4154281670205237
E01010510,1589,835,754,0.5254877281309,0.47451227186910006
E01010511,1625,854,771,0.5255384615384615,0.47446153846153843
E01010512,1443,750,693,0.5197505197505198,0.4802494802494803
E01010442,1305,623,682,0.47739463601532567,0.5226053639846743
E01010443,1711,833,878,0.48684979544126245,0.5131502045587376
E01010444,1320,657,663,0.49772727272727274,0.5022727272727273
E01010445,1373,663,710,0.482884195193008,0.517115804806992
E01010447,1819,942,877,0.5178669598680594,0.48213304013194064
E01010448,1528,749,779,0.49018324607329844,0.5098167539267016
E01010509,1478,719,759,0.486468200270636,0.513531799729364
E01010550,1595,774,821,0.4852664576802508,0.5147335423197492
E01010551,1628,841,787,0.5165847665847666,0.4834152334152334
E01010552,1847,881,966,0.47698971304818627,0.5230102869518137
E01010463,1635,840,795,0.5137614678899083,0.48623853211009177
E01010464,1598,849,749,0.5312891113892365,0.46871088861076343
E01010465,1641,805,836,0.49055453991468617,0.5094454600853139
E01010466,1492,696,796,0.46648793565683644,0.5335120643431636
E01010470,1408,725,683,0.5149147727272727,0.4850852272727273
E01010521,2547,1418,1129,0.5567334118570868,0.44326658814291325
E01010487,1522,752,770,0.4940867279894875,0.5059132720105125
E01010488,1436,685,751,0.47701949860724235,0.5229805013927576
E01010493,1539,756,783,0.49122807017543857,0.5087719298245614
E01010504,1387,661,726,0.47656813266041814,0.5234318673395818
E01010505,1290,634,656,0.49147286821705427,0.5085271317829457
E01010507,1473,705,768,0.4786150712830957,0.5213849287169042
E01010418,1538,750,788,0.48764629388816644,0.5123537061118335
E01010421,1584,743,841,0.4690656565656566,0.5309343434343434
E01010423,1552,725,827,0.46713917525773196,0.532860824742268
E01010424,1579,789,790,0.499683343888537,0.5003166561114629
E01010417,1651,831,820,0.5033313143549364,0.4966686856450636
E01010419,1437,715,722,0.4975643702157272,0.5024356297842728
E01010420,1298,633,665,0.487673343605547,0.512326656394453
E01010425,1351,676,675,0.5003700962250185,0.4996299037749815
E01010446,1630,833,797,0.5110429447852761,0.48895705521472393
E01010467,1588,795,793,0.5006297229219143,0.4993702770780856
E01010468,1500,704,796,0.4693333333333333,0.5306666666666666
E01010469,1422,692,730,0.4866385372714487,0.5133614627285513
E01010516,1445,724,721,0.501038062283737,0.49896193771626296
E01010518,1623,804,819,0.4953789279112754,0.5046210720887245
E01010414,1962,989,973,0.5040774719673802,0.49592252803261977
E01010415,1710,842,868,0.49239766081871345,0.5076023391812865
E01010416,1665,783,882,0.4702702702702703,0.5297297297297298
E01010422,1694,863,831,0.5094451003541912,0.49055489964580873
E01010489,1534,732,802,0.4771838331160365,0.5228161668839635
E01010490,1728,899,829,0.5202546296296297,0.47974537037037035
E01010491,1505,689,816,0.4578073089700997,0.5421926910299003
E01010492,1340,663,677,0.49477611940298505,0.505223880597015
E01010494,1585,764,821,0.48201892744479496,0.5179810725552051
E01010449,2317,1123,1194,0.48467846353042726,0.5153215364695727
E01010450,1738,876,862,0.5040276179516686,0.49597238204833144
E01010451,1577,807,770,0.5117311350665821,0.48826886493341787
E01010452,1565,781,784,0.49904153354632586,0.5009584664536741
E01010455,1835,916,919,0.4991825613079019,0.500817438692098
E01010427,1699,847,852,0.4985285462036492,0.5014714537963508
E01010431,1606,805,801,0.5012453300124533,0.4987546699875467
E01010432,1560,782,778,0.5012820512820513,0.4987179487179487
E01010519,1602,779,823,0.48626716604244696,0.5137328339575531
E01010520,1647,813,834,0.4936247723132969,0.5063752276867031
E01010513,1530,689,841,0.4503267973856209,0.5496732026143791
E01010514,1624,831,793,0.5116995073891626,0.4883004926108374
E01010515,1638,814,824,0.49694749694749696,0.503052503052503
E01010517,1609,784,825,0.4872591671845867,0.5127408328154133
E01010533,1721,843,878,0.4898314933178385,0.5101685066821615
E01010535,1564,744,820,0.47570332480818417,0.5242966751918159
E01010536,1645,813,832,0.49422492401215806,0.505775075987842
E01010537,1462,713,749,0.48768809849521205,0.512311901504788
E01010410,1670,810,860,0.48502994011976047,0.5149700598802395
E01010411,1663,838,825,0.5039085989176187,0.49609140108238126
E01010412,2036,1008,1028,0.4950884086444008,0.5049115913555993
E01010413,1710,831,879,0.48596491228070177,0.5140350877192983
E01010531,1762,812,950,0.4608399545970488,0.5391600454029511
E01010532,1653,815,838,0.49304295220810646,0.5069570477918935
E01010534,1592,808,784,0.507537688442211,0.49246231155778897
E01010538,1638,796,842,0.48595848595848595,0.514041514041514
E01010426,1544,809,735,0.5239637305699482,0.47603626943005184
E01010428,1444,753,691,0.5214681440443213,0.47853185595567865
E01010429,1290,639,651,0.49534883720930234,0.5046511627906977
E01010430,1710,853,857,0.4988304093567251,0.5011695906432748
E01010433,1169,572,597,0.4893071000855432,0.5106928999144568
E01010453,1925,921,1004,0.47844155844155845,0.5215584415584416
E01010454,1636,826,810,0.5048899755501223,0.49511002444987773
E01010530,1382,704,678,0.5094066570188133,0.4905933429811867
E01032138,1419,692,727,0.48766737138830163,0.5123326286116984
E01032139,1670,813,857,0.4868263473053892,0.5131736526946108
E01032140,1702,796,906,0.46768507638072854,0.5323149236192715
E01032141,1479,721,758,0.4874915483434753,0.5125084516565247
E01032136,1330,678,652,0.5097744360902255,0.49022556390977445
E01032137,1534,764,770,0.4980443285528031,0.5019556714471969
E01032168,1118,557,561,0.49821109123434704,0.501788908765653
E01032169,1119,552,567,0.4932975871313673,0.5067024128686327
E01032176,2165,1072,1093,0.4951501154734411,0.5048498845265589
E01032126,2078,1018,1060,0.4898941289701636,0.5101058710298364
E01032170,1446,707,739,0.48893499308437066,0.5110650069156293
E01032171,1517,752,765,0.4957152274225445,0.5042847725774555
E01032172,1450,725,725,0.5,0.5
E01032133,1647,783,864,0.47540983606557374,0.5245901639344263
E01032135,1648,806,842,0.4890776699029126,0.5109223300970874
E01032145,1451,727,724,0.5010337698139214,0.49896623018607855
E01032147,1193,570,623,0.47778709136630343,0.5222129086336965
E01032134,1645,792,853,0.48145896656534953,0.5185410334346504
E01032146,1659,806,853,0.48583484026522,0.5141651597347799
E01032177,1148,567,581,0.49390243902439024,0.5060975609756098
E01032178,1287,617,670,0.4794094794094794,0.5205905205905206
E01032142,1531,771,760,0.503592423252776,0.496407576747224
E01032143,1476,720,756,0.4878048780487805,0.5121951219512195
E01032144,1794,852,942,0.47491638795986624,0.5250836120401338
E01032149,1232,613,619,0.49756493506493504,0.502435064935065
E01032127,1635,821,814,0.5021406727828747,0.4978593272171254
E01032128,1419,698,721,0.4918957011980268,0.5081042988019733
E01032129,1416,698,718,0.4929378531073446,0.5070621468926554
E01032152,1338,632,706,0.47234678624813153,0.5276532137518685
E01032148,1100,528,572,0.48,0.52
E01032150,1500,747,753,0.498,0.502
E01032151,1366,670,696,0.4904831625183016,0.5095168374816984
E01032153,1466,697,769,0.47544338335607095,0.524556616643929
E01032155,1742,890,852,0.5109070034443168,0.4890929965556831
E01032122,2089,1058,1031,0.5064624222115844,0.4935375777884155
E01032123,1524,742,782,0.4868766404199475,0.5131233595800525
E01032124,1499,700,799,0.466977985323549,0.5330220146764509
E01032125,1452,693,759,0.4772727272727273,0.5227272727272727
E01032154,1805,896,909,0.496398891966759,0.503601108033241
E01032159,1757,829,928,0.4718269778030734,0.5281730221969266
E01032160,1687,812,875,0.48132780082987553,0.5186721991701245
E01032161,1447,705,742,0.48721492743607464,0.5127850725639254
E01032156,1793,899,894,0.5013943112102621,0.4986056887897379
E01032157,1728,762,966,0.4409722222222222,0.5590277777777778
E01032173,1676,832,844,0.4964200477326969,0.5035799522673031
E01032175,1607,797,810,0.49595519601742377,0.5040448039825762
E01032158,1454,686,768,0.4718019257221458,0.5281980742778541
E01032162,1915,940,975,0.4908616187989556,0.5091383812010444
E01033059,1592,793,799,0.4981155778894472,0.5018844221105527
E01033061,1906,898,1008,0.47114375655823715,0.5288562434417629
E01032130,2669,1321,1348,0.494941925814912,0.5050580741850881
E01032131,1709,836,873,0.489174956114687,0.510825043885313
E01032132,2167,1043,1124,0.48131056760498386,0.5186894323950162
E01032174,1557,750,807,0.4816955684007707,0.5183044315992292
E01032166,2094,1060,1034,0.5062082139446036,0.49379178605539636
E01033060,2149,1570,579,0.7305723592368544,0.2694276407631456
E01033062,2396,1210,1186,0.505008347245409,0.494991652754591
E01033243,1245,616,629,0.4947791164658635,0.5052208835341365
E01032193,2172,1070,1102,0.49263351749539597,0.507366482504604
E01032212,1918,957,961,0.4989572471324296,0.5010427528675704
E01032213,1589,817,772,0.514159848961611,0.4858401510383889
E01032214,2188,1043,1145,0.476691042047532,0.523308957952468
E01032181,2104,1023,1081,0.4862167300380228,0.5137832699619772
E01032190,1849,915,934,0.494862087614927,0.505137912385073
E01032199,1752,866,886,0.4942922374429224,0.5057077625570776
E01032223,2142,1082,1060,0.5051353874883286,0.49486461251167135
E01032179,1675,841,834,0.502089552238806,0.49791044776119403
E01032180,1832,909,923,0.49617903930131,0.50382096069869
E01032182,2016,1004,1012,0.498015873015873,0.501984126984127
E01032183,1406,696,710,0.4950213371266003,0.5049786628733998
E01032194,1448,661,787,0.4564917127071823,0.5435082872928176
E01032195,1612,778,834,0.4826302729528536,0.5173697270471465
E01032196,1592,787,805,0.4943467336683417,0.5056532663316583
E01032197,1503,707,796,0.4703925482368596,0.5296074517631404
E01032205,1070,534,536,0.49906542056074765,0.5009345794392523
E01032206,1180,572,608,0.4847457627118644,0.5152542372881356
E01032207,1441,697,744,0.48369188063844554,0.5163081193615545
E01032217,1571,757,814,0.4818586887332909,0.5181413112667091
E01032188,1975,944,1031,0.4779746835443038,0.5220253164556962
E01032189,1982,965,1017,0.48688193743693237,0.5131180625630676
E01032220,1492,758,734,0.5080428954423593,0.49195710455764075
E01032221,1385,718,667,0.5184115523465704,0.4815884476534296
E01032222,1389,695,694,0.5003599712023038,0.4996400287976962
E01032201,1588,751,837,0.4729219143576826,0.5270780856423174
E01032202,1735,831,904,0.4789625360230548,0.5210374639769453
E01032203,1494,753,741,0.5040160642570282,0.4959839357429719
E01032204,1608,771,837,0.47947761194029853,0.5205223880597015
E01032191,2312,1121,1191,0.48486159169550175,0.5151384083044983
E01032192,1600,754,846,0.47125,0.52875
E01032211,1779,837,942,0.47048903878583476,0.5295109612141653
E01032184,1541,712,829,0.46203763789746916,0.5379623621025308
E01032185,1428,688,740,0.48179271708683474,0.5182072829131653
E01032186,1445,600,845,0.41522491349480967,0.5847750865051903
E01032187,1717,810,907,0.47175305765870706,0.528246942341293
E01032208,1464,725,739,0.4952185792349727,0.5047814207650273
E01032209,1483,753,730,0.5077545515846258,0.49224544841537426
E01032210,1130,517,613,0.4575221238938053,0.5424778761061947
E01032218,1577,792,785,0.5022194039315155,0.49778059606848446
E01032219,1619,817,802,0.5046324891908586,0.49536751080914143
E01032198,2115,1040,1075,0.491725768321513,0.508274231678487
E01032200,2063,999,1064,0.4842462433349491,0.5157537566650509
E01032215,1123,524,599,0.4666073018699911,0.5333926981300089
E01032216,1527,745,782,0.48788474132285525,0.5121152586771447
E01032226,2005,1007,998,0.5022443890274314,0.4977556109725686
E01032227,1057,530,527,0.5014191106906338,0.4985808893093661
E01032243,1403,676,727,0.48182466143977193,0.5181753385602281
E01032244,1240,609,631,0.49112903225806454,0.5088709677419355
E01032240,1341,670,671,0.49962714392244595,0.5003728560775541
E01032241,1385,681,704,0.49169675090252707,0.5083032490974729
E01032242,1378,663,715,0.4811320754716981,0.5188679245283019
E01032245,1385,688,697,0.4967509025270758,0.5032490974729242
E01032232,1668,811,857,0.4862110311750599,0.5137889688249401
E01032233,2978,1502,1476,0.5043653458697113,0.4956346541302888
E01032234,1819,840,979,0.46179219351291917,0.5382078064870808
E01032235,1817,877,940,0.4826637314254265,0.5173362685745735
E01032224,1779,957,822,0.5379426644182125,0.4620573355817875
E01032225,1148,560,588,0.4878048780487805,0.5121951219512195
E01032239,1812,986,826,0.5441501103752759,0.45584988962472406
E01032262,2139,1097,1042,0.5128564749883123,0.48714352501168773
E01032273,1396,709,687,0.5078796561604585,0.49212034383954156
E01032275,1359,676,683,0.4974245768947756,0.5025754231052244
E01032277,1304,654,650,0.5015337423312883,0.49846625766871167
E01032278,1603,797,806,0.49719276356830944,0.5028072364316906
E01032236,1779,921,858,0.5177065767284992,0.4822934232715008
E01032237,1511,729,782,0.4824619457313038,0.5175380542686963
E01032238,1356,694,662,0.5117994100294986,0.4882005899705015
E01032264,1765,903,862,0.511614730878187,0.488385269121813
E01032255,1416,724,692,0.5112994350282486,0.4887005649717514
E01032263,1784,889,895,0.49831838565022424,0.5016816143497758
E01032266,1589,800,789,0.5034612964128382,0.49653870358716173
E01032274,1294,647,647,0.5,0.5
E01032259,1530,696,834,0.4549019607843137,0.5450980392156862
E01032269,1638,803,835,0.4902319902319902,0.5097680097680097
E01032270,1337,638,699,0.47718773373223633,0.5228122662677637
E01032271,1313,655,658,0.49885757806549885,0.5011424219345011
E01032272,1242,612,630,0.4927536231884058,0.5072463768115942
E01032253,1311,670,641,0.5110602593440122,0.4889397406559878
E01032265,1596,785,811,0.4918546365914787,0.5081453634085213
E01032267,1675,841,834,0.502089552238806,0.49791044776119403
E01032268,1225,605,620,0.49387755102040815,0.5061224489795918
E01032276,1475,756,719,0.512542372881356,0.48745762711864404
E01032250,1389,699,690,0.5032397408207343,0.49676025917926564
E01032251,1762,868,894,0.492622020431328,0.5073779795686719
E01032252,1434,713,721,0.49721059972105996,0.50278940027894
E01032254,1603,801,802,0.49968808484092325,0.5003119151590767
E01032256,1506,715,791,0.4747675962815405,0.5252324037184595
E01032257,1463,732,731,0.5003417634996582,0.49965823650034175
E01032258,1478,712,766,0.4817320703653586,0.5182679296346414
E01032260,1382,629,753,0.455137481910275,0.5448625180897251
E01032246,1404,698,706,0.49715099715099714,0.5028490028490028
E01032247,1418,686,732,0.4837799717912553,0.5162200282087447
E01032248,1477,750,727,0.5077860528097495,0.4922139471902505
E01032249,1579,790,789,0.5003166561114629,0.499683343888537
E01032261,1415,715,700,0.5053003533568905,0.49469964664310956
E01032228,1387,702,685,0.5061283345349675,0.4938716654650324
E01032229,1483,736,747,0.49629130141604855,0.5037086985839514
E01032230,1464,701,763,0.47882513661202186,0.5211748633879781
E01032231,1718,843,875,0.49068684516880096,0.5093131548311991
E01032296,1650,787,863,0.476969696969697,0.5230303030303031
E01032297,1605,790,815,0.49221183800623053,0.5077881619937694
E01032298,1794,867,927,0.48327759197324416,0.5167224080267558
E01032299,1539,774,765,0.5029239766081871,0.49707602339181284
E01032300,1587,773,814,0.4870825456836799,0.5129174543163201
E01032303,1175,554,621,0.4714893617021277,0.5285106382978724
E01032304,1447,691,756,0.47753973738769867,0.5224602626123013
E01032331,1386,688,698,0.4963924963924964,0.5036075036075036
E01032332,1197,583,614,0.48705096073517123,0.5129490392648287
E01032330,1217,625,592,0.5135579293344289,0.4864420706655711
E01032334,2350,1162,1188,0.49446808510638296,0.505531914893617
E01032335,1602,821,781,0.5124843945068664,0.4875156054931336
E01032336,1565,748,817,0.4779552715654952,0.5220447284345048
E01032279,1299,638,661,0.4911470361816782,0.5088529638183218
E01032312,1465,755,710,0.515358361774744,0.48464163822525597
E01032327,1564,732,832,0.4680306905370844,0.5319693094629157
E01032328,1487,690,797,0.46402151983860124,0.5359784801613988
E01032329,1988,983,1005,0.49446680080482897,0.505533199195171
E01032301,1428,704,724,0.49299719887955185,0.5070028011204482
E01032302,1241,632,609,0.5092667203867849,0.49073327961321517
E01032310,1462,761,701,0.5205198358413132,0.4794801641586867
E01032311,1525,754,771,0.4944262295081967,0.5055737704918033
E01032313,1348,648,700,0.4807121661721068,0.5192878338278932
E01032333,1962,928,1034,0.47298674821610603,0.527013251783894
E01032314,1135,555,580,0.4889867841409692,0.5110132158590308
E01032315,2096,985,1111,0.4699427480916031,0.5300572519083969
E01032316,1175,568,607,0.48340425531914893,0.516595744680851
E01032317,1506,712,794,0.47277556440903057,0.5272244355909694
E01032280,1610,790,820,0.4906832298136646,0.5093167701863354
E01032281,1366,669,697,0.48975109809663253,0.5102489019033675
E01032282,1759,919,840,0.5224559408754974,0.47754405912450254
E01033246,1154,578,576,0.5008665511265165,0.49913344887348354
E01033247,1090,600,490,0.5504587155963303,0.44954128440366975
E01032337,1898,922,976,0.4857744994731296,0.5142255005268704
E01032338,2078,1009,1069,0.485563041385948,0.5144369586140519
E01032339,1663,811,852,0.48767288033674083,0.5123271196632592
E01032318,1584,741,843,0.4678030303030303,0.5321969696969697
E01032319,1710,852,858,0.4982456140350877,0.5017543859649123
E01032320,1816,910,906,0.501101321585903,0.4988986784140969
E01032321,1492,752,740,0.5040214477211796,0.4959785522788204
E01032322,1818,873,945,0.4801980198019802,0.5198019801980198
E01032305,1655,841,814,0.5081570996978853,0.4918429003021148
E01032306,1534,740,794,0.48239895697522817,0.5176010430247718
E01032307,1791,877,914,0.4896705750977108,0.5103294249022893
E01032309,1580,752,828,0.4759493670886076,0.5240506329113924
E01032285,1693,828,865,0.48907265209686945,0.5109273479031305
E01032292,1629,857,772,0.5260896255371393,0.47391037446286066
E01032294,1446,722,724,0.49930843706777317,0.5006915629322268
E01033248,1015,532,483,0.5241379310344828,0.47586206896551725
E01033249,1232,652,580,0.5292207792207793,0.4707792207792208
E01032286,1689,862,827,0.5103611604499704,0.4896388395500296
E01032287,1615,800,815,0.4953560371517028,0.5046439628482973
E01032288,1578,754,824,0.47782002534854245,0.5221799746514575
E01032289,1486,737,749,0.4959623149394347,0.5040376850605652
E01032290,1522,730,792,0.47963206307490147,0.5203679369250985
E01032283,1643,770,873,0.46865489957395007,0.5313451004260499
E01032284,1971,962,1009,0.4880771182141045,0.5119228817858955
E01032295,2419,1240,1179,0.5126085159156676,0.48739148408433236
E01032308,1586,758,828,0.47793190416141235,0.5220680958385876
E01032323,1481,712,769,0.48075624577987847,0.5192437542201216
E01032324,1365,660,705,0.4835164835164835,0.5164835164835165
E01032325,1597,770,827,0.48215403882279273,0.5178459611772073
E01032326,1408,673,735,0.47798295454545453,0.5220170454545454
E01032354,2452,1188,1264,0.48450244698205547,0.5154975530179445
E01032386,1330,663,667,0.49849624060150377,0.5015037593984962
E01032387,1384,691,693,0.49927745664739887,0.5007225433526011
E01032401,1496,737,759,0.49264705882352944,0.5073529411764706
E01032368,1228,609,619,0.495928338762215,0.504071661237785
E01032369,1543,732,811,0.474400518470512,0.525599481529488
E01032370,1265,613,652,0.48458498023715413,0.5154150197628459
E01032371,1348,631,717,0.4681008902077151,0.5318991097922848
E01032359,1803,830,973,0.4603438713255685,0.5396561286744315
E01032360,1933,941,992,0.4868080703569581,0.5131919296430419
E01032361,1694,840,854,0.49586776859504134,0.5041322314049587
E01032357,1187,567,620,0.4776748104465038,0.5223251895534962
E01032358,1450,717,733,0.49448275862068963,0.5055172413793103
E01032365,1803,855,948,0.47420965058236275,0.5257903494176372
E01032367,1487,683,804,0.4593140551445864,0.5406859448554135
E01032362,1979,971,1008,0.49065184436584136,0.5093481556341587
E01032363,1521,765,756,0.5029585798816568,0.4970414201183432
E01032364,1661,817,844,0.4918723660445515,0.5081276339554486
E01032366,1602,770,832,0.48064918851435706,0.519350811485643
E01032399,1690,830,860,0.4911242603550296,0.5088757396449705
E01032400,2251,1141,1110,0.5068858285206574,0.4931141714793425
E01032404,2360,1201,1159,0.5088983050847458,0.49110169491525424
E01032345,1447,727,720,0.502418797512094,0.497581202487906
E01032346,1331,669,662,0.5026296018031555,0.4973703981968445
E01032395,1206,590,616,0.4892205638474295,0.5107794361525705
E01032417,1491,719,772,0.48222669349429914,0.5177733065057009
E01032392,1518,743,775,0.4894598155467721,0.5105401844532279
E01032393,1552,773,779,0.49806701030927836,0.5019329896907216
E01032394,1187,609,578,0.5130581297388374,0.4869418702611626
E01032416,1117,548,569,0.4905998209489705,0.5094001790510295
E01032355,1293,630,663,0.4872389791183295,0.5127610208816705
E01032356,1123,540,583,0.4808548530721282,0.5191451469278717
E01032402,1506,719,787,0.47742363877822047,0.5225763612217795
E01032403,1444,706,738,0.4889196675900277,0.5110803324099723
E01032375,1165,574,591,0.4927038626609442,0.5072961373390558
E01032382,1244,594,650,0.477491961414791,0.522508038585209
E01032383,1480,726,754,0.4905405405405405,0.5094594594594595
E01032410,1354,697,657,0.5147710487444609,0.48522895125553916
E01032411,1597,764,833,0.47839699436443334,0.5216030056355667
E01032390,1364,677,687,0.4963343108504399,0.5036656891495601
E01032391,1097,544,553,0.495897903372835,0.504102096627165
E01032414,1524,737,787,0.4835958005249344,0.5164041994750657
E01032415,1643,1001,642,0.6092513694461351,0.3907486305538649
E01032405,1330,656,674,0.4932330827067669,0.5067669172932331
E01032406,1389,667,722,0.48020158387329015,0.5197984161267099
E01032407,1420,705,715,0.4964788732394366,0.5035211267605634
E01032408,1357,639,718,0.470891672807664,0.529108327192336
E01032409,1569,771,798,0.491395793499044,0.5086042065009561
E01032340,1433,711,722,0.4961618981158409,0.5038381018841591
E01032341,1315,656,659,0.4988593155893536,0.5011406844106464
E01032349,1513,718,795,0.47455386649041637,0.5254461335095836
E01032350,1052,526,526,0.5,0.5
E01032388,1343,658,685,0.48994787788533134,0.5100521221146687
E01032389,1267,618,649,0.4877663772691397,0.5122336227308603
E01032343,2336,1167,1169,0.4995719178082192,0.5004280821917808
E01032377,1792,881,911,0.4916294642857143,0.5083705357142857
E01032378,1705,838,867,0.49149560117302055,0.5085043988269795
E01032376,1507,748,759,0.49635036496350365,0.5036496350364964
E01032384,1313,655,658,0.49885757806549885,0.5011424219345011
E01032385,1225,568,657,0.4636734693877551,0.5363265306122449
E01032396,1668,822,846,0.49280575539568344,0.5071942446043165
E01032342,1565,776,789,0.49584664536741213,0.5041533546325878
E01032344,1448,719,729,0.4965469613259669,0.5034530386740331
E01032379,1879,945,934,0.5029270888770623,0.4970729111229377
E01032380,1575,762,813,0.4838095238095238,0.5161904761904762
E01032381,1903,925,978,0.4860746190225959,0.5139253809774041
E01032397,1745,854,891,0.48939828080229225,0.5106017191977077
E01032398,1767,883,884,0.49971703452178834,0.5002829654782116
E01032351,1503,711,792,0.47305389221556887,0.5269461077844312
E01032352,1501,735,766,0.48967355096602266,0.5103264490339774
E01032353,1577,732,845,0.4641724793912492,0.5358275206087508
E01032374,1291,632,659,0.4895429899302866,0.5104570100697134
E01032347,1289,646,643,0.5011636927851048,0.49883630721489525
E01032348,1215,587,628,0.4831275720164609,0.516872427983539
E01032372,1452,714,738,0.49173553719008267,0.5082644628099173
E01032373,1253,626,627,0.49960095770151636,0.5003990422984836
E01032412,1229,595,634,0.48413344182262,0.51586655817738
E01032413,1068,520,548,0.4868913857677903,0.5131086142322098
E01032431,1441,735,706,0.5100624566273422,0.4899375433726579
E01032432,1454,840,614,0.5777166437414031,0.422283356258597
E01032433,1303,630,673,0.4834996162701458,0.5165003837298542
E01032439,1373,679,694,0.4945375091041515,0.5054624908958485
E01032440,1190,537,653,0.4512605042016807,0.5487394957983194
E01032479,2087,1027,1060,0.4920939147101102,0.5079060852898898
E01032441,1257,635,622,0.5051710421638823,0.49482895783611774
E01032442,1471,730,741,0.49626104690686607,0.5037389530931339
E01032443,1335,650,685,0.4868913857677903,0.5131086142322098
E01032444,1207,590,617,0.4888152444076222,0.5111847555923777
E01032445,1520,728,792,0.4789473684210526,0.5210526315789473
E01032436,1522,762,760,0.5006570302233903,0.49934296977660975
E01032438,1514,757,757,0.5,0.5
E01032446,1440,686,754,0.47638888888888886,0.5236111111111111
E01032447,1468,728,740,0.49591280653950953,0.5040871934604905
E01032448,1227,588,639,0.4792176039119804,0.5207823960880196
E01032434,1650,828,822,0.5018181818181818,0.49818181818181817
E01032435,1446,711,735,0.491701244813278,0.508298755186722
E01032437,1801,901,900,0.5002776235424764,0.4997223764575236
E01032450,2269,1122,1147,0.4944909651829,0.5055090348171001
E01032430,1678,842,836,0.5017878426698451,0.49821215733015495
E01032480,1782,874,908,0.4904601571268238,0.5095398428731762
E01032481,1717,834,883,0.4857309260337799,0.5142690739662201
E01032482,1399,698,701,0.498927805575411,0.501072194424589
E01032451,1531,755,776,0.4931417374265186,0.5068582625734814
E01032452,1567,764,803,0.48755583918315254,0.5124441608168475
E01032453,1681,792,889,0.4711481261154075,0.5288518738845925
E01032454,1666,807,859,0.4843937575030012,0.5156062424969988
E01032449,1594,816,778,0.5119196988707654,0.4880803011292346
E01032464,1495,708,787,0.4735785953177257,0.5264214046822743
E01032465,1495,712,783,0.4762541806020067,0.5237458193979934
E01032466,1391,652,739,0.46872753414809487,0.5312724658519051
E01032467,1158,567,591,0.4896373056994819,0.5103626943005182
E01032468,1168,562,606,0.4811643835616438,0.5188356164383562
E01032474,1703,879,824,0.5161479741632413,0.4838520258367587
E01032475,1658,835,823,0.5036188178528347,0.49638118214716526
E01032476,1399,696,703,0.49749821300929237,0.5025017869907077
E01032477,1193,589,604,0.49371332774518023,0.5062866722548198
E01032478,1529,738,791,0.48266841072596467,0.5173315892740353
E01032469,1738,879,859,0.5057537399309551,0.4942462600690449
E01032470,1818,908,910,0.49944994499449946,0.5005500550055005
E01032471,1608,803,805,0.4993781094527363,0.5006218905472637
E01032418,1315,680,635,0.5171102661596958,0.4828897338403042
E01032419,1313,642,671,0.48895658796648894,0.511043412033511
E01032420,1261,641,620,0.5083267248215702,0.4916732751784298
E01032421,1243,622,621,0.500402252614642,0.499597747385358
E01032422,1447,674,773,0.46579129232895644,0.5342087076710436
E01032427,1563,761,802,0.4868841970569418,0.5131158029430583
E01032428,1635,843,792,0.5155963302752293,0.48440366972477067
E01032429,1520,732,788,0.48157894736842105,0.5184210526315789
E01032472,1204,614,590,0.5099667774086378,0.4900332225913621
E01032473,1239,601,638,0.4850686037126715,0.5149313962873285
E01032455,1506,730,776,0.4847277556440903,0.5152722443559097
E01032456,1220,580,640,0.47540983606557374,0.5245901639344263
E01032457,1348,628,720,0.4658753709198813,0.5341246290801187
E01032458,1367,666,701,0.48719824433065106,0.5128017556693489
E01032459,1438,676,762,0.47009735744089015,0.5299026425591099
E01032460,1785,872,913,0.48851540616246497,0.511484593837535
E01032461,1978,1053,925,0.532355915065723,0.46764408493427706
E01032462,2224,1086,1138,0.48830935251798563,0.5116906474820144
E01032463,1635,795,840,0.48623853211009177,0.5137614678899083
E01032423,1499,738,761,0.4923282188125417,0.5076717811874583
E01032424,1423,688,735,0.48348559381588196,0.516514406184118
E01032425,1430,683,747,0.47762237762237764,0.5223776223776224
E01032426,1439,720,719,0.5003474635163307,0.4996525364836692
E01017540,1466,725,741,0.4945429740791269,0.5054570259208732
E01017541,1286,638,648,0.49611197511664074,0.5038880248833593
E01017544,1431,669,762,0.46750524109014674,0.5324947589098532
E01017545,1492,741,751,0.49664879356568364,0.5033512064343163
E01017464,1460,740,720,0.5068493150684932,0.4931506849315068
E01017465,1426,695,731,0.48737727910238426,0.5126227208976157
E01017503,1311,645,666,0.4919908466819222,0.5080091533180778
E01017504,1978,952,1026,0.48129423660262893,0.5187057633973711
E01017546,1225,603,622,0.4922448979591837,0.5077551020408163
E01017547,1547,794,753,0.513251454427925,0.486748545572075
E01017478,1715,831,884,0.4845481049562682,0.5154518950437318
E01017479,1269,607,662,0.47832939322301027,0.5216706067769897
E01017480,2091,963,1128,0.460545193687231,0.539454806312769
E01017481,1200,591,609,0.4925,0.5075
E01017528,2493,1221,1272,0.4897713598074609,0.5102286401925391
E01017495,2003,969,1034,0.4837743384922616,0.5162256615077384
E01017496,1473,722,751,0.49015614392396467,0.5098438560760353
E01017542,1383,692,691,0.5003615328994938,0.49963846710050613
E01017543,1464,765,699,0.5225409836065574,0.4774590163934426
E01033431,1462,681,781,0.46580027359781123,0.5341997264021888
E01033432,2249,1078,1171,0.47932414406402846,0.5206758559359715
E01017453,1330,662,668,0.49774436090225566,0.5022556390977444
E01017454,1473,711,762,0.48268839103869654,0.5173116089613035
E01017455,1458,714,744,0.4897119341563786,0.5102880658436214
E01017456,1432,688,744,0.48044692737430167,0.5195530726256983
E01017457,1180,562,618,0.47627118644067795,0.523728813559322
E01017458,1280,644,636,0.503125,0.496875
E01017529,1295,632,663,0.488030888030888,0.511969111969112
E01017530,1410,720,690,0.5106382978723404,0.48936170212765956
E01017531,1354,627,727,0.4630723781388479,0.5369276218611522
E01017532,1271,636,635,0.5003933910306845,0.4996066089693155
E01017533,1209,577,632,0.4772539288668321,0.522746071133168
E01017534,1533,740,793,0.4827136333985649,0.5172863666014351
E01017488,1451,705,746,0.48587181254307377,0.5141281874569262
E01017489,1581,732,849,0.4629981024667932,0.5370018975332068
E01017490,1383,645,738,0.46637744034707157,0.5336225596529284
E01017491,1548,781,767,0.5045219638242894,0.49547803617571057
E01017492,1470,695,775,0.47278911564625853,0.5272108843537415
E01017493,1657,769,888,0.464091732045866,0.5359082679541339
E01017459,1688,823,865,0.48755924170616116,0.5124407582938388
E01017460,1586,782,804,0.4930643127364439,0.5069356872635561
E01017461,1904,937,967,0.49212184873949577,0.5078781512605042
E01017462,1621,811,810,0.500308451573103,0.499691548426897
E01017463,1345,639,706,0.475092936802974,0.5249070631970261
E01017482,1344,682,662,0.5074404761904762,0.49255952380952384
E01017483,1988,890,1098,0.4476861167002012,0.5523138832997988
E01017484,1288,759,529,0.5892857142857143,0.4107142857142857
E01017485,1388,745,643,0.5367435158501441,0.46325648414985593
E01017497,1407,724,683,0.5145700071073206,0.48542999289267946
E01017498,1277,637,640,0.4988253719655442,0.5011746280344558
E01017499,1334,657,677,0.49250374812593706,0.507496251874063
E01017500,1147,637,510,0.5553618134263295,0.44463818657367044
E01017501,1362,613,749,0.4500734214390602,0.5499265785609398
E01017502,1721,983,738,0.5711795467751307,0.4288204532248693
E01017524,1560,756,804,0.4846153846153846,0.5153846153846153
E01017525,1206,604,602,0.5008291873963516,0.49917081260364843
E01017526,1455,692,763,0.4756013745704467,0.5243986254295533
E01017527,1174,569,605,0.4846678023850085,0.5153321976149915
E01017466,1921,1074,847,0.5590838105153566,0.4409161894846434
E01017467,1297,615,682,0.47417116422513494,0.525828835774865
E01017468,1315,642,673,0.488212927756654,0.511787072243346
E01017469,1753,865,888,0.4934398174557901,0.50656018254421
E01017470,1275,611,664,0.4792156862745098,0.5207843137254902
E01017471,1508,802,706,0.5318302387267905,0.46816976127320953
E01017535,1456,707,749,0.4855769230769231,0.5144230769230769
E01017536,2391,1224,1167,0.5119196988707654,0.4880803011292346
E01017537,1369,657,712,0.4799123447772096,0.5200876552227903
E01017538,1815,924,891,0.509090909090909,0.4909090909090909
E01017539,1521,780,741,0.5128205128205128,0.48717948717948717
E01017518,1534,729,805,0.47522816166883963,0.5247718383311604
E01017519,1578,742,836,0.47021546261089986,0.5297845373891001
E01017520,1461,728,733,0.49828884325804246,0.5017111567419575
E01017521,1528,771,757,0.5045811518324608,0.4954188481675393
E01017522,1811,924,887,0.5102153506350083,0.4897846493649917
E01017523,1556,703,853,0.4517994858611825,0.5482005141388174
E01017472,1462,688,774,0.47058823529411764,0.5294117647058824
E01017473,2252,1143,1109,0.5075488454706927,0.49245115452930727
E01017474,1728,855,873,0.4947916666666667,0.5052083333333334
E01017475,1521,749,772,0.49243918474687703,0.5075608152531229
E01017476,1457,704,753,0.48318462594371997,0.51681537405628
E01017477,1261,588,673,0.4662965900079302,0.5337034099920698
E01017509,1253,599,654,0.47805267358339987,0.5219473264166001
E01017510,1510,704,806,0.46622516556291393,0.5337748344370861
E01017511,1258,635,623,0.5047694753577107,0.49523052464228934
E01017512,1454,721,733,0.4958734525447043,0.5041265474552957
E01017505,1535,765,770,0.498371335504886,0.501628664495114
E01017506,1552,739,813,0.47615979381443296,0.523840206185567
E01017507,1356,650,706,0.47935103244837757,0.5206489675516224
E01017508,1618,789,829,0.48763906056860323,0.5123609394313968
E01017513,1489,698,791,0.46877098723975824,0.5312290127602418
E01017514,1635,786,849,0.48073394495412847,0.5192660550458715
E01017515,1597,778,819,0.48716343143393864,0.5128365685660614
E01017516,1481,740,741,0.49966239027683995,0.50033760972316
E01017517,1592,784,808,0.49246231155778897,0.507537688442211
E01017486,1719,822,897,0.4781849912739965,0.5218150087260035
E01017487,1808,860,948,0.4756637168141593,0.5243362831858407
E01017548,1862,891,971,0.47851772287862515,0.5214822771213748
E01017549,1408,667,741,0.4737215909090909,0.5262784090909091
E01017550,2702,1321,1381,0.48889711324944485,0.5111028867505552
E01017551,1447,714,733,0.4934346924671735,0.5065653075328266
E01017552,1190,588,602,0.49411764705882355,0.5058823529411764
E01017553,1258,617,641,0.4904610492845787,0.5095389507154213
E01017554,1451,717,734,0.4941419710544452,0.5058580289455548
E01017433,1588,780,808,0.491183879093199,0.5088161209068011
E01017434,1684,860,824,0.5106888361045131,0.48931116389548696
E01017436,2329,1192,1137,0.5118076427651352,0.48819235723486476
E01017430,1392,701,691,0.5035919540229885,0.4964080459770115
E01017431,1481,746,735,0.5037137069547603,0.4962862930452397
E01017432,1491,715,776,0.4795439302481556,0.5204560697518444
E01017435,1692,829,863,0.48995271867612294,0.5100472813238771
E01017425,1062,526,536,0.4952919020715631,0.504708097928437
E01017426,1370,654,716,0.47737226277372263,0.5226277372262774
E01017427,1731,865,866,0.49971114962449453,0.5002888503755055
E01017428,1631,796,835,0.4880441446965052,0.5119558553034947
E01017429,1405,714,691,0.5081850533807829,0.4918149466192171
E01017412,1520,779,741,0.5125,0.4875
E01017422,1516,752,764,0.49604221635883905,0.503957783641161
E01017423,1536,761,775,0.4954427083333333,0.5045572916666666
E01017424,1374,680,694,0.4949053857350801,0.50509461426492
E01017383,1870,938,932,0.5016042780748663,0.4983957219251337
E01017384,1612,775,837,0.4807692307692308,0.5192307692307693
E01017385,1653,847,806,0.5124016938898972,0.48759830611010285
E01017386,1782,886,896,0.49719416386083054,0.5028058361391695
E01017387,1350,645,705,0.4777777777777778,0.5222222222222223
E01017388,1344,669,675,0.49776785714285715,0.5022321428571429
E01017381,1473,726,747,0.49287169042769857,0.5071283095723014
E01017382,1474,698,776,0.4735413839891452,0.5264586160108549
E01017389,1944,977,967,0.5025720164609053,0.4974279835390947
E01017390,2049,975,1074,0.47584187408491946,0.5241581259150805
E01017379,1191,596,595,0.5004198152812762,0.4995801847187238
E01017380,1241,608,633,0.48992747784045126,0.5100725221595488
E01017394,1540,804,736,0.522077922077922,0.4779220779220779
E01017397,1673,852,821,0.5092647937836222,0.4907352062163778
E01033194,2667,1509,1158,0.5658042744656918,0.4341957255343082
E01017410,1199,603,596,0.5029190992493745,0.4970809007506255
E01017411,1514,754,760,0.49801849405548215,0.5019815059445178
E01017419,1612,794,818,0.49255583126550867,0.5074441687344913
E01017420,1520,722,798,0.475,0.525
E01017421,1738,864,874,0.49712313003452246,0.5028768699654775
E01017416,1981,1003,978,0.5063099444724887,0.4936900555275114
E01017417,2365,1175,1190,0.49682875264270615,0.5031712473572939
E01017418,1557,752,805,0.4829800899165061,0.5170199100834939
E01017451,1418,685,733,0.4830747531734838,0.5169252468265162
E01017452,1166,559,607,0.4794168096054888,0.5205831903945112
E01017376,1845,933,912,0.5056910569105691,0.4943089430894309
E01017377,1971,965,1006,0.4895991882293252,0.5104008117706748
E01017378,1768,867,901,0.49038461538461536,0.5096153846153846
E01017413,1756,866,890,0.49316628701594534,0.5068337129840547
E01017414,1736,873,863,0.5028801843317973,0.4971198156682028
E01017415,1852,903,949,0.48758099352051837,0.5124190064794817
E01017437,1528,753,775,0.49280104712041883,0.5071989528795812
E01017438,1662,826,836,0.4969915764139591,0.5030084235860409
E01017439,1676,819,857,0.4886634844868735,0.5113365155131265
E01017440,1374,685,689,0.4985443959243086,0.5014556040756915
E01017441,1935,989,946,0.5111111111111111,0.4888888888888889
E01017444,1842,924,918,0.501628664495114,0.498371335504886
E01017371,1300,621,679,0.4776923076923077,0.5223076923076924
E01017372,1472,710,762,0.48233695652173914,0.5176630434782609
E01017373,1488,748,740,0.5026881720430108,0.49731182795698925
E01017374,1472,733,739,0.49796195652173914,0.5020380434782609
E01017375,1443,721,722,0.49965349965349964,0.5003465003465003
E01017391,1367,676,691,0.49451353328456477,0.5054864667154353
E01017392,1511,740,771,0.48974189278623426,0.5102581072137657
E01017393,1745,837,908,0.4796561604584527,0.5203438395415473
E01017442,2052,1018,1034,0.49610136452241715,0.5038986354775828
E01017443,1805,953,852,0.52797783933518,0.47202216066481995
E01017446,1731,860,871,0.49682264586943964,0.5031773541305604
E01017447,2067,1011,1056,0.48911465892597966,0.5108853410740203
E01017449,1486,736,750,0.4952893674293405,0.5047106325706595
E01033188,1430,693,737,0.4846153846153846,0.5153846153846153
E01033189,1542,760,782,0.49286640726329445,0.5071335927367056
E01033190,1376,675,701,0.49055232558139533,0.5094476744186046
E01017399,1495,756,739,0.505685618729097,0.494314381270903
E01017400,1496,745,751,0.4979946524064171,0.5020053475935828
E01017401,1271,635,636,0.4996066089693155,0.5003933910306845
E01017402,1599,806,793,0.5040650406504065,0.4959349593495935
E01017403,1419,708,711,0.4989429175475687,0.5010570824524313
E01017404,1348,690,658,0.5118694362017804,0.48813056379821956
E01017405,1449,720,729,0.4968944099378882,0.5031055900621118
E01017406,1555,775,780,0.4983922829581994,0.5016077170418006
E01017407,1602,807,795,0.5037453183520599,0.49625468164794007
E01017398,2400,1216,1184,0.5066666666666667,0.49333333333333335
E01017408,1072,538,534,0.5018656716417911,0.498134328358209
E01017409,1225,611,614,0.4987755102040816,0.5012244897959184
E01017445,1791,868,923,0.48464544946957006,0.5153545505304299
E01017450,2300,1164,1136,0.5060869565217392,0.49391304347826087
E01017558,1798,886,912,0.492769744160178,0.5072302558398221
E01017559,1703,822,881,0.48267762771579564,0.5173223722842043
E01017560,1491,743,748,0.4983232729711603,0.5016767270288397
E01017616,2320,1159,1161,0.4995689655172414,0.5004310344827586
E01017577,2169,1097,1072,0.5057630244352236,0.4942369755647764
E01017615,2097,1039,1058,0.4954697186456843,0.5045302813543157
E01017620,1802,902,900,0.5005549389567148,0.49944506104328523
E01017621,1640,822,818,0.501219512195122,0.49878048780487805
E01017622,1681,837,844,0.49791790600832836,0.5020820939916716
E01017603,1501,760,741,0.5063291139240507,0.4936708860759494
E01017604,1661,830,831,0.4996989765201686,0.5003010234798314
E01017605,1416,686,730,0.4844632768361582,0.5155367231638418
E01017606,1514,742,772,0.4900924702774108,0.5099075297225891
E01017607,1409,695,714,0.49325762952448543,0.5067423704755145
E01017555,1910,943,967,0.493717277486911,0.506282722513089
E01017556,1579,794,785,0.5028499050031665,0.49715009499683344
E01017557,1759,810,949,0.4604889141557703,0.5395110858442297
E01017608,1729,828,901,0.47888953152111047,0.5211104684788895
E01017609,1668,783,885,0.4694244604316547,0.5305755395683454
E01017589,1653,846,807,0.5117967332123412,0.4882032667876588
E01017590,1528,783,745,0.512434554973822,0.487565445026178
E01017591,1696,834,862,0.49174528301886794,0.5082547169811321
E01017610,1133,555,578,0.48984995586937335,0.5101500441306267
E01017611,1267,623,644,0.49171270718232046,0.5082872928176796
E01017612,1325,645,680,0.4867924528301887,0.5132075471698113
E01017613,1387,684,703,0.4931506849315068,0.5068493150684932
E01017614,1495,766,729,0.5123745819397993,0.48762541806020065
E01017600,1939,1001,938,0.516245487364621,0.48375451263537905
E01017601,1487,724,763,0.48688634835238737,0.5131136516476127
E01017602,1554,756,798,0.4864864864864865,0.5135135135135135
E01017618,1645,797,848,0.4844984802431611,0.5155015197568389
E01017619,2171,1080,1091,0.49746660525103636,0.5025333947489636
E01017573,1424,715,709,0.5021067415730337,0.4978932584269663
E01017575,2478,1245,1233,0.5024213075060533,0.4975786924939467
E01017576,1407,688,719,0.48898365316275766,0.5110163468372424
E01033191,1417,714,703,0.5038814396612562,0.49611856033874385
E01033192,1524,749,775,0.4914698162729659,0.5085301837270341
E01033193,1589,799,790,0.5028319697923223,0.4971680302076778
E01017578,1749,876,873,0.5008576329331046,0.49914236706689535
E01017579,1467,691,776,0.4710293115201091,0.5289706884798909
E01017580,2138,1002,1136,0.4686623012160898,0.5313376987839102
E01017581,1828,874,954,0.47811816192560175,0.5218818380743983
E01017617,1305,655,650,0.5019157088122606,0.49808429118773945
E01017582,1518,767,751,0.505270092226614,0.49472990777338605
E01017583,1843,909,934,0.4932175800325556,0.5067824199674443
E01017584,1968,936,1032,0.47560975609756095,0.524390243902439
E01017585,1417,725,692,0.5116443189837685,0.4883556810162315
E01017566,1498,721,777,0.48130841121495327,0.5186915887850467
E01017595,1197,589,608,0.49206349206349204,0.5079365079365079
E01017596,1539,736,803,0.47823261858349575,0.5217673814165043
E01017597,1448,714,734,0.4930939226519337,0.5069060773480663
E01017598,1058,552,506,0.5217391304347826,0.4782608695652174
E01017599,2125,1058,1067,0.4978823529411765,0.5021176470588236
E01017565,1521,748,773,0.4917817225509533,0.5082182774490467
E01017567,1655,812,843,0.4906344410876133,0.5093655589123867
E01017568,1850,904,946,0.48864864864864865,0.5113513513513513
E01017569,1612,781,831,0.4844913151364764,0.5155086848635235
E01017570,1936,970,966,0.5010330578512396,0.4989669421487603
E01017592,1540,758,782,0.4922077922077922,0.5077922077922078
E01017593,1487,720,767,0.484196368527236,0.515803631472764
E01017594,2166,1048,1118,0.4838411819021237,0.5161588180978762
E01017623,1680,840,840,0.5,0.5
E01017624,1877,892,985,0.47522642514651037,0.5247735748534896
E01017625,1609,800,809,0.49720323182100684,0.5027967681789932
E01017626,1709,860,849,0.5032182562902282,0.4967817437097718
E01017571,1231,591,640,0.4800974817221771,0.5199025182778229
E01017572,1354,680,674,0.5022156573116692,0.4977843426883309
E01017586,1455,717,738,0.4927835051546392,0.5072164948453608
E01017587,1548,780,768,0.5038759689922481,0.49612403100775193
E01017588,1172,560,612,0.4778156996587031,0.5221843003412969
E01017561,1497,764,733,0.5103540414161657,0.48964595858383436
E01017562,1440,674,766,0.46805555555555556,0.5319444444444444
E01017563,1583,766,817,0.4838913455464308,0.5161086544535691
E01017564,1406,692,714,0.492176386913229,0.5078236130867709
E01015706,1406,672,734,0.4779516358463727,0.5220483641536273
E01015707,1442,722,720,0.5006934812760055,0.49930651872399445
E01015708,1399,720,679,0.5146533238027162,0.4853466761972838
E01015709,1466,711,755,0.4849931787175989,0.515006821282401
E01015710,1494,731,763,0.4892904953145917,0.5107095046854083
E01015770,1279,652,627,0.509773260359656,0.490226739640344
E01015801,1761,881,880,0.5002839295854627,0.4997160704145372
E01015803,1505,744,761,0.4943521594684385,0.5056478405315614
E01015804,1830,917,913,0.5010928961748634,0.4989071038251366
E01015805,1335,679,656,0.5086142322097378,0.49138576779026216
E01015769,1195,574,621,0.4803347280334728,0.5196652719665272
E01015771,1427,683,744,0.47862648913805184,0.5213735108619482
E01015772,1475,700,775,0.4745762711864407,0.5254237288135594
E01015773,1333,634,699,0.47561890472618157,0.5243810952738185
E01015774,1444,673,771,0.4660664819944598,0.5339335180055401
E01015802,1518,730,788,0.48089591567852435,0.5191040843214756
E01015744,1438,702,736,0.48817802503477054,0.5118219749652295
E01015746,1507,710,797,0.47113470471134705,0.528865295288653
E01015747,1434,690,744,0.4811715481171548,0.5188284518828452
E01015748,1660,782,878,0.4710843373493976,0.5289156626506024
E01015749,1894,915,979,0.48310454065469904,0.5168954593453009
E01015751,1721,793,928,0.4607786170830912,0.5392213829169088
E01015752,1339,644,695,0.4809559372666169,0.5190440627333831
E01015753,1413,711,702,0.5031847133757962,0.4968152866242038
E01015754,1773,835,938,0.4709531866892273,0.5290468133107727
E01015755,1672,788,884,0.47129186602870815,0.5287081339712919
E01015764,1555,754,801,0.48488745980707393,0.5151125401929261
E01015765,1649,813,836,0.49302607640994545,0.5069739235900546
E01015766,1675,815,860,0.48656716417910445,0.5134328358208955
E01015767,1572,808,764,0.5139949109414759,0.4860050890585242
E01015768,1453,690,763,0.4748795595320027,0.5251204404679972
E01015783,1722,852,870,0.49477351916376305,0.5052264808362369
E01015785,2134,1061,1073,0.4971883786316776,0.5028116213683224
E01015693,1545,745,800,0.48220064724919093,0.517799352750809
E01015694,1443,710,733,0.49203049203049204,0.507969507969508
E01015695,1592,793,799,0.4981155778894472,0.5018844221105527
E01015696,1385,638,747,0.46064981949458483,0.5393501805054152
E01015697,1771,837,934,0.47261434217955955,0.5273856578204404
E01015745,1590,801,789,0.5037735849056604,0.4962264150943396
E01015797,1307,656,651,0.5019127773527161,0.49808722264728383
E01015798,1342,641,701,0.47764530551415796,0.522354694485842
E01015799,1388,692,696,0.49855907780979825,0.5014409221902018
E01015800,1523,764,759,0.5016414970453054,0.4983585029546947
E01015812,1359,666,693,0.4900662251655629,0.5099337748344371
E01015813,1314,630,684,0.4794520547945205,0.5205479452054794
E01015756,1593,743,850,0.46641556811048335,0.5335844318895167
E01015757,1533,716,817,0.46705805609915196,0.532941943900848
E01015758,1494,740,754,0.49531459170013387,0.5046854082998661
E01015759,1506,730,776,0.4847277556440903,0.5152722443559097
E01015760,1490,715,775,0.4798657718120805,0.5201342281879194
E01015761,1652,801,851,0.4848668280871671,0.5151331719128329
E01015700,2438,1228,1210,0.5036915504511895,0.4963084495488105
E01015701,2219,1144,1075,0.5155475439387112,0.4844524560612889
E01015704,2116,1038,1078,0.4905482041587902,0.5094517958412098
E01015782,2070,1050,1020,0.5072463768115942,0.4927536231884058
E01015784,2200,1111,1089,0.505,0.495
E01015786,2210,1117,1093,0.5054298642533936,0.49457013574660635
E01015711,1703,861,842,0.5055783910745743,0.4944216089254257
E01015712,1805,930,875,0.5152354570637119,0.48476454293628807
E01015715,1822,915,907,0.5021953896816685,0.4978046103183315
E01015716,1854,867,987,0.46763754045307443,0.5323624595469255
E01015717,1537,762,775,0.49577098243331164,0.5042290175666884
E01015750,2186,1105,1081,0.5054894784995425,0.49451052150045743
E01015740,1565,781,784,0.49904153354632586,0.5009584664536741
E01015775,1609,790,819,0.49098819142324424,0.5090118085767558
E01015776,1892,911,981,0.48150105708245244,0.5184989429175476
E01015777,1732,861,871,0.4971131639722864,0.5028868360277137
E01015778,1726,874,852,0.5063731170336037,0.4936268829663963
E01015796,1461,732,729,0.5010266940451745,0.4989733059548255
E01015713,1408,709,699,0.5035511363636364,0.49644886363636365
E01015714,1727,872,855,0.5049218297625941,0.4950781702374059
E01015718,1614,769,845,0.476456009913259,0.523543990086741
E01015762,1699,846,853,0.49793996468510887,0.5020600353148911
E01015763,1552,746,806,0.4806701030927835,0.5193298969072165
E01015721,1536,773,763,0.5032552083333334,0.4967447916666667
E01015722,1275,621,654,0.48705882352941177,0.5129411764705882
E01015806,1318,652,666,0.4946889226100152,0.5053110773899848
E01015808,1414,681,733,0.4816124469589816,0.5183875530410184
E01015809,1413,736,677,0.5208775654635527,0.47912243453644726
E01015810,1391,654,737,0.4701653486700216,0.5298346513299784
E01015811,1428,721,707,0.5049019607843137,0.4950980392156863
E01015703,2145,1102,1043,0.5137529137529138,0.48624708624708624
E01015726,2328,1190,1138,0.511168384879725,0.4888316151202749
E01015731,1971,1020,951,0.517503805175038,0.4824961948249619
E01015787,2013,1010,1003,0.50173869846001,0.49826130153999004
E01015788,2033,1040,993,0.5115592720118052,0.48844072798819477
E01015719,1423,722,701,0.5073787772312017,0.49262122276879833
E01015720,1525,764,761,0.5009836065573771,0.49901639344262294
E01015723,1311,653,658,0.498093058733791,0.501906941266209
E01015779,1474,712,762,0.4830393487109905,0.5169606512890095
E01015780,1645,811,834,0.4930091185410334,0.5069908814589665
E01015781,1545,750,795,0.4854368932038835,0.5145631067961165
E01015807,1363,652,711,0.4783565663976522,0.5216434336023478
E01015698,1885,1005,880,0.53315649867374,0.46684350132625996
E01015699,1838,919,919,0.5,0.5
E01015702,1780,892,888,0.501123595505618,0.49887640449438203
E01015705,1697,903,794,0.5321154979375369,0.4678845020624632
E01015725,1751,887,864,0.5065676756139349,0.4934323243860651
E01015727,1898,1040,858,0.547945205479452,0.4520547945205479
E01015739,1908,1057,851,0.5539832285115304,0.4460167714884696
E01015741,2256,1250,1006,0.5540780141843972,0.44592198581560283
E01015742,1769,930,839,0.5257207461842849,0.4742792538157151
E01015743,1548,836,712,0.5400516795865633,0.4599483204134367
E01015789,1747,971,776,0.5558099599313108,0.4441900400686892
E01015794,2505,1366,1139,0.5453093812375249,0.4546906187624751
E01015724,2342,1227,1115,0.5239111870196413,0.47608881298035866
E01015728,1802,921,881,0.5110987791342952,0.48890122086570476
E01015729,1961,1096,865,0.5588985211626721,0.4411014788373279
E01015730,2340,1267,1073,0.5414529914529914,0.4585470085470085
E01015732,1523,734,789,0.4819435325016415,0.5180564674983585
E01015733,1807,846,961,0.4681793027116768,0.5318206972883232
E01015734,1855,921,934,0.4964959568733154,0.5035040431266846
E01015735,1730,890,840,0.5144508670520231,0.48554913294797686
E01015736,1740,840,900,0.4827586206896552,0.5172413793103449
E01015737,1535,749,786,0.48794788273615636,0.5120521172638437
E01015738,1806,1010,796,0.5592469545957918,0.4407530454042082
E01015790,1620,850,770,0.5246913580246914,0.47530864197530864
E01015791,2492,1337,1155,0.5365168539325843,0.46348314606741575
E01015792,1742,937,805,0.5378874856486797,0.46211251435132034
E01015793,1727,914,813,0.5292414591777649,0.4707585408222351
E01015795,2154,1272,882,0.5905292479108635,0.40947075208913647
E01015629,1740,844,896,0.4850574712643678,0.5149425287356322
E01015635,1534,746,788,0.4863102998696219,0.5136897001303781
E01015636,1150,573,577,0.49826086956521737,0.5017391304347826
E01015679,1792,892,900,0.49776785714285715,0.5022321428571429
E01015678,1422,708,714,0.4978902953586498,0.5021097046413502
E01015680,1511,723,788,0.4784910655195235,0.5215089344804765
E01015681,1552,743,809,0.4787371134020619,0.5212628865979382
E01015682,1442,716,726,0.49653259361997226,0.5034674063800277
E01015630,1539,786,753,0.5107212475633528,0.48927875243664715
E01015631,1306,660,646,0.5053598774885145,0.4946401225114854
E01015659,1951,994,957,0.5094823167606356,0.49051768323936445
E01015684,1491,718,773,0.4815560026827633,0.5184439973172368
E01015685,1611,783,828,0.4860335195530726,0.5139664804469274
E01015589,1654,807,847,0.4879081015719468,0.5120918984280532
E01015590,1222,602,620,0.49263502454991814,0.5073649754500819
E01015626,1485,764,721,0.5144781144781144,0.4855218855218855
E01015628,2268,1288,980,0.5679012345679012,0.43209876543209874
E01015617,1317,650,667,0.4935459377372817,0.5064540622627183
E01015618,1084,519,565,0.47878228782287824,0.5212177121771218
E01015619,2033,943,1090,0.46384653221839645,0.5361534677816036
E01015620,1704,845,859,0.49589201877934275,0.5041079812206573
E01015674,1495,696,799,0.46555183946488293,0.534448160535117
E01015675,1582,778,804,0.4917825537294564,0.5082174462705437
E01015676,1507,752,755,0.49900464499004643,0.5009953550099535
E01015683,1836,878,958,0.4782135076252723,0.5217864923747276
E01015686,1505,728,777,0.48372093023255813,0.5162790697674419
E01015607,1407,648,759,0.4605543710021322,0.5394456289978679
E01015609,1735,883,852,0.5089337175792508,0.4910662824207493
E01015656,1541,756,785,0.49059052563270605,0.509409474367294
E01015657,1975,958,1017,0.4850632911392405,0.5149367088607595
E01015658,1553,756,797,0.4867997424339987,0.5132002575660013
E01015660,1530,745,785,0.4869281045751634,0.5130718954248366
E01015605,1630,792,838,0.48588957055214727,0.5141104294478528
E01015608,1559,756,803,0.48492623476587554,0.5150737652341244
E01015610,1564,765,799,0.4891304347826087,0.5108695652173914
E01015633,2223,1069,1154,0.4808816914080072,0.5191183085919928
E01015634,1850,896,954,0.4843243243243243,0.5156756756756756
E01015593,1430,702,728,0.4909090909090909,0.509090909090909
E01015596,1655,797,858,0.481570996978852,0.518429003021148
E01015662,1450,741,709,0.5110344827586207,0.4889655172413793
E01015663,1451,688,763,0.4741557546519642,0.5258442453480359
E01015664,1672,811,861,0.48504784688995217,0.5149521531100478
E01015603,2292,1212,1080,0.5287958115183246,0.4712041884816754
E01015604,1963,1005,958,0.5119714722363728,0.4880285277636271
E01015632,2028,1059,969,0.522189349112426,0.47781065088757396
E01015661,1749,906,843,0.5180102915951973,0.48198970840480276
E01015677,1065,513,552,0.48169014084507045,0.5183098591549296
E01015591,1479,743,736,0.5023664638269101,0.4976335361730899
E01015592,1529,740,789,0.4839764551994768,0.5160235448005233
E01015594,1822,906,916,0.4972557628979144,0.5027442371020856
E01015595,1459,689,770,0.4722412611377656,0.5277587388622345
E01015597,1573,764,809,0.48569612205975843,0.5143038779402416
E01015601,2055,1021,1034,0.4968369829683698,0.5031630170316301
E01015651,2060,1051,1009,0.5101941747572816,0.48980582524271843
E01015652,2030,1037,993,0.5108374384236454,0.4891625615763547
E01015653,1818,879,939,0.4834983498349835,0.5165016501650165
E01015654,2374,1144,1230,0.4818871103622578,0.5181128896377422
E01015606,1725,843,882,0.48869565217391303,0.5113043478260869
E01015611,2097,1067,1030,0.508822126847878,0.4911778731521221
E01015613,1549,774,775,0.49967721110393803,0.500322788896062
E01015614,1799,890,909,0.4947192884936076,0.5052807115063924
E01015615,1614,798,816,0.4944237918215613,0.5055762081784386
E01015616,1779,892,887,0.5014052838673412,0.4985947161326588
E01015599,1881,1010,871,0.5369484316852738,0.4630515683147262
E01015600,1875,990,885,0.528,0.472
E01015602,1947,1033,914,0.5305598356445814,0.4694401643554186
E01015612,2183,1101,1082,0.5043518094365552,0.4956481905634448
E01015655,2136,1111,1025,0.5201310861423221,0.4798689138576779
E01015598,1498,741,757,0.4946595460614152,0.5053404539385847
E01015687,1590,772,818,0.48553459119496856,0.5144654088050314
E01015689,1435,701,734,0.48850174216027875,0.5114982578397212
E01015690,1204,598,606,0.49667774086378735,0.5033222591362126
E01015691,1391,662,729,0.47591660675772823,0.5240833932422717
E01015622,2361,1208,1153,0.5116476069462093,0.48835239305379075
E01015665,1668,829,839,0.4970023980815348,0.5029976019184652
E01015688,1421,705,716,0.49612948627726955,0.5038705137227305
E01015692,1421,676,745,0.4757213230119634,0.5242786769880365
E01033173,1907,961,946,0.5039328788673308,0.4960671211326691
E01033182,1472,745,727,0.5061141304347826,0.4938858695652174
E01015621,1975,967,1008,0.489620253164557,0.5103797468354431
E01015623,1713,848,865,0.4950379451255108,0.5049620548744892
E01015624,1627,829,798,0.5095267363245236,0.49047326367547633
E01015666,1300,611,689,0.47,0.53
E01015668,1777,869,908,0.48902644907146875,0.5109735509285313
E01015627,1740,851,889,0.48908045977011494,0.5109195402298851
E01015644,1946,954,992,0.49023638232271327,0.5097636176772867
E01015645,1634,800,834,0.48959608323133413,0.5104039167686658
E01015646,1913,923,990,0.48248823836905386,0.5175117616309461
E01015648,1413,679,734,0.4805378627034678,0.5194621372965322
E01015667,1324,668,656,0.5045317220543807,0.4954682779456193
E01015669,1394,689,705,0.49426111908177905,0.505738880918221
E01015670,1440,731,709,0.5076388888888889,0.49236111111111114
E01015671,1573,757,816,0.48124602670057215,0.5187539732994279
E01015672,1580,771,809,0.4879746835443038,0.5120253164556962
E01015673,1496,727,769,0.4859625668449198,0.5140374331550802
E01015637,1462,706,756,0.4829001367989056,0.5170998632010944
E01015639,1512,732,780,0.48412698412698413,0.5158730158730159
E01015640,1467,731,736,0.49829584185412407,0.501704158145876
E01015641,1259,600,659,0.4765687053216839,0.5234312946783162
E01015642,1527,755,772,0.49443352979698757,0.5055664702030125
E01015647,1399,642,757,0.45889921372408865,0.5411007862759114
E01015638,1557,742,815,0.4765574823378292,0.5234425176621709
E01015650,2023,1034,989,0.5111220958971824,0.4888779041028176
E01033174,1221,567,654,0.4643734643734644,0.5356265356265356
E01033179,1526,702,824,0.4600262123197903,0.5399737876802096
E01033181,1574,785,789,0.49872935196950446,0.5012706480304956
E01015643,1375,685,690,0.49818181818181817,0.5018181818181818
E01033175,1476,757,719,0.5128726287262872,0.48712737127371275
E01033176,1605,804,801,0.5009345794392523,0.49906542056074765
E01033177,1419,718,701,0.5059901338971107,0.4940098661028894
E01033178,1545,739,806,0.47831715210355985,0.5216828478964401
E01033180,1632,811,821,0.49693627450980393,0.5030637254901961
E01015833,1543,766,777,0.4964355152300713,0.5035644847699287
E01015834,1464,708,756,0.48360655737704916,0.5163934426229508
E01015835,1659,807,852,0.4864376130198915,0.5135623869801085
E01015836,1515,729,786,0.48118811881188117,0.5188118811881188
E01015837,1683,819,864,0.48663101604278075,0.5133689839572193
E01015838,1500,736,764,0.49066666666666664,0.5093333333333333
E01015863,2371,1152,1219,0.4858709405314213,0.5141290594685787
E01015864,1360,665,695,0.4889705882352941,0.5110294117647058
E01015865,1425,692,733,0.4856140350877193,0.5143859649122807
E01015866,1532,745,787,0.48629242819843344,0.5137075718015666
E01015867,1434,663,771,0.46234309623430964,0.5376569037656904
E01015868,1604,822,782,0.5124688279301746,0.48753117206982544
E01015814,1423,679,744,0.47716092761770906,0.5228390723822909
E01015815,1598,761,837,0.4762202753441802,0.5237797246558198
E01015816,1485,714,771,0.4808080808080808,0.5191919191919192
E01015817,1573,760,813,0.4831532104259377,0.5168467895740623
E01015818,1712,818,894,0.477803738317757,0.522196261682243
E01015819,1428,692,736,0.484593837535014,0.5154061624649859
E01015857,1543,758,785,0.49125081011017496,0.508749189889825
E01015858,1724,866,858,0.5023201856148491,0.4976798143851508
E01015859,1923,959,964,0.4986999479979199,0.50130005200208
E01015860,1540,769,771,0.4993506493506494,0.5006493506493507
E01015861,1694,819,875,0.4834710743801653,0.5165289256198347
E01015862,1547,749,798,0.4841628959276018,0.5158371040723982
E01015820,1485,738,747,0.49696969696969695,0.503030303030303
E01015821,1565,753,812,0.48115015974440895,0.518849840255591
E01015822,1223,584,639,0.47751430907604253,0.5224856909239575
E01015823,1659,790,869,0.47619047619047616,0.5238095238095238
E01015824,1545,737,808,0.47702265372168284,0.5229773462783172
E01015825,1600,795,805,0.496875,0.503125
E01015826,1398,666,732,0.47639484978540775,0.5236051502145923
E01015869,1630,808,822,0.49570552147239266,0.5042944785276073
E01015870,1643,802,841,0.4881314668289714,0.5118685331710287
E01015871,1617,796,821,0.49226963512677796,0.507730364873222
E01015872,1688,818,870,0.48459715639810425,0.5154028436018957
E01015873,1301,617,684,0.47425057647963104,0.5257494235203689
E01015874,1669,840,829,0.5032953864589574,0.49670461354104256
E01015875,1665,832,833,0.4996996996996997,0.5003003003003003
E01015901,1461,709,752,0.48528405201916497,0.5147159479808351
E01015902,1682,840,842,0.4994054696789536,0.5005945303210464
E01015903,1598,793,805,0.49624530663329164,0.5037546933667084
E01015904,1648,801,847,0.48604368932038833,0.5139563106796117
E01015905,1428,732,696,0.5126050420168067,0.48739495798319327
E01015906,1581,799,782,0.5053763440860215,0.4946236559139785
E01015907,1449,726,723,0.5010351966873706,0.4989648033126294
E01015908,1611,794,817,0.4928615766604593,0.5071384233395406
E01015909,1551,760,791,0.49000644745325594,0.5099935525467441
E01015910,1507,755,752,0.5009953550099535,0.49900464499004643
E01015911,1306,636,670,0.4869831546707504,0.5130168453292496
E01015912,1497,692,805,0.4622578490313961,0.5377421509686039
E01015913,1682,835,847,0.49643281807372175,0.5035671819262783
E01015883,1383,666,717,0.48156182212581344,0.5184381778741866
E01015884,2119,1012,1107,0.4775837659273242,0.5224162340726758
E01015885,1656,781,875,0.4716183574879227,0.5283816425120773
E01015886,1495,745,750,0.4983277591973244,0.5016722408026756
E01015887,1594,759,835,0.47616060225846923,0.5238393977415308
E01015888,1463,690,773,0.47163362952836635,0.5283663704716336
E01015895,1958,1006,952,0.5137895812053116,0.48621041879468846
E01015896,1966,988,978,0.5025432349949135,0.49745676500508645
E01015897,2037,992,1045,0.48699067255768286,0.5130093274423171
E01015898,1690,828,862,0.48994082840236686,0.5100591715976331
E01015899,1899,963,936,0.5071090047393365,0.4928909952606635
E01015900,1454,748,706,0.5144429160935351,0.4855570839064649
E01015845,1623,769,854,0.4738139248305607,0.5261860751694393
E01015846,1756,847,909,0.48234624145785876,0.5176537585421412
E01015847,1733,858,875,0.49509521061742645,0.5049047893825735
E01015848,1646,787,859,0.4781287970838396,0.5218712029161604
E01015849,1669,804,865,0.481725584182145,0.518274415817855
E01015850,1656,827,829,0.4993961352657005,0.5006038647342995
E01015827,1661,815,846,0.4906682721252258,0.5093317278747742
E01015828,1632,873,759,0.5349264705882353,0.4650735294117647
E01015829,1562,716,846,0.45838668373879643,0.5416133162612036
E01015830,1574,749,825,0.4758576874205845,0.5241423125794155
E01015831,1998,1065,933,0.5330330330330331,0.466966966966967
E01015832,1618,764,854,0.4721878862793572,0.5278121137206427
E01015876,2168,1069,1099,0.49308118081180813,0.5069188191881919
E01015877,1785,840,945,0.47058823529411764,0.5294117647058824
E01015878,1354,671,683,0.49556868537666177,0.5044313146233382
E01015879,1401,659,742,0.470378301213419,0.529621698786581
E01015880,1452,689,763,0.47451790633608815,0.5254820936639119
E01015881,1391,685,706,0.49245147375988496,0.507548526240115
E01015882,1608,777,831,0.4832089552238806,0.5167910447761194
E01015839,1679,810,869,0.48243001786777845,0.5175699821322216
E01015840,1740,876,864,0.503448275862069,0.496551724137931
E01015841,2356,1244,1112,0.5280135823429541,0.47198641765704585
E01015842,1878,894,984,0.476038338658147,0.5239616613418531
E01015843,1687,798,889,0.4730290456431535,0.5269709543568465
E01015844,1790,893,897,0.4988826815642458,0.5011173184357542
E01015851,1695,844,851,0.49793510324483775,0.5020648967551622
E01015852,1735,898,837,0.5175792507204611,0.48242074927953893
E01015853,1820,879,941,0.48296703296703297,0.5170329670329671
E01015854,2028,1056,972,0.5207100591715976,0.47928994082840237
E01015855,2024,1042,982,0.5148221343873518,0.4851778656126482
E01015856,1761,893,868,0.5070982396365701,0.49290176036342986
E01015889,1439,695,744,0.4829742876997915,0.5170257123002084
E01015890,1516,754,762,0.4973614775725594,0.5026385224274407
E01015891,1443,699,744,0.48440748440748443,0.5155925155925156
E01015892,1703,819,884,0.48091603053435117,0.5190839694656488
E01015893,1579,704,875,0.44585180493983534,0.5541481950601647
E01015894,1535,772,763,0.5029315960912052,0.4970684039087948
E01015914,1365,687,678,0.5032967032967033,0.4967032967032967
E01015915,1462,714,748,0.4883720930232558,0.5116279069767442
E01015916,1522,717,805,0.47109067017082784,0.5289093298291722
E01015917,1679,795,884,0.4734961286480048,0.5265038713519953
E01015918,1419,659,760,0.46441155743481327,0.5355884425651868
E01015919,1313,643,670,0.4897182025894897,0.5102817974105103
E01015920,1520,714,806,0.4697368421052632,0.5302631578947369
E01015943,1486,750,736,0.5047106325706595,0.4952893674293405
E01015944,1242,595,647,0.47906602254428343,0.5209339774557166
E01015946,1536,757,779,0.4928385416666667,0.5071614583333334
E01015997,1389,673,716,0.4845212383009359,0.515478761699064
E01015999,1387,716,671,0.5162220620043259,0.4837779379956741
E01015945,1214,590,624,0.48599670510708404,0.514003294892916
E01015983,1455,729,726,0.5010309278350515,0.49896907216494846
E01015987,1482,698,784,0.4709851551956815,0.5290148448043185
E01015988,1464,626,838,0.4275956284153005,0.5724043715846995
E01015998,1598,775,823,0.48498122653316644,0.5150187734668336
E01015984,1312,643,669,0.49009146341463417,0.5099085365853658
E01015985,1390,651,739,0.4683453237410072,0.5316546762589928
E01015986,1504,711,793,0.47273936170212766,0.5272606382978723
E01015990,1503,739,764,0.4916833000665336,0.5083166999334664
E01016001,1351,653,698,0.48334566987416727,0.5166543301258327
E01015977,1865,888,977,0.47613941018766753,0.5238605898123324
E01015978,1281,637,644,0.4972677595628415,0.5027322404371585
E01015979,1373,676,697,0.4923525127458121,0.507647487254188
E01015980,1596,785,811,0.4918546365914787,0.5081453634085213
E01015989,1563,783,780,0.5009596928982726,0.4990403071017274
E01015991,1425,703,722,0.49333333333333335,0.5066666666666667
E01015992,1888,948,940,0.5021186440677966,0.4978813559322034
E01016000,1414,689,725,0.4872701555869873,0.5127298444130127
E01016002,1368,674,694,0.4926900584795322,0.5073099415204678
E01015932,1585,787,798,0.4965299684542587,0.5034700315457413
E01015971,1459,708,751,0.4852638793694311,0.5147361206305688
E01015972,1704,866,838,0.5082159624413145,0.49178403755868544
E01015973,1758,857,901,0.48748577929465303,0.512514220705347
E01015974,1421,675,746,0.47501759324419424,0.5249824067558058
E01015975,1559,769,790,0.4932649134060295,0.5067350865939705
E01015927,1857,889,968,0.47872913301023157,0.5212708669897684
E01015928,1747,878,869,0.5025758443045221,0.497424155695478
E01015929,1503,714,789,0.4750499001996008,0.5249500998003992
E01015930,1764,905,859,0.5130385487528345,0.48696145124716556
E01015931,1324,701,623,0.5294561933534743,0.4705438066465257
E01015976,1779,885,894,0.4974704890387858,0.5025295109612141
E01015922,1518,738,780,0.48616600790513836,0.5138339920948617
E01015923,1577,774,803,0.49080532656943565,0.5091946734305643
E01015924,1551,760,791,0.49000644745325594,0.5099935525467441
E01015925,1565,778,787,0.4971246006389776,0.5028753993610223
E01015926,1525,762,763,0.499672131147541,0.5003278688524591
E01015957,1539,760,779,0.49382716049382713,0.5061728395061729
E01015958,1315,677,638,0.5148288973384031,0.48517110266159696
E01015993,1602,773,829,0.48252184769038703,0.517478152309613
E01015994,1556,730,826,0.4691516709511568,0.5308483290488432
E01015995,1671,836,835,0.5002992220227409,0.49970077797725915
E01015996,1631,818,813,0.5015328019619865,0.4984671980380135
E01015963,1189,576,613,0.48444070647603027,0.5155592935239697
E01015964,1555,760,795,0.4887459807073955,0.5112540192926045
E01015965,1446,722,724,0.49930843706777317,0.5006915629322268
E01015966,1580,800,780,0.5063291139240507,0.4936708860759494
E01015933,1551,715,836,0.46099290780141844,0.5390070921985816
E01015934,1496,720,776,0.48128342245989303,0.5187165775401069
E01015935,1604,806,798,0.5024937655860349,0.4975062344139651
E01015936,1697,806,891,0.4749558043606364,0.5250441956393636
E01015937,1633,817,816,0.5003061849357011,0.49969381506429883
E01015938,1884,878,1006,0.46602972399150744,0.5339702760084926
E01015947,1408,696,712,0.4943181818181818,0.5056818181818182
E01015948,1538,761,777,0.49479843953185954,0.5052015604681405
E01015949,1690,808,882,0.47810650887573963,0.5218934911242603
E01015950,1728,842,886,0.48726851851851855,0.5127314814814815
E01015960,1470,736,734,0.5006802721088436,0.4993197278911565
E01015967,1522,754,768,0.49540078843626806,0.5045992115637319
E01015968,1367,661,706,0.48354059985369424,0.5164594001463058
E01015969,1737,839,898,0.4830166954519286,0.5169833045480714
E01015970,1329,687,642,0.5169300225733634,0.48306997742663654
E01015921,1176,606,570,0.5153061224489796,0.4846938775510204
E01016011,1513,786,727,0.5194976867151355,0.48050231328486454
E01016012,2513,1289,1224,0.5129327497015519,0.48706725029844805
E01016013,2202,1129,1073,0.5127157129881925,0.4872842870118074
E01016014,2537,1225,1312,0.4828537642885298,0.5171462357114702
E01016015,1713,880,833,0.5137186223000584,0.4862813776999416
E01015955,1550,774,776,0.4993548387096774,0.5006451612903225
E01015956,2059,1013,1046,0.4919864011656144,0.5080135988343856
E01015959,1667,844,823,0.5062987402519497,0.4937012597480504
E01015961,1502,761,741,0.5066577896138482,0.4933422103861518
E01015962,1657,825,832,0.4978877489438745,0.5021122510561256
E01015951,1681,854,827,0.5080309339678762,0.49196906603212376
E01015952,2045,1046,999,0.5114914425427873,0.4885085574572127
E01015953,2082,1129,953,0.5422670509125841,0.45773294908741596
E01015954,2278,1134,1144,0.4978050921861282,0.5021949078138718
E01016003,1966,956,1010,0.4862665310274669,0.513733468972533
E01016004,1662,759,903,0.4566787003610108,0.5433212996389891
E01016005,1556,765,791,0.4916452442159383,0.5083547557840618
E01016006,1694,801,893,0.47284533648170013,0.5271546635182999
E01016007,1489,750,739,0.503693754197448,0.49630624580255206
E01016008,1524,765,759,0.5019685039370079,0.49803149606299213
E01016009,1707,817,890,0.4786174575278266,0.5213825424721734
E01016010,1457,707,750,0.4852436513383665,0.5147563486616334
E01015982,2566,1301,1265,0.5070148090413095,0.4929851909586906
E01033610,1648,803,845,0.48725728155339804,0.5127427184466019
E01033611,1631,824,807,0.5052115266707541,0.49478847332924586
E01033613,1539,718,821,0.4665367121507472,0.5334632878492528
E01015939,1564,787,777,0.5031969309462916,0.4968030690537084
E01015941,1448,722,726,0.4986187845303867,0.5013812154696132
E01015942,1607,802,805,0.49906658369632856,0.5009334163036714
E01033612,1580,802,778,0.5075949367088608,0.49240506329113926
E01033614,1872,936,936,0.5,0.5
E01017975,1652,824,828,0.49878934624697335,0.5012106537530266
E01017976,1658,890,768,0.5367913148371531,0.4632086851628468
E01017977,1617,824,793,0.5095856524427953,0.4904143475572047
E01017978,1551,773,778,0.498388136686009,0.501611863313991
E01017979,1558,775,783,0.49743260590500643,0.5025673940949936
E01017980,1106,558,548,0.5045207956600362,0.49547920433996384
E01017949,1620,848,772,0.5234567901234568,0.4765432098765432
E01017950,1364,700,664,0.5131964809384164,0.4868035190615836
E01017951,1467,754,713,0.5139740967961827,0.48602590320381733
E01017952,1492,758,734,0.5080428954423593,0.49195710455764075
E01017953,1620,829,791,0.5117283950617284,0.4882716049382716
E01017954,1507,718,789,0.47644326476443266,0.5235567352355673
E01017971,1669,867,802,0.5194727381665668,0.4805272618334332
E01017972,1622,815,807,0.5024660912453761,0.49753390875462394
E01017973,1759,833,926,0.47356452529846504,0.526435474701535
E01017974,1738,889,849,0.5115074798619103,0.48849252013808975
E01032792,1306,675,631,0.5168453292496171,0.4831546707503829
E01032802,1311,652,659,0.4973302822273074,0.5026697177726926
E01018006,1656,826,830,0.49879227053140096,0.501207729468599
E01018007,1612,809,803,0.5018610421836228,0.4981389578163772
E01018008,1641,847,794,0.5161486898232784,0.4838513101767215
E01018009,1935,1020,915,0.5271317829457365,0.4728682170542636
E01018010,1785,922,863,0.5165266106442578,0.4834733893557423
E01017955,1469,709,760,0.48264125255275697,0.517358747447243
E01017956,1651,897,754,0.5433070866141733,0.4566929133858268
E01017957,1522,603,919,0.3961892247043364,0.6038107752956636
E01017958,5143,2956,2187,0.5747618121718842,0.4252381878281159
E01017943,1751,921,830,0.5259851513420902,0.47401484865790977
E01017944,1407,724,683,0.5145700071073206,0.48542999289267946
E01017945,1726,927,799,0.5370799536500579,0.46292004634994205
E01017946,1629,827,802,0.5076734192756293,0.4923265807243708
E01017947,1671,858,813,0.5134649910233393,0.4865350089766607
E01017948,1723,847,876,0.4915844457341846,0.5084155542658154
E01017983,1896,987,909,0.5205696202531646,0.47943037974683544
E01017984,1615,824,791,0.5102167182662539,0.48978328173374613
E01017985,2605,1304,1301,0.5005758157389635,0.49942418426103646
E01017986,3647,1870,1777,0.5127502056484782,0.4872497943515218
E01032797,5254,2948,2306,0.5610963075751808,0.4389036924248192
E01017987,1735,877,858,0.5054755043227666,0.49452449567723344
E01017988,1693,900,793,0.5316007088009451,0.46839929119905493
E01017989,2201,1114,1087,0.506133575647433,0.493866424352567
E01017990,1247,638,609,0.5116279069767442,0.4883720930232558
E01017991,1457,748,709,0.5133836650652025,0.48661633493479756
E01017997,2284,1158,1126,0.5070052539404554,0.4929947460595447
E01017998,1718,849,869,0.49417927823050056,0.5058207217694994
E01017999,1801,895,906,0.4969461410327596,0.5030538589672404
E01018000,1751,909,842,0.519131924614506,0.480868075385494
E01018001,1698,893,805,0.5259128386336867,0.4740871613663133
E01017965,1707,869,838,0.5090802577621558,0.4909197422378442
E01017966,2703,1433,1270,0.5301516833148354,0.46984831668516464
E01017967,1764,888,876,0.5034013605442177,0.4965986394557823
E01017968,1589,794,795,0.49968533668974197,0.500314663310258
E01017969,1623,786,837,0.48428835489833644,0.5157116451016636
E01017959,1693,860,833,0.5079740106320142,0.4920259893679858
E01017960,1334,610,724,0.4572713643178411,0.5427286356821589
E01017961,1199,562,637,0.46872393661384487,0.5312760633861552
E01017962,1625,811,814,0.4990769230769231,0.5009230769230769
E01017963,1593,779,814,0.48901443816698054,0.5109855618330195
E01017964,1336,671,665,0.5022455089820359,0.4977544910179641
E01018002,1579,781,798,0.49461684610512985,0.5053831538948702
E01018003,1574,774,800,0.49174078780177893,0.5082592121982211
E01018005,2037,1012,1025,0.49680903289150713,0.5031909671084929
E01032794,1276,654,622,0.512539184952978,0.48746081504702193
E01032795,1568,758,810,0.48341836734693877,0.5165816326530612
E01017992,1898,905,993,0.4768177028451001,0.5231822971549
E01017993,2118,948,1170,0.4475920679886686,0.5524079320113314
E01017994,1652,807,845,0.48849878934624696,0.511501210653753
E01017995,1476,712,764,0.4823848238482385,0.5176151761517616
E01017996,1983,981,1002,0.4947049924357035,0.5052950075642966
E01018042,1455,685,770,0.47079037800687284,0.5292096219931272
E01018043,2121,1051,1070,0.4955209806694955,0.5044790193305044
E01018044,1715,895,820,0.521865889212828,0.478134110787172
E01018045,1347,682,665,0.5063103192279139,0.49368968077208614
E01018046,2100,1016,1084,0.4838095238095238,0.5161904761904762
E01018020,1505,747,758,0.4963455149501661,0.5036544850498339
E01018021,1508,726,782,0.48143236074270557,0.5185676392572944
E01018022,1411,724,687,0.513111268603827,0.48688873139617295
E01018055,2042,1028,1014,0.5034280117531832,0.49657198824681686
E01018056,1910,915,995,0.4790575916230366,0.5209424083769634
E01018027,1752,846,906,0.4828767123287671,0.5171232876712328
E01018029,2542,1261,1281,0.496066089693155,0.503933910306845
E01018032,2523,1226,1297,0.48592944906856916,0.5140705509314308
E01018033,1932,914,1018,0.4730848861283644,0.5269151138716356
E01033426,1510,768,742,0.5086092715231788,0.4913907284768212
E01033430,1514,739,775,0.48811096433289297,0.511889035667107
E01018024,1094,548,546,0.5009140767824497,0.4990859232175503
E01018025,1545,775,770,0.5016181229773463,0.49838187702265374
E01018026,1391,668,723,0.4802300503235083,0.5197699496764917
E01018030,1036,492,544,0.4749034749034749,0.525096525096525
E01033425,1983,988,995,0.4982349974785678,0.5017650025214322
E01033428,1434,717,717,0.5,0.5
E01018036,1643,830,813,0.505173463177115,0.49482653682288497
E01018037,1393,713,680,0.5118449389806173,0.4881550610193826
E01018038,1570,768,802,0.489171974522293,0.510828025477707
E01018039,1323,662,661,0.5003779289493575,0.4996220710506425
E01018053,1707,859,848,0.5032220269478618,0.4967779730521383
E01018054,2264,1143,1121,0.5048586572438163,0.49514134275618377
E01018047,1907,934,973,0.4897745149449397,0.5102254850550603
E01018049,1663,833,830,0.5009019843656043,0.49909801563439565
E01018050,1395,691,704,0.4953405017921147,0.5046594982078854
E01018051,1693,831,862,0.4908446544595393,0.5091553455404607
E01018052,1778,908,870,0.5106861642294713,0.48931383577052867
E01033427,1332,684,648,0.5135135135135135,0.4864864864864865
E01033429,1931,994,937,0.5147591921284309,0.48524080787156915
E01018034,1564,790,774,0.5051150895140665,0.4948849104859335
E01018035,2204,1063,1141,0.4823049001814882,0.5176950998185118
E01018040,1264,631,633,0.49920886075949367,0.5007911392405063
E01018041,1114,552,562,0.4955116696588869,0.5044883303411131
E01018013,1748,827,921,0.4731121281464531,0.5268878718535469
E01018014,1807,885,922,0.48976203652462647,0.5102379634753735
E01018015,1339,660,679,0.49290515309932786,0.5070948469006722
E01018016,1415,712,703,0.5031802120141343,0.49681978798586574
E01018011,2615,1264,1351,0.48336520076481837,0.5166347992351816
E01018012,1399,669,730,0.4781987133666905,0.5218012866333095
E01018057,2025,974,1051,0.48098765432098767,0.5190123456790123
E01018017,1263,622,641,0.4924782264449723,0.5075217735550277
E01018019,1036,506,530,0.48841698841698844,0.5115830115830116
E01018023,2253,1128,1125,0.5006657789613849,0.4993342210386152
E01032611,1803,899,904,0.4986134220743206,0.5013865779256794
E01018094,1763,848,915,0.48099829835507657,0.5190017016449234
E01018095,1555,760,795,0.4887459807073955,0.5112540192926045
E01018096,1576,794,782,0.5038071065989848,0.49619289340101524
E01018097,1411,712,699,0.5046066619418852,0.4953933380581148
E01018063,2331,1163,1168,0.49892749892749894,0.5010725010725011
E01018073,2300,1125,1175,0.4891304347826087,0.5108695652173914
E01018107,1680,815,865,0.4851190476190476,0.5148809523809523
E01018108,2000,999,1001,0.4995,0.5005
E01018109,1862,905,957,0.48603651987110635,0.5139634801288937
E01018069,1763,863,900,0.4895065229722065,0.5104934770277936
E01018070,1701,826,875,0.48559670781893005,0.51440329218107
E01018071,1844,846,998,0.45878524945770066,0.5412147505422994
E01018093,2371,1155,1216,0.48713622943905527,0.5128637705609448
E01018103,1182,587,595,0.4966159052453469,0.5033840947546532
E01018104,1222,620,602,0.5073649754500819,0.49263502454991814
E01033111,1421,691,730,0.48627726952850103,0.513722730471499
E01033112,1164,590,574,0.506872852233677,0.49312714776632305
E01018066,1449,684,765,0.4720496894409938,0.5279503105590062
E01018067,1812,894,918,0.49337748344370863,0.5066225165562914
E01018068,1534,776,758,0.5058670143415906,0.4941329856584094
E01018090,1768,845,923,0.47794117647058826,0.5220588235294118
E01018091,1423,728,695,0.5115952213633169,0.4884047786366831
E01018092,1704,839,865,0.4923708920187793,0.5076291079812206
E01018081,1918,1178,740,0.6141814389989573,0.3858185610010427
E01018082,1931,945,986,0.4893837389953392,0.5106162610046608
E01018083,1950,962,988,0.49333333333333335,0.5066666666666667
E01018084,2036,994,1042,0.48821218074656186,0.5117878192534381
E01018064,2002,970,1032,0.48451548451548454,0.5154845154845155
E01018072,1697,817,880,0.48143783146729524,0.5185621685327048
E01018074,1221,582,639,0.47665847665847666,0.5233415233415234
E01018075,1239,578,661,0.4665052461662631,0.5334947538337369
E01018098,1241,595,646,0.4794520547945205,0.5205479452054794
E01018099,1265,622,643,0.491699604743083,0.508300395256917
E01018100,1199,591,608,0.49291075896580483,0.5070892410341952
E01018101,1333,641,692,0.4808702175543886,0.5191297824456114
E01018077,1759,890,869,0.5059693007390563,0.49403069926094373
E01018078,1640,756,884,0.4609756097560976,0.5390243902439025
E01018079,1712,797,915,0.4655373831775701,0.5344626168224299
E01018080,2319,1138,1181,0.49072876239758517,0.5092712376024149
E01018058,1548,740,808,0.4780361757105943,0.5219638242894057
E01018059,1332,670,662,0.503003003003003,0.496996996996997
E01018060,1846,937,909,0.5075839653304443,0.4924160346695558
E01018061,1272,636,636,0.5,0.5
E01018085,1717,810,907,0.47175305765870706,0.528246942341293
E01018086,1707,832,875,0.4874048037492677,0.5125951962507322
E01018087,2038,976,1062,0.478900883218842,0.521099116781158
E01018088,1571,748,823,0.4761298535964354,0.5238701464035647
E01018065,2181,1072,1109,0.4915176524530032,0.5084823475469968
E01018076,2088,1009,1079,0.48323754789272033,0.5167624521072797
E01018111,2211,1097,1114,0.49615558570782453,0.5038444142921755
E01018062,2512,1198,1314,0.4769108280254777,0.5230891719745223
E01018102,2577,1281,1296,0.4970896391152503,0.5029103608847497
E01018105,1155,580,575,0.5021645021645021,0.49783549783549785
E01018106,1551,770,781,0.49645390070921985,0.5035460992907801
E01018110,2658,1334,1324,0.5018811136192626,0.49811888638073737
E01018212,1672,819,853,0.48983253588516745,0.5101674641148325
E01018213,1895,934,961,0.49287598944591027,0.5071240105540897
E01018214,1973,956,1017,0.4845413076533198,0.5154586923466802
E01018215,1398,677,721,0.4842632331902718,0.5157367668097281
E01018216,2461,1214,1247,0.49329540837058106,0.5067045916294189
E01018217,1642,800,842,0.48721071863581,0.51278928136419
E01018127,1515,750,765,0.49504950495049505,0.504950495049505
E01018128,1152,554,598,0.4809027777777778,0.5190972222222222
E01018200,1648,819,829,0.4969660194174757,0.5030339805825242
E01018201,1443,721,722,0.49965349965349964,0.5003465003465003
E01018156,1680,814,866,0.4845238095238095,0.5154761904761904
E01018157,2043,1039,1004,0.508565834557024,0.491434165442976
E01018158,1680,832,848,0.49523809523809526,0.5047619047619047
E01018159,1408,711,697,0.5049715909090909,0.4950284090909091
E01018160,1668,835,833,0.500599520383693,0.49940047961630696
E01018191,1195,597,598,0.499581589958159,0.500418410041841
E01018192,1444,739,705,0.5117728531855956,0.48822714681440443
E01018193,1188,589,599,0.4957912457912458,0.5042087542087542
E01018194,1410,707,703,0.5014184397163121,0.49858156028368794
E01018195,1299,614,685,0.472671285604311,0.527328714395689
E01018208,1634,811,823,0.496328029375765,0.503671970624235
E01018209,1480,757,723,0.5114864864864865,0.4885135135135135
E01018210,1402,672,730,0.4793152639087018,0.5206847360912982
E01018211,1838,900,938,0.4896626768226333,0.5103373231773667
E01018196,1260,629,631,0.4992063492063492,0.5007936507936508
E01018197,1500,734,766,0.48933333333333334,0.5106666666666667
E01018198,1659,837,822,0.5045207956600362,0.49547920433996384
E01018199,1516,761,755,0.5019788918205804,0.4980211081794195
E01018206,1910,938,972,0.49109947643979057,0.5089005235602094
E01018207,1530,763,767,0.49869281045751634,0.5013071895424837
E01018121,1361,683,678,0.5018368846436444,0.4981631153563556
E01018122,1156,580,576,0.5017301038062284,0.4982698961937716
E01018123,1606,829,777,0.5161892901618929,0.4838107098381071
E01018124,2003,1003,1000,0.5007488766849726,0.49925112331502747
E01018143,1651,783,868,0.4742580254391278,0.5257419745608722
E01018144,1497,736,761,0.4916499665998664,0.5083500334001336
E01018145,1323,656,667,0.4958427815570673,0.5041572184429327
E01018146,2170,1074,1096,0.4949308755760369,0.5050691244239631
E01018147,1736,888,848,0.511520737327189,0.48847926267281105
E01018139,1546,747,799,0.4831824062095731,0.5168175937904269
E01018140,1283,653,630,0.5089633671083398,0.49103663289166016
E01018141,1604,764,840,0.4763092269326683,0.5236907730673317
E01018142,1524,738,786,0.484251968503937,0.515748031496063
E01018113,1487,737,750,0.49562878278412914,0.5043712172158709
E01018116,1277,673,604,0.5270164447924823,0.4729835552075176
E01018117,1625,784,841,0.48246153846153844,0.5175384615384615
E01018118,1960,946,1014,0.4826530612244898,0.5173469387755102
E01033433,2222,1133,1089,0.5099009900990099,0.4900990099009901
E01018161,1381,669,712,0.4844315713251267,0.5155684286748733
E01018162,1616,790,826,0.48886138613861385,0.5111386138613861
E01018163,1434,700,734,0.4881450488145049,0.5118549511854951
E01018164,1281,635,646,0.4957064793130367,0.5042935206869633
E01018165,1287,638,649,0.49572649572649574,0.5042735042735043
E01018170,1399,688,711,0.49177984274481773,0.5082201572551823
E01018171,1471,739,732,0.5023793337865398,0.49762066621346024
E01018138,1924,982,942,0.5103950103950103,0.4896049896049896
E01018148,2504,1231,1273,0.49161341853035145,0.5083865814696485
E01018149,1479,739,740,0.49966193373901285,0.5003380662609872
E01018150,1724,838,886,0.48607888631090485,0.5139211136890951
E01018151,1767,892,875,0.5048104131295982,0.4951895868704018
E01018166,1556,790,766,0.5077120822622108,0.4922879177377892
E01018167,1465,738,727,0.5037542662116041,0.4962457337883959
E01018168,1925,960,965,0.4987012987012987,0.5012987012987012
E01018169,1569,757,812,0.4824729126832377,0.5175270873167622
E01018131,1553,772,781,0.4971023824855119,0.5028976175144881
E01018132,1632,800,832,0.49019607843137253,0.5098039215686274
E01018133,1676,822,854,0.4904534606205251,0.5095465393794749
E01018134,1850,881,969,0.47621621621621624,0.5237837837837838
E01018125,1566,772,794,0.4929757343550447,0.5070242656449553
E01018126,1609,808,801,0.5021752641392169,0.4978247358607831
E01018152,1506,758,748,0.5033200531208499,0.49667994687915007
E01018153,1847,900,947,0.48727666486193827,0.5127233351380617
E01018129,1541,764,777,0.49578195976638545,0.5042180402336145
E01018130,1701,803,898,0.4720752498530276,0.5279247501469724
E01018202,1443,694,749,0.48094248094248093,0.5190575190575191
E01018203,1384,676,708,0.4884393063583815,0.5115606936416185
E01018204,1392,681,711,0.4892241379310345,0.5107758620689655
E01018205,1817,908,909,0.49972482113373695,0.500275178866263
E01018115,2426,1791,635,0.738252267106348,0.2617477328936521
E01018119,1504,758,746,0.5039893617021277,0.49601063829787234
E01018120,1789,835,954,0.46674119619899385,0.5332588038010061
E01018137,1714,857,857,0.5,0.5
E01018135,2942,1428,1514,0.48538409245411285,0.5146159075458872
E01018136,1748,873,875,0.4994279176201373,0.5005720823798627
E01018154,1756,865,891,0.49259681093394075,0.5074031890660592
E01018155,1488,743,745,0.4993279569892473,0.5006720430107527
E01018187,1924,958,966,0.4979209979209979,0.502079002079002
E01018188,1470,714,756,0.4857142857142857,0.5142857142857142
E01018189,1322,646,676,0.4886535552193646,0.5113464447806354
E01018190,1556,780,776,0.5012853470437018,0.4987146529562982
E01018172,1405,658,747,0.46832740213523133,0.5316725978647687
E01018173,1183,589,594,0.4978867286559594,0.5021132713440406
E01018174,1572,805,767,0.5120865139949109,0.48791348600508905
E01018175,1382,708,674,0.5123010130246021,0.487698986975398
E01018176,1273,647,626,0.5082482325216026,0.4917517674783975
E01018181,2762,1383,1379,0.500724112961622,0.499275887038378
E01018182,1489,786,703,0.5278710543989255,0.47212894560107455
E01018183,1476,720,756,0.4878048780487805,0.5121951219512195
E01018184,1345,680,665,0.5055762081784386,0.4944237918215613
E01018185,1650,818,832,0.49575757575757573,0.5042424242424243
E01018186,1755,876,879,0.49914529914529915,0.5008547008547009
E01018177,1502,777,725,0.5173102529960053,0.4826897470039947
E01018178,1475,719,756,0.48745762711864404,0.512542372881356
E01018179,1407,705,702,0.5010660980810234,0.4989339019189765
E01018180,1320,658,662,0.4984848484848485,0.5015151515151515
E01018304,1848,891,957,0.48214285714285715,0.5178571428571429
E01018305,1332,654,678,0.49099099099099097,0.509009009009009
E01018306,1530,757,773,0.4947712418300654,0.5052287581699346
E01018307,2167,1100,1067,0.5076142131979695,0.49238578680203043
E01018233,1575,779,796,0.4946031746031746,0.5053968253968254
E01018234,1672,818,854,0.4892344497607656,0.5107655502392344
E01018235,1684,816,868,0.4845605700712589,0.5154394299287411
E01018236,1612,768,844,0.47642679900744417,0.5235732009925558
E01018237,1527,765,762,0.5009823182711198,0.49901768172888017
E01018266,2657,1337,1320,0.5031990967256305,0.4968009032743696
E01018284,1264,650,614,0.5142405063291139,0.48575949367088606
E01018285,1199,595,604,0.4962468723936614,0.5037531276063386
E01018298,1821,1116,705,0.6128500823723229,0.3871499176276771
E01018299,1654,829,825,0.5012091898428053,0.4987908101571947
E01018300,1162,597,565,0.5137693631669535,0.48623063683304646
E01018301,1377,687,690,0.4989106753812636,0.5010893246187363
E01018221,1659,827,832,0.4984930681133213,0.5015069318866787
E01018222,1509,767,742,0.508283631544069,0.4917163684559311
E01018223,1880,925,955,0.4920212765957447,0.5079787234042553
E01018257,1363,630,733,0.46221570066030815,0.5377842993396919
E01018258,1626,803,823,0.49384993849938497,0.506150061500615
E01018259,1325,680,645,0.5132075471698113,0.4867924528301887
E01018260,1780,838,942,0.4707865168539326,0.5292134831460674
E01018262,1459,728,731,0.498971898560658,0.5010281014393421
E01033120,1459,712,747,0.4880054832076765,0.5119945167923236
E01033121,1588,826,762,0.5201511335012594,0.47984886649874053
E01018272,1332,668,664,0.5015015015015015,0.4984984984984985
E01018273,1607,791,816,0.492221530802738,0.507778469197262
E01018274,1740,895,845,0.514367816091954,0.48563218390804597
E01018297,1682,841,841,0.5,0.5
E01018224,1428,719,709,0.5035014005602241,0.4964985994397759
E01018225,1078,494,584,0.4582560296846011,0.5417439703153989
E01018248,2338,1201,1137,0.5136869118905047,0.4863130881094953
E01018249,1007,491,516,0.48758689175769615,0.5124131082423039
E01018250,1214,574,640,0.4728171334431631,0.5271828665568369
E01018231,2478,1240,1238,0.5004035512510089,0.4995964487489911
E01018232,2346,1126,1220,0.4799658994032396,0.5200341005967605
E01018251,1220,619,601,0.5073770491803279,0.4926229508196721
E01018252,1450,693,757,0.47793103448275864,0.5220689655172414
E01018255,1149,559,590,0.4865100087032202,0.5134899912967799
E01018242,1280,607,673,0.47421875,0.52578125
E01018243,1765,860,905,0.48725212464589235,0.5127478753541076
E01018244,1628,807,821,0.4957002457002457,0.5042997542997543
E01018286,1612,820,792,0.5086848635235732,0.4913151364764268
E01018287,1331,670,661,0.5033809166040571,0.4966190833959429
E01018296,1079,556,523,0.5152919369786839,0.484708063021316
E01018292,1408,703,705,0.4992897727272727,0.5007102272727273
E01018293,1481,717,764,0.4841323430114787,0.5158676569885212
E01018294,1646,786,860,0.4775212636695018,0.5224787363304981
E01018295,1569,776,793,0.4945825366475462,0.5054174633524537
E01018245,1700,858,842,0.5047058823529412,0.49529411764705883
E01018246,1628,783,845,0.480958230958231,0.519041769041769
E01018247,1572,799,773,0.5082697201017812,0.4917302798982188
E01018275,2329,1112,1217,0.47745813653928726,0.5225418634607127
E01018240,1232,617,615,0.5008116883116883,0.4991883116883117
E01018253,1080,545,535,0.5046296296296297,0.49537037037037035
E01018254,1322,656,666,0.4962178517397882,0.5037821482602118
E01018256,1507,758,749,0.5029860650298607,0.49701393497013935
E01018291,1218,600,618,0.49261083743842365,0.5073891625615764
E01018279,1492,701,791,0.4698391420911528,0.5301608579088471
E01018280,1506,775,731,0.5146082337317397,0.4853917662682603
E01018281,1564,780,784,0.49872122762148335,0.5012787723785166
E01018282,1309,655,654,0.5003819709702063,0.49961802902979374
E01018283,1274,620,654,0.48665620094191525,0.5133437990580848
E01018218,1770,895,875,0.5056497175141242,0.4943502824858757
E01018219,1405,680,725,0.48398576512455516,0.5160142348754448
E01018220,1507,740,767,0.49104180491041804,0.508958195089582
E01018263,1478,731,747,0.4945872801082544,0.5054127198917456
E01018264,1606,767,839,0.4775840597758406,0.5224159402241594
E01018265,1762,843,919,0.4784335981838819,0.521566401816118
E01018238,1455,729,726,0.5010309278350515,0.49896907216494846
E01018239,1353,641,712,0.4737620103473762,0.5262379896526238
E01018288,1155,560,595,0.48484848484848486,0.5151515151515151
E01018289,1153,552,601,0.4787510841283608,0.5212489158716392
E01018302,1499,761,738,0.5076717811874583,0.4923282188125417
E01018303,1201,618,583,0.514571190674438,0.48542880932556204
E01018241,1206,605,601,0.5016583747927031,0.49834162520729686
E01018267,2328,1134,1194,0.48711340206185566,0.5128865979381443
E01018268,1905,932,973,0.48923884514435695,0.510761154855643
E01018269,1377,663,714,0.48148148148148145,0.5185185185185185
E01018270,1120,561,559,0.5008928571428571,0.49910714285714286
E01018271,1431,682,749,0.47658979734451434,0.5234102026554857
E01018226,1525,850,675,0.5573770491803278,0.4426229508196721
E01018227,1896,914,982,0.4820675105485232,0.5179324894514767
E01018228,1667,818,849,0.4907018596280744,0.5092981403719257
E01018290,2404,1188,1216,0.49417637271214643,0.5058236272878536
E01033113,1120,537,583,0.47946428571428573,0.5205357142857143
E01033114,1539,784,755,0.5094217024041585,0.49057829759584143
E01033115,1407,691,716,0.49111584932480457,0.5088841506751954
E01033117,1314,668,646,0.5083713850837138,0.4916286149162861
E01033119,1805,902,903,0.4997229916897507,0.5002770083102493
E01018276,1431,692,739,0.4835779175401817,0.5164220824598184
E01018277,1719,860,859,0.5002908667830134,0.4997091332169866
E01018278,1738,850,888,0.4890678941311853,0.5109321058688148
E01033116,1686,831,855,0.4928825622775801,0.5071174377224199
E01033118,1463,744,719,0.508544087491456,0.4914559125085441
E01021237,1384,681,703,0.4920520231213873,0.5079479768786127
E01021238,1387,688,699,0.4960346070656092,0.5039653929343908
E01021242,1227,613,614,0.49959250203748984,0.5004074979625102
E01021250,1548,764,784,0.4935400516795866,0.5064599483204134
E01021251,1587,782,805,0.4927536231884058,0.5072463768115942
E01021245,1449,684,765,0.4720496894409938,0.5279503105590062
E01021246,1478,707,771,0.4783491204330176,0.5216508795669824
E01021248,1433,713,720,0.4975575715282624,0.5024424284717376
E01021249,1559,763,796,0.4894162924951892,0.5105837075048107
E01021252,1428,687,741,0.4810924369747899,0.5189075630252101
E01021239,1443,718,725,0.49757449757449757,0.5024255024255024
E01021240,1628,798,830,0.49017199017199015,0.5098280098280098
E01021241,1573,730,843,0.46408137317228226,0.5359186268277177
E01021243,1689,861,828,0.5097690941385435,0.49023090586145646
E01021247,1482,733,749,0.49460188933873145,0.5053981106612686
E01021244,1446,702,744,0.4854771784232365,0.5145228215767634
E01021253,1699,844,855,0.4967628016480283,0.5032371983519718
E01021255,1363,651,712,0.4776228906823184,0.5223771093176816
E01021256,1465,710,755,0.48464163822525597,0.515358361774744
E01021258,1589,734,855,0.4619257394587791,0.5380742605412209
E01021334,1704,811,893,0.47593896713615025,0.5240610328638498
E01021336,1628,769,859,0.47235872235872234,0.5276412776412777
E01021338,1455,705,750,0.4845360824742268,0.5154639175257731
E01021339,1389,672,717,0.4838012958963283,0.5161987041036717
E01021264,1448,745,703,0.5145027624309392,0.48549723756906077
E01021329,1494,708,786,0.4738955823293173,0.5261044176706827
E01021330,1589,770,819,0.4845814977973568,0.5154185022026432
E01021332,1429,696,733,0.48705388383484954,0.5129461161651504
E01021333,1553,740,813,0.4764971023824855,0.5235028976175145
E01021335,1428,721,707,0.5049019607843137,0.4950980392156863
E01021337,1410,694,716,0.4921985815602837,0.5078014184397163
E01021340,1610,784,826,0.48695652173913045,0.5130434782608696
E01021341,1611,798,813,0.49534450651769085,0.5046554934823091
E01021345,2003,980,1023,0.4892661008487269,0.5107338991512731
E01021331,1537,755,782,0.49121665582303187,0.5087833441769681
E01021342,1602,755,847,0.4712858926342072,0.5287141073657927
E01021343,1760,844,916,0.47954545454545455,0.5204545454545455
E01021344,2213,1109,1104,0.5011296882060551,0.49887031179394487
E01021346,1959,985,974,0.5028075548749362,0.49719244512506383
E01021254,1457,745,712,0.511324639670556,0.4886753603294441
E01021257,1517,729,788,0.48055372445616346,0.5194462755438365
E01021259,1530,744,786,0.48627450980392156,0.5137254901960784
E01021260,2388,1135,1253,0.4752931323283082,0.5247068676716918
E01021261,1705,844,861,0.4950146627565982,0.5049853372434018
E01021262,1563,760,803,0.48624440179142675,0.5137555982085733
E01021263,1839,895,944,0.4866775421424687,0.5133224578575313
E01021274,1867,878,989,0.4702731655061596,0.5297268344938404
E01021279,1637,788,849,0.4813683567501527,0.5186316432498472
E01021301,1518,717,801,0.4723320158102767,0.5276679841897233
E01021303,1328,660,668,0.49698795180722893,0.5030120481927711
E01021307,1334,651,683,0.48800599700149927,0.5119940029985007
E01021308,1286,640,646,0.4976671850699845,0.5023328149300156
E01021309,1321,663,658,0.5018925056775171,0.49810749432248297
E01021312,1598,797,801,0.49874843554443055,0.5012515644555695
E01021265,1550,707,843,0.4561290322580645,0.5438709677419354
E01021267,1716,843,873,0.49125874125874125,0.5087412587412588
E01021269,1665,776,889,0.46606606606606604,0.533933933933934
E01021270,1502,756,746,0.5033288948069241,0.4966711051930759
E01021272,1603,729,874,0.45477230193387397,0.545227698066126
E01021271,1765,852,913,0.4827195467422096,0.5172804532577904
E01021302,1548,766,782,0.49483204134366926,0.5051679586563308
E01021304,1452,702,750,0.4834710743801653,0.5165289256198347
E01021305,1465,696,769,0.4750853242320819,0.5249146757679181
E01021306,1470,716,754,0.48707482993197276,0.5129251700680272
E01021273,1683,816,867,0.48484848484848486,0.5151515151515151
E01021275,1649,801,848,0.48574893875075803,0.5142510612492419
E01021276,1446,698,748,0.4827109266943292,0.5172890733056709
E01021277,1416,688,728,0.4858757062146893,0.5141242937853108
E01021278,1669,802,867,0.4805272618334332,0.5194727381665668
E01021266,1658,765,893,0.46139927623642946,0.5386007237635706
E01021268,1659,681,978,0.4104882459312839,0.5895117540687161
E01021318,2043,1007,1036,0.49290259422418015,0.5070974057758199
E01021320,1651,794,857,0.4809206541490006,0.5190793458509994
E01021321,1610,733,877,0.45527950310559007,0.5447204968944099
E01021286,1734,843,891,0.486159169550173,0.513840830449827
E01021288,1811,801,1010,0.44229707344008834,0.5577029265599116
E01021289,1792,850,942,0.47433035714285715,0.5256696428571429
E01021290,1775,809,966,0.45577464788732397,0.5442253521126761
E01021291,1667,830,837,0.4979004199160168,0.5020995800839833
E01021287,1506,753,753,0.5,0.5
E01021292,1518,744,774,0.4901185770750988,0.5098814229249012
E01021293,1685,800,885,0.47477744807121663,0.5252225519287834
E01021298,1588,747,841,0.4704030226700252,0.5295969773299748
E01021319,1583,733,850,0.46304485154769426,0.5369551484523057
E01021313,1467,737,730,0.5023858214042263,0.49761417859577367
E01021314,1373,660,713,0.4806991988346686,0.5193008011653314
E01021315,1499,710,789,0.47364909939959976,0.5263509006004002
E01021316,1491,695,796,0.466130114017438,0.533869885982562
E01021317,1625,826,799,0.5083076923076923,0.4916923076923077
E01021322,1523,769,754,0.504924491135916,0.495075508864084
E01021323,1760,839,921,0.47670454545454544,0.5232954545454546
E01021324,1651,792,859,0.47970926711084194,0.5202907328891581
E01021325,1565,758,807,0.48434504792332267,0.5156549520766773
E01021327,1688,819,869,0.48518957345971564,0.5148104265402843
E01021294,1616,786,830,0.4863861386138614,0.5136138613861386
E01021295,1685,826,859,0.4902077151335312,0.5097922848664689
E01021296,1720,853,867,0.49593023255813956,0.5040697674418605
E01021297,1638,808,830,0.4932844932844933,0.5067155067155067
E01021299,1512,743,769,0.4914021164021164,0.5085978835978836
E01021280,1527,740,787,0.48461034708578915,0.5153896529142109
E01021281,1494,721,773,0.4825970548862115,0.5174029451137885
E01021282,1527,750,777,0.4911591355599214,0.5088408644400786
E01021283,1581,793,788,0.5015812776723593,0.49841872232764073
E01021284,1580,773,807,0.4892405063291139,0.510759493670886
E01021285,1355,683,672,0.5040590405904058,0.4959409594095941
E01021300,2107,1021,1086,0.4845752254390128,0.5154247745609872
E01021310,1334,721,613,0.54047976011994,0.45952023988005997
E01021311,1349,684,665,0.5070422535211268,0.49295774647887325
E01021326,1818,886,932,0.48734873487348734,0.5126512651265126
E01021328,1566,764,802,0.4878671775223499,0.51213282247765
E01021375,1152,559,593,0.4852430555555556,0.5147569444444444
E01021376,1406,693,713,0.49288762446657186,0.5071123755334281
E01021414,2145,1060,1085,0.49417249417249415,0.5058275058275058
E01021430,2175,1102,1073,0.5066666666666667,0.49333333333333335
E01021398,1493,751,742,0.5030140656396517,0.49698593436034827
E01021406,2166,1087,1079,0.5018467220683287,0.4981532779316713
E01021407,2180,1098,1082,0.5036697247706422,0.4963302752293578
E01021382,1292,622,670,0.48142414860681115,0.5185758513931888
E01021397,1764,866,898,0.4909297052154195,0.5090702947845805
E01021399,1606,776,830,0.48318804483188044,0.5168119551681195
E01021400,1687,855,832,0.5068168346176645,0.49318316538233553
E01021387,1968,949,1019,0.48221544715447157,0.5177845528455285
E01021388,1623,784,839,0.48305606900800985,0.5169439309919901
E01021391,1712,817,895,0.4772196261682243,0.5227803738317757
E01021392,1671,792,879,0.473967684021544,0.526032315978456
E01021393,1509,772,737,0.5115970841616965,0.48840291583830353
E01021404,2063,1031,1032,0.4997576345128454,0.5002423654871546
E01021411,1227,591,636,0.48166259168704156,0.5183374083129584
E01021412,1471,740,731,0.5030591434398368,0.4969408565601632
E01021413,1269,636,633,0.5011820330969267,0.4988179669030733
E01021389,1826,945,881,0.5175246440306681,0.4824753559693319
E01021390,1597,736,861,0.46086412022542267,0.5391358797745773
E01021408,1778,862,916,0.484814398200225,0.515185601799775
E01021409,1806,869,937,0.48117386489479513,0.5188261351052049
E01021410,1657,790,867,0.4767652383826192,0.5232347616173808
E01021349,1424,712,712,0.5,0.5
E01021351,1584,790,794,0.49873737373737376,0.5012626262626263
E01021352,1677,796,881,0.47465712581991654,0.5253428741800835
E01021355,2010,947,1063,0.4711442786069652,0.5288557213930348
E01021356,1423,694,729,0.4877020379479972,0.5122979620520028
E01021381,1173,595,578,0.5072463768115942,0.4927536231884058
E01021354,1295,648,647,0.5003861003861004,0.4996138996138996
E01021357,1514,723,791,0.4775429326287979,0.5224570673712021
E01021358,2230,1064,1166,0.47713004484304933,0.5228699551569507
E01021359,2052,961,1091,0.46832358674463936,0.5316764132553606
E01021350,1719,859,860,0.4997091332169866,0.5002908667830134
E01021353,1779,891,888,0.5008431703204047,0.4991568296795953
E01021365,2291,1148,1143,0.5010912265386294,0.4989087734613706
E01033458,1313,654,659,0.49809596344249807,0.5019040365575019
E01033459,1819,910,909,0.5002748763056625,0.4997251236943375
E01021364,1642,799,843,0.4866017052375152,0.5133982947624848
E01021366,1557,767,790,0.49261400128452154,0.5073859987154785
E01021383,2136,1028,1108,0.4812734082397004,0.5187265917602997
E01021405,2299,1124,1175,0.48890822096563724,0.5110917790343628
E01021368,1523,778,745,0.5108338804990151,0.4891661195009849
E01021370,1639,787,852,0.4801708358755339,0.5198291641244661
E01021372,1825,944,881,0.5172602739726028,0.4827397260273973
E01021373,2391,1177,1214,0.49226265161020494,0.5077373483897951
E01021374,1535,729,806,0.4749185667752443,0.5250814332247556
E01021360,2001,982,1019,0.49075462268865566,0.5092453773113443
E01021361,1624,805,819,0.4956896551724138,0.5043103448275862
E01021367,1508,716,792,0.47480106100795755,0.5251989389920424
E01021369,2887,1413,1474,0.48943540006927605,0.5105645999307239
E01021380,2311,1159,1152,0.5015144958892255,0.4984855041107746
E01021347,2478,1238,1240,0.4995964487489911,0.5004035512510089
E01021371,1726,823,903,0.4768250289687138,0.5231749710312862
E01021384,2334,1129,1205,0.4837189374464439,0.5162810625535561
E01021385,1331,622,709,0.4673178061607814,0.5326821938392187
E01021386,1650,792,858,0.48,0.52
E01021377,1756,855,901,0.4869020501138952,0.5130979498861048
E01021378,1610,739,871,0.45900621118012425,0.5409937888198758
E01021379,1835,911,924,0.49645776566757494,0.5035422343324251
E01021401,1509,760,749,0.5036447978793903,0.4963552021206097
E01021402,2078,1034,1044,0.49759384023099135,0.5024061597690087
E01021403,1561,794,767,0.5086483023702755,0.4913516976297245
E01021362,1487,772,715,0.5191661062542031,0.4808338937457969
E01021417,1506,720,786,0.47808764940239046,0.5219123505976095
E01021418,1491,727,764,0.4875922199865862,0.5124077800134138
E01021419,1661,812,849,0.48886213124623723,0.5111378687537628
E01021426,1307,627,680,0.4797245600612089,0.5202754399387911
E01021428,1403,691,712,0.4925160370634355,0.5074839629365645
E01021423,1570,761,809,0.48471337579617835,0.5152866242038217
E01021425,1537,746,791,0.4853610930383865,0.5146389069616135
E01021427,1369,689,680,0.5032870708546384,0.4967129291453616
E01021429,1344,668,676,0.49702380952380953,0.5029761904761905
E01021415,1459,652,807,0.4468814256339959,0.5531185743660041
E01021416,1601,774,827,0.4834478450968145,0.5165521549031855
E01021420,1657,824,833,0.49728424864212434,0.5027157513578757
E01021422,1634,766,868,0.46878824969400246,0.5312117503059975
E01033460,1216,610,606,0.5016447368421053,0.49835526315789475
E01033461,1502,766,736,0.5099866844207723,0.49001331557922767
E01033462,1066,542,524,0.5084427767354597,0.4915572232645403
E01021348,1576,783,793,0.49682741116751267,0.5031725888324873
E01021394,1444,711,733,0.49238227146814406,0.5076177285318559
E01021395,1470,712,758,0.48435374149659866,0.5156462585034014
E01021396,1462,715,747,0.4890560875512996,0.5109439124487004
E01021424,2030,989,1041,0.48719211822660097,0.512807881773399
E01021441,1505,726,779,0.48239202657807306,0.5176079734219269
E01021442,1348,658,690,0.48813056379821956,0.5118694362017804
E01021443,1496,690,806,0.4612299465240642,0.5387700534759359
E01021444,1609,792,817,0.49223119950279676,0.5077688004972032
E01021469,1155,561,594,0.4857142857142857,0.5142857142857142
E01021470,1079,535,544,0.49582947173308617,0.5041705282669138
E01021471,1573,776,797,0.4933248569612206,0.5066751430387794
E01021457,1399,668,731,0.47748391708363114,0.5225160829163689
E01021458,1633,762,871,0.46662584200857316,0.5333741579914268
E01021459,1315,626,689,0.47604562737642586,0.5239543726235741
E01021460,1619,772,847,0.4768375540457072,0.5231624459542927
E01021448,1405,676,729,0.4811387900355872,0.5188612099644128
E01021449,1596,742,854,0.4649122807017544,0.5350877192982456
E01021450,2065,1008,1057,0.488135593220339,0.511864406779661
E01021451,1551,732,819,0.47195357833655704,0.528046421663443
E01021452,1467,711,756,0.48466257668711654,0.5153374233128835
E01021431,1566,745,821,0.47573435504469985,0.5242656449553001
E01021432,1681,800,881,0.4759071980963712,0.5240928019036288
E01021434,1310,612,698,0.467175572519084,0.5328244274809161
E01021461,1450,712,738,0.4910344827586207,0.5089655172413793
E01021464,1567,750,817,0.4786215698787492,0.5213784301212508
E01021447,2450,1196,1254,0.4881632653061225,0.5118367346938776
E01021453,1218,622,596,0.5106732348111659,0.48932676518883417
E01021455,1352,671,681,0.496301775147929,0.503698224852071
E01021465,1872,958,914,0.5117521367521367,0.48824786324786323
E01021466,1812,896,916,0.49448123620309054,0.5055187637969095
E01021467,1748,853,895,0.4879862700228833,0.5120137299771167
E01021438,2025,984,1041,0.48592592592592593,0.5140740740740741
E01021462,1393,695,698,0.4989231873653984,0.5010768126346016
E01021463,1553,724,829,0.46619446233097234,0.5338055376690277
E01021468,1891,931,960,0.4923320994182972,0.5076679005817029
E01021433,1928,892,1036,0.46265560165975106,0.5373443983402489
E01021436,2201,1085,1116,0.49295774647887325,0.5070422535211268
E01021439,2312,1140,1172,0.4930795847750865,0.5069204152249135
E01021475,1516,741,775,0.4887862796833773,0.5112137203166227
E01033063,1340,649,691,0.4843283582089552,0.5156716417910447
E01033064,1370,672,698,0.4905109489051095,0.5094890510948905
E01021435,1858,861,997,0.46340150699677074,0.5365984930032293
E01021437,1730,787,943,0.4549132947976879,0.5450867052023122
E01021472,1533,717,816,0.46771037181996084,0.5322896281800391
E01021473,1351,656,695,0.4855662472242783,0.5144337527757217
E01021474,1573,764,809,0.48569612205975843,0.5143038779402416
E01021445,2175,1066,1109,0.4901149425287356,0.5098850574712643
E01021446,1537,764,773,0.4970722186076773,0.5029277813923227
E01021454,1245,600,645,0.4819277108433735,0.5180722891566265
E01021456,1229,604,625,0.49145646867371845,0.5085435313262815
E01021513,1624,798,826,0.49137931034482757,0.5086206896551724
E01021514,1518,733,785,0.48287220026350464,0.5171277997364954
E01021515,1352,650,702,0.4807692307692308,0.5192307692307693
E01021525,1508,757,751,0.5019893899204244,0.4980106100795756
E01021527,1672,807,865,0.4826555023923445,0.5173444976076556
E01021509,1366,678,688,0.49633967789165445,0.5036603221083455
E01021510,1450,701,749,0.48344827586206895,0.516551724137931
E01021511,1328,641,687,0.48268072289156627,0.5173192771084337
E01021528,1612,769,843,0.4770471464019851,0.5229528535980149
E01021531,1373,666,707,0.4850691915513474,0.5149308084486526
E01021476,1905,932,973,0.48923884514435695,0.510761154855643
E01021477,1540,751,789,0.4876623376623377,0.5123376623376623
E01021478,1724,837,887,0.48549883990719256,0.5145011600928074
E01021516,1364,662,702,0.48533724340175954,0.5146627565982405
E01021479,1525,743,782,0.48721311475409834,0.5127868852459017
E01021481,1549,763,786,0.4925758553905746,0.5074241446094254
E01021483,1747,857,890,0.49055523755008584,0.5094447624499141
E01021512,1564,758,806,0.4846547314578005,0.5153452685421995
E01021526,1617,782,835,0.4836116264687693,0.5163883735312307
E01021517,1602,768,834,0.4794007490636704,0.5205992509363296
E01021519,1471,713,758,0.4847042828008158,0.5152957171991842
E01021530,1426,710,716,0.49789621318373073,0.5021037868162693
E01021532,1450,700,750,0.4827586206896552,0.5172413793103449
E01021482,1627,787,840,0.48371235402581436,0.5162876459741856
E01021518,1917,894,1023,0.46635367762128327,0.5336463223787168
E01021520,1563,752,811,0.48112603966730644,0.5188739603326935
E01021529,1498,715,783,0.4773030707610147,0.5226969292389854
E01021480,1829,933,896,0.5101148168398032,0.4898851831601968
E01021521,1422,711,711,0.5,0.5
E01021522,1745,854,891,0.48939828080229225,0.5106017191977077
E01021523,1367,660,707,0.48280907095830283,0.5171909290416972
E01021524,1586,761,825,0.4798234552332913,0.5201765447667087
E01021487,1375,680,695,0.49454545454545457,0.5054545454545455
E01021494,1490,729,761,0.489261744966443,0.5107382550335571
E01021504,1514,745,769,0.49207397622192867,0.5079260237780714
E01021505,1413,709,704,0.5017692852087756,0.4982307147912243
E01021506,1320,644,676,0.48787878787878786,0.5121212121212121
E01021492,1743,838,905,0.48078026391279405,0.519219736087206
E01021493,1549,743,806,0.47966429954809553,0.5203357004519045
E01021495,2011,934,1077,0.4644455494778717,0.5355544505221282
E01021496,1432,730,702,0.5097765363128491,0.49022346368715086
E01021485,1256,607,649,0.48328025477707004,0.51671974522293
E01021486,1274,618,656,0.4850863422291994,0.5149136577708007
E01021488,1468,687,781,0.46798365122615804,0.532016348773842
E01021503,1414,691,723,0.4886845827439887,0.5113154172560113
E01021507,1600,743,857,0.464375,0.535625
E01021508,1382,694,688,0.5021707670043415,0.49782923299565845
E01021484,1370,673,697,0.4912408759124088,0.5087591240875913
E01021498,1488,716,772,0.48118279569892475,0.5188172043010753
E01021499,1669,849,820,0.5086878370281606,0.49131216297183944
E01021501,1414,695,719,0.4915134370579915,0.5084865629420084
E01021502,2225,1130,1095,0.5078651685393258,0.49213483146067416
E01021489,1416,720,696,0.5084745762711864,0.4915254237288136
E01021490,1493,734,759,0.4916275954454119,0.5083724045545881
E01021491,1663,812,851,0.4882742032471437,0.5117257967528562
E01021497,1495,726,769,0.48561872909698994,0.51438127090301
E01021500,1696,817,879,0.48172169811320753,0.5182783018867925
E01021538,2709,1312,1397,0.48431155407899595,0.515688445921004
E01021539,1298,669,629,0.5154083204930663,0.48459167950693377
E01021540,1534,766,768,0.49934810951760106,0.500651890482399
E01021541,1465,707,758,0.4825938566552901,0.5174061433447099
E01021542,2052,1007,1045,0.49074074074074076,0.5092592592592593
E01021543,1714,804,910,0.4690781796966161,0.5309218203033839
E01021587,1460,719,741,0.49246575342465754,0.5075342465753425
E01021590,1472,702,770,0.47690217391304346,0.5230978260869565
E01021591,1499,725,774,0.4836557705136758,0.5163442294863242
E01021550,1404,714,690,0.5085470085470085,0.49145299145299143
E01021597,1466,726,740,0.495225102319236,0.504774897680764
E01021598,1476,709,767,0.4803523035230352,0.5196476964769647
E01021600,1173,583,590,0.49701619778346123,0.5029838022165388
E01021601,1558,740,818,0.4749679075738126,0.5250320924261874
E01021616,1441,709,732,0.49201943095072864,0.5079805690492714
E01021617,1368,673,695,0.4919590643274854,0.5080409356725146
E01021619,1513,757,756,0.5003304692663583,0.4996695307336418
E01021620,1450,724,726,0.4993103448275862,0.5006896551724138
E01021623,1250,611,639,0.4888,0.5112
E01021624,1232,605,627,0.49107142857142855,0.5089285714285714
E01021536,1576,768,808,0.4873096446700508,0.5126903553299492
E01021537,2021,989,1032,0.48936170212765956,0.5106382978723404
E01021568,1586,781,805,0.49243379571248425,0.5075662042875158
E01033142,2174,1063,1111,0.4889604415823367,0.5110395584176632
E01033144,1852,910,942,0.49136069114470843,0.5086393088552916
E01021576,1637,749,888,0.4575442883323152,0.5424557116676848
E01021588,1412,667,745,0.4723796033994334,0.5276203966005666
E01021589,1504,736,768,0.48936170212765956,0.5106382978723404
E01021592,1592,732,860,0.45979899497487436,0.5402010050251256
E01021596,1571,788,783,0.501591343093571,0.49840865690642905
E01021618,1484,728,756,0.49056603773584906,0.5094339622641509
E01021621,1551,801,750,0.5164410058027079,0.4835589941972921
E01021622,1467,720,747,0.49079754601226994,0.50920245398773
E01021625,1453,702,751,0.4831383344803854,0.5168616655196145
E01021626,1415,704,711,0.4975265017667845,0.5024734982332155
E01021544,1311,665,646,0.5072463768115942,0.4927536231884058
E01021545,1618,779,839,0.4814585908529048,0.5185414091470952
E01021546,1458,705,753,0.4835390946502058,0.5164609053497943
E01021547,1558,782,776,0.5019255455712451,0.4980744544287548
E01021628,1686,812,874,0.4816132858837485,0.5183867141162515
E01021629,1659,818,841,0.49306811332127787,0.5069318866787221
E01021573,1716,889,827,0.5180652680652681,0.4819347319347319
E01021575,1698,828,870,0.4876325088339223,0.5123674911660777
E01021599,1837,914,923,0.497550353837779,0.502449646162221
E01021631,1900,868,1032,0.4568421052631579,0.5431578947368421
E01033138,1515,768,747,0.5069306930693069,0.49306930693069306
E01033139,1461,755,706,0.5167693360711841,0.48323066392881586
E01021574,2350,1222,1128,0.52,0.48
E01021578,1698,879,819,0.5176678445229682,0.4823321554770318
E01021582,1848,970,878,0.5248917748917749,0.4751082251082251
E01021627,1535,927,608,0.6039087947882736,0.39609120521172636
E01033140,1111,575,536,0.5175517551755175,0.48244824482448245
E01033141,1023,491,532,0.47996089931573804,0.520039100684262
E01021551,1360,660,700,0.4852941176470588,0.5147058823529411
E01021632,1443,703,740,0.48717948717948717,0.5128205128205128
E01021633,1384,657,727,0.47471098265895956,0.5252890173410405
E01021634,1521,760,761,0.4996712689020381,0.5003287310979618
E01021635,1383,654,729,0.47288503253796094,0.527114967462039
E01021636,1095,522,573,0.4767123287671233,0.5232876712328767
E01021556,1655,815,840,0.49244712990936557,0.5075528700906344
E01021577,1471,714,757,0.48538409245411285,0.5146159075458872
E01021579,1610,769,841,0.47763975155279503,0.522360248447205
E01021580,1440,727,713,0.5048611111111111,0.4951388888888889
E01021584,1227,623,604,0.5077424612876935,0.49225753871230643
E01021548,1306,665,641,0.5091883614088821,0.4908116385911179
E01021560,1650,781,869,0.47333333333333333,0.5266666666666666
E01021561,1788,892,896,0.4988814317673378,0.5011185682326622
E01021564,1492,722,770,0.4839142091152815,0.5160857908847185
E01021571,1612,781,831,0.4844913151364764,0.5155086848635235
E01021562,1762,836,926,0.47446083995459704,0.5255391600454029
E01021563,1685,836,849,0.49614243323442137,0.5038575667655787
E01021565,1591,762,829,0.47894406033940917,0.5210559396605908
E01021566,1720,840,880,0.4883720930232558,0.5116279069767442
E01033137,1577,789,788,0.5003170577045022,0.49968294229549776
E01033145,1385,675,710,0.48736462093862815,0.5126353790613718
E01021557,1264,637,627,0.5039556962025317,0.49604430379746833
E01021558,1266,614,652,0.4849921011058452,0.5150078988941548
E01021583,1575,762,813,0.4838095238095238,0.5161904761904762
E01021585,1272,621,651,0.4882075471698113,0.5117924528301887
E01021586,1550,745,805,0.4806451612903226,0.5193548387096775
E01021533,2270,1126,1144,0.4960352422907489,0.5039647577092511
E01021535,1790,847,943,0.4731843575418994,0.5268156424581005
E01021569,1611,817,794,0.5071384233395406,0.4928615766604593
E01021570,1942,973,969,0.5010298661174047,0.49897013388259526
E01021572,1534,742,792,0.48370273794002605,0.516297262059974
E01021552,1538,730,808,0.47464239271781533,0.5253576072821846
E01021553,1382,675,707,0.48842257597684513,0.5115774240231549
E01021554,1440,720,720,0.5,0.5
E01021555,1378,679,699,0.4927431059506531,0.5072568940493469
E01021559,1505,734,771,0.4877076411960133,0.5122923588039867
E01021602,1676,829,847,0.4946300715990454,0.5053699284009546
E01021604,2286,1168,1118,0.510936132983377,0.4890638670166229
E01033143,2589,1268,1321,0.48976438779451525,0.5102356122054847
E01021611,1501,772,729,0.5143237841439041,0.48567621585609594
E01021612,1527,731,796,0.47871643745907005,0.5212835625409299
E01021613,1818,886,932,0.48734873487348734,0.5126512651265126
E01021614,1767,907,860,0.5132993774759479,0.48670062252405205
E01021615,1474,722,752,0.4898236092265943,0.5101763907734057
E01021605,1250,619,631,0.4952,0.5048
E01021606,1715,831,884,0.4845481049562682,0.5154518950437318
E01021607,1517,744,773,0.4904416611733685,0.5095583388266315
E01021608,1145,556,589,0.485589519650655,0.514410480349345
E01021609,1424,710,714,0.49859550561797755,0.5014044943820225
E01021610,1315,645,670,0.49049429657794674,0.5095057034220533
E01021593,1665,804,861,0.4828828828828829,0.5171171171171172
E01021594,1627,816,811,0.5015365703749232,0.49846342962507684
E01021595,1729,854,875,0.4939271255060729,0.5060728744939271
E01021655,1394,685,709,0.4913916786226686,0.5086083213773315
E01021656,1549,761,788,0.49128469980632666,0.5087153001936734
E01021659,2079,1031,1048,0.4959114959114959,0.5040885040885041
E01021661,1776,869,907,0.48930180180180183,0.5106981981981982
E01021668,1651,837,814,0.5069654754694125,0.49303452453058755
E01021669,1525,719,806,0.47147540983606556,0.5285245901639344
E01021670,1550,752,798,0.48516129032258065,0.5148387096774194
E01021671,1457,712,745,0.4886753603294441,0.511324639670556
E01033720,2012,1010,1002,0.5019880715705766,0.49801192842942343
E01033721,1792,898,894,0.5011160714285714,0.49888392857142855
E01021660,1477,748,729,0.5064319566689235,0.4935680433310765
E01021728,1636,820,816,0.5012224938875306,0.49877750611246946
E01021729,1708,822,886,0.4812646370023419,0.5187353629976581
E01021730,1730,838,892,0.484393063583815,0.5156069364161849
E01021679,2360,1189,1171,0.5038135593220339,0.4961864406779661
E01021680,2826,1376,1450,0.4869072894550602,0.5130927105449399
E01021681,2690,1349,1341,0.5014869888475837,0.49851301115241636
E01021682,2689,1324,1365,0.49237634808478986,0.5076236519152101
E01021646,2023,988,1035,0.48838358872960946,0.5116164112703905
E01021647,1791,900,891,0.5025125628140703,0.49748743718592964
E01021648,2356,1184,1172,0.5025466893039049,0.49745331069609505
E01021649,1874,916,958,0.4887940234791889,0.5112059765208111
E01021650,1952,987,965,0.5056352459016393,0.49436475409836067
E01021696,1559,733,826,0.47017318794098784,0.5298268120590122
E01021697,1660,828,832,0.4987951807228916,0.5012048192771085
E01021698,1507,751,756,0.49834107498341074,0.5016589250165893
E01021699,1490,681,809,0.4570469798657718,0.5429530201342282
E01021700,1511,704,807,0.46591661151555264,0.5340833884844474
E01033719,1667,822,845,0.4931013797240552,0.5068986202759448
E01033722,1597,826,771,0.5172197871008141,0.482780212899186
E01021673,1426,654,772,0.4586255259467041,0.541374474053296
E01021674,1358,653,705,0.4808541973490427,0.5191458026509573
E01021675,1312,641,671,0.4885670731707317,0.5114329268292683
E01021676,1453,678,775,0.4666207845836201,0.5333792154163799
E01021654,1915,930,985,0.4856396866840731,0.5143603133159269
E01021662,1596,815,781,0.5106516290726817,0.4893483709273183
E01021663,1099,533,566,0.48498635122838946,0.5150136487716106
E01021677,1212,611,601,0.5041254125412541,0.49587458745874585
E01021678,1339,688,651,0.513816280806572,0.48618371919342795
E01021683,2368,1726,642,0.7288851351351351,0.27111486486486486
E01021684,1515,768,747,0.5069306930693069,0.49306930693069306
E01021685,1917,922,995,0.4809598330725091,0.5190401669274909
E01021686,1848,919,929,0.4972943722943723,0.5027056277056277
E01021687,1630,787,843,0.48282208588957054,0.5171779141104295
E01021688,1404,685,719,0.4878917378917379,0.5121082621082621
E01021718,1521,761,760,0.5003287310979618,0.4996712689020381
E01021719,1541,763,778,0.49513303049967555,0.5048669695003245
E01021720,1561,704,857,0.4509929532351057,0.5490070467648943
E01021721,1985,955,1030,0.4811083123425693,0.5188916876574308
E01021722,1675,796,879,0.4752238805970149,0.5247761194029851
E01021651,1626,825,801,0.507380073800738,0.492619926199262
E01021652,1524,777,747,0.5098425196850394,0.49015748031496065
E01021653,1332,678,654,0.509009009009009,0.49099099099099097
E01021717,1726,845,881,0.4895712630359212,0.5104287369640788
E01021689,1453,693,760,0.4769442532690984,0.5230557467309016
E01021690,1320,645,675,0.48863636363636365,0.5113636363636364
E01021691,1466,709,757,0.48362892223738063,0.5163710777626194
E01021692,1493,715,778,0.47890154052243805,0.521098459477562
E01021693,1664,794,870,0.47716346153846156,0.5228365384615384
E01021711,1295,608,687,0.4694980694980695,0.5305019305019305
E01021713,1191,590,601,0.49538203190596136,0.5046179680940386
E01021714,1782,907,875,0.5089786756453423,0.4910213243546577
E01021715,1462,719,743,0.49179206566347466,0.5082079343365253
E01033723,2630,1286,1344,0.48897338403041823,0.5110266159695818
E01021657,1582,760,822,0.4804045512010114,0.5195954487989887
E01021658,1051,488,563,0.4643196955280685,0.5356803044719315
E01021664,2045,1000,1045,0.4889975550122249,0.511002444987775
E01021665,1364,652,712,0.4780058651026393,0.5219941348973607
E01021666,1295,635,660,0.49034749034749037,0.5096525096525096
E01021667,1477,704,773,0.4766418415707515,0.5233581584292485
E01021736,3391,1657,1734,0.4886464169861398,0.5113535830138602
E01021737,1232,593,639,0.48133116883116883,0.5186688311688312
E01021738,2104,1026,1078,0.4876425855513308,0.5123574144486692
E01021739,1563,773,790,0.4945617402431222,0.5054382597568778
E01021740,1735,838,897,0.4829971181556196,0.5170028818443804
E01021637,1184,610,574,0.5152027027027027,0.4847972972972973
E01021638,1244,594,650,0.477491961414791,0.522508038585209
E01021639,1975,1089,886,0.5513924050632911,0.4486075949367089
E01021640,1205,585,620,0.4854771784232365,0.5145228215767634
E01021641,1403,700,703,0.4989308624376336,0.5010691375623664
E01021642,2003,966,1037,0.4822765851223165,0.5177234148776835
E01021643,2448,1189,1259,0.48570261437908496,0.514297385620915
E01021644,1710,856,854,0.5005847953216375,0.4994152046783626
E01021645,1493,757,736,0.507032819825854,0.49296718017414604
E01021694,1447,716,731,0.4948168624740843,0.5051831375259157
E01021695,1149,564,585,0.4908616187989556,0.5091383812010444
E01021723,1641,789,852,0.48080438756855576,0.5191956124314442
E01021724,1670,794,876,0.4754491017964072,0.5245508982035928
E01021725,1290,647,643,0.5015503875968992,0.49844961240310076
E01021726,1527,740,787,0.48461034708578915,0.5153896529142109
E01021727,1455,701,754,0.481786941580756,0.518213058419244
E01021731,1445,667,778,0.4615916955017301,0.5384083044982699
E01021732,1523,716,807,0.4701247537754432,0.5298752462245568
E01021733,1501,726,775,0.4836775483011326,0.5163224516988674
E01021734,1357,657,700,0.48415622697126015,0.5158437730287398
E01021735,1357,638,719,0.47015475313190863,0.5298452468680914
E01021702,1331,638,693,0.4793388429752066,0.5206611570247934
E01021703,1275,616,659,0.4831372549019608,0.5168627450980392
E01021704,1516,762,754,0.5026385224274407,0.4973614775725594
E01021705,2034,1026,1008,0.504424778761062,0.49557522123893805
E01021706,1352,634,718,0.46893491124260356,0.5310650887573964
E01021707,1366,641,725,0.46925329428989754,0.5307467057101025
E01021708,1421,697,724,0.4904996481351161,0.5095003518648838
E01021709,1434,720,714,0.502092050209205,0.497907949790795
E01021710,1952,942,1010,0.48258196721311475,0.5174180327868853
E01021768,2138,1052,1086,0.4920486435921422,0.5079513564078578
E01021795,2014,1018,996,0.5054617676266137,0.4945382323733863
E01021797,1314,662,652,0.5038051750380518,0.4961948249619482
E01021798,1536,753,783,0.490234375,0.509765625
E01021799,1627,766,861,0.47080516287645974,0.5291948371235402
E01021741,1970,996,974,0.5055837563451777,0.49441624365482234
E01021792,1205,587,618,0.4871369294605809,0.512863070539419
E01021793,1523,759,764,0.4983585029546947,0.5016414970453054
E01021794,1146,545,601,0.4755671902268761,0.5244328097731239
E01021801,2193,1081,1112,0.49293205654354766,0.5070679434564523
E01021769,2237,1116,1121,0.4988824318283415,0.5011175681716584
E01021796,2122,1053,1069,0.49622997172478794,0.5037700282752121
E01021800,2256,1135,1121,0.5031028368794326,0.49689716312056736
E01021753,1407,685,722,0.48685145700071075,0.5131485429992892
E01021754,1538,753,785,0.4895968790637191,0.5104031209362809
E01021755,1101,541,560,0.4913714804722979,0.508628519527702
E01021802,2205,1030,1175,0.4671201814058957,0.5328798185941043
E01021760,1512,737,775,0.48743386243386244,0.5125661375661376
E01021761,1850,869,981,0.4697297297297297,0.5302702702702703
E01021762,1380,631,749,0.4572463768115942,0.5427536231884058
E01021763,1496,734,762,0.49064171122994654,0.5093582887700535
E01021756,1527,756,771,0.4950884086444008,0.5049115913555993
E01021757,1626,787,839,0.484009840098401,0.515990159901599
E01021758,1548,709,839,0.45801033591731266,0.5419896640826873
E01021759,1491,716,775,0.4802146210596915,0.5197853789403085
E01021811,1364,628,736,0.4604105571847507,0.5395894428152492
E01021813,1386,695,691,0.5014430014430015,0.49855699855699853
E01021814,1531,706,825,0.4611365120836055,0.5388634879163945
E01021815,1547,747,800,0.48287007110536523,0.5171299288946348
E01021816,1328,641,687,0.48268072289156627,0.5173192771084337
E01021807,1534,764,770,0.4980443285528031,0.5019556714471969
E01021808,1486,721,765,0.4851951547779273,0.5148048452220727
E01021809,1425,705,720,0.49473684210526314,0.5052631578947369
E01021810,1822,892,930,0.48957189901207465,0.5104281009879253
E01021817,2491,1231,1260,0.4941790445604175,0.5058209554395825
E01021806,2236,1133,1103,0.5067084078711985,0.4932915921288014
E01021812,1241,626,615,0.5044319097502015,0.49556809024979853
E01021818,1758,857,901,0.48748577929465303,0.512514220705347
E01021770,2013,975,1038,0.4843517138599106,0.5156482861400894
E01021803,1327,659,668,0.49660889223813115,0.5033911077618689
E01021804,1441,677,764,0.46981263011797364,0.5301873698820264
E01021805,1294,628,666,0.4853168469860896,0.5146831530139103
E01021774,1409,704,705,0.49964513839602553,0.5003548616039745
E01021775,1457,683,774,0.46877144818119426,0.5312285518188058
E01021776,1367,642,725,0.46964155084125825,0.5303584491587418
E01021777,1372,652,720,0.4752186588921283,0.5247813411078717
E01021778,1454,727,727,0.5,0.5
E01021779,1491,727,764,0.4875922199865862,0.5124077800134138
E01021786,1253,606,647,0.4836392657621708,0.5163607342378292
E01021787,1548,775,773,0.5006459948320413,0.49935400516795864
E01021788,1558,748,810,0.48010269576379977,0.5198973042362003
E01021789,1575,766,809,0.48634920634920636,0.5136507936507937
E01021790,1480,693,787,0.46824324324324323,0.5317567567567567
E01021791,1557,768,789,0.4932562620423892,0.5067437379576107
E01021771,1523,718,805,0.4714379514116875,0.5285620485883126
E01021772,1490,739,751,0.4959731543624161,0.5040268456375839
E01021773,1513,711,802,0.4699272967614012,0.5300727032385988
E01021783,1554,736,818,0.47361647361647363,0.5263835263835264
E01021784,1532,717,815,0.4680156657963446,0.5319843342036553
E01021780,1468,709,759,0.4829700272479564,0.5170299727520435
E01021781,1475,725,750,0.4915254237288136,0.5084745762711864
E01021782,1410,683,727,0.48439716312056735,0.5156028368794326
E01021785,1620,773,847,0.47716049382716047,0.5228395061728395
E01021742,1375,657,718,0.4778181818181818,0.5221818181818182
E01021743,1693,755,938,0.4459539279385706,0.5540460720614294
E01021744,1548,765,783,0.4941860465116279,0.5058139534883721
E01021745,1525,718,807,0.47081967213114756,0.5291803278688525
E01021746,1783,847,936,0.4750420639371845,0.5249579360628155
E01021747,1727,813,914,0.4707585408222351,0.5292414591777649
E01021748,1729,867,862,0.5014459224985541,0.4985540775014459
E01021749,2207,1074,1133,0.4866334390575442,0.5133665609424558
E01021750,1269,638,631,0.5027580772261623,0.49724192277383766
E01021751,1341,668,673,0.4981357196122297,0.5018642803877703
E01021752,1550,737,813,0.4754838709677419,0.5245161290322581
E01021764,1770,808,962,0.45649717514124294,0.5435028248587571
E01021765,1620,769,851,0.47469135802469137,0.5253086419753087
E01021766,1491,719,772,0.48222669349429914,0.5177733065057009
E01021767,1739,847,892,0.4870615296147211,0.5129384703852788
E01021854,1639,811,828,0.49481391092129345,0.5051860890787065
E01021855,1394,657,737,0.4713055954088953,0.5286944045911047
E01021856,1421,663,758,0.4665728360309641,0.5334271639690359
E01021857,2514,1229,1285,0.4888623707239459,0.5111376292760541
E01021844,1365,650,715,0.47619047619047616,0.5238095238095238
E01021845,1434,660,774,0.4602510460251046,0.5397489539748954
E01021846,1351,665,686,0.49222797927461137,0.5077720207253886
E01021847,1459,678,781,0.46470185058259084,0.5352981494174092
E01021848,1575,765,810,0.4857142857142857,0.5142857142857142
E01021849,1603,782,821,0.4878353087960075,0.5121646912039926
E01021850,1430,688,742,0.4811188811188811,0.5188811188811189
E01021851,1485,745,740,0.5016835016835017,0.4983164983164983
E01021852,1571,747,824,0.475493316359007,0.524506683640993
E01021853,1334,666,668,0.4992503748125937,0.5007496251874063
E01021839,1513,738,775,0.48777263714474556,0.5122273628552545
E01021840,1441,697,744,0.48369188063844554,0.5163081193615545
E01021841,1393,664,729,0.4766690595836324,0.5233309404163675
E01021842,1529,713,816,0.46631785480706345,0.5336821451929366
E01021843,2081,1007,1074,0.48390197020663145,0.5160980297933686
E01021824,1732,855,877,0.49364896073903003,0.50635103926097
E01021825,1618,788,830,0.48702101359703337,0.5129789864029666
E01021826,1602,796,806,0.4968789013732834,0.5031210986267166
E01021827,1628,764,864,0.4692874692874693,0.5307125307125307
E01021828,2315,1124,1191,0.48552915766738663,0.5144708423326134
E01021819,1546,755,791,0.4883570504527814,0.5116429495472187
E01021820,1507,707,800,0.46914399469143997,0.53085600530856
E01021822,1621,762,859,0.4700801974090068,0.5299198025909932
E01021823,1712,835,877,0.4877336448598131,0.5122663551401869
E01021870,1308,632,676,0.4831804281345566,0.5168195718654435
E01021831,1426,700,726,0.4908835904628331,0.5091164095371669
E01021868,1599,739,860,0.46216385240775487,0.5378361475922452
E01021869,1351,660,691,0.48852701702442636,0.5114729829755736
E01021871,1471,703,768,0.477906186267845,0.522093813732155
E01021872,1815,896,919,0.49366391184573005,0.50633608815427
E01021821,1337,644,693,0.4816753926701571,0.518324607329843
E01021834,1497,680,817,0.45424181696726784,0.5457581830327322
E01021835,1492,726,766,0.4865951742627346,0.5134048257372654
E01021836,1441,688,753,0.4774462179042332,0.5225537820957669
E01021837,1439,694,745,0.48227936066712995,0.51772063933287
E01021829,1468,736,732,0.5013623978201635,0.4986376021798365
E01021830,1183,597,586,0.5046491969568893,0.49535080304311074
E01021832,1247,611,636,0.48997594226142743,0.5100240577385726
E01021833,1219,574,645,0.47087776866283837,0.5291222313371616
E01021865,1338,654,684,0.48878923766816146,0.5112107623318386
E01021838,1491,707,784,0.47417840375586856,0.5258215962441315
E01021858,1492,730,762,0.48927613941018766,0.5107238605898123
E01021859,1461,721,740,0.4934976043805613,0.5065023956194388
E01021860,1526,740,786,0.4849279161205767,0.5150720838794234
E01021861,1300,632,668,0.48615384615384616,0.5138461538461538
E01021862,1448,691,757,0.47720994475138123,0.5227900552486188
E01021863,1591,818,773,0.51414204902577,0.48585795097423007
E01021864,1437,730,707,0.5080027835768963,0.4919972164231037
E01021866,1338,658,680,0.49177877428998507,0.5082212257100149
E01021867,1416,702,714,0.4957627118644068,0.5042372881355932
E01021908,1977,984,993,0.4977238239757208,0.5022761760242792
E01021909,1349,673,676,0.4988880652335063,0.5011119347664937
E01021910,1469,727,742,0.4948944860449285,0.5051055139550715
E01021911,1247,613,634,0.491579791499599,0.5084202085004009
E01021882,2024,976,1048,0.48221343873517786,0.5177865612648221
E01021883,1636,834,802,0.5097799511002445,0.4902200488997555
E01021912,1999,981,1018,0.49074537268634316,0.5092546273136568
E01021913,1501,747,754,0.49766822118587606,0.5023317788141239
E01021884,1413,706,707,0.4996461429582449,0.5003538570417552
E01021885,1131,581,550,0.5137046861184792,0.48629531388152075
E01021886,1479,751,728,0.5077755240027045,0.49222447599729546
E01021887,2213,1057,1156,0.47763217352010845,0.5223678264798916
E01021888,1939,950,989,0.48994326972666324,0.5100567302733368
E01021889,2189,1055,1134,0.4819552306989493,0.5180447693010507
E01021890,1742,871,871,0.5,0.5
E01021891,1467,665,802,0.45330606680299934,0.5466939331970007
E01021892,1030,469,561,0.4553398058252427,0.5446601941747573
E01021893,1544,755,789,0.4889896373056995,0.5110103626943006
E01021894,1245,585,660,0.46987951807228917,0.5301204819277109
E01021895,1226,583,643,0.47553017944535075,0.5244698205546493
E01021896,1350,680,670,0.5037037037037037,0.4962962962962963
E01021897,1156,566,590,0.48961937716262977,0.5103806228373703
E01021898,1271,619,652,0.48701809598741147,0.5129819040125885
E01021901,1878,939,939,0.5,0.5
E01021904,1505,760,745,0.5049833887043189,0.4950166112956811
E01021905,1257,634,623,0.5043754972155927,0.49562450278440734
E01021906,1510,736,774,0.48741721854304637,0.5125827814569537
E01021907,2182,1104,1078,0.5059578368469294,0.4940421631530706
E01021873,1373,703,670,0.5120174799708667,0.4879825200291333
E01021874,1348,655,693,0.48590504451038574,0.5140949554896143
E01021875,1407,701,706,0.4982231698649609,0.501776830135039
E01021899,1385,707,678,0.5104693140794224,0.48953068592057764
E01021900,1097,549,548,0.5004557885141294,0.4995442114858706
E01021902,1807,923,884,0.5107913669064749,0.4892086330935252
E01021903,1612,813,799,0.5043424317617866,0.4956575682382134
E01021878,1401,686,715,0.489650249821556,0.510349750178444
E01021879,1366,680,686,0.4978038067349927,0.5021961932650073
E01021880,1428,712,716,0.49859943977591037,0.5014005602240896
E01021881,1164,578,586,0.4965635738831615,0.5034364261168385
E01033057,2312,1150,1162,0.49740484429065746,0.5025951557093425
E01021942,1579,778,801,0.4927169094363521,0.5072830905636478
E01021943,1754,846,908,0.4823261117445838,0.5176738882554162
E01021944,1632,815,817,0.4993872549019608,0.5006127450980392
E01021945,1562,778,784,0.4980793854033291,0.5019206145966709
E01021914,2095,1051,1044,0.5016706443914081,0.4983293556085919
E01021927,1353,668,685,0.49371766444937176,0.5062823355506282
E01021928,1543,710,833,0.46014257939079717,0.5398574206092028
E01021929,1640,827,813,0.5042682926829268,0.49573170731707317
E01021931,1338,650,688,0.4857997010463378,0.5142002989536621
E01021933,1365,706,659,0.5172161172161173,0.4827838827838828
E01021934,1416,699,717,0.4936440677966102,0.5063559322033898
E01021935,1353,655,698,0.48410938654841096,0.515890613451589
E01021936,1697,806,891,0.4749558043606364,0.5250441956393636
E01021937,1648,833,815,0.5054611650485437,0.4945388349514563
E01021938,1495,695,800,0.46488294314381273,0.5351170568561873
E01021939,1686,822,864,0.4875444839857651,0.5124555160142349
E01021940,2120,1061,1059,0.5004716981132076,0.4995283018867924
E01021941,2096,1022,1074,0.48759541984732824,0.5124045801526718
E01021915,1347,669,678,0.49665924276169265,0.5033407572383074
E01021916,1072,518,554,0.4832089552238806,0.5167910447761194
E01021953,1483,703,780,0.47403910991233983,0.5259608900876601
E01021955,1823,858,965,0.4706527701590784,0.5293472298409215
E01021918,1521,745,776,0.4898093359631821,0.5101906640368179
E01021919,1296,637,659,0.49151234567901236,0.5084876543209876
E01021925,1637,800,837,0.48869883934025654,0.5113011606597434
E01021960,2203,1169,1034,0.5306400363141172,0.4693599636858829
E01021961,1494,718,776,0.48058902275769744,0.5194109772423026
E01021920,2026,1024,1002,0.5054294175715696,0.4945705824284304
E01021926,2102,1017,1085,0.4838249286393911,0.5161750713606089
E01021957,1471,734,737,0.4989802855200544,0.5010197144799456
E01021958,1243,598,645,0.48109412711182625,0.5189058728881738
E01021959,1701,814,887,0.47854203409758966,0.5214579659024103
E01021930,1375,719,656,0.5229090909090909,0.47709090909090907
E01021932,1536,761,775,0.4954427083333333,0.5045572916666666
E01021952,1410,640,770,0.45390070921985815,0.5460992907801419
E01021954,1520,743,777,0.4888157894736842,0.5111842105263158
E01021956,1459,699,760,0.47909527073337904,0.520904729266621
E01021950,1465,715,750,0.4880546075085324,0.5119453924914675
E01021951,1272,600,672,0.4716981132075472,0.5283018867924528
E01021962,1256,576,680,0.4585987261146497,0.5414012738853503
E01021963,1363,679,684,0.49816581071166544,0.5018341892883346
E01021964,1572,750,822,0.4770992366412214,0.5229007633587787
E01021966,1755,813,942,0.46324786324786327,0.5367521367521367
E01021946,1556,779,777,0.5006426735218509,0.4993573264781491
E01021947,1197,590,607,0.4928989139515455,0.5071010860484545
E01021948,1335,657,678,0.49213483146067416,0.5078651685393258
E01021949,1518,748,770,0.4927536231884058,0.5072463768115942
E01021965,2293,1131,1162,0.4932402965547318,0.5067597034452682
E01021917,1876,950,926,0.5063965884861408,0.4936034115138593
E01021921,1501,731,770,0.4870086608927382,0.5129913391072618
E01021922,1591,766,825,0.48145820238843495,0.518541797611565
E01021923,1364,673,691,0.4934017595307918,0.5065982404692082
E01021924,1282,641,641,0.5,0.5
E01021997,1323,695,628,0.5253212396069539,0.47467876039304613
E01021998,1353,680,673,0.5025868440502587,0.49741315594974134
E01021999,1728,801,927,0.4635416666666667,0.5364583333333334
E01022001,1668,836,832,0.5011990407673861,0.4988009592326139
E01022000,1631,775,856,0.4751686082158185,0.5248313917841815
E01022006,1618,756,862,0.4672435105067985,0.5327564894932015
E01022007,1690,840,850,0.4970414201183432,0.5029585798816568
E01033051,2373,1162,1211,0.4896755162241888,0.5103244837758112
E01021978,2233,1102,1131,0.4935064935064935,0.5064935064935064
E01022013,1554,775,779,0.49871299871299873,0.5012870012870013
E01022014,1359,645,714,0.4746136865342163,0.5253863134657837
E01022015,1389,652,737,0.46940244780417567,0.5305975521958244
E01022019,1492,738,754,0.49463806970509383,0.5053619302949062
E01022020,1740,804,936,0.46206896551724136,0.5379310344827586
E01022021,1371,666,705,0.48577680525164113,0.5142231947483589
E01021991,1017,514,503,0.5054080629301868,0.4945919370698132
E01021992,1171,575,596,0.4910333048676345,0.5089666951323655
E01022002,1914,917,997,0.47910135841170326,0.5208986415882968
E01022004,1656,782,874,0.4722222222222222,0.5277777777777778
E01022005,1715,845,870,0.49271137026239065,0.5072886297376094
E01022028,1358,656,702,0.48306332842415317,0.5169366715758469
E01021971,1042,536,506,0.5143953934740882,0.4856046065259117
E01021972,1269,643,626,0.5066981875492513,0.4933018124507486
E01022051,1452,739,713,0.5089531680440771,0.49104683195592286
E01022052,1440,705,735,0.4895833333333333,0.5104166666666666
E01021985,1332,608,724,0.45645645645645644,0.5435435435435435
E01021986,1445,649,796,0.4491349480968858,0.5508650519031142
E01022054,1479,675,804,0.4563894523326572,0.5436105476673428
E01022055,1307,554,753,0.42387146136189746,0.5761285386381025
E01022056,1586,770,816,0.4854981084489281,0.5145018915510718
E01021973,1139,566,573,0.49692712906057945,0.5030728709394205
E01021974,1161,585,576,0.5038759689922481,0.49612403100775193
E01022016,1734,840,894,0.4844290657439446,0.5155709342560554
E01022017,1427,718,709,0.5031534688156972,0.4968465311843027
E01022018,1429,689,740,0.4821553533939818,0.5178446466060181
E01021987,1225,557,668,0.4546938775510204,0.5453061224489796
E01021994,1130,520,610,0.46017699115044247,0.5398230088495575
E01021995,1369,638,731,0.4660336011687363,0.5339663988312637
E01021996,1348,592,756,0.4391691394658754,0.5608308605341247
E01022009,1387,675,712,0.48666186012977647,0.5133381398702235
E01022010,1546,727,819,0.4702457956015524,0.5297542043984476
E01022011,1791,863,928,0.4818537130094919,0.5181462869905081
E01022012,1900,818,1082,0.4305263157894737,0.5694736842105264
E01021967,2009,976,1033,0.485813837730214,0.514186162269786
E01021983,1353,671,682,0.4959349593495935,0.5040650406504065
E01021993,2253,1117,1136,0.4957833999112295,0.5042166000887706
E01022053,1795,903,892,0.5030640668523677,0.4969359331476323
E01021984,2027,949,1078,0.4681795757276764,0.5318204242723237
E01022039,1478,686,792,0.46414073071718537,0.5358592692828146
E01022040,1727,814,913,0.4713375796178344,0.5286624203821656
E01022041,1457,665,792,0.456417295813315,0.543582704186685
E01021979,1484,708,776,0.477088948787062,0.522911051212938
E01021980,1765,856,909,0.484985835694051,0.515014164305949
E01021981,1690,828,862,0.48994082840236686,0.5100591715976331
E01021982,1784,874,910,0.4899103139013453,0.5100896860986547
E01022046,1576,789,787,0.5006345177664975,0.4993654822335025
E01022008,2051,979,1072,0.47732813261823503,0.522671867381765
E01022033,1413,667,746,0.4720452937013447,0.5279547062986554
E01022034,1501,689,812,0.4590273151232512,0.5409726848767489
E01022035,1476,680,796,0.46070460704607047,0.5392953929539296
E01021975,1484,693,791,0.4669811320754717,0.5330188679245284
E01021976,1408,675,733,0.4794034090909091,0.5205965909090909
E01021977,1657,788,869,0.4755582377791189,0.5244417622208811
E01022022,1479,740,739,0.5003380662609872,0.49966193373901285
E01022044,1624,780,844,0.4802955665024631,0.5197044334975369
E01022042,1486,690,796,0.46433378196500674,0.5356662180349933
E01022043,1908,959,949,0.5026205450733753,0.4973794549266247
E01022048,1591,718,873,0.4512884978001257,0.5487115021998743
E01022049,1492,705,787,0.4725201072386059,0.5274798927613941
E01022050,1668,769,899,0.46103117505995206,0.5389688249400479
E01022023,1459,700,759,0.47978067169294036,0.5202193283070596
E01022024,1498,678,820,0.45260347129506007,0.5473965287049399
E01022030,1630,773,857,0.4742331288343558,0.5257668711656441
E01022031,1364,662,702,0.48533724340175954,0.5146627565982405
E01022032,1793,830,963,0.4629113218070273,0.5370886781929727
E01021970,1639,746,893,0.45515558267236117,0.5448444173276388
E01022025,1616,817,799,0.505569306930693,0.4944306930693069
E01022026,1588,778,810,0.4899244332493703,0.5100755667506297
E01022027,1632,781,851,0.47855392156862747,0.5214460784313726
E01021968,1776,838,938,0.47184684684684686,0.5281531531531531
E01021969,1426,658,768,0.46143057503506313,0.5385694249649369
E01022036,1237,579,658,0.46806790622473726,0.5319320937752627
E01022037,1493,664,829,0.4447421299397187,0.5552578700602813
E01022038,1470,691,779,0.47006802721088436,0.5299319727891156
E01021988,1778,913,865,0.5134983127109112,0.4865016872890889
E01021989,1451,685,766,0.4720882150241213,0.5279117849758787
E01021990,1570,741,829,0.47197452229299364,0.5280254777070064
E01022045,1426,683,743,0.4789621318373071,0.5210378681626928
E01022047,1275,603,672,0.47294117647058825,0.5270588235294118
E01022057,1736,855,881,0.4925115207373272,0.5074884792626728
E01022075,1839,898,941,0.4883088635127787,0.5116911364872213
E01022077,1563,767,796,0.490722968650032,0.509277031349968
E01022094,1709,834,875,0.4880046811000585,0.5119953188999414
E01022074,1509,719,790,0.47647448641484424,0.5235255135851558
E01022076,1686,794,892,0.4709371293001186,0.5290628706998813
E01022078,1526,736,790,0.48230668414154654,0.5176933158584535
E01022079,1706,819,887,0.48007033997655335,0.5199296600234466
E01022080,1584,825,759,0.5208333333333334,0.4791666666666667
E01022081,2312,1082,1230,0.4679930795847751,0.5320069204152249
E01022082,1779,903,876,0.5075885328836425,0.4924114671163575
E01022061,1461,710,751,0.485968514715948,0.5140314852840521
E01022071,1708,843,865,0.49355971896955503,0.5064402810304449
E01022072,1886,936,950,0.49628844114528103,0.503711558854719
E01022073,1557,778,779,0.49967886962106617,0.5003211303789339
E01022098,1520,753,767,0.4953947368421053,0.5046052631578948
E01022092,1752,875,877,0.4994292237442922,0.5005707762557078
E01022093,1760,837,923,0.47556818181818183,0.5244318181818182
E01022097,1900,954,946,0.5021052631578947,0.4978947368421053
E01022099,2407,1316,1091,0.5467386788533444,0.45326132114665557
E01022062,2092,1034,1058,0.494263862332696,0.505736137667304
E01022063,1587,778,809,0.4902331442974165,0.5097668557025835
E01022083,1699,832,867,0.4896998234255444,0.5103001765744556
E01022084,1608,800,808,0.4975124378109453,0.5024875621890548
E01022085,1570,797,773,0.5076433121019108,0.4923566878980892
E01022087,1803,893,910,0.49528563505268997,0.50471436494731
E01022089,1552,769,783,0.4954896907216495,0.5045103092783505
E01022086,1369,699,670,0.5105916727538349,0.48940832724616506
E01022090,2367,1184,1183,0.5002112378538234,0.49978876214617657
E01022091,2349,1173,1176,0.49936143039591313,0.5006385696040868
E01022095,1577,788,789,0.49968294229549776,0.5003170577045022
E01022067,1800,857,943,0.4761111111111111,0.5238888888888888
E01022068,1589,769,820,0.4839521711768408,0.5160478288231592
E01033054,1087,541,546,0.49770009199632015,0.5022999080036799
E01033055,1462,706,756,0.4829001367989056,0.5170998632010944
E01033056,1329,631,698,0.4747930775018811,0.5252069224981188
E01022058,1701,868,833,0.5102880658436214,0.4897119341563786
E01022064,1759,872,887,0.49573621375781696,0.504263786242183
E01022069,1563,729,834,0.46641074856046066,0.5335892514395394
E01022088,1560,776,784,0.49743589743589745,0.5025641025641026
E01033052,1884,936,948,0.4968152866242038,0.5031847133757962
E01033053,1882,929,953,0.49362380446333687,0.5063761955366631
E01022059,1615,800,815,0.4953560371517028,0.5046439628482973
E01022060,1956,970,986,0.49591002044989774,0.5040899795501023
E01022070,1930,930,1000,0.48186528497409326,0.5181347150259067
E01022096,1853,908,945,0.4900161899622234,0.5099838100377766
E01023316,1446,720,726,0.4979253112033195,0.5020746887966805
E01023317,2547,1228,1319,0.4821358460934433,0.5178641539065567
E01023318,1612,780,832,0.4838709677419355,0.5161290322580645
E01023319,1576,774,802,0.49111675126903553,0.5088832487309645
E01023327,1440,685,755,0.4756944444444444,0.5243055555555556
E01023328,1380,673,707,0.48768115942028983,0.5123188405797101
E01023329,1311,640,671,0.4881769641495042,0.5118230358504958
E01023330,1507,752,755,0.49900464499004643,0.5009953550099535
E01023331,1549,748,801,0.4828921885087153,0.5171078114912847
E01023320,1929,952,977,0.49351995852773456,0.5064800414722654
E01023321,1955,948,1007,0.48491048593350383,0.5150895140664962
E01023322,1765,887,878,0.5025495750708215,0.49745042492917846
E01023323,1591,797,794,0.5009428032683847,0.49905719673161536
E01023289,1531,760,771,0.496407576747224,0.503592423252776
E01023290,1658,811,847,0.48914354644149577,0.5108564535585042
E01023291,1552,771,781,0.49677835051546393,0.5032216494845361
E01023292,1497,730,767,0.4876419505678023,0.5123580494321978
E01023340,1736,855,881,0.4925115207373272,0.5074884792626728
E01023341,1783,858,925,0.4812114413909142,0.5187885586090858
E01023342,2648,1258,1390,0.47507552870090636,0.5249244712990937
E01023343,1871,873,998,0.4665954035275254,0.5334045964724746
E01023344,1725,834,891,0.4834782608695652,0.5165217391304348
E01023307,1575,760,815,0.48253968253968255,0.5174603174603175
E01023308,1703,849,854,0.49853200234879624,0.5014679976512038
E01023309,1713,823,890,0.4804436660828955,0.5195563339171045
E01023310,2201,1022,1179,0.4643343934575193,0.5356656065424807
E01023311,1655,811,844,0.4900302114803625,0.5099697885196375
E01023312,1680,852,828,0.5071428571428571,0.4928571428571429
E01023313,1640,802,838,0.48902439024390243,0.5109756097560976
E01023315,1861,904,957,0.48576034390112843,0.5142396560988716
E01023302,1488,711,777,0.4778225806451613,0.5221774193548387
E01023303,1560,750,810,0.4807692307692308,0.5192307692307693
E01023304,1549,753,796,0.48612007746933505,0.513879922530665
E01023305,1382,666,716,0.48191027496382055,0.5180897250361794
E01023306,1467,707,760,0.48193592365371507,0.5180640763462849
E01023314,1336,659,677,0.49326347305389223,0.5067365269461078
E01023324,1409,657,752,0.46628814762242726,0.5337118523775728
E01023325,1421,666,755,0.4686840253342716,0.5313159746657283
E01023326,1634,773,861,0.4730722154222766,0.5269277845777234
E01023297,1364,684,680,0.501466275659824,0.49853372434017595
E01023298,1578,750,828,0.4752851711026616,0.5247148288973384
E01023299,1690,858,832,0.5076923076923077,0.49230769230769234
E01023300,1408,618,790,0.43892045454545453,0.5610795454545454
E01023301,1606,787,819,0.4900373599003736,0.5099626400996264
E01023293,1731,850,881,0.49104563835932985,0.5089543616406701
E01023294,1517,694,823,0.4574818721160185,0.5425181278839816
E01023295,1422,696,726,0.48945147679324896,0.510548523206751
E01023296,1666,792,874,0.47539015606242496,0.524609843937575
E01023332,2067,953,1114,0.4610546686018384,0.5389453313981616
E01023333,1844,901,943,0.4886117136659436,0.5113882863340564
E01023334,1703,840,863,0.4932472108044627,0.5067527891955372
E01023335,1723,868,855,0.5037724898432966,0.4962275101567034
E01023336,2022,946,1076,0.4678536102868447,0.5321463897131553
E01023337,1675,829,846,0.4949253731343284,0.5050746268656716
E01023338,2201,1070,1131,0.48614266242616994,0.5138573375738301
E01023339,1509,722,787,0.4784625579854208,0.5215374420145792
E01023430,1206,611,595,0.5066334991708126,0.49336650082918737
E01023431,1295,646,649,0.4988416988416988,0.5011583011583012
E01023432,1448,733,715,0.5062154696132597,0.4937845303867403
E01023433,1464,709,755,0.4842896174863388,0.5157103825136612
E01023423,1390,665,725,0.4784172661870504,0.5215827338129496
E01023424,1390,687,703,0.49424460431654677,0.5057553956834533
E01023425,1337,628,709,0.46970830216903514,0.5302916978309649
E01023426,1546,713,833,0.4611901681759379,0.5388098318240621
E01023418,1409,682,727,0.48403122782114977,0.5159687721788503
E01023419,2118,1049,1069,0.4952785646836638,0.5047214353163362
E01023420,1551,751,800,0.4842037395228885,0.5157962604771116
E01023352,2447,1196,1251,0.48876174908050674,0.5112382509194933
E01023421,1478,733,745,0.4959404600811908,0.5040595399188093
E01023422,1270,634,636,0.49921259842519683,0.5007874015748032
E01023434,1533,765,768,0.49902152641878667,0.5009784735812133
E01023435,1493,762,731,0.5103817816476892,0.4896182183523108
E01023436,1208,605,603,0.5008278145695364,0.4991721854304636
E01023437,1531,748,783,0.488569562377531,0.511430437622469
E01023355,1546,765,781,0.4948253557567917,0.5051746442432082
E01023356,1125,554,571,0.49244444444444446,0.5075555555555555
E01023416,1454,703,751,0.48349381017881704,0.5165061898211829
E01023417,1359,643,716,0.4731420161883738,0.5268579838116262
E01023393,1669,862,807,0.5164769322947873,0.4835230677052127
E01023394,1376,692,684,0.502906976744186,0.49709302325581395
E01023395,1632,826,806,0.5061274509803921,0.49387254901960786
E01023396,1559,777,782,0.49839640795381657,0.5016035920461834
E01023397,1338,664,674,0.4962630792227205,0.5037369207772795
E01023401,1820,878,942,0.4824175824175824,0.5175824175824176
E01023402,1618,793,825,0.4901112484548826,0.5098887515451175
E01023403,1504,692,812,0.4601063829787234,0.5398936170212766
E01023404,1315,631,684,0.47984790874524713,0.5201520912547528
E01023405,1507,758,749,0.5029860650298607,0.49701393497013935
E01023361,1701,854,847,0.5020576131687243,0.49794238683127573
E01023362,1734,829,905,0.47808535178777395,0.5219146482122261
E01023363,1553,748,805,0.4816484224082421,0.5183515775917579
E01023364,1294,630,664,0.4868624420401855,0.5131375579598145
E01023390,2028,1017,1011,0.5014792899408284,0.4985207100591716
E01023391,1702,808,894,0.47473560517038776,0.5252643948296122
E01023399,1602,782,820,0.48813982521847693,0.5118601747815231
E01023392,1626,762,864,0.46863468634686345,0.5313653136531366
E01023427,1673,838,835,0.5008965929468021,0.49910340705319783
E01023428,1477,724,753,0.4901828029790115,0.5098171970209885
E01023429,1801,852,949,0.47307051637978903,0.526929483620211
E01023369,1462,702,760,0.4801641586867305,0.5198358413132695
E01023370,1659,828,831,0.49909584086799275,0.5009041591320073
E01023371,1509,722,787,0.4784625579854208,0.5215374420145792
E01023372,1453,695,758,0.4783207157604955,0.5216792842395045
E01023345,1557,773,784,0.4964675658317277,0.5035324341682723
E01023346,1309,623,686,0.47593582887700536,0.5240641711229946
E01023347,1326,621,705,0.4683257918552036,0.5316742081447964
E01023348,1656,779,877,0.47041062801932365,0.5295893719806763
E01023365,1264,629,635,0.497626582278481,0.502373417721519
E01023366,1499,743,756,0.49566377585056703,0.5043362241494329
E01023367,1171,553,618,0.47224594363791633,0.5277540563620837
E01023368,1716,817,899,0.4761072261072261,0.5238927738927739
E01023349,1945,920,1025,0.4730077120822622,0.5269922879177378
E01023350,1629,789,840,0.4843462246777164,0.5156537753222836
E01023351,1589,768,821,0.48332284455632474,0.5166771554436753
E01023398,2425,1250,1175,0.5154639175257731,0.4845360824742268
E01023400,1802,872,930,0.4839067702552719,0.516093229744728
E01023383,1497,728,769,0.4863059452237809,0.5136940547762191
E01023384,1910,930,980,0.4869109947643979,0.5130890052356021
E01023385,1661,842,819,0.5069235400361228,0.49307645996387717
E01023409,1497,771,726,0.5150300601202404,0.4849699398797595
E01023410,1357,654,703,0.4819454679439941,0.5180545320560059
E01023411,1493,709,784,0.47488278633623576,0.5251172136637642
E01023412,1270,645,625,0.5078740157480315,0.4921259842519685
E01023413,1344,649,695,0.48288690476190477,0.5171130952380952
E01023354,1683,864,819,0.5133689839572193,0.48663101604278075
E01023379,1605,779,826,0.4853582554517134,0.5146417445482866
E01023380,1148,562,586,0.4895470383275261,0.5104529616724739
E01023381,1325,665,660,0.5018867924528302,0.4981132075471698
E01023382,1488,722,766,0.4852150537634409,0.5147849462365591
E01033022,1311,689,622,0.5255530129672006,0.4744469870327994
E01033023,1509,789,720,0.5228628230616302,0.47713717693836977
E01023386,1522,753,769,0.4947437582128778,0.5052562417871223
E01023387,1386,648,738,0.4675324675324675,0.5324675324675324
E01023388,1592,785,807,0.49309045226130654,0.5069095477386935
E01023389,1683,829,854,0.49257278669043375,0.5074272133095663
E01023357,1669,831,838,0.4979029358897543,0.5020970641102457
E01023358,1477,721,756,0.4881516587677725,0.5118483412322274
E01023359,1823,857,966,0.4701042238069117,0.5298957761930884
E01023360,1473,753,720,0.5112016293279023,0.48879837067209775
E01023414,1432,707,725,0.4937150837988827,0.5062849162011173
E01023415,1381,672,709,0.4866039102099928,0.5133960897900073
E01023373,1903,1302,601,0.6841828691539674,0.3158171308460326
E01023374,1418,694,724,0.4894217207334274,0.5105782792665726
E01023375,1537,779,758,0.5068314899154196,0.49316851008458035
E01023376,1268,608,660,0.4794952681388013,0.5205047318611987
E01023377,1212,572,640,0.47194719471947194,0.528052805280528
E01023378,1661,814,847,0.4900662251655629,0.5099337748344371
E01023406,1915,911,1004,0.47571801566579636,0.5242819843342037
E01023407,1664,805,859,0.48377403846153844,0.5162259615384616
E01023408,1635,785,850,0.4801223241590214,0.5198776758409785
E01023462,1337,686,651,0.5130890052356021,0.4869109947643979
E01023464,2170,1078,1092,0.4967741935483871,0.5032258064516129
E01023465,1450,739,711,0.5096551724137931,0.4903448275862069
E01023466,1758,849,909,0.48293515358361777,0.5170648464163823
E01023467,2395,1189,1206,0.4964509394572025,0.5035490605427975
E01023494,1206,583,623,0.4834162520729685,0.5165837479270315
E01023495,1291,668,623,0.517428350116189,0.482571649883811
E01023508,1472,722,750,0.4904891304347826,0.5095108695652174
E01023509,1356,685,671,0.5051622418879056,0.4948377581120944
E01023452,1388,676,712,0.48703170028818443,0.5129682997118156
E01023453,1470,732,738,0.49795918367346936,0.5020408163265306
E01023454,1311,631,680,0.4813119755911518,0.5186880244088482
E01023455,1338,638,700,0.476831091180867,0.523168908819133
E01023463,1203,586,617,0.48711554447215294,0.512884455527847
E01023493,2468,1234,1234,0.5,0.5
E01023449,1620,781,839,0.4820987654320988,0.5179012345679013
E01023450,1937,974,963,0.5028394424367578,0.4971605575632421
E01023451,2141,1039,1102,0.4852872489490892,0.5147127510509107
E01023438,1449,702,747,0.484472049689441,0.515527950310559
E01023439,1358,657,701,0.48379970544919,0.5162002945508101
E01023440,1641,797,844,0.48567946374162096,0.514320536258379
E01023441,1457,701,756,0.48112560054907344,0.5188743994509266
E01023442,2095,1039,1056,0.49594272076372314,0.5040572792362769
E01023498,2653,1309,1344,0.49340369393139843,0.5065963060686016
E01023506,1406,705,701,0.5014224751066856,0.49857752489331436
E01023507,1682,857,825,0.509512485136742,0.49048751486325803
E01023443,1561,758,803,0.4855861627162076,0.5144138372837924
E01023444,1629,809,820,0.49662369551872315,0.5033763044812769
E01023445,1733,848,885,0.4893248701673399,0.5106751298326602
E01023446,2135,1043,1092,0.4885245901639344,0.5114754098360655
E01023447,1248,572,676,0.4583333333333333,0.5416666666666666
E01023448,1523,755,768,0.49573210768220616,0.5042678923177938
E01023456,1435,719,716,0.5010452961672474,0.4989547038327526
E01023457,1507,724,783,0.4804246848042468,0.5195753151957532
E01023458,1331,669,662,0.5026296018031555,0.4973703981968445
E01023459,1389,672,717,0.4838012958963283,0.5161987041036717
E01023460,1519,766,753,0.5042791310072416,0.4957208689927584
E01023461,1623,804,819,0.4953789279112754,0.5046210720887245
E01023491,1279,646,633,0.5050820953870211,0.4949179046129789
E01023492,1492,750,742,0.5026809651474531,0.4973190348525469
E01023496,1291,585,706,0.45313710302091403,0.546862896979086
E01023497,1571,757,814,0.4818586887332909,0.5181413112667091
E01023485,2277,1123,1154,0.4931927975406236,0.5068072024593764
E01023486,2514,1226,1288,0.48766905330151156,0.5123309466984884
E01033609,2338,1137,1201,0.4863130881094953,0.5136869118905047
E01023499,1753,857,896,0.48887621220764405,0.511123787792356
E01023500,1734,896,838,0.5167243367935409,0.48327566320645904
E01023501,1513,723,790,0.47785855915399866,0.5221414408460013
E01023502,1735,840,895,0.484149855907781,0.515850144092219
E01023503,1723,857,866,0.4973882762623331,0.5026117237376668
E01023512,1860,899,961,0.48333333333333334,0.5166666666666667
E01023513,1488,727,761,0.4885752688172043,0.5114247311827957
E01023514,1792,843,949,0.47042410714285715,0.5295758928571429
E01023518,2045,1014,1031,0.4958435207823961,0.5041564792176039
E01023519,1735,840,895,0.484149855907781,0.515850144092219
E01023520,1608,796,812,0.49502487562189057,0.5049751243781094
E01023510,1513,720,793,0.47587574355584933,0.5241242564441507
E01023511,1517,755,762,0.4976928147659855,0.5023071852340145
E01023515,1561,795,766,0.5092889173606663,0.4907110826393338
E01023516,2085,1065,1020,0.5107913669064749,0.4892086330935252
E01023517,1595,772,823,0.48401253918495296,0.515987460815047
E01023470,1763,846,917,0.47986386840612594,0.5201361315938741
E01023471,1334,631,703,0.47301349325337333,0.5269865067466267
E01023472,1343,630,713,0.46909903201787045,0.5309009679821296
E01023473,1455,722,733,0.4962199312714777,0.5037800687285223
E01023474,1561,760,801,0.4868673926969891,0.5131326073030109
E01023487,1374,670,704,0.487627365356623,0.512372634643377
E01023488,1609,752,857,0.46737103791174645,0.5326289620882536
E01023489,1309,644,665,0.4919786096256685,0.5080213903743316
E01023490,1272,624,648,0.49056603773584906,0.5094339622641509
E01023482,1953,954,999,0.48847926267281105,0.511520737327189
E01023483,1969,974,995,0.494667343829355,0.505332656170645
E01023484,1531,755,776,0.4931417374265186,0.5068582625734814
E01023475,1461,711,750,0.486652977412731,0.5133470225872689
E01023476,1478,730,748,0.4939106901217862,0.5060893098782138
E01023477,2096,1075,1021,0.512881679389313,0.48711832061068705
E01023478,1708,872,836,0.5105386416861827,0.4894613583138173
E01023479,1567,778,789,0.4964901084875558,0.5035098915124442
E01023468,1368,688,680,0.5029239766081871,0.49707602339181284
E01023469,1510,738,772,0.48874172185430464,0.5112582781456954
E01023480,1576,767,809,0.4866751269035533,0.5133248730964467
E01023481,1669,866,803,0.5188735769922109,0.4811264230077891
E01023504,1363,648,715,0.47542186353631694,0.524578136463683
E01023505,1714,836,878,0.48774795799299886,0.5122520420070011
E01023576,1477,708,769,0.47935003385240355,0.5206499661475965
E01023577,1707,795,912,0.46572934973637964,0.5342706502636204
E01023578,1590,744,846,0.4679245283018868,0.5320754716981132
E01023579,1382,620,762,0.44862518089725034,0.5513748191027497
E01023580,1719,814,905,0.4735311227457824,0.5264688772542175
E01023567,2058,1008,1050,0.4897959183673469,0.5102040816326531
E01023568,1511,722,789,0.47782925215089345,0.5221707478491066
E01023569,1622,774,848,0.47718865598027127,0.5228113440197287
E01023570,1472,681,791,0.4626358695652174,0.5373641304347826
E01023571,1504,717,787,0.4767287234042553,0.5232712765957447
E01023572,1447,693,754,0.47892190739460955,0.5210780926053905
E01023573,1210,552,658,0.456198347107438,0.543801652892562
E01023574,1601,745,856,0.46533416614615863,0.5346658338538414
E01023575,1582,743,839,0.4696586599241466,0.5303413400758533
E01023581,1336,656,680,0.49101796407185627,0.5089820359281437
E01023582,1713,795,918,0.46409807355516636,0.5359019264448336
E01023583,1425,677,748,0.4750877192982456,0.5249122807017544
E01023584,1032,505,527,0.4893410852713178,0.5106589147286822
E01023523,1726,890,836,0.5156431054461182,0.4843568945538818
E01023524,1537,770,767,0.5009759271307742,0.4990240728692258
E01023525,1676,825,851,0.4922434367541766,0.5077565632458234
E01023526,1780,869,911,0.48820224719101124,0.5117977528089888
E01023527,1444,684,760,0.47368421052631576,0.5263157894736842
E01023534,1695,839,856,0.49498525073746313,0.5050147492625369
E01023535,1694,781,913,0.461038961038961,0.538961038961039
E01023536,1604,742,862,0.4625935162094763,0.5374064837905237
E01023537,1770,866,904,0.48926553672316386,0.5107344632768361
E01023538,1676,792,884,0.47255369928400953,0.5274463007159904
E01023529,1494,710,784,0.47523427041499333,0.5247657295850067
E01023530,1223,582,641,0.4758789860997547,0.5241210139002453
E01023531,1964,953,1011,0.48523421588594706,0.5147657841140529
E01023532,1649,824,825,0.4996967859308672,0.5003032140691328
E01023533,1598,762,836,0.47684605757196497,0.523153942428035
E01023552,1664,804,860,0.4831730769230769,0.5168269230769231
E01023553,1687,826,861,0.4896265560165975,0.5103734439834025
E01023554,1670,798,872,0.47784431137724553,0.5221556886227545
E01023555,1706,855,851,0.5011723329425557,0.4988276670574443
E01023544,1187,580,607,0.4886267902274642,0.5113732097725358
E01023545,1235,614,621,0.497165991902834,0.5028340080971659
E01023546,1805,883,922,0.489196675900277,0.510803324099723
E01023547,1679,841,838,0.5008933889219773,0.4991066110780226
E01023528,1652,840,812,0.5084745762711864,0.4915254237288136
E01023564,1717,817,900,0.47582993593476997,0.52417006406523
E01023565,1707,846,861,0.4956063268892794,0.5043936731107206
E01023566,1686,823,863,0.48813760379596677,0.5118623962040332
E01023539,2926,1467,1459,0.5013670539986329,0.49863294600136704
E01023540,1696,824,872,0.4858490566037736,0.5141509433962265
E01023541,1918,963,955,0.5020855057351408,0.49791449426485923
E01023542,1776,886,890,0.4988738738738739,0.5011261261261262
E01023543,1366,662,704,0.48462664714494874,0.5153733528550513
E01023558,1682,785,897,0.4667063020214031,0.5332936979785969
E01023559,1514,754,760,0.49801849405548215,0.5019815059445178
E01023560,1482,690,792,0.46558704453441296,0.5344129554655871
E01023561,1620,764,856,0.47160493827160493,0.528395061728395
E01023562,1469,735,734,0.5003403675970047,0.4996596324029952
E01023563,1496,682,814,0.45588235294117646,0.5441176470588235
E01023548,1813,883,930,0.4870380584666299,0.5129619415333702
E01023549,1675,742,933,0.44298507462686565,0.5570149253731344
E01023550,1691,844,847,0.4991129509166174,0.5008870490833827
E01023551,1534,750,784,0.48891786179921776,0.5110821382007823
E01023556,1538,764,774,0.4967490247074122,0.5032509752925878
E01023557,1522,730,792,0.47963206307490147,0.5203679369250985
E01023660,2205,1081,1124,0.490249433106576,0.509750566893424
E01023661,1366,670,696,0.4904831625183016,0.5095168374816984
E01023662,1548,767,781,0.49547803617571057,0.5045219638242894
E01023654,1554,772,782,0.4967824967824968,0.5032175032175032
E01023655,1511,741,770,0.49040370615486434,0.5095962938451357
E01023656,2165,1071,1094,0.49468822170900695,0.505311778290993
E01023657,2506,1258,1248,0.5019952114924182,0.4980047885075818
E01023658,1598,800,798,0.5006257822277848,0.49937421777221525
E01023659,1328,669,659,0.5037650602409639,0.49623493975903615
E01023635,1476,705,771,0.47764227642276424,0.5223577235772358
E01023636,1805,902,903,0.4997229916897507,0.5002770083102493
E01023637,1700,816,884,0.48,0.52
E01023638,1557,750,807,0.4816955684007707,0.5183044315992292
E01023587,1097,566,531,0.5159525979945305,0.4840474020054695
E01023588,1342,659,683,0.4910581222056632,0.5089418777943369
E01023589,1643,858,785,0.5222154595252587,0.47778454047474134
E01023590,1710,840,870,0.49122807017543857,0.5087719298245614
E01023591,1510,745,765,0.49337748344370863,0.5066225165562914
E01023592,1576,756,820,0.4796954314720812,0.5203045685279187
E01023593,1402,702,700,0.5007132667617689,0.4992867332382311
E01023585,1167,572,595,0.49014567266495285,0.5098543273350471
E01023586,1529,726,803,0.4748201438848921,0.5251798561151079
E01023597,1218,592,626,0.4860426929392447,0.5139573070607554
E01023598,1390,683,707,0.4913669064748201,0.5086330935251798
E01023600,1390,663,727,0.47697841726618706,0.5230215827338129
E01023663,2091,1025,1066,0.49019607843137253,0.5098039215686274
E01033024,1619,833,786,0.5145151327980235,0.48548486720197653
E01033025,1286,619,667,0.4813374805598756,0.5186625194401244
E01033026,1580,825,755,0.5221518987341772,0.4778481012658228
E01033027,1471,768,703,0.522093813732155,0.477906186267845
E01023630,1653,758,895,0.45856019358741684,0.5414398064125832
E01023631,1663,802,861,0.48226097414311486,0.5177390258568851
E01023632,1373,657,716,0.4785142024763292,0.5214857975236707
E01023633,1376,681,695,0.4949127906976744,0.5050872093023255
E01023634,1308,644,664,0.4923547400611621,0.5076452599388379
E01023649,1253,609,644,0.4860335195530726,0.5139664804469274
E01023650,1477,726,751,0.4915368991198375,0.5084631008801624
E01023651,1230,612,618,0.4975609756097561,0.5024390243902439
E01023652,1451,664,787,0.45761543762922124,0.5423845623707788
E01023644,1657,799,858,0.4821967410983706,0.5178032589016295
E01023645,1528,734,794,0.4803664921465969,0.5196335078534031
E01023646,1389,651,738,0.468682505399568,0.531317494600432
E01023647,1532,755,777,0.49281984334203655,0.5071801566579635
E01023648,1231,586,645,0.4760357432981316,0.5239642567018684
E01023639,1357,653,704,0.4812085482682388,0.5187914517317612
E01023640,1212,571,641,0.47112211221122113,0.5288778877887789
E01023641,1327,668,659,0.5033911077618689,0.49660889223813115
E01023642,1326,656,670,0.4947209653092006,0.5052790346907994
E01023643,1368,672,696,0.49122807017543857,0.5087719298245614
E01023601,2132,1105,1027,0.5182926829268293,0.4817073170731707
E01023602,1580,804,776,0.5088607594936709,0.4911392405063291
E01023603,1572,770,802,0.48982188295165396,0.510178117048346
E01023604,1369,697,672,0.5091307523739956,0.49086924762600437
E01023605,1444,727,717,0.5034626038781164,0.49653739612188363
E01023617,1488,745,743,0.5006720430107527,0.4993279569892473
E01023618,1511,734,777,0.485771012574454,0.514228987425546
E01023619,1619,845,774,0.5219271155033972,0.47807288449660285
E01023620,1324,655,669,0.4947129909365559,0.5052870090634441
E01023621,1346,654,692,0.48588410104011887,0.5141158989598811
E01023611,1638,772,866,0.4713064713064713,0.5286935286935287
E01023612,1794,863,931,0.4810479375696767,0.5189520624303233
E01023613,1653,798,855,0.4827586206896552,0.5172413793103449
E01023614,1950,955,995,0.4897435897435897,0.5102564102564102
E01023615,1583,807,776,0.5097915350600126,0.4902084649399874
E01023616,2036,964,1072,0.47347740667976423,0.5265225933202358
E01023606,1640,787,853,0.4798780487804878,0.5201219512195122
E01023607,1473,705,768,0.4786150712830957,0.5213849287169042
E01023608,1509,732,777,0.4850894632206759,0.5149105367793241
E01023609,1570,775,795,0.49363057324840764,0.5063694267515924
E01023610,1370,658,712,0.4802919708029197,0.5197080291970803
E01023594,2194,1086,1108,0.4949863263445761,0.5050136736554239
E01023622,1177,546,631,0.4638912489379779,0.536108751062022
E01023623,1468,727,741,0.4952316076294278,0.5047683923705722
E01023624,1331,666,665,0.5003756574004508,0.4996243425995492
E01023625,1106,544,562,0.4918625678119349,0.5081374321880651
E01023653,2179,1054,1125,0.48370812299219823,0.5162918770078018
E01023595,1494,710,784,0.47523427041499333,0.5247657295850067
E01023596,1099,520,579,0.4731574158325751,0.5268425841674249
E01023626,2167,1078,1089,0.49746192893401014,0.5025380710659898
E01023627,1754,840,914,0.4789053591790194,0.5210946408209807
E01023628,1723,854,869,0.4956471271038886,0.5043528728961114
E01023629,1770,871,899,0.492090395480226,0.507909604519774
E01023690,1607,761,846,0.4735532047293093,0.5264467952706907
E01023691,1458,712,746,0.4883401920438957,0.5116598079561042
E01023692,1412,682,730,0.4830028328611898,0.5169971671388102
E01023693,1288,621,667,0.48214285714285715,0.5178571428571429
E01023694,1474,723,751,0.49050203527815467,0.5094979647218453
E01023685,1690,845,845,0.5,0.5
E01023686,1593,775,818,0.48650345260514755,0.5134965473948525
E01023687,1521,725,796,0.47666009204470744,0.5233399079552926
E01023688,1428,709,719,0.4964985994397759,0.5035014005602241
E01023689,1459,748,711,0.5126799177518848,0.4873200822481151
E01023699,1534,709,825,0.4621903520208605,0.5378096479791395
E01023700,1356,641,715,0.47271386430678464,0.5272861356932154
E01023701,1779,853,926,0.47948285553681846,0.5205171444631815
E01023702,1609,785,824,0.48788067122436296,0.512119328775637
E01023703,1465,727,738,0.4962457337883959,0.5037542662116041
E01023746,1545,731,814,0.47313915857605177,0.5268608414239482
E01023747,1792,845,947,0.47154017857142855,0.5284598214285714
E01023748,1383,670,713,0.48445408532176426,0.5155459146782357
E01023749,1690,813,877,0.48106508875739645,0.5189349112426036
E01023695,1578,795,783,0.5038022813688213,0.49619771863117873
E01023696,1736,859,877,0.49481566820276496,0.505184331797235
E01023697,1855,902,953,0.4862533692722372,0.5137466307277628
E01023698,1606,812,794,0.5056039850560399,0.4943960149439601
E01023722,1429,716,713,0.5010496850944717,0.4989503149055283
E01023723,1692,826,866,0.48817966903073284,0.5118203309692672
E01023724,1588,742,846,0.4672544080604534,0.5327455919395466
E01023725,1517,743,774,0.4897824653922215,0.5102175346077785
E01023713,1872,917,955,0.48985042735042733,0.5101495726495726
E01023734,1648,801,847,0.48604368932038833,0.5139563106796117
E01023735,1746,859,887,0.4919816723940435,0.5080183276059564
E01023736,1560,733,827,0.46987179487179487,0.5301282051282051
E01023709,1658,788,870,0.4752714113389626,0.5247285886610374
E01023710,1564,769,795,0.49168797953964194,0.5083120204603581
E01023711,1588,775,813,0.4880352644836272,0.5119647355163728
E01023712,1687,838,849,0.4967397747480735,0.5032602252519265
E01023669,1681,760,921,0.45211183819155265,0.5478881618084473
E01023670,2172,1002,1170,0.4613259668508287,0.5386740331491713
E01023671,1892,886,1006,0.4682875264270613,0.5317124735729387
E01023672,1958,954,1004,0.48723186925434114,0.5127681307456589
E01023673,1441,728,713,0.5052047189451769,0.49479528105482307
E01023714,1822,884,938,0.48518111964873767,0.5148188803512623
E01023715,1604,768,836,0.47880299251870323,0.5211970074812967
E01023716,2040,1004,1036,0.492156862745098,0.5078431372549019
E01023666,1714,881,833,0.5140023337222871,0.48599766627771296
E01023674,1862,911,951,0.4892588614393126,0.5107411385606875
E01023675,1409,697,712,0.49467707594038324,0.5053229240596168
E01023676,2173,1077,1096,0.4956281638288081,0.5043718361711919
E01023726,1671,860,811,0.5146618791143028,0.48533812088569717
E01023727,1916,992,924,0.5177453027139874,0.4822546972860125
E01023728,2203,1102,1101,0.5002269632319565,0.4997730367680436
E01023729,1812,931,881,0.5137969094922737,0.48620309050772625
E01023664,1751,878,873,0.5014277555682467,0.4985722444317533
E01023665,1590,796,794,0.5006289308176101,0.49937106918238994
E01023667,1431,703,728,0.4912648497554158,0.5087351502445842
E01023668,1406,736,670,0.5234708392603129,0.47652916073968704
E01023742,1484,731,753,0.4925876010781671,0.5074123989218329
E01023743,1723,866,857,0.5026117237376668,0.4973882762623331
E01023744,1470,724,746,0.4925170068027211,0.507482993197279
E01023745,1727,856,871,0.4956572090330052,0.5043427909669947
E01023677,1240,649,591,0.5233870967741936,0.47661290322580646
E01023678,1899,959,940,0.5050026329647183,0.49499736703528174
E01023679,1478,736,742,0.4979702300405954,0.5020297699594046
E01023680,1345,670,675,0.49814126394052044,0.5018587360594795
E01023681,1601,833,768,0.5202998126171143,0.4797001873828857
E01023682,1730,845,885,0.4884393063583815,0.5115606936416185
E01023683,1660,798,862,0.4807228915662651,0.519277108433735
E01023684,1623,798,825,0.49168207024029575,0.5083179297597042
E01023737,1338,634,704,0.47384155455904337,0.5261584454409567
E01023738,1586,818,768,0.5157629255989912,0.4842370744010088
E01023739,1506,711,795,0.4721115537848606,0.5278884462151394
E01023740,1338,676,662,0.5052316890881914,0.4947683109118087
E01023741,1589,758,831,0.4770295783511643,0.5229704216488358
E01023704,1612,792,820,0.4913151364764268,0.5086848635235732
E01023705,1704,835,869,0.49002347417840375,0.5099765258215962
E01023706,1590,763,827,0.479874213836478,0.520125786163522
E01023708,1512,737,775,0.48743386243386244,0.5125661375661376
E01033028,1490,727,763,0.4879194630872483,0.5120805369127517
E01033029,1599,807,792,0.5046904315196998,0.49530956848030017
E01023718,1746,874,872,0.5005727376861397,0.49942726231386025
E01023719,1126,543,583,0.4822380106571936,0.5177619893428064
E01023720,1852,951,901,0.5134989200863931,0.4865010799136069
E01023721,1406,690,716,0.4907539118065434,0.5092460881934566
E01023717,1232,605,627,0.49107142857142855,0.5089285714285714
E01023730,1747,858,889,0.4911276473955352,0.5088723526044648
E01023731,1479,729,750,0.49290060851926976,0.5070993914807302
E01023732,1674,796,878,0.4755077658303465,0.5244922341696535
E01023733,1603,771,832,0.4809731752963194,0.5190268247036806
E01023787,1425,751,674,0.5270175438596492,0.4729824561403509
E01023788,1597,787,810,0.49279899812147776,0.5072010018785222
E01023789,1986,980,1006,0.49345417925478346,0.5065458207452165
E01023790,1738,861,877,0.4953970080552359,0.5046029919447641
E01023776,2511,1308,1203,0.5209080047789725,0.47909199522102747
E01023777,1805,905,900,0.5013850415512465,0.4986149584487535
E01023778,1694,775,919,0.4574970484061393,0.5425029515938606
E01023799,1378,660,718,0.47895500725689405,0.521044992743106
E01023800,1989,959,1030,0.48215183509301157,0.5178481649069885
E01023801,2417,1168,1249,0.48324369052544475,0.5167563094745552
E01023771,1601,803,798,0.5015615240474703,0.49843847595252966
E01023772,1718,879,839,0.5116414435389989,0.4883585564610012
E01023773,1371,655,716,0.4777534646243618,0.5222465353756383
E01023774,1639,845,794,0.5155582672361196,0.4844417327638804
E01023767,1454,742,712,0.5103163686382394,0.4896836313617607
E01023768,1665,840,825,0.5045045045045045,0.4954954954954955
E01023769,1695,823,872,0.4855457227138643,0.5144542772861357
E01023770,1512,782,730,0.5171957671957672,0.4828042328042328
E01023795,1520,739,781,0.4861842105263158,0.5138157894736842
E01023796,1474,744,730,0.5047489823609227,0.49525101763907736
E01023797,1317,646,671,0.4905087319665907,0.5094912680334093
E01023798,1484,741,743,0.49932614555256066,0.5006738544474394
E01023775,1912,970,942,0.5073221757322176,0.49267782426778245
E01023779,1605,778,827,0.48473520249221186,0.5152647975077882
E01023780,1411,713,698,0.5053153791637137,0.49468462083628634
E01023781,1681,842,839,0.5008923259964307,0.4991076740035693
E01023782,1391,720,671,0.5176132278936018,0.4823867721063983
E01023759,1510,704,806,0.46622516556291393,0.5337748344370861
E01023760,1543,778,765,0.5042125729099157,0.4957874270900843
E01023761,2168,1055,1113,0.48662361623616235,0.5133763837638377
E01023762,1558,783,775,0.5025673940949936,0.49743260590500643
E01023755,1610,767,843,0.4763975155279503,0.5236024844720497
E01023756,1668,822,846,0.49280575539568344,0.5071942446043165
E01023757,1889,892,997,0.4722075172048703,0.5277924827951297
E01023758,1848,969,879,0.5243506493506493,0.47564935064935066
E01023750,1284,599,685,0.4665109034267913,0.5334890965732088
E01023751,1202,595,607,0.4950083194675541,0.5049916805324459
E01023752,1329,664,665,0.4996237772761475,0.5003762227238525
E01023753,1475,736,739,0.49898305084745764,0.5010169491525424
E01023754,1368,665,703,0.4861111111111111,0.5138888888888888
E01023791,1564,765,799,0.4891304347826087,0.5108695652173914
E01023792,1638,798,840,0.48717948717948717,0.5128205128205128
E01023793,1441,700,741,0.4857737682165163,0.5142262317834837
E01023794,1567,754,813,0.48117421825143586,0.5188257817485641
E01023783,1665,851,814,0.5111111111111111,0.4888888888888889
E01023784,1629,777,852,0.47697974217311234,0.5230202578268877
E01023785,1574,780,794,0.49555273189326554,0.5044472681067345
E01023786,1527,727,800,0.47609692206941717,0.5239030779305829
E01023763,1483,744,739,0.5016857720836143,0.4983142279163857
E01023764,1425,708,717,0.4968421052631579,0.5031578947368421
E01023765,1472,716,756,0.48641304347826086,0.5135869565217391
E01023766,1530,718,812,0.469281045751634,0.530718954248366
E01023802,1723,857,866,0.4973882762623331,0.5026117237376668
E01023803,1536,758,778,0.4934895833333333,0.5065104166666666
E01023804,1519,736,783,0.48452929558920343,0.5154707044107966
E01023807,1510,768,742,0.5086092715231788,0.4913907284768212
E01023808,2527,1292,1235,0.5112781954887218,0.48872180451127817
E01023829,1708,813,895,0.47599531615925056,0.5240046838407494
E01023830,1412,693,719,0.49079320113314445,0.5092067988668555
E01023832,1689,827,862,0.4896388395500296,0.5103611604499704
E01023833,2362,1163,1199,0.49237933954276036,0.5076206604572396
E01023834,1561,759,802,0.48622677770659833,0.5137732222934016
E01023823,1385,619,766,0.4469314079422383,0.5530685920577617
E01023824,1936,921,1015,0.4757231404958678,0.5242768595041323
E01023831,2027,977,1050,0.48199309324124323,0.5180069067587568
E01023854,1849,894,955,0.48350459707950244,0.5164954029204976
E01023812,1459,722,737,0.49485949280328995,0.5051405071967101
E01023813,1551,729,822,0.4700193423597679,0.5299806576402321
E01023814,1162,525,637,0.45180722891566266,0.5481927710843374
E01023851,1636,726,910,0.44376528117359415,0.5562347188264058
E01023815,1544,767,777,0.49676165803108807,0.5032383419689119
E01023816,1293,635,658,0.4911059551430781,0.5088940448569219
E01023817,1355,651,704,0.48044280442804427,0.5195571955719557
E01023818,1375,665,710,0.48363636363636364,0.5163636363636364
E01023819,1580,749,831,0.4740506329113924,0.5259493670886076
E01023820,1282,619,663,0.4828393135725429,0.517160686427457
E01023821,1292,629,663,0.4868421052631579,0.5131578947368421
E01023822,1361,667,694,0.49008082292432037,0.5099191770756797
E01023825,2265,1140,1125,0.5033112582781457,0.4966887417218543
E01023826,1461,727,734,0.4976043805612594,0.5023956194387406
E01023847,1890,908,982,0.4804232804232804,0.5195767195767196
E01023848,1659,831,828,0.5009041591320073,0.49909584086799275
E01023850,1412,714,698,0.5056657223796034,0.4943342776203966
E01023852,1493,699,794,0.4681848626925653,0.5318151373074347
E01023853,2067,1028,1039,0.49733913884857284,0.5026608611514272
E01023827,2186,1058,1128,0.4839890210430009,0.5160109789569991
E01023828,1507,737,770,0.48905109489051096,0.5109489051094891
E01023845,1824,885,939,0.48519736842105265,0.5148026315789473
E01023846,1512,749,763,0.49537037037037035,0.5046296296296297
E01023835,1407,678,729,0.48187633262260127,0.5181236673773987
E01023836,1394,653,741,0.4684361549497848,0.5315638450502153
E01023837,1550,745,805,0.4806451612903226,0.5193548387096775
E01023838,1251,601,650,0.48041566746602715,0.5195843325339728
E01023805,1671,813,858,0.4865350089766607,0.5134649910233393
E01023809,1651,776,875,0.4700181708055724,0.5299818291944276
E01023810,1736,825,911,0.47523041474654376,0.5247695852534562
E01023811,1474,703,771,0.4769335142469471,0.5230664857530529
E01023839,2249,1090,1159,0.48465984882169855,0.5153401511783015
E01023840,1671,828,843,0.4955116696588869,0.5044883303411131
E01023841,1612,831,781,0.5155086848635235,0.4844913151364764
E01023849,1435,710,725,0.49477351916376305,0.5052264808362369
E01023806,2190,1061,1129,0.48447488584474885,0.5155251141552512
E01023842,1576,729,847,0.46256345177664976,0.5374365482233503
E01023843,1929,909,1020,0.4712286158631415,0.5287713841368584
E01023844,1611,782,829,0.48541278708876473,0.5145872129112352
E01023904,1993,943,1050,0.4731560461615655,0.5268439538384345
E01023905,1882,899,983,0.47768331562167904,0.5223166843783209
E01023906,1485,737,748,0.4962962962962963,0.5037037037037037
E01023907,1723,862,861,0.5002901915264074,0.4997098084735926
E01023890,1279,633,646,0.4949179046129789,0.5050820953870211
E01023891,1440,719,721,0.49930555555555556,0.5006944444444444
E01023892,1312,604,708,0.4603658536585366,0.5396341463414634
E01023893,1710,812,898,0.47485380116959064,0.5251461988304094
E01023894,1454,705,749,0.48486932599724897,0.515130674002751
E01023873,1287,609,678,0.4731934731934732,0.5268065268065268
E01023874,1320,643,677,0.4871212121212121,0.5128787878787879
E01023875,1840,901,939,0.48967391304347824,0.5103260869565217
E01023876,1738,797,941,0.45857307249712315,0.5414269275028769
E01023877,1647,773,874,0.4693381906496661,0.5306618093503339
E01023868,1728,851,877,0.49247685185185186,0.5075231481481481
E01023869,1377,710,667,0.5156136528685549,0.4843863471314452
E01023870,1483,723,760,0.4875252865812542,0.5124747134187457
E01023871,1190,576,614,0.48403361344537815,0.5159663865546219
E01023872,1706,854,852,0.5005861664712778,0.49941383352872215
E01023895,1604,819,785,0.5105985037406484,0.48940149625935164
E01023896,1341,652,689,0.4862043251304996,0.5137956748695004
E01023897,1586,806,780,0.5081967213114754,0.4918032786885246
E01023898,1569,798,771,0.5086042065009561,0.491395793499044
E01023855,1813,931,882,0.5135135135135135,0.4864864864864865
E01023856,2279,1138,1141,0.499341816586222,0.500658183413778
E01023857,1656,840,816,0.5072463768115942,0.4927536231884058
E01023858,1696,867,829,0.5112028301886793,0.48879716981132076
E01023878,1944,967,977,0.4974279835390947,0.5025720164609053
E01023879,2218,1085,1133,0.48917944093778176,0.5108205590622182
E01023880,1831,899,932,0.4909885308574549,0.509011469142545
E01023881,1613,784,829,0.486050836949783,0.513949163050217
E01023886,2709,1378,1331,0.5086747877445552,0.4913252122554448
E01023887,1698,855,843,0.5035335689045937,0.49646643109540634
E01023888,1597,795,802,0.4978083907326237,0.5021916092673764
E01023889,1774,867,907,0.4887260428410372,0.5112739571589628
E01023859,2112,1102,1010,0.521780303030303,0.47821969696969696
E01023860,1835,967,868,0.5269754768392371,0.47302452316076293
E01023861,2231,1215,1016,0.5445988346033169,0.4554011653966831
E01023862,1965,975,990,0.4961832061068702,0.5038167938931297
E01023899,1548,796,752,0.5142118863049095,0.48578811369509045
E01023900,1728,915,813,0.5295138888888888,0.4704861111111111
E01023901,1909,966,943,0.5060240963855421,0.4939759036144578
E01023902,1510,736,774,0.48741721854304637,0.5125827814569537
E01023903,1563,816,747,0.5220729366602687,0.4779270633397313
E01023863,1727,892,835,0.5165026056745802,0.4834973943254198
E01023864,1556,734,822,0.4717223650385604,0.5282776349614395
E01023865,1661,776,885,0.46718844069837445,0.5328115593016255
E01023866,1553,703,850,0.45267224726336125,0.5473277527366388
E01023867,2129,1089,1040,0.511507750117426,0.488492249882574
E01023882,1564,757,807,0.4840153452685422,0.5159846547314578
E01023883,1660,801,859,0.4825301204819277,0.5174698795180723
E01023884,1709,853,856,0.49912229373902867,0.5008777062609713
E01023885,1819,903,916,0.4964266080263881,0.5035733919736118
E01023965,1416,705,711,0.4978813559322034,0.5021186440677966
E01023966,1588,778,810,0.4899244332493703,0.5100755667506297
E01023967,1362,661,701,0.4853157121879589,0.5146842878120411
E01023971,1629,798,831,0.48987108655616945,0.5101289134438306
E01023968,1277,629,648,0.4925606891151135,0.5074393108848865
E01023969,1370,671,699,0.4897810218978102,0.5102189781021897
E01023970,1390,674,716,0.4848920863309353,0.5151079136690647
E01033310,1665,839,826,0.5039039039039039,0.4960960960960961
E01033313,1487,740,747,0.4976462676529926,0.5023537323470074
E01023959,1432,681,751,0.4755586592178771,0.5244413407821229
E01023960,1572,761,811,0.48409669211195927,0.5159033078880407
E01023961,1427,653,774,0.4576033637000701,0.54239663629993
E01023962,1492,702,790,0.47050938337801607,0.5294906166219839
E01023912,1441,689,752,0.47814018043025674,0.5218598195697433
E01023913,1348,665,683,0.49332344213649854,0.5066765578635015
E01023914,1654,792,862,0.4788391777509069,0.5211608222490931
E01023915,1521,742,779,0.4878369493754109,0.5121630506245891
E01023950,1585,803,782,0.5066246056782334,0.4933753943217666
E01023951,1577,808,769,0.5123652504755866,0.48763474952441344
E01023952,1724,843,881,0.48897911832946633,0.5110208816705336
E01023953,1428,722,706,0.5056022408963585,0.4943977591036415
E01023916,1704,810,894,0.4753521126760563,0.5246478873239436
E01023917,1720,819,901,0.4761627906976744,0.5238372093023256
E01023918,1728,767,961,0.44386574074074076,0.5561342592592593
E01023919,1654,786,868,0.4752116082224909,0.524788391777509
E01023954,1770,866,904,0.48926553672316386,0.5107344632768361
E01023955,1382,651,731,0.4710564399421129,0.5289435600578871
E01023956,1355,641,714,0.47306273062730625,0.5269372693726937
E01023957,1485,705,780,0.47474747474747475,0.5252525252525253
E01023958,1439,675,764,0.46907574704656013,0.5309242529534399
E01023943,1527,730,797,0.47806155861165683,0.5219384413883431
E01023944,2068,1020,1048,0.4932301740812379,0.5067698259187621
E01023945,1594,780,814,0.4893350062735257,0.5106649937264742
E01023946,1551,751,800,0.4842037395228885,0.5157962604771116
E01023939,1224,598,626,0.48856209150326796,0.511437908496732
E01023940,1741,855,886,0.4910970706490523,0.5089029293509477
E01023941,2794,1389,1405,0.4971367215461704,0.5028632784538296
E01023942,1682,777,905,0.4619500594530321,0.5380499405469679
E01023929,1613,795,818,0.49287042777433354,0.5071295722256665
E01023930,1628,840,788,0.515970515970516,0.48402948402948404
E01023938,2854,1482,1372,0.5192711983181499,0.48072880168185006
E01033308,2892,1415,1477,0.4892807745504841,0.5107192254495159
E01033311,1523,769,754,0.504924491135916,0.495075508864084
E01033314,2102,1024,1078,0.4871550903901047,0.5128449096098954
E01023924,1661,910,751,0.5478627332931969,0.45213726670680315
E01023925,1246,588,658,0.47191011235955055,0.5280898876404494
E01023926,1739,895,844,0.5146635997699828,0.48533640023001723
E01023927,1725,847,878,0.4910144927536232,0.5089855072463768
E01023920,1637,844,793,0.5155772755039707,0.4844227244960293
E01023921,2072,1050,1022,0.5067567567567568,0.49324324324324326
E01023922,1768,886,882,0.501131221719457,0.498868778280543
E01023923,1847,939,908,0.5083919870059556,0.4916080129940444
E01023932,1708,923,785,0.5403981264637002,0.4596018735362998
E01023934,1469,784,685,0.5336963921034718,0.46630360789652825
E01023935,1334,703,631,0.5269865067466267,0.47301349325337333
E01023936,2274,1156,1118,0.5083553210202286,0.4916446789797713
E01023937,1334,713,621,0.5344827586206896,0.46551724137931033
E01023933,1510,747,763,0.4947019867549669,0.5052980132450331
E01023963,2236,1085,1151,0.48524150268336314,0.5147584973166368
E01023964,1505,711,794,0.47242524916943524,0.5275747508305648
E01023908,1542,767,775,0.4974059662775616,0.5025940337224384
E01023909,1389,578,811,0.41612670986321093,0.583873290136789
E01023910,1371,665,706,0.4850474106491612,0.5149525893508388
E01023911,1572,705,867,0.4484732824427481,0.5515267175572519
E01023947,1607,816,791,0.507778469197262,0.492221530802738
E01023948,1610,776,834,0.48198757763975153,0.5180124223602485
E01023949,1964,975,989,0.4964358452138493,0.5035641547861507
E01026436,2261,1093,1168,0.4834144183989385,0.5165855816010615
E01026461,1336,654,682,0.48952095808383234,0.5104790419161677
E01026483,1142,569,573,0.4982486865148862,0.5017513134851138
E01033042,2372,1315,1057,0.5543844856661045,0.44561551433389546
E01026442,2163,1071,1092,0.49514563106796117,0.5048543689320388
E01026443,2112,1061,1051,0.5023674242424242,0.49763257575757575
E01026445,2220,1084,1136,0.4882882882882883,0.5117117117117117
E01026462,2240,1089,1151,0.4861607142857143,0.5138392857142857
E01026428,2758,1326,1432,0.4807831762146483,0.5192168237853517
E01026429,1495,721,774,0.4822742474916388,0.5177257525083612
E01026430,1793,851,942,0.4746235359732292,0.5253764640267707
E01026431,1138,534,604,0.46924428822495606,0.5307557117750439
E01026446,1923,956,967,0.4971398855954238,0.5028601144045762
E01026452,1672,816,856,0.4880382775119617,0.5119617224880383
E01026453,1586,805,781,0.5075662042875158,0.49243379571248425
E01026454,1668,822,846,0.49280575539568344,0.5071942446043165
E01026425,1945,938,1007,0.48226221079691517,0.5177377892030849
E01026426,2372,1194,1178,0.5033726812816189,0.4966273187183811
E01026427,2198,1026,1172,0.46678798908098273,0.5332120109190173
E01026432,1470,717,753,0.48775510204081635,0.5122448979591837
E01026433,1470,712,758,0.48435374149659866,0.5156462585034014
E01026434,1970,954,1016,0.4842639593908629,0.515736040609137
E01026479,1489,707,782,0.4748153122901276,0.5251846877098724
E01026480,1463,706,757,0.4825700615174299,0.51742993848257
E01026481,1228,613,615,0.499185667752443,0.500814332247557
E01026484,1371,674,697,0.49161196207148067,0.5083880379285193
E01026485,1089,549,540,0.5041322314049587,0.49586776859504134
E01026455,1901,847,1054,0.445554971067859,0.554445028932141
E01026456,1169,546,623,0.46706586826347307,0.5329341317365269
E01026457,1272,591,681,0.46462264150943394,0.535377358490566
E01026458,1498,704,794,0.4699599465954606,0.5300400534045394
E01026459,1418,671,747,0.47320169252468264,0.5267983074753173
E01026437,1180,571,609,0.48389830508474574,0.5161016949152543
E01026438,1027,502,525,0.48880233690360275,0.5111976630963972
E01026451,2057,973,1084,0.4730189596499757,0.5269810403500244
E01026495,1287,615,672,0.47785547785547783,0.5221445221445221
E01026496,1090,531,559,0.4871559633027523,0.5128440366972477
E01026486,1532,741,791,0.48368146214099217,0.5163185378590078
E01026487,1589,800,789,0.5034612964128382,0.49653870358716173
E01026488,1169,574,595,0.49101796407185627,0.5089820359281437
E01026489,1344,660,684,0.49107142857142855,0.5089285714285714
E01026490,1568,732,836,0.46683673469387754,0.5331632653061225
E01026419,1218,613,605,0.5032840722495895,0.4967159277504105
E01026420,1132,582,550,0.5141342756183745,0.48586572438162545
E01026464,1266,627,639,0.495260663507109,0.504739336492891
E01026491,2148,1048,1100,0.48789571694599626,0.5121042830540037
E01033040,1985,1415,570,0.7128463476070529,0.2871536523929471
E01033041,1061,543,518,0.5117813383600377,0.4882186616399623
E01026422,1946,958,988,0.49229188078108943,0.5077081192189106
E01026423,1814,878,936,0.48401323042998895,0.515986769570011
E01026447,1511,728,783,0.4818001323626737,0.5181998676373263
E01026449,1959,968,991,0.4941296579887698,0.5058703420112303
E01026450,1779,871,908,0.4896008993816751,0.5103991006183249
E01026424,2078,1026,1052,0.4937439846005775,0.5062560153994226
E01026444,2013,988,1025,0.49080973671137607,0.5091902632886239
E01026492,1291,639,652,0.4949651432997676,0.5050348567002324
E01026493,1172,619,553,0.5281569965870307,0.4718430034129693
E01026421,1730,841,889,0.4861271676300578,0.5138728323699422
E01026435,2242,1127,1115,0.5026761819803747,0.49732381801962533
E01026448,2251,1135,1116,0.504220346512661,0.49577965348733893
E01026439,1533,761,772,0.4964122635355512,0.5035877364644488
E01026440,1191,603,588,0.5062972292191436,0.49370277078085645
E01026441,1578,772,806,0.4892268694550063,0.5107731305449936
E01026494,2208,1110,1098,0.5027173913043478,0.49728260869565216
E01026465,1796,887,909,0.4938752783964365,0.5061247216035635
E01026466,1914,967,947,0.5052246603970741,0.4947753396029258
E01026467,2200,1056,1144,0.48,0.52
E01026468,2373,1157,1216,0.48756847871892117,0.5124315212810788
E01026469,1584,806,778,0.5088383838383839,0.4911616161616162
E01026470,2758,1424,1334,0.5163161711385061,0.48368382886149386
E01026471,1240,613,627,0.49435483870967745,0.5056451612903226
E01026472,1206,605,601,0.5016583747927031,0.49834162520729686
E01026473,1474,741,733,0.5027137042062415,0.4972862957937585
E01026474,1691,802,889,0.4742755765819042,0.5257244234180958
E01026475,1471,732,739,0.49762066621346024,0.5023793337865398
E01026476,1485,760,725,0.5117845117845118,0.4882154882154882
E01026477,1447,707,740,0.48859709744298546,0.5114029025570145
E01026478,1701,842,859,0.4950029394473839,0.5049970605526161
E01026499,1520,702,818,0.4618421052631579,0.5381578947368421
E01026500,1701,816,885,0.47971781305114636,0.5202821869488536
E01026501,1607,788,819,0.4903546981953951,0.5096453018046049
E01026502,1161,588,573,0.5064599483204134,0.4935400516795866
E01026503,1389,658,731,0.47372210223182143,0.5262778977681786
E01026522,1437,707,730,0.4919972164231037,0.5080027835768963
E01026523,1862,944,918,0.5069817400644469,0.49301825993555315
E01026524,1443,716,727,0.4961884961884962,0.5038115038115039
E01026525,1068,539,529,0.5046816479400749,0.4953183520599251
E01026547,1419,702,717,0.49471458773784355,0.5052854122621564
E01026548,1290,609,681,0.4720930232558139,0.5279069767441861
E01026514,1533,761,772,0.4964122635355512,0.5035877364644488
E01026515,1082,548,534,0.5064695009242144,0.49353049907578556
E01026516,1248,605,643,0.484775641025641,0.5152243589743589
E01026517,1439,680,759,0.47255038220986795,0.527449617790132
E01026533,1190,592,598,0.49747899159663866,0.5025210084033613
E01026534,1639,819,820,0.4996949359365467,0.5003050640634533
E01026535,1674,835,839,0.498805256869773,0.501194743130227
E01026536,1693,835,858,0.4932073242764324,0.5067926757235677
E01026537,1541,743,798,0.48215444516547695,0.517845554834523
E01026549,1724,850,874,0.49303944315545245,0.5069605568445475
E01026550,1131,560,571,0.4951370468611848,0.5048629531388152
E01026551,1188,580,608,0.4882154882154882,0.5117845117845118
E01026552,1399,707,692,0.505360972122945,0.49463902787705505
E01026562,1231,608,623,0.4939073923639318,0.5060926076360682
E01026563,1410,692,718,0.4907801418439716,0.5092198581560283
E01026564,1631,837,794,0.513182096873084,0.48681790312691603
E01026565,1165,572,593,0.49098712446351933,0.5090128755364807
E01026566,1484,714,770,0.4811320754716981,0.5188679245283019
E01026567,1638,801,837,0.489010989010989,0.510989010989011
E01026568,1583,760,823,0.4801010739102969,0.5198989260897031
E01026518,1395,690,705,0.4946236559139785,0.5053763440860215
E01026519,1707,831,876,0.4868189806678383,0.5131810193321616
E01026520,1115,538,577,0.48251121076233183,0.5174887892376682
E01026521,1272,573,699,0.45047169811320753,0.5495283018867925
E01026545,1633,808,825,0.4947948560930802,0.5052051439069197
E01026546,1502,739,763,0.49201065246338216,0.5079893475366178
E01026578,1972,950,1022,0.4817444219066937,0.5182555780933062
E01026579,1486,740,746,0.4979811574697174,0.5020188425302826
E01026580,1636,785,851,0.4798288508557457,0.5201711491442543
E01026540,1444,670,774,0.46398891966759004,0.53601108033241
E01026541,2428,1174,1254,0.48352553542009885,0.5164744645799012
E01026542,1477,735,742,0.4976303317535545,0.5023696682464455
E01026543,1422,690,732,0.48523206751054854,0.5147679324894515
E01026544,1687,854,833,0.5062240663900415,0.49377593360995853
E01026526,1421,699,722,0.4919071076706545,0.5080928923293455
E01026527,1454,675,779,0.4642365887207703,0.5357634112792297
E01026528,1388,652,736,0.4697406340057637,0.5302593659942363
E01026529,1544,746,798,0.483160621761658,0.5168393782383419
E01026530,1705,865,840,0.5073313782991202,0.49266862170087977
E01026531,1698,840,858,0.49469964664310956,0.5053003533568905
E01026532,1747,860,887,0.4922724670864339,0.5077275329135661
E01026553,1387,668,719,0.4816149963950973,0.5183850036049027
E01026554,1165,548,617,0.4703862660944206,0.5296137339055794
E01026555,1510,728,782,0.4821192052980132,0.5178807947019868
E01026556,1421,682,739,0.47994370161857847,0.5200562983814215
E01026557,1375,671,704,0.488,0.512
E01026558,1276,616,660,0.4827586206896552,0.5172413793103449
E01026559,1479,742,737,0.5016903313049358,0.4983096686950642
E01026560,1340,652,688,0.48656716417910445,0.5134328358208955
E01026561,1388,678,710,0.4884726224783862,0.5115273775216138
E01026504,1532,727,805,0.4745430809399478,0.5254569190600522
E01026505,1372,637,735,0.4642857142857143,0.5357142857142857
E01026506,1367,656,711,0.47988295537673736,0.5201170446232626
E01026507,1323,640,683,0.4837490551776266,0.5162509448223734
E01026512,1297,627,670,0.48342328450269856,0.5165767154973014
E01026513,1346,657,689,0.48811292719167904,0.5118870728083209
E01026569,1427,688,739,0.4821303433777155,0.5178696566222845
E01026570,1574,738,836,0.46886912325285895,0.531130876747141
E01026571,1469,712,757,0.4846834581347856,0.5153165418652145
E01026572,1456,708,748,0.48626373626373626,0.5137362637362637
E01026573,1370,672,698,0.4905109489051095,0.5094890510948905
E01026574,1734,835,899,0.4815455594002307,0.5184544405997693
E01026575,1736,847,889,0.4879032258064516,0.5120967741935484
E01026576,2098,1050,1048,0.5004766444232602,0.49952335557673977
E01026577,1692,848,844,0.5011820330969267,0.4988179669030733
E01026508,1438,686,752,0.47705146036161333,0.5229485396383866
E01026509,1593,794,799,0.49843063402385435,0.5015693659761457
E01026510,1618,769,849,0.4752781211372064,0.5247218788627935
E01026511,1141,565,576,0.49517966695880805,0.5048203330411919
E01026497,1467,720,747,0.49079754601226994,0.50920245398773
E01026498,1357,641,716,0.47236551215917466,0.5276344878408253
E01026538,1568,757,811,0.48278061224489793,0.517219387755102
E01026539,1677,853,824,0.5086463923673226,0.4913536076326774
E01026605,1680,784,896,0.4666666666666667,0.5333333333333333
E01026606,1567,746,821,0.47606892150606256,0.5239310784939375
E01026607,1595,800,795,0.5015673981191222,0.49843260188087773
E01026627,1388,671,717,0.4834293948126801,0.5165706051873199
E01026628,1395,694,701,0.4974910394265233,0.5025089605734767
E01026629,1493,720,773,0.4822505023442733,0.5177494976557268
E01026608,1257,625,632,0.4972155926809865,0.5027844073190135
E01026609,1169,566,603,0.48417450812660395,0.5158254918733961
E01026636,1549,775,774,0.500322788896062,0.49967721110393803
E01026637,2007,988,1019,0.4922770303936223,0.5077229696063776
E01026638,1562,742,820,0.47503201024327785,0.5249679897567221
E01026589,1424,701,723,0.4922752808988764,0.5077247191011236
E01026590,1382,664,718,0.4804630969609262,0.5195369030390738
E01026591,1745,819,926,0.46934097421203436,0.5306590257879656
E01026592,1449,695,754,0.47964113181504486,0.5203588681849551
E01026593,1314,655,659,0.4984779299847793,0.5015220700152208
E01026594,1762,841,921,0.47729852440408627,0.5227014755959137
E01026599,1432,722,710,0.5041899441340782,0.4958100558659218
E01026639,1562,786,776,0.5032010243277849,0.4967989756722151
E01026640,1577,732,845,0.4641724793912492,0.5358275206087508
E01026641,1507,714,793,0.47378898473788983,0.5262110152621101
E01026595,1708,789,919,0.46194379391100704,0.538056206088993
E01026596,1691,806,885,0.47664104080425784,0.5233589591957422
E01026597,1862,933,929,0.5010741138560687,0.49892588614393124
E01026598,1605,820,785,0.5109034267912772,0.48909657320872274
E01026622,1642,822,820,0.5006090133982948,0.4993909866017052
E01026623,1542,851,691,0.5518806744487679,0.4481193255512322
E01026624,1798,911,887,0.5066740823136818,0.4933259176863181
E01026625,1795,919,876,0.5119777158774373,0.48802228412256266
E01026626,1904,972,932,0.5105042016806722,0.4894957983193277
E01026600,1477,730,747,0.4942450914014895,0.5057549085985105
E01026633,1861,952,909,0.5115529285330468,0.48844707146695326
E01026634,1543,773,770,0.5009721322099806,0.49902786779001945
E01026635,2253,1132,1121,0.5024411895250777,0.49755881047492234
E01026581,1686,856,830,0.5077105575326216,0.49228944246737844
E01026582,1938,941,997,0.4855521155830753,0.5144478844169247
E01026583,1328,641,687,0.48268072289156627,0.5173192771084337
E01026584,1496,752,744,0.5026737967914439,0.49732620320855614
E01026601,1490,715,775,0.4798657718120805,0.5201342281879194
E01026602,1481,718,763,0.48480756245779877,0.5151924375422012
E01026603,1664,800,864,0.4807692307692308,0.5192307692307693
E01026604,1577,799,778,0.5066582117945466,0.4933417882054534
E01026632,1676,795,881,0.4743436754176611,0.5256563245823389
E01026610,1533,749,784,0.4885844748858447,0.5114155251141552
E01026611,1513,722,791,0.47719762062128224,0.5228023793787178
E01026612,2502,1201,1301,0.4800159872102318,0.5199840127897681
E01026630,1737,833,904,0.47956246401842256,0.5204375359815774
E01026631,1718,883,835,0.5139697322467986,0.4860302677532014
E01026617,1277,632,645,0.49490994518402504,0.5050900548159749
E01026618,1592,770,822,0.4836683417085427,0.5163316582914573
E01026619,1498,711,787,0.47463284379172227,0.5253671562082777
E01026620,1436,671,765,0.4672701949860724,0.5327298050139275
E01026621,1453,731,722,0.5030970406056435,0.4969029593943565
E01026613,1296,645,651,0.4976851851851852,0.5023148148148148
E01026614,1602,796,806,0.4968789013732834,0.5031210986267166
E01026615,1355,679,676,0.5011070110701107,0.4988929889298893
E01026616,1226,610,616,0.49755301794453505,0.5024469820554649
E01026585,1284,615,669,0.47897196261682246,0.5210280373831776
E01026586,1048,491,557,0.4685114503816794,0.5314885496183206
E01026587,1748,867,881,0.4959954233409611,0.5040045766590389
E01026588,2626,1289,1337,0.4908606245239909,0.5091393754760092
E01026680,1457,633,824,0.4344543582704187,0.5655456417295813
E01026681,1409,695,714,0.49325762952448543,0.5067423704755145
E01026682,1258,567,691,0.4507154213036566,0.5492845786963434
E01026683,1296,626,670,0.48302469135802467,0.5169753086419753
E01026645,1293,627,666,0.48491879350348027,0.5150812064965197
E01026646,1714,823,891,0.48016336056009334,0.5198366394399067
E01026656,1937,926,1011,0.4780588538977801,0.52194114610222
E01026695,2128,1083,1045,0.5089285714285714,0.49107142857142855
E01026676,1678,785,893,0.46781883194278906,0.5321811680572109
E01026677,1504,697,807,0.4634308510638298,0.5365691489361702
E01026678,1568,752,816,0.47959183673469385,0.5204081632653061
E01026701,1587,739,848,0.465658475110271,0.5343415248897291
E01026702,1280,594,686,0.4640625,0.5359375
E01026703,1165,575,590,0.49356223175965663,0.5064377682403434
E01026653,1740,811,929,0.46609195402298853,0.5339080459770115
E01026654,1555,717,838,0.46109324758842446,0.5389067524115756
E01026655,1345,620,725,0.46096654275092935,0.5390334572490706
E01026718,2256,1092,1164,0.48404255319148937,0.5159574468085106
E01026691,1174,577,597,0.49148211243611584,0.5085178875638842
E01026692,1271,609,662,0.47915027537372146,0.5208497246262785
E01026708,1355,658,697,0.48560885608856086,0.5143911439114391
E01026709,1915,906,1009,0.4731070496083551,0.5268929503916449
E01026710,1193,587,606,0.4920368818105616,0.5079631181894384
E01026669,1624,767,857,0.4722906403940887,0.5277093596059114
E01026670,1624,777,847,0.47844827586206895,0.521551724137931
E01026671,1407,712,695,0.5060412224591329,0.4939587775408671
E01026672,1493,725,768,0.4855994641661085,0.5144005358338914
E01026673,1533,760,773,0.4957599478147423,0.5042400521852577
E01026687,1575,778,797,0.49396825396825395,0.506031746031746
E01026688,1485,694,791,0.46734006734006733,0.5326599326599326
E01026689,1525,762,763,0.499672131147541,0.5003278688524591
E01026690,1487,724,763,0.48688634835238737,0.5131136516476127
E01026647,2171,1072,1099,0.493781667434362,0.506218332565638
E01026711,1522,728,794,0.4783180026281209,0.5216819973718791
E01026712,1639,793,846,0.4838316046369738,0.5161683953630263
E01026713,1537,770,767,0.5009759271307742,0.4990240728692258
E01026666,1904,894,1010,0.4695378151260504,0.5304621848739496
E01026667,1622,790,832,0.4870530209617756,0.5129469790382244
E01026668,1589,794,795,0.49968533668974197,0.500314663310258
E01026693,1907,955,952,0.5007865757734662,0.4992134242265338
E01026662,2483,1229,1254,0.49496576721707614,0.5050342327829239
E01026663,1794,865,929,0.4821627647714604,0.5178372352285395
E01026664,2202,1062,1140,0.4822888283378747,0.5177111716621253
E01026714,2027,973,1054,0.48001973359644795,0.519980266403552
E01026698,1950,953,997,0.4887179487179487,0.5112820512820513
E01026699,1505,754,751,0.5009966777408638,0.49900332225913624
E01026700,1406,771,635,0.5483641536273115,0.4516358463726885
E01026704,1828,884,944,0.48358862144420134,0.5164113785557987
E01026705,1575,772,803,0.4901587301587302,0.5098412698412699
E01026706,1568,772,796,0.4923469387755102,0.5076530612244898
E01026665,2240,1080,1160,0.48214285714285715,0.5178571428571429
E01026674,1117,525,592,0.4700089525514772,0.5299910474485229
E01026675,1220,594,626,0.48688524590163934,0.5131147540983606
E01026694,2431,1197,1234,0.49238996297819826,0.5076100370218017
E01026684,1209,596,613,0.49296939619520264,0.5070306038047974
E01026685,1276,612,664,0.47962382445141066,0.5203761755485894
E01026719,2322,1180,1142,0.508182601205857,0.491817398794143
E01026720,1324,680,644,0.513595166163142,0.486404833836858
E01026721,1317,649,668,0.49278663629460895,0.507213363705391
E01026642,1338,635,703,0.47458893871449925,0.5254110612855007
E01026643,1400,710,690,0.5071428571428571,0.4928571428571429
E01026644,2798,1706,1092,0.6097212294496068,0.3902787705503931
E01026723,1619,804,815,0.49660284126003706,0.5033971587399629
E01026724,1665,794,871,0.47687687687687685,0.5231231231231231
E01026725,1450,706,744,0.4868965517241379,0.5131034482758621
E01026696,1196,579,617,0.48411371237458195,0.5158862876254181
E01026697,1271,617,654,0.4854445318646735,0.5145554681353265
E01026722,2455,1182,1273,0.4814663951120163,0.5185336048879837
E01026726,2102,1064,1038,0.5061845861084682,0.4938154138915319
E01026659,1572,808,764,0.5139949109414759,0.4860050890585242
E01026660,1648,792,856,0.48058252427184467,0.5194174757281553
E01026661,1480,718,762,0.4851351351351351,0.5148648648648648
E01026715,1421,676,745,0.4757213230119634,0.5242786769880365
E01026716,1871,916,955,0.48957776590058794,0.5104222340994121
E01026717,1535,787,748,0.5127035830618892,0.48729641693811077
E01026686,2017,957,1060,0.4744670302429351,0.525532969757065
E01026707,2079,976,1103,0.46945646945646946,0.5305435305435305
E01033036,1615,778,837,0.48173374613003095,0.518266253869969
E01033037,1514,736,778,0.4861294583883752,0.5138705416116248
E01033038,1761,820,941,0.46564452015900054,0.5343554798409994
E01033039,1008,485,523,0.48115079365079366,0.5188492063492064
E01026679,2409,1214,1195,0.5039435450394355,0.49605645496056455
E01026727,2504,1219,1285,0.48682108626198084,0.5131789137380192
E01026728,2276,1102,1174,0.484182776801406,0.515817223198594
E01026648,1506,737,769,0.4893758300132802,0.5106241699867198
E01026649,1566,783,783,0.5,0.5
E01026650,1203,584,619,0.485453034081463,0.514546965918537
E01026651,2332,1161,1171,0.4978559176672384,0.5021440823327615
E01026652,1324,665,659,0.5022658610271903,0.49773413897280966
E01026770,1987,917,1070,0.4614997483643684,0.5385002516356316
E01026771,1596,737,859,0.4617794486215539,0.5382205513784462
E01026772,1722,827,895,0.4802555168408827,0.5197444831591173
E01026773,2062,972,1090,0.4713870029097963,0.5286129970902037
E01026739,2044,969,1075,0.4740704500978474,0.5259295499021527
E01026763,1383,675,708,0.4880694143167028,0.5119305856832972
E01026764,1195,557,638,0.4661087866108787,0.5338912133891214
E01026765,1330,655,675,0.4924812030075188,0.5075187969924813
E01026734,1159,604,555,0.5211389128559103,0.47886108714408976
E01026735,1199,562,637,0.46872393661384487,0.5312760633861552
E01026736,1290,606,684,0.4697674418604651,0.5302325581395348
E01026777,1123,528,595,0.4701691896705254,0.5298308103294747
E01026778,1441,628,813,0.4358084663428175,0.5641915336571826
E01026779,1471,706,765,0.4799456152277362,0.5200543847722637
E01026741,1894,910,984,0.4804646251319958,0.5195353748680043
E01026742,1579,728,851,0.461051298290057,0.538948701709943
E01026743,2231,1029,1202,0.4612281488121918,0.5387718511878081
E01026762,2401,1165,1236,0.48521449396084965,0.5147855060391504
E01026766,2231,1104,1127,0.4948453608247423,0.5051546391752577
E01026781,2125,1053,1072,0.4955294117647059,0.5044705882352941
E01026731,1062,500,562,0.4708097928436911,0.5291902071563088
E01026732,1253,620,633,0.4948124501197127,0.5051875498802874
E01026733,2322,1127,1195,0.4853574504737295,0.5146425495262704
E01026737,2344,1164,1180,0.49658703071672355,0.5034129692832765
E01026738,2456,1207,1249,0.49144951140065146,0.5085504885993485
E01026750,1363,634,729,0.46515040352164344,0.5348495964783566
E01026751,1395,635,760,0.4551971326164875,0.5448028673835126
E01026752,1433,708,725,0.49406838799720865,0.5059316120027914
E01026729,2244,1113,1131,0.4959893048128342,0.5040106951871658
E01026730,2439,1197,1242,0.4907749077490775,0.5092250922509225
E01026788,1265,629,636,0.4972332015810277,0.5027667984189723
E01026780,2521,1239,1282,0.49147163823879414,0.5085283617612059
E01026782,2167,1050,1117,0.4845408398707891,0.5154591601292109
E01026787,1040,519,521,0.49903846153846154,0.5009615384615385
E01026753,1575,741,834,0.4704761904761905,0.5295238095238095
E01026754,1413,667,746,0.4720452937013447,0.5279547062986554
E01026755,1215,580,635,0.4773662551440329,0.522633744855967
E01026756,1233,576,657,0.46715328467153283,0.5328467153284672
E01026757,1583,776,807,0.4902084649399874,0.5097915350600126
E01026758,1374,660,714,0.48034934497816595,0.519650655021834
E01026759,1339,614,725,0.4585511575802838,0.5414488424197162
E01026760,1334,642,692,0.48125937031484256,0.5187406296851574
E01026761,1568,759,809,0.4840561224489796,0.5159438775510204
E01026745,1649,772,877,0.4681625227410552,0.5318374772589448
E01026746,1657,810,847,0.4888352444176222,0.5111647555823778
E01026747,1329,656,673,0.49360421369450713,0.5063957863054929
E01026748,1430,692,738,0.48391608391608393,0.5160839160839161
E01026749,1552,717,835,0.46198453608247425,0.5380154639175257
E01026740,2386,1149,1237,0.4815590947191953,0.5184409052808047
E01026767,1253,627,626,0.5003990422984836,0.49960095770151636
E01026768,1681,1117,564,0.6644854253420583,0.3355145746579417
E01026789,1223,603,620,0.49304987735077677,0.5069501226492232
E01026790,1161,571,590,0.491817398794143,0.508182601205857
E01026774,1451,707,744,0.487250172294969,0.512749827705031
E01026775,1273,580,693,0.4556166535742341,0.5443833464257659
E01026776,1588,790,798,0.49748110831234255,0.5025188916876574
E01026786,2190,1107,1083,0.5054794520547945,0.4945205479452055
E01026744,1948,927,1021,0.4758726899383984,0.5241273100616016
E01026769,2130,1008,1122,0.4732394366197183,0.5267605633802817
E01026783,1801,882,919,0.48972792892837314,0.5102720710716269
E01026784,1045,524,521,0.5014354066985646,0.49856459330143543
E01026785,1351,675,676,0.4996299037749815,0.5003700962250185
E01026797,2402,1243,1159,0.5174854288093256,0.4825145711906744
E01026798,1533,781,752,0.5094585779517287,0.49054142204827134
E01026799,1459,728,731,0.498971898560658,0.5010281014393421
E01026800,1991,1036,955,0.5203415369161225,0.47965846308387744
E01026801,1606,778,828,0.48443337484433374,0.5155666251556662
E01026802,1605,783,822,0.48785046728971965,0.5121495327102804
E01026828,1744,842,902,0.4827981651376147,0.5172018348623854
E01026829,2093,1031,1062,0.4925943621595795,0.5074056378404205
E01026830,1276,649,627,0.5086206896551724,0.49137931034482757
E01026831,1242,647,595,0.5209339774557166,0.47906602254428343
E01026832,1415,689,726,0.48692579505300354,0.5130742049469965
E01026833,1382,723,659,0.5231548480463097,0.4768451519536903
E01026834,1503,712,791,0.4737192282102462,0.5262807717897539
E01026841,1453,761,692,0.5237439779766001,0.47625602202339984
E01026842,1648,832,816,0.5048543689320388,0.49514563106796117
E01026843,1905,887,1018,0.46561679790026245,0.5343832020997376
E01026844,1741,878,863,0.5043078690407812,0.4956921309592188
E01026845,1561,775,786,0.4964766175528507,0.5035233824471492
E01026846,1626,818,808,0.5030750307503075,0.4969249692496925
E01026803,1438,653,785,0.4541029207232267,0.5458970792767733
E01026804,1429,679,750,0.47515745276417076,0.5248425472358292
E01026805,1421,681,740,0.4792399718508093,0.5207600281491908
E01026806,1503,942,561,0.626746506986028,0.37325349301397204
E01026807,1252,614,638,0.4904153354632588,0.5095846645367412
E01026808,1320,653,667,0.4946969696969697,0.5053030303030303
E01026809,1492,754,738,0.5053619302949062,0.49463806970509383
E01026791,1475,741,734,0.5023728813559322,0.4976271186440678
E01026792,1445,695,750,0.4809688581314879,0.5190311418685121
E01026793,1817,861,956,0.47385800770500824,0.5261419922949917
E01026794,2065,1029,1036,0.49830508474576274,0.5016949152542373
E01026796,1643,789,854,0.480219111381619,0.519780888618381
E01033435,1845,889,956,0.48184281842818427,0.5181571815718157
E01033436,1393,668,725,0.47954055994257,0.5204594400574301
E01026863,1814,895,919,0.4933847850055127,0.5066152149944874
E01026864,1547,768,779,0.4964447317388494,0.5035552682611506
E01026865,1949,961,988,0.4930733709594664,0.5069266290405336
E01026866,1574,779,795,0.4949174078780178,0.5050825921219823
E01026867,1592,776,816,0.48743718592964824,0.5125628140703518
E01026868,1628,796,832,0.48894348894348894,0.5110565110565111
E01026869,1400,700,700,0.5,0.5
E01026822,2031,1037,994,0.5105859182668636,0.4894140817331364
E01026823,1906,1015,891,0.5325288562434418,0.46747114375655824
E01026824,1471,724,747,0.4921821889870836,0.5078178110129163
E01026825,1276,659,617,0.5164576802507836,0.4835423197492163
E01026826,1456,724,732,0.49725274725274726,0.5027472527472527
E01026827,1501,722,779,0.4810126582278481,0.5189873417721519
E01026835,1502,710,792,0.47270306258322237,0.5272969374167776
E01026836,1566,762,804,0.48659003831417624,0.5134099616858238
E01026837,1471,745,726,0.5064581917063222,0.4935418082936778
E01026838,1551,696,855,0.44874274661508706,0.5512572533849129
E01026839,1596,742,854,0.4649122807017544,0.5350877192982456
E01026840,1611,786,825,0.48789571694599626,0.5121042830540037
E01026858,1512,709,803,0.4689153439153439,0.531084656084656
E01026859,1659,776,883,0.46775165762507537,0.5322483423749247
E01026860,4313,1994,2319,0.4623232089033156,0.5376767910966844
E01026861,1493,699,794,0.4681848626925653,0.5318151373074347
E01026862,1302,614,688,0.4715821812596006,0.5284178187403994
E01026852,1295,598,697,0.4617760617760618,0.5382239382239382
E01026853,1751,926,825,0.5288406624785836,0.4711593375214163
E01026855,1568,796,772,0.5076530612244898,0.4923469387755102
E01026856,1821,852,969,0.46787479406919275,0.5321252059308073
E01026857,1515,710,805,0.46864686468646866,0.5313531353135313
E01033434,1076,572,504,0.5315985130111525,0.4684014869888476
E01033437,1378,663,715,0.4811320754716981,0.5188679245283019
E01026810,1389,640,749,0.4607631389488841,0.5392368610511159
E01026811,1544,747,797,0.4838082901554404,0.5161917098445595
E01026812,1425,698,727,0.4898245614035088,0.5101754385964913
E01026813,1426,694,732,0.48667601683029454,0.5133239831697055
E01026814,1522,738,784,0.48488830486202367,0.5151116951379764
E01026815,1475,681,794,0.4616949152542373,0.5383050847457627
E01026816,1741,837,904,0.4807581849511775,0.5192418150488225
E01026817,1415,670,745,0.4734982332155477,0.5265017667844523
E01026818,1462,708,754,0.4842681258549932,0.5157318741450069
E01026819,1439,690,749,0.4794996525364837,0.5205003474635164
E01026820,1727,822,905,0.47596988998262885,0.5240301100173712
E01026821,1542,727,815,0.4714656290531777,0.5285343709468223
E01033438,1397,691,706,0.49463135289906945,0.5053686471009305
E01033439,1440,759,681,0.5270833333333333,0.47291666666666665
E01033440,1070,608,462,0.5682242990654206,0.43177570093457945
E01033441,1229,680,549,0.5532953620829943,0.4467046379170057
E01026848,1856,877,979,0.47252155172413796,0.5274784482758621
E01026849,1738,924,814,0.5316455696202531,0.46835443037974683
E01026850,1827,929,898,0.5084838533114395,0.4915161466885605
E01026916,2028,1019,1009,0.502465483234714,0.497534516765286
E01026917,1481,721,760,0.48683322079675895,0.513166779203241
E01026918,1689,862,827,0.5103611604499704,0.4896388395500296
E01026924,1514,742,772,0.4900924702774108,0.5099075297225891
E01026925,2102,1019,1083,0.48477640342530925,0.5152235965746907
E01033538,2165,1070,1095,0.4942263279445728,0.5057736720554272
E01033540,1484,738,746,0.4973045822102426,0.5026954177897575
E01026881,1335,641,694,0.4801498127340824,0.5198501872659176
E01026882,2072,982,1090,0.47393822393822393,0.5260617760617761
E01026883,1645,787,858,0.478419452887538,0.521580547112462
E01026895,1514,760,754,0.5019815059445178,0.49801849405548215
E01026896,1203,581,622,0.4829592684954281,0.5170407315045719
E01026905,1025,476,549,0.46439024390243905,0.535609756097561
E01026906,1375,666,709,0.4843636363636364,0.5156363636363637
E01026907,1832,874,958,0.47707423580786024,0.5229257641921398
E01026908,1459,697,762,0.47772446881425634,0.5222755311857437
E01026909,1420,684,736,0.48169014084507045,0.5183098591549296
E01026910,1488,730,758,0.4905913978494624,0.5094086021505376
E01026947,1315,640,675,0.4866920152091255,0.5133079847908745
E01026948,1993,993,1000,0.49824385348720523,0.5017561465127948
E01026870,1553,728,825,0.4687701223438506,0.5312298776561494
E01026871,1296,629,667,0.4853395061728395,0.5146604938271605
E01026921,1366,669,697,0.48975109809663253,0.5102489019033675
E01026922,1499,707,792,0.47164776517678453,0.5283522348232155
E01026875,1142,560,582,0.4903677758318739,0.5096322241681261
E01026876,1520,704,816,0.4631578947368421,0.5368421052631579
E01026926,1555,746,809,0.4797427652733119,0.5202572347266881
E01026927,1837,904,933,0.49210669569951004,0.50789330430049
E01026928,1434,684,750,0.4769874476987448,0.5230125523012552
E01026936,1392,664,728,0.47701149425287354,0.5229885057471264
E01026937,1475,696,779,0.471864406779661,0.528135593220339
E01026884,1157,548,609,0.4736387208297321,0.526361279170268
E01026885,1435,733,702,0.510801393728223,0.489198606271777
E01026933,2789,1338,1451,0.479741842954464,0.520258157045536
E01026945,2234,1096,1138,0.4905998209489705,0.5094001790510295
E01026946,1076,517,559,0.4804832713754647,0.5195167286245354
E01026879,1228,605,623,0.49267100977198697,0.507328990228013
E01026880,1485,723,762,0.4868686868686869,0.5131313131313131
E01026911,1108,511,597,0.4611913357400722,0.5388086642599278
E01026912,1540,762,778,0.4948051948051948,0.5051948051948052
E01026929,1304,639,665,0.49003067484662577,0.5099693251533742
E01026930,1535,786,749,0.5120521172638437,0.48794788273615636
E01026913,1639,798,841,0.48688224527150703,0.513117754728493
E01026914,1518,719,799,0.4736495388669302,0.5263504611330698
E01026915,1964,951,1013,0.48421588594704684,0.5157841140529531
E01026919,1524,718,806,0.47112860892388453,0.5288713910761155
E01026920,1134,539,595,0.47530864197530864,0.5246913580246914
E01026941,1250,630,620,0.504,0.496
E01026942,1149,569,580,0.49521322889469105,0.504786771105309
E01026898,1392,685,707,0.4920977011494253,0.5079022988505747
E01026899,1479,725,754,0.49019607843137253,0.5098039215686274
E01026943,1537,788,749,0.5126870527000651,0.48731294729993496
E01026944,1189,595,594,0.5004205214465938,0.49957947855340623
E01026877,1537,761,776,0.4951203643461288,0.5048796356538712
E01026878,1200,588,612,0.49,0.51
E01026897,2701,1338,1363,0.4953720844131803,0.5046279155868197
E01026938,1983,953,1030,0.48058497226424607,0.5194150277357539
E01026939,1735,900,835,0.5187319884726225,0.4812680115273775
E01026940,1801,882,919,0.48972792892837314,0.5102720710716269
E01026892,1306,639,667,0.4892802450229709,0.5107197549770292
E01026893,1027,515,512,0.501460564751704,0.498539435248296
E01026894,2444,1174,1270,0.48036006546644844,0.5196399345335515
E01026903,1198,603,595,0.503338898163606,0.496661101836394
E01026904,1362,655,707,0.48091042584434657,0.5190895741556535
E01026872,2200,1117,1083,0.5077272727272727,0.49227272727272725
E01026900,1446,682,764,0.47164591977869985,0.5283540802213001
E01026901,1333,621,712,0.46586646661665415,0.5341335333833458
E01026902,1862,935,927,0.5021482277121375,0.49785177228786254
E01026873,1265,630,635,0.4980237154150198,0.5019762845849802
E01026874,1545,761,784,0.4925566343042071,0.5074433656957928
E01026886,1342,663,679,0.4940387481371088,0.5059612518628912
E01026887,1472,746,726,0.5067934782608695,0.49320652173913043
E01026934,1028,514,514,0.5,0.5
E01026935,1329,642,687,0.48306997742663654,0.5169300225733634
E01026888,1617,741,876,0.4582560296846011,0.5417439703153989
E01026889,1522,719,803,0.4724047306176084,0.5275952693823915
E01026891,1646,798,848,0.4848116646415553,0.5151883353584447
E01026931,1214,605,609,0.49835255354200986,0.5016474464579901
E01026932,1236,612,624,0.49514563106796117,0.5048543689320388
E01033539,1391,691,700,0.49676491732566497,0.503235082674335
E01033541,1396,682,714,0.4885386819484241,0.5114613180515759
E01029876,2181,1126,1055,0.5162769371847776,0.48372306281522237
E01029898,1722,822,900,0.47735191637630664,0.5226480836236934
E01029907,2162,1054,1108,0.48751156336725254,0.5124884366327475
E01029881,2057,1018,1039,0.4948954788526981,0.5051045211473019
E01029884,1556,783,773,0.5032133676092545,0.4967866323907455
E01029885,2145,1078,1067,0.5025641025641026,0.49743589743589745
E01029900,1622,784,838,0.4833538840937115,0.5166461159062885
E01029901,2152,1064,1088,0.4944237918215613,0.5055762081784386
E01029917,1893,916,977,0.48388800845219226,0.5161119915478077
E01029892,1835,884,951,0.4817438692098093,0.5182561307901907
E01029893,2686,1324,1362,0.49292628443782577,0.5070737155621743
E01029894,1163,578,585,0.49699054170249357,0.5030094582975064
E01029895,1189,575,614,0.48359966358284273,0.5164003364171573
E01029896,1380,638,742,0.4623188405797101,0.5376811594202898
E01029911,2191,1082,1109,0.49383842994066635,0.5061615700593336
E01029877,1295,639,656,0.4934362934362934,0.5065637065637065
E01029878,1198,577,621,0.48163606010016696,0.5183639398998331
E01029879,1515,756,759,0.499009900990099,0.500990099009901
E01029908,1629,792,837,0.4861878453038674,0.5138121546961326
E01029909,1556,762,794,0.4897172236503856,0.5102827763496144
E01029910,1157,580,577,0.5012964563526361,0.49870354364736386
E01029880,1699,845,854,0.4973513831665686,0.5026486168334314
E01029921,1270,635,635,0.5,0.5
E01029922,1306,639,667,0.4892802450229709,0.5107197549770292
E01029923,1399,690,709,0.49320943531093636,0.5067905646890636
E01029912,1615,756,859,0.4681114551083591,0.5318885448916408
E01029913,1083,500,583,0.4616805170821791,0.5383194829178208
E01029914,1620,803,817,0.495679012345679,0.504320987654321
E01029915,1223,582,641,0.4758789860997547,0.5241210139002453
E01029916,1313,626,687,0.4767707539984768,0.5232292460015232
E01029918,1107,575,532,0.5194218608852755,0.48057813911472447
E01029919,1485,700,785,0.4713804713804714,0.5286195286195287
E01029920,1724,786,938,0.45591647331786544,0.5440835266821346
E01029886,1294,594,700,0.45904173106646057,0.5409582689335394
E01029887,1800,889,911,0.4938888888888889,0.5061111111111111
E01029888,1203,586,617,0.48711554447215294,0.512884455527847
E01029889,1349,669,680,0.49592290585618976,0.5040770941438102
E01029890,1337,672,665,0.5026178010471204,0.4973821989528796
E01029891,1925,978,947,0.5080519480519481,0.49194805194805197
E01029875,2170,1092,1078,0.5032258064516129,0.4967741935483871
E01029899,1772,852,920,0.48081264108352145,0.5191873589164786
E01029902,2150,1095,1055,0.5093023255813953,0.4906976744186046
E01029906,1845,863,982,0.46775067750677507,0.532249322493225
E01029870,1165,557,608,0.4781115879828326,0.5218884120171674
E01029872,1401,708,693,0.5053533190578159,0.49464668094218417
E01029882,1561,773,788,0.4951953875720692,0.5048046124279308
E01029883,1980,1000,980,0.5050505050505051,0.494949494949495
E01029903,1403,698,705,0.49750534568781185,0.5024946543121882
E01029904,1444,718,726,0.49722991689750695,0.502770083102493
E01029905,1087,527,560,0.48482060717571296,0.515179392824287
E01029871,1352,641,711,0.47411242603550297,0.525887573964497
E01029873,2157,1063,1094,0.49281409364858597,0.507185906351414
E01029874,1750,862,888,0.49257142857142855,0.5074285714285715
E01029897,2467,1198,1269,0.48561005269558166,0.5143899473044183
E01029926,1664,818,846,0.49158653846153844,0.5084134615384616
E01029927,2360,1180,1180,0.5,0.5
E01029928,1829,918,911,0.5019136139967195,0.4980863860032805
E01029929,2238,1118,1120,0.49955317247542447,0.5004468275245755
E01029930,1545,785,760,0.5080906148867314,0.4919093851132686
E01029942,1473,738,735,0.5010183299389002,0.4989816700610998
E01029944,1671,829,842,0.49611011370436864,0.5038898862956314
E01033453,3414,1939,1475,0.5679554774458113,0.4320445225541886
E01029945,1922,975,947,0.5072840790842872,0.4927159209157128
E01032523,1315,706,609,0.5368821292775665,0.46311787072243343
E01032524,983,481,502,0.4893184130213632,0.5106815869786369
E01032525,2833,1434,1399,0.5061771973173315,0.49382280268266854
E01032526,1627,840,787,0.5162876459741856,0.48371235402581436
E01029938,1401,725,676,0.5174875089221984,0.4825124910778016
E01029939,1540,772,768,0.5012987012987012,0.4987012987012987
E01029940,1433,701,732,0.4891835310537334,0.5108164689462665
E01029946,2112,1039,1073,0.49195075757575757,0.5080492424242424
E01029947,2202,1089,1113,0.494550408719346,0.5054495912806539
E01029941,1824,931,893,0.5104166666666666,0.4895833333333333
E01029957,1663,810,853,0.48707155742633795,0.5129284425736621
E01033451,1475,717,758,0.48610169491525423,0.5138983050847458
E01033452,1394,722,672,0.5179340028694405,0.48206599713055953
E01033454,1255,651,604,0.5187250996015936,0.48127490039840637
E01029937,1960,1004,956,0.5122448979591837,0.48775510204081635
E01029953,1424,692,732,0.4859550561797753,0.5140449438202247
E01029954,2439,1216,1223,0.4985649856498565,0.5014350143501435
E01029955,1817,885,932,0.4870665932856357,0.5129334067143644
E01029956,1356,692,664,0.5103244837758112,0.4896755162241888
E01029925,1714,871,843,0.5081680280046674,0.4918319719953326
E01029949,1404,679,725,0.48361823361823364,0.5163817663817664
E01029950,1785,897,888,0.5025210084033613,0.49747899159663866
E01029951,1393,684,709,0.4910265613783202,0.5089734386216799
E01029952,1261,602,659,0.4773988897700238,0.5226011102299762
E01032612,2022,1013,1009,0.5009891196834817,0.4990108803165183
E01030032,1506,725,781,0.4814077025232404,0.5185922974767596
E01030033,1534,756,778,0.49282920469361147,0.5071707953063885
E01030034,1414,687,727,0.48585572842998587,0.5141442715700142
E01030035,1842,902,940,0.48968512486427795,0.510314875135722
E01030036,1743,835,908,0.4790590935169248,0.5209409064830751
E01029973,1515,735,780,0.48514851485148514,0.5148514851485149
E01029974,1568,769,799,0.49043367346938777,0.5095663265306123
E01029975,1294,626,668,0.48377125193199383,0.5162287480680062
E01029976,1549,783,766,0.5054874112330536,0.4945125887669464
E01029977,1537,751,786,0.4886141834743006,0.5113858165256994
E01030027,2059,1047,1012,0.508499271491015,0.49150072850898496
E01030028,1631,792,839,0.4855916615573268,0.5144083384426732
E01030029,1637,818,819,0.49969456322541234,0.5003054367745876
E01030030,2001,1004,997,0.5017491254372813,0.49825087456271866
E01030031,1551,753,798,0.48549323017408125,0.5145067698259188
E01029997,1591,770,821,0.48397234443746073,0.5160276555625393
E01029998,1902,926,976,0.4868559411146162,0.5131440588853838
E01029999,1708,847,861,0.4959016393442623,0.5040983606557377
E01030000,1569,775,794,0.49394518801784576,0.5060548119821542
E01030001,1554,735,819,0.47297297297297297,0.527027027027027
E01030007,1650,798,852,0.48363636363636364,0.5163636363636364
E01030008,1303,611,692,0.4689178818112049,0.5310821181887951
E01030009,1481,736,745,0.49696151249155973,0.5030384875084403
E01030010,1854,924,930,0.49838187702265374,0.5016181229773463
E01030011,1588,767,821,0.48299748110831237,0.5170025188916877
E01030022,2199,1140,1059,0.5184174624829468,0.4815825375170532
E01030023,1886,999,887,0.5296924708377518,0.47030752916224816
E01030024,2341,1386,955,0.5920546774882529,0.40794532251174714
E01030025,1788,896,892,0.5011185682326622,0.4988814317673378
E01030026,1724,849,875,0.49245939675174016,0.5075406032482599
E01029958,1420,715,705,0.5035211267605634,0.4964788732394366
E01029960,1795,864,931,0.4813370473537604,0.5186629526462395
E01029961,1523,744,779,0.4885095206828628,0.5114904793171372
E01029962,1594,828,766,0.5194479297365119,0.48055207026348806
E01033124,1105,563,542,0.5095022624434389,0.49049773755656106
E01033125,1022,577,445,0.5645792563600783,0.4354207436399217
E01033129,1241,705,536,0.5680902497985496,0.43190975020145045
E01030002,1913,924,989,0.4830109775222164,0.5169890224777836
E01030003,1736,823,913,0.4740783410138249,0.5259216589861752
E01030004,1341,657,684,0.4899328859060403,0.5100671140939598
E01030005,2316,1123,1193,0.4848877374784111,0.5151122625215889
E01030006,1828,893,935,0.4885120350109409,0.5114879649890591
E01029963,1541,764,777,0.49578195976638545,0.5042180402336145
E01029964,1341,704,637,0.5249813571961223,0.4750186428038777
E01029965,1474,705,769,0.47829036635006783,0.5217096336499322
E01029966,1402,712,690,0.5078459343794579,0.4921540656205421
E01029967,1297,605,692,0.4664610639938319,0.5335389360061681
E01029984,1527,750,777,0.4911591355599214,0.5088408644400786
E01029985,2305,1211,1094,0.5253796095444685,0.47462039045553145
E01029986,1573,764,809,0.48569612205975843,0.5143038779402416
E01029987,1562,763,799,0.4884763124199744,0.5115236875800256
E01029988,1859,1037,822,0.5578267885960194,0.44217321140398064
E01029990,1617,837,780,0.5176252319109462,0.48237476808905383
E01029991,1633,825,808,0.5052051439069197,0.4947948560930802
E01029992,1328,637,691,0.4796686746987952,0.5203313253012049
E01033123,1799,918,881,0.5102834908282379,0.48971650917176207
E01033126,1422,820,602,0.5766526019690577,0.42334739803094235
E01029968,1477,752,725,0.5091401489505755,0.49085985104942453
E01029969,1470,700,770,0.47619047619047616,0.5238095238095238
E01029970,1735,869,866,0.500864553314121,0.49913544668587895
E01029971,1465,690,775,0.4709897610921502,0.5290102389078498
E01033122,1441,763,678,0.5294934073560028,0.47050659264399725
E01033130,1044,570,474,0.5459770114942529,0.4540229885057471
E01030012,1120,564,556,0.5035714285714286,0.49642857142857144
E01030013,1397,647,750,0.46313528990694347,0.5368647100930566
E01030014,1400,676,724,0.4828571428571429,0.5171428571428571
E01030015,1310,647,663,0.49389312977099237,0.5061068702290077
E01030016,1433,706,727,0.4926727145847872,0.5073272854152129
E01029994,1616,781,835,0.4832920792079208,0.5167079207920792
E01029995,1602,797,805,0.4975031210986267,0.5024968789013733
E01029996,1701,853,848,0.5014697236919459,0.4985302763080541
E01033127,1528,749,779,0.49018324607329844,0.5098167539267016
E01033128,1102,539,563,0.48911070780399274,0.5108892921960072
E01033131,1442,669,773,0.46393897364771153,0.5360610263522885
E01030017,1365,663,702,0.4857142857142857,0.5142857142857142
E01030018,1464,746,718,0.5095628415300546,0.49043715846994534
E01030019,1555,764,791,0.49131832797427655,0.5086816720257235
E01030020,1500,727,773,0.4846666666666667,0.5153333333333333
E01030021,1392,669,723,0.48060344827586204,0.5193965517241379
E01029978,1321,654,667,0.49507948523845574,0.5049205147615443
E01029979,1650,797,853,0.48303030303030303,0.516969696969697
E01029980,1625,743,882,0.4572307692307692,0.5427692307692308
E01029981,1166,576,590,0.4939965694682676,0.5060034305317325
E01029982,1461,723,738,0.4948665297741273,0.5051334702258727
E01029983,1569,784,785,0.4996813256851498,0.5003186743148502
E01030052,2154,1032,1122,0.479108635097493,0.520891364902507
E01030058,2060,1006,1054,0.4883495145631068,0.5116504854368932
E01030064,2308,1146,1162,0.4965337954939341,0.5034662045060658
E01030088,1167,572,595,0.49014567266495285,0.5098543273350471
E01030039,1462,737,725,0.5041039671682627,0.49589603283173733
E01030054,1253,622,631,0.49640861931364727,0.5035913806863528
E01030055,1398,694,704,0.49642346208869814,0.5035765379113019
E01030066,1585,763,822,0.48138801261829656,0.5186119873817034
E01030067,1273,615,658,0.4831107619795758,0.5168892380204242
E01030068,1688,841,847,0.4982227488151659,0.5017772511848341
E01030053,2292,1145,1147,0.49956369982547993,0.5004363001745201
E01030082,2557,1285,1272,0.5025420414548298,0.4974579585451701
E01030090,2429,1213,1216,0.49938246191848495,0.500617538081515
E01030040,1195,565,630,0.47280334728033474,0.5271966527196653
E01030049,1691,828,863,0.48965109402720286,0.5103489059727971
E01030050,2038,996,1042,0.4887144259077527,0.5112855740922473
E01030084,1611,800,811,0.4965859714463066,0.5034140285536933
E01030085,1621,797,824,0.49167180752621836,0.5083281924737816
E01030037,1211,609,602,0.5028901734104047,0.49710982658959535
E01030038,1228,618,610,0.503257328990228,0.496742671009772
E01030059,2254,1116,1138,0.4951197870452529,0.5048802129547472
E01030081,2263,1124,1139,0.4966858152894388,0.5033141847105612
E01030051,1696,841,855,0.49587264150943394,0.504127358490566
E01030056,2181,1073,1108,0.4919761577258138,0.5080238422741862
E01030065,2080,1026,1054,0.4932692307692308,0.5067307692307692
E01030086,1177,578,599,0.49107901444350044,0.5089209855564996
E01030089,1995,979,1016,0.4907268170426065,0.5092731829573934
E01030048,2369,1122,1247,0.4736175601519629,0.5263824398480371
E01030057,2323,1167,1156,0.5023676280671545,0.4976323719328455
E01030083,2326,1168,1158,0.5021496130696474,0.49785038693035255
E01030087,1363,695,668,0.5099046221570066,0.4900953778429934
E01030073,1502,699,803,0.46537949400798934,0.5346205059920106
E01030077,1503,693,810,0.46107784431137727,0.5389221556886228
E01030079,1632,750,882,0.45955882352941174,0.5404411764705882
E01030080,1641,791,850,0.48202315661182205,0.517976843388178
E01030063,2364,1128,1236,0.47715736040609136,0.5228426395939086
E01030069,1310,664,646,0.5068702290076336,0.49312977099236643
E01030072,1604,787,817,0.4906483790523691,0.5093516209476309
E01030075,1668,832,836,0.4988009592326139,0.5011990407673861
E01030060,1636,779,857,0.47616136919315405,0.523838630806846
E01030071,1467,706,761,0.4812542603953647,0.5187457396046353
E01030076,1489,752,737,0.5050369375419744,0.4949630624580255
E01030078,1717,877,840,0.5107746068724519,0.48922539312754804
E01033316,1572,757,815,0.4815521628498728,0.5184478371501272
E01033317,1573,795,778,0.505403687221869,0.494596312778131
E01033319,1912,950,962,0.49686192468619245,0.5031380753138075
E01030041,2165,1092,1073,0.5043879907621247,0.4956120092378753
E01030043,1235,624,611,0.5052631578947369,0.49473684210526314
E01030061,1556,750,806,0.4820051413881748,0.5179948586118251
E01030062,1336,638,698,0.47754491017964074,0.5224550898203593
E01030070,2200,1449,751,0.6586363636363637,0.34136363636363637
E01030042,1567,784,783,0.5003190810465858,0.49968091895341415
E01030044,1148,556,592,0.4843205574912892,0.5156794425087108
E01030045,1804,878,926,0.4866962305986696,0.5133037694013304
E01030046,1624,803,821,0.4944581280788177,0.5055418719211823
E01030047,1258,617,641,0.4904610492845787,0.5095389507154213
E01030095,1179,589,590,0.49957591178965227,0.5004240882103478
E01030096,1443,713,730,0.4941094941094941,0.5058905058905059
E01030097,1201,595,606,0.4954204829308909,0.5045795170691091
E01030145,1412,702,710,0.4971671388101983,0.5028328611898017
E01030146,1095,540,555,0.4931506849315068,0.5068493150684932
E01030094,1412,678,734,0.4801699716713881,0.5198300283286119
E01030121,2365,1138,1227,0.481183932346723,0.5188160676532769
E01030132,1956,1297,659,0.6630879345603272,0.3369120654396728
E01030133,1464,716,748,0.4890710382513661,0.5109289617486339
E01030130,1293,613,680,0.47409126063418405,0.525908739365816
E01030131,1299,641,658,0.49345650500384913,0.5065434949961509
E01030139,1725,856,869,0.49623188405797103,0.503768115942029
E01030140,1277,646,631,0.5058731401722788,0.4941268598277212
E01030141,1607,773,834,0.48102053515868076,0.5189794648413192
E01030103,2030,956,1074,0.470935960591133,0.529064039408867
E01030104,2191,1109,1082,0.5061615700593336,0.49383842994066635
E01030138,2341,1171,1170,0.5002135839384878,0.4997864160615122
E01030127,1246,628,618,0.5040128410914928,0.4959871589085072
E01030128,1472,747,725,0.5074728260869565,0.49252717391304346
E01030129,1427,721,706,0.5052557813594954,0.49474421864050455
E01033044,1458,726,732,0.49794238683127573,0.5020576131687243
E01033045,1072,526,546,0.4906716417910448,0.5093283582089553
E01033050,1293,649,644,0.5019334880123744,0.4980665119876257
E01030091,1782,860,922,0.4826038159371493,0.5173961840628507
E01030093,1532,763,769,0.4980417754569191,0.5019582245430809
E01030137,1591,794,797,0.49905719673161536,0.5009428032683847
E01033043,1224,600,624,0.49019607843137253,0.5098039215686274
E01033046,1123,600,523,0.5342831700801425,0.4657168299198575
E01033047,1176,603,573,0.5127551020408163,0.4872448979591837
E01030092,1679,796,883,0.47409172126265636,0.5259082787373437
E01030123,1596,817,779,0.5119047619047619,0.4880952380952381
E01030124,1530,746,784,0.4875816993464052,0.5124183006535947
E01030125,1511,714,797,0.47253474520185307,0.5274652547981469
E01030148,1260,623,637,0.49444444444444446,0.5055555555555555
E01030149,1477,705,772,0.47731888964116453,0.5226811103588355
E01030098,2317,1109,1208,0.4786361674579197,0.5213638325420803
E01030100,2090,1018,1072,0.48708133971291867,0.5129186602870813
E01030119,2255,1116,1139,0.49490022172949,0.50509977827051
E01030134,1188,569,619,0.47895622895622897,0.5210437710437711
E01030135,1458,745,713,0.5109739368998628,0.4890260631001372
E01030142,1712,819,893,0.4783878504672897,0.5216121495327103
E01030143,1592,817,775,0.5131909547738693,0.48680904522613067
E01030144,1235,584,651,0.4728744939271255,0.5271255060728745
E01030147,1458,707,751,0.4849108367626886,0.5150891632373114
E01033048,1274,613,661,0.4811616954474097,0.5188383045525903
E01033049,1192,524,668,0.4395973154362416,0.5604026845637584
E01030099,1984,979,1005,0.4934475806451613,0.5065524193548387
E01030101,2028,954,1074,0.47041420118343197,0.5295857988165681
E01030150,2192,1094,1098,0.4990875912408759,0.5009124087591241
E01030120,3002,1916,1086,0.6382411725516323,0.36175882744836774
E01030122,2017,985,1032,0.48834903321765,0.51165096678235
E01030151,2234,1220,1014,0.5461056401074306,0.4538943598925694
E01030109,1864,913,951,0.4898068669527897,0.5101931330472103
E01030110,2839,1356,1483,0.47763296935540683,0.5223670306445932
E01030111,1392,694,698,0.4985632183908046,0.5014367816091954
E01030112,1701,886,815,0.520870076425632,0.479129923574368
E01030115,2364,1160,1204,0.4906937394247039,0.5093062605752962
E01030116,2299,1143,1156,0.49717268377555457,0.5028273162244454
E01030117,1632,822,810,0.5036764705882353,0.4963235294117647
E01030118,1679,834,845,0.49672424061941634,0.5032757593805837
E01030105,1797,914,883,0.5086254869226489,0.49137451307735114
E01030106,2454,1233,1221,0.5024449877750611,0.49755501222493886
E01030107,1620,807,813,0.4981481481481482,0.5018518518518519
E01030108,1885,937,948,0.4970822281167109,0.5029177718832891
E01030113,1900,942,958,0.4957894736842105,0.5042105263157894
E01030114,1615,833,782,0.5157894736842106,0.4842105263157895
E01030201,2076,1041,1035,0.5014450867052023,0.4985549132947977
E01030219,1966,956,1010,0.4862665310274669,0.513733468972533
E01030222,1901,911,990,0.4792214623882167,0.5207785376117833
E01030154,2144,1052,1092,0.4906716417910448,0.5093283582089553
E01030172,1657,800,857,0.4828002414001207,0.5171997585998793
E01030173,1685,802,883,0.47596439169139465,0.5240356083086053
E01030174,1402,672,730,0.4793152639087018,0.5206847360912982
E01030176,1977,962,1015,0.48659585230146685,0.5134041476985332
E01030186,1449,710,739,0.48999309868875085,0.5100069013112492
E01030208,1269,627,642,0.4940898345153664,0.5059101654846335
E01030209,1520,719,801,0.4730263157894737,0.5269736842105263
E01030210,2124,1011,1113,0.4759887005649718,0.5240112994350282
E01030212,1911,903,1008,0.4725274725274725,0.5274725274725275
E01030152,2001,888,1113,0.44377811094452774,0.5562218890554723
E01030153,1224,585,639,0.47794117647058826,0.5220588235294118
E01030187,1581,765,816,0.4838709677419355,0.5161290322580645
E01030188,1639,806,833,0.4917632702867602,0.5082367297132397
E01030189,1691,805,886,0.47604967474866944,0.5239503252513306
E01030193,1638,823,815,0.5024420024420024,0.49755799755799757
E01030194,1612,738,874,0.45781637717121587,0.5421836228287841
E01030195,1633,800,833,0.4898958971218616,0.5101041028781383
E01030220,2156,1025,1131,0.475417439703154,0.524582560296846
E01030175,2306,1125,1181,0.4878577623590633,0.5121422376409367
E01030200,2272,1139,1133,0.5013204225352113,0.49867957746478875
E01030221,1965,962,1003,0.4895674300254453,0.5104325699745547
E01030199,1830,897,933,0.4901639344262295,0.5098360655737705
E01033443,1739,1058,681,0.6083956296722254,0.39160437032777456
E01033445,1703,804,899,0.4721080446271286,0.5278919553728714
E01033446,2473,1463,1010,0.5915891629599677,0.40841083704003234
E01033448,1275,617,658,0.483921568627451,0.516078431372549
E01033449,1685,823,862,0.4884272997032641,0.511572700296736
E01030155,2073,1031,1042,0.497346840328027,0.502653159671973
E01030185,2121,985,1136,0.4644035832154644,0.5355964167845356
E01030203,1967,890,1077,0.45246568378240976,0.5475343162175902
E01030211,1935,853,1082,0.4408268733850129,0.5591731266149871
E01030179,2686,1295,1391,0.4821295606850335,0.5178704393149665
E01030180,1398,686,712,0.4907010014306152,0.5092989985693849
E01030183,1965,962,1003,0.4895674300254453,0.5104325699745547
E01030184,1771,852,919,0.4810841332580463,0.5189158667419537
E01030207,1475,726,749,0.4922033898305085,0.5077966101694915
E01030181,1993,1005,988,0.5042649272453588,0.49573507275464124
E01030190,1795,896,899,0.4991643454038997,0.5008356545961002
E01030191,1621,806,815,0.4972239358420728,0.5027760641579272
E01030192,1481,738,743,0.49831195138419987,0.5016880486158002
E01030198,1294,641,653,0.4953632148377125,0.5046367851622875
E01033442,1622,770,852,0.4747225647348952,0.5252774352651048
E01033444,1509,747,762,0.49502982107355864,0.5049701789264414
E01033447,1458,705,753,0.4835390946502058,0.5164609053497943
E01030196,1690,840,850,0.4970414201183432,0.5029585798816568
E01030197,1618,810,808,0.5006180469715699,0.49938195302843014
E01030204,1850,924,926,0.49945945945945946,0.5005405405405405
E01030205,1314,649,665,0.4939117199391172,0.5060882800608828
E01030206,1546,764,782,0.49417852522639066,0.5058214747736093
E01030171,1942,962,980,0.49536560247167866,0.5046343975283213
E01030214,1327,675,652,0.5086661642803316,0.49133383571966843
E01030215,1315,670,645,0.5095057034220533,0.49049429657794674
E01030216,1485,704,781,0.4740740740740741,0.5259259259259259
E01030217,1316,664,652,0.5045592705167173,0.49544072948328266
E01030218,1480,726,754,0.4905405405405405,0.5094594594594595
E01030158,1431,700,731,0.4891684136967156,0.5108315863032844
E01030159,1499,717,782,0.4783188792528352,0.5216811207471648
E01030164,1516,707,809,0.4663588390501319,0.533641160949868
E01030166,1519,716,803,0.47136273864384465,0.5286372613561554
E01033450,2379,1112,1267,0.46742328709541825,0.5325767129045818
E01030160,1406,682,724,0.4850640113798009,0.5149359886201992
E01030161,1393,657,736,0.47164393395549176,0.5283560660445082
E01030168,1459,700,759,0.47978067169294036,0.5202193283070596
E01030169,1546,775,771,0.5012936610608021,0.4987063389391979
E01030170,1703,787,916,0.46212566059894306,0.537874339401057
E01030162,1391,654,737,0.4701653486700216,0.5298346513299784
E01030163,1525,761,764,0.49901639344262294,0.5009836065573771
E01030165,1580,773,807,0.4892405063291139,0.510759493670886
E01030167,1400,657,743,0.4692857142857143,0.5307142857142857
E01030240,1565,740,825,0.4728434504792332,0.5271565495207667
E01030241,1440,705,735,0.4895833333333333,0.5104166666666666
E01030242,1395,698,697,0.5003584229390681,0.4996415770609319
E01030259,1132,558,574,0.4929328621908127,0.5070671378091873
E01030260,1436,930,506,0.6476323119777159,0.35236768802228413
E01030261,1419,695,724,0.4897815362931642,0.5102184637068358
E01030262,1241,581,660,0.46817082997582593,0.5318291700241741
E01030277,1192,564,628,0.47315436241610737,0.5268456375838926
E01030279,1391,669,722,0.4809489575844716,0.5190510424155284
E01030281,2406,1163,1243,0.4833748960931006,0.5166251039068994
E01030266,1676,806,870,0.4809069212410501,0.5190930787589498
E01030267,1358,673,685,0.4955817378497791,0.5044182621502209
E01030271,1456,711,745,0.4883241758241758,0.5116758241758241
E01030278,1578,743,835,0.4708491761723701,0.5291508238276299
E01030280,1400,696,704,0.49714285714285716,0.5028571428571429
E01030246,1412,695,717,0.4922096317280453,0.5077903682719547
E01030248,1487,731,756,0.49159381304640215,0.5084061869535978
E01030249,1646,806,840,0.4896719319562576,0.5103280680437424
E01030250,1806,885,921,0.4900332225913621,0.5099667774086378
E01030264,1427,699,728,0.4898388227049755,0.5101611772950245
E01030265,1446,696,750,0.48132780082987553,0.5186721991701245
E01030255,1357,673,684,0.49594694178334564,0.5040530582166544
E01030263,1365,691,674,0.5062271062271062,0.4937728937728938
E01030270,1542,769,773,0.4987029831387808,0.5012970168612192
E01030289,1445,697,748,0.4823529411764706,0.5176470588235295
E01030290,1508,738,770,0.48938992042440316,0.5106100795755968
E01030233,1512,748,764,0.4947089947089947,0.5052910052910053
E01030235,1482,703,779,0.47435897435897434,0.5256410256410257
E01030268,1353,655,698,0.48410938654841096,0.515890613451589
E01030269,1621,776,845,0.47871684145589144,0.5212831585441086
E01030288,1414,683,731,0.48302687411598305,0.516973125884017
E01030247,1467,731,736,0.49829584185412407,0.501704158145876
E01030254,1463,701,762,0.47915242652084755,0.5208475734791524
E01030256,1511,762,749,0.5043017868960953,0.4956982131039047
E01030258,1528,804,724,0.5261780104712042,0.4738219895287958
E01030276,1229,583,646,0.4743694060211554,0.5256305939788446
E01030257,1580,752,828,0.4759493670886076,0.5240506329113924
E01030274,1187,547,640,0.46082561078348777,0.5391743892165122
E01030275,1131,560,571,0.4951370468611848,0.5048629531388152
E01030287,1425,672,753,0.47157894736842104,0.5284210526315789
E01030291,1477,674,803,0.45633039945836157,0.5436696005416385
E01030234,1592,737,855,0.4629396984924623,0.5370603015075377
E01030236,1737,831,906,0.4784110535405872,0.5215889464594128
E01030237,2902,1430,1472,0.49276361130255,0.50723638869745
E01030238,1848,889,959,0.4810606060606061,0.5189393939393939
E01030223,1715,815,900,0.4752186588921283,0.5247813411078717
E01030224,1675,777,898,0.4638805970149254,0.5361194029850747
E01030225,1615,768,847,0.47554179566563465,0.5244582043343653
E01030227,1441,682,759,0.4732824427480916,0.5267175572519084
E01030228,1773,833,940,0.4698251551043429,0.530174844895657
E01030226,1904,947,957,0.49737394957983194,0.5026260504201681
E01030286,2185,1083,1102,0.4956521739130435,0.5043478260869565
E01030292,1485,739,746,0.49764309764309766,0.5023569023569023
E01030293,1700,828,872,0.48705882352941177,0.5129411764705882
E01030294,1488,711,777,0.4778225806451613,0.5221774193548387
E01030239,2018,1010,1008,0.5004955401387512,0.49950445986124875
E01030251,1572,764,808,0.4860050890585242,0.5139949109414759
E01030252,1745,851,894,0.4876790830945559,0.5123209169054441
E01030253,1788,870,918,0.4865771812080537,0.5134228187919463
E01030272,1496,697,799,0.4659090909090909,0.5340909090909091
E01030273,1520,730,790,0.48026315789473684,0.5197368421052632
E01030230,1830,857,973,0.46830601092896174,0.5316939890710383
E01030231,1568,762,806,0.48596938775510207,0.514030612244898
E01030232,1729,853,876,0.4933487565066512,0.5066512434933488
E01030285,2242,1129,1113,0.5035682426404996,0.49643175735950046
E01030282,1098,471,627,0.42896174863387976,0.5710382513661202
E01030283,1359,643,716,0.4731420161883738,0.5268579838116262
E01030284,1223,561,662,0.45870809484873265,0.5412919051512673
E01030295,2224,1101,1123,0.49505395683453235,0.5049460431654677
E01030229,2150,1064,1086,0.4948837209302326,0.5051162790697674
E01030243,1461,708,753,0.48459958932238195,0.5154004106776181
E01030244,1677,770,907,0.45915324985092426,0.5408467501490757
E01030245,1588,747,841,0.4704030226700252,0.5295969773299748
E01000907,1430,663,767,0.4636363636363636,0.5363636363636364
E01000908,1581,686,895,0.43390259329538267,0.5660974067046173
E01000909,1614,766,848,0.4745972738537794,0.5254027261462205
E01000912,1589,734,855,0.4619257394587791,0.5380742605412209
E01000913,1710,840,870,0.49122807017543857,0.5087719298245614
E01000893,1566,745,821,0.47573435504469985,0.5242656449553001
E01000894,1389,680,709,0.4895608351331893,0.5104391648668106
E01000895,1630,811,819,0.49754601226993866,0.5024539877300613
E01000896,1692,822,870,0.4858156028368794,0.5141843971631206
E01000899,1667,822,845,0.4931013797240552,0.5068986202759448
E01000910,1472,718,754,0.48777173913043476,0.5122282608695652
E01000911,1559,738,821,0.4733803720333547,0.5266196279666453
E01000921,1966,940,1026,0.47812817904374366,0.5218718209562564
E01000923,1494,689,805,0.46117804551539493,0.5388219544846051
E01000928,1681,843,838,0.5014872099940512,0.49851279000594884
E01000878,1624,766,858,0.47167487684729065,0.5283251231527094
E01000879,1458,714,744,0.4897119341563786,0.5102880658436214
E01000880,1602,767,835,0.4787765293383271,0.521223470661673
E01000884,1469,724,745,0.4928522804628999,0.5071477195371
E01000885,1484,694,790,0.46765498652291104,0.532345013477089
E01000871,1664,821,843,0.4933894230769231,0.5066105769230769
E01000872,1902,965,937,0.5073606729758149,0.49263932702418506
E01000873,1639,816,823,0.4978645515558267,0.5021354484441732
E01000874,1559,746,813,0.47851186658114175,0.5214881334188582
E01000877,1574,786,788,0.4993646759847522,0.5006353240152478
E01000886,1445,704,741,0.48719723183391006,0.5128027681660899
E01000887,1486,705,781,0.47442799461641993,0.5255720053835801
E01000888,1605,793,812,0.4940809968847352,0.5059190031152648
E01000892,1843,880,963,0.47748236570808467,0.5225176342919153
E01000903,1439,709,730,0.4927032661570535,0.5072967338429465
E01000889,1670,798,872,0.47784431137724553,0.5221556886227545
E01000890,1640,806,834,0.49146341463414633,0.5085365853658537
E01000891,1575,752,823,0.4774603174603175,0.5225396825396825
E01000901,1977,939,1038,0.47496206373292865,0.5250379362670713
E01000922,1547,761,786,0.4919198448610213,0.5080801551389786
E01000927,1738,836,902,0.4810126582278481,0.5189873417721519
E01000881,1510,784,726,0.519205298013245,0.48079470198675495
E01000882,1513,745,768,0.49239920687376076,0.5076007931262393
E01000883,1326,635,691,0.47888386123680243,0.5211161387631976
E01000897,1597,759,838,0.47526612398246715,0.5247338760175329
E01000898,1729,836,893,0.4835164835164835,0.5164835164835165
E01000866,2030,942,1088,0.4640394088669951,0.5359605911330049
E01000870,1693,779,914,0.46012994683992914,0.5398700531600709
E01000924,1637,785,852,0.47953573610262673,0.5204642638973732
E01000925,1563,736,827,0.4708893154190659,0.5291106845809341
E01000926,1791,866,925,0.4835287548855388,0.5164712451144612
E01000969,2032,979,1053,0.48179133858267714,0.5182086614173228
E01000970,1444,719,725,0.4979224376731302,0.5020775623268698
E01000971,1478,699,779,0.472936400541272,0.527063599458728
E01000972,2009,976,1033,0.485813837730214,0.514186162269786
E01000973,1885,899,986,0.47692307692307695,0.5230769230769231
E01000842,1444,687,757,0.4757617728531856,0.5242382271468145
E01000844,1772,903,869,0.5095936794582393,0.4904063205417607
E01000848,1588,773,815,0.48677581863979846,0.5132241813602015
E01000849,1569,748,821,0.4767367750159337,0.5232632249840663
E01000900,1801,859,942,0.47695724597445865,0.5230427540255413
E01000902,1451,687,764,0.47346657477601656,0.5265334252239835
E01000904,2120,1063,1057,0.5014150943396226,0.49858490566037733
E01000905,2044,951,1093,0.4652641878669276,0.5347358121330724
E01000906,1532,682,850,0.4451697127937337,0.5548302872062664
E01000875,1654,874,780,0.528415961305925,0.47158403869407495
E01000876,1748,877,871,0.5017162471395881,0.4982837528604119
E01000931,1910,889,1021,0.4654450261780105,0.5345549738219896
E01000932,1838,932,906,0.5070729053318824,0.4929270946681175
E01000974,1707,831,876,0.4868189806678383,0.5131810193321616
E01000843,1678,777,901,0.46305125148986886,0.5369487485101311
E01000845,1464,689,775,0.47062841530054644,0.5293715846994536
E01000846,1501,699,802,0.46568954030646237,0.5343104596935376
E01000847,1686,815,871,0.4833926453143535,0.5166073546856464
E01000864,1537,733,804,0.47690305790500975,0.5230969420949902
E01000865,1505,748,757,0.49700996677740866,0.5029900332225914
E01000867,1608,788,820,0.4900497512437811,0.5099502487562189
E01000868,1442,744,698,0.5159500693481276,0.4840499306518724
E01000869,2110,1053,1057,0.4990521327014218,0.5009478672985782
E01000962,1592,732,860,0.45979899497487436,0.5402010050251256
E01000964,1577,751,826,0.47622067216233355,0.5237793278376665
E01000965,1522,712,810,0.46780551905387646,0.5321944809461235
E01000966,1512,743,769,0.4914021164021164,0.5085978835978836
E01000968,1505,719,786,0.4777408637873754,0.5222591362126245
E01000960,1774,828,946,0.46674182638105977,0.5332581736189402
E01000961,1591,736,855,0.46260213702074165,0.5373978629792583
E01000963,1923,883,1040,0.4591783671346854,0.5408216328653146
E01000967,1409,653,756,0.46344925479063165,0.5365507452093683
E01000857,1447,705,742,0.48721492743607464,0.5127850725639254
E01000858,1861,910,951,0.48898441698011824,0.5110155830198818
E01000859,1586,757,829,0.47730138713745274,0.5226986128625473
E01000860,1307,621,686,0.4751338944146901,0.5248661055853099
E01000862,1712,871,841,0.5087616822429907,0.4912383177570093
E01000856,1645,815,830,0.49544072948328266,0.5045592705167173
E01000861,1574,818,756,0.5196950444726811,0.48030495552731894
E01000957,1729,884,845,0.5112781954887218,0.48872180451127817
E01000958,2264,1019,1245,0.4500883392226148,0.5499116607773852
E01000959,1670,806,864,0.48263473053892214,0.5173652694610779
E01000929,1675,784,891,0.46805970149253734,0.5319402985074627
E01000930,1910,896,1014,0.46910994764397906,0.5308900523560209
E01000933,1671,838,833,0.5014961101137043,0.4985038898862956
E01000934,1619,753,866,0.46510191476219886,0.5348980852378011
E01000935,1415,631,784,0.44593639575971733,0.5540636042402827
E01000863,1481,781,700,0.5273463875759622,0.4726536124240378
E01000946,1516,705,811,0.4650395778364116,0.5349604221635884
E01000947,1954,1073,881,0.5491299897645855,0.4508700102354145
E01000948,1736,890,846,0.5126728110599078,0.4873271889400922
E01000952,1729,830,899,0.4800462695199537,0.5199537304800462
E01000953,1643,762,881,0.46378575776019476,0.5362142422398052
E01000954,1656,781,875,0.4716183574879227,0.5283816425120773
E01000955,1595,765,830,0.47962382445141066,0.5203761755485894
E01000956,1532,743,789,0.4849869451697128,0.5150130548302873
E01000944,1899,1168,731,0.6150605581885202,0.3849394418114797
E01000945,1821,852,969,0.46787479406919275,0.5321252059308073
E01000949,1633,754,879,0.46172688303735454,0.5382731169626455
E01000950,1431,716,715,0.5003494060097834,0.4996505939902166
E01000951,1538,760,778,0.494148244473342,0.505851755526658
E01000936,1839,898,941,0.4883088635127787,0.5116911364872213
E01000938,1752,924,828,0.5273972602739726,0.4726027397260274
E01000939,1223,593,630,0.4848732624693377,0.5151267375306623
E01000940,1130,571,559,0.5053097345132743,0.4946902654867257
E01000853,1631,798,833,0.4892703862660944,0.5107296137339056
E01000937,1504,735,769,0.4886968085106383,0.5113031914893617
E01000941,1230,640,590,0.5203252032520326,0.4796747967479675
E01000942,2111,1043,1068,0.49407863571766936,0.5059213642823307
E01000943,1054,522,532,0.4952561669829222,0.5047438330170778
E01000850,1694,919,775,0.5425029515938606,0.4574970484061393
E01000851,2383,1327,1056,0.5568610994544692,0.44313890054553084
E01000852,1587,725,862,0.45683679899180846,0.5431632010081916
E01000854,1833,1037,796,0.5657392253136934,0.4342607746863066
E01000915,1527,785,742,0.5140798952193845,0.4859201047806156
E01000916,1796,942,854,0.5244988864142539,0.4755011135857461
E01000917,1888,1004,884,0.5317796610169492,0.4682203389830508
E01000920,1946,1040,906,0.5344295991778006,0.46557040082219936
E01000855,1764,880,884,0.4988662131519274,0.5011337868480725
E01000914,1762,928,834,0.5266742338251986,0.4733257661748014
E01000918,2090,1125,965,0.5382775119617225,0.46172248803827753
E01000919,2014,1084,930,0.5382323733862959,0.4617676266137041
E01000001,1465,767,698,0.5235494880546075,0.4764505119453925
E01000002,1436,767,669,0.5341225626740947,0.4658774373259053
E01000003,1346,714,632,0.5304606240713224,0.46953937592867756
E01000005,985,528,457,0.5360406091370559,0.4639593908629442
E01032739,1044,648,396,0.6206896551724138,0.3793103448275862
E01032740,1099,667,432,0.6069153776160146,0.39308462238398545
E01001808,1838,923,915,0.5021762785636561,0.49782372143634385
E01001809,1977,985,992,0.49822964087000504,0.5017703591299949
E01001814,1660,843,817,0.5078313253012048,0.49216867469879516
E01001823,1765,882,883,0.49971671388101985,0.5002832861189802
E01001825,1598,815,783,0.5100125156445557,0.4899874843554443
E01001714,1490,732,758,0.4912751677852349,0.508724832214765
E01001811,1503,728,775,0.48436460412508314,0.5156353958749168
E01001813,1250,600,650,0.48,0.52
E01033701,1849,956,893,0.5170362358031368,0.48296376419686315
E01001799,1582,811,771,0.5126422250316056,0.48735777496839444
E01001802,1294,619,675,0.47836166924265844,0.5216383307573416
E01001804,1528,748,780,0.4895287958115183,0.5104712041884817
E01001807,1806,928,878,0.5138427464008859,0.48615725359911405
E01001812,1746,854,892,0.48911798396334477,0.5108820160366552
E01001725,1909,949,960,0.4971189104243059,0.5028810895756941
E01001726,1357,654,703,0.4819454679439941,0.5180545320560059
E01001800,1597,781,816,0.48904195366311837,0.5109580463368817
E01001824,1517,769,748,0.5069215557020436,0.4930784442979565
E01001826,1740,878,862,0.5045977011494253,0.4954022988505747
E01001723,1944,1000,944,0.51440329218107,0.48559670781893005
E01001724,2219,1084,1135,0.4885083370887787,0.5114916629112213
E01001727,1920,957,963,0.4984375,0.5015625
E01001768,1825,901,924,0.4936986301369863,0.5063013698630137
E01001769,1594,774,820,0.48557089084065247,0.5144291091593476
E01001715,1321,690,631,0.522331566994701,0.47766843300529904
E01001716,1318,696,622,0.5280728376327769,0.47192716236722304
E01001717,1222,579,643,0.47381342062193127,0.5261865793780688
E01001718,1787,931,856,0.5209848908785675,0.4790151091214326
E01001719,1139,563,576,0.4942932396839333,0.5057067603160668
E01001720,1736,844,892,0.4861751152073733,0.5138248847926268
E01001742,1810,841,969,0.46464088397790054,0.5353591160220994
E01001801,1664,762,902,0.4579326923076923,0.5420673076923077
E01001803,1863,908,955,0.487385936661299,0.512614063338701
E01001806,1546,714,832,0.46183699870633893,0.538163001293661
E01001741,1490,695,795,0.4664429530201342,0.5335570469798657
E01001805,1206,585,621,0.48507462686567165,0.5149253731343284
E01001829,1794,840,954,0.4682274247491639,0.5317725752508361
E01001831,1677,838,839,0.49970184853905786,0.5002981514609421
E01001832,1619,793,826,0.4898085237801112,0.5101914762198888
E01001764,1688,849,839,0.5029620853080569,0.49703791469194314
E01001765,1717,849,868,0.49446709376820036,0.5055329062317997
E01001767,1603,792,811,0.4940736119775421,0.5059263880224579
E01001770,1738,882,856,0.5074798619102416,0.49252013808975836
E01033703,1410,699,711,0.4957446808510638,0.5042553191489362
E01033713,1346,694,652,0.5156017830609212,0.48439821693907875
E01001792,1780,884,896,0.4966292134831461,0.503370786516854
E01001793,1685,839,846,0.49792284866468844,0.5020771513353116
E01001794,1909,906,1003,0.47459402828706126,0.5254059717129387
E01001795,1464,711,753,0.48565573770491804,0.514344262295082
E01001796,1647,862,785,0.5233758348512447,0.47662416514875533
E01001736,1656,808,848,0.48792270531400966,0.5120772946859904
E01001737,1842,942,900,0.511400651465798,0.48859934853420195
E01001738,1758,881,877,0.5011376564277589,0.4988623435722412
E01001739,2090,1002,1088,0.47942583732057414,0.5205741626794258
E01001786,1825,875,950,0.4794520547945205,0.5205479452054794
E01001787,1589,752,837,0.473253618628068,0.5267463813719321
E01001788,1582,734,848,0.4639696586599241,0.5360303413400759
E01001790,1343,658,685,0.48994787788533134,0.5100521221146687
E01001740,1566,760,806,0.48531289910600256,0.5146871008939975
E01001747,2137,1085,1052,0.5077211043518952,0.49227889564810484
E01001830,1904,990,914,0.5199579831932774,0.4800420168067227
E01001833,2143,1021,1122,0.4764349043397107,0.5235650956602893
E01001834,2059,1023,1036,0.4968431277319087,0.5031568722680914
E01001835,1249,630,619,0.5044035228182546,0.4955964771817454
E01001733,1822,923,899,0.5065861690450055,0.4934138309549945
E01001785,1486,677,809,0.45558546433378194,0.544414535666218
E01001789,1739,842,897,0.484186313973548,0.515813686026452
E01001791,1534,737,797,0.4804432855280313,0.5195567144719687
E01001745,2249,1114,1135,0.49533125833703867,0.5046687416629613
E01001746,1656,783,873,0.47282608695652173,0.5271739130434783
E01001757,1717,791,926,0.46068724519510773,0.5393127548048923
E01001758,2087,1027,1060,0.4920939147101102,0.5079060852898898
E01001759,1804,913,891,0.5060975609756098,0.49390243902439024
E01001761,1779,864,915,0.4856661045531197,0.5143338954468802
E01001731,2300,1153,1147,0.5013043478260869,0.49869565217391304
E01001734,1821,932,889,0.5118066996155958,0.48819330038440417
E01001760,1754,862,892,0.49144811858608894,0.508551881413911
E01001762,1765,861,904,0.4878186968838527,0.5121813031161473
E01001846,1216,573,643,0.4712171052631579,0.5287828947368421
E01001847,1129,574,555,0.508414526129318,0.491585473870682
E01001848,1654,816,838,0.49334945586457074,0.5066505441354293
E01001849,2364,1202,1162,0.5084602368866328,0.49153976311336717
E01001729,2021,1035,986,0.5121227115289461,0.48787728847105394
E01001730,1921,990,931,0.5153565851119208,0.4846434148880791
E01001732,1715,833,882,0.4857142857142857,0.5142857142857142
E01001735,1632,774,858,0.4742647058823529,0.5257352941176471
E01001838,1746,848,898,0.4856815578465063,0.5143184421534936
E01001850,1810,825,985,0.4558011049723757,0.5441988950276243
E01001748,2306,1208,1098,0.5238508239375542,0.4761491760624458
E01001749,1717,838,879,0.48806057076295867,0.5119394292370414
E01001763,1642,794,848,0.4835566382460414,0.5164433617539586
E01001816,1625,790,835,0.48615384615384616,0.5138461538461538
E01001819,1577,769,808,0.48763474952441344,0.5123652504755866
E01001744,1879,906,973,0.48217136774880254,0.5178286322511975
E01001750,1838,905,933,0.4923830250272035,0.5076169749727966
E01001751,1547,807,740,0.5216548157724629,0.4783451842275372
E01001756,2155,1075,1080,0.4988399071925754,0.5011600928074246
E01033698,1259,614,645,0.48768864177918986,0.5123113582208102
E01033699,1217,653,564,0.5365653245686114,0.46343467543138867
E01033700,1566,846,720,0.5402298850574713,0.45977011494252873
E01033707,1303,651,652,0.49961627014581733,0.5003837298541827
E01001836,1866,903,963,0.48392282958199356,0.5160771704180064
E01001840,1676,794,882,0.4737470167064439,0.5262529832935561
E01001841,1411,694,717,0.49184975194897235,0.5081502480510276
E01001844,2006,997,1009,0.49700897308075775,0.5029910269192422
E01001845,1555,753,802,0.4842443729903537,0.5157556270096463
E01001837,1488,722,766,0.4852150537634409,0.5147849462365591
E01001839,2211,1034,1177,0.46766169154228854,0.5323383084577115
E01001842,1589,769,820,0.4839521711768408,0.5160478288231592
E01001843,1244,580,664,0.4662379421221865,0.5337620578778135
E01033704,1631,849,782,0.5205395462906193,0.47946045370938073
E01033712,1578,745,833,0.4721166032953105,0.5278833967046895
E01001772,1046,537,509,0.5133843212237094,0.48661567877629064
E01001774,2095,1019,1076,0.4863961813842482,0.5136038186157518
E01001775,1776,871,905,0.49042792792792794,0.5095720720720721
E01001815,1774,845,929,0.4763246899661781,0.5236753100338218
E01001820,1463,714,749,0.4880382775119617,0.5119617224880383
E01001821,1460,711,749,0.48698630136986304,0.513013698630137
E01001752,2307,1183,1124,0.5127871694841786,0.4872128305158214
E01001753,1629,825,804,0.5064456721915286,0.49355432780847147
E01001754,2379,1237,1142,0.5199663724253888,0.48003362757461115
E01001755,1788,870,918,0.4865771812080537,0.5134228187919463
E01001773,2052,1026,1026,0.5,0.5
E01001776,1439,748,691,0.5198054204308548,0.48019457956914524
E01001779,2437,1241,1196,0.5092326631103816,0.4907673368896184
E01001781,1667,851,816,0.510497900419916,0.489502099580084
E01001782,2300,1213,1087,0.5273913043478261,0.4726086956521739
E01001783,1897,957,940,0.5044807590933053,0.4955192409066948
E01001777,2358,1194,1164,0.5063613231552163,0.49363867684478374
E01001780,1825,977,848,0.5353424657534247,0.46465753424657535
E01001784,2273,1047,1226,0.46062472503299606,0.539375274967004
E01033706,1539,857,682,0.5568551007147499,0.44314489928525014
E01033708,1599,978,621,0.6116322701688556,0.3883677298311445
E01033709,1670,861,809,0.5155688622754491,0.4844311377245509
E01033711,1105,596,509,0.539366515837104,0.4606334841628959
E01001798,1785,876,909,0.4907563025210084,0.5092436974789916
E01001828,2057,1005,1052,0.4885755955274672,0.5114244044725328
E01033702,1193,597,596,0.5004191114836547,0.49958088851634536
E01033705,1417,656,761,0.4629498941425547,0.5370501058574453
E01033710,1159,590,569,0.5090595340811044,0.4909404659188956
E01001722,2028,978,1050,0.4822485207100592,0.5177514792899408
E01001728,2015,938,1077,0.4655086848635236,0.5344913151364764
E01001822,1785,880,905,0.49299719887955185,0.5070028011204482
E01001827,1916,928,988,0.48434237995824636,0.5156576200417536
E01001874,2055,911,1144,0.44330900243309,0.55669099756691
E01001875,1854,855,999,0.46116504854368934,0.5388349514563107
E01001876,2232,1170,1062,0.5241935483870968,0.47580645161290325
E01001877,1345,645,700,0.4795539033457249,0.5204460966542751
E01001878,1689,769,920,0.4552989934872706,0.5447010065127295
E01001955,1807,854,953,0.472606530160487,0.527393469839513
E01001957,1616,787,829,0.4870049504950495,0.5129950495049505
E01001958,1671,757,914,0.4530221424296828,0.5469778575703171
E01001961,1564,701,863,0.44820971867007675,0.5517902813299232
E01001954,1525,712,813,0.4668852459016393,0.5331147540983606
E01001956,1593,760,833,0.4770872567482737,0.5229127432517263
E01001959,1728,826,902,0.47800925925925924,0.5219907407407407
E01001960,1885,920,965,0.4880636604774536,0.5119363395225465
E01001943,1954,984,970,0.503582395087001,0.49641760491299897
E01001944,1689,840,849,0.49733570159857904,0.5026642984014209
E01001945,1752,818,934,0.4668949771689498,0.5331050228310502
E01001946,1633,780,853,0.47764849969381507,0.5223515003061849
E01001862,1768,921,847,0.5209276018099548,0.47907239819004527
E01001940,1601,750,851,0.4684572142410993,0.5315427857589007
E01001941,1677,861,816,0.5134168157423972,0.4865831842576029
E01001942,1869,991,878,0.5302300695559122,0.46976993044408777
E01001858,1793,909,884,0.5069715560513106,0.49302844394868933
E01001860,1769,944,825,0.5336348219332957,0.46636517806670436
E01001861,1498,700,798,0.4672897196261682,0.5327102803738317
E01001863,1531,760,771,0.496407576747224,0.503592423252776
E01001864,1578,785,793,0.49746514575411915,0.5025348542458808
E01001852,1792,896,896,0.5,0.5
E01001853,1533,732,801,0.4774951076320939,0.5225048923679061
E01001854,1732,843,889,0.4867205542725173,0.5132794457274826
E01001857,1477,706,771,0.4779959377115775,0.5220040622884224
E01001859,2541,1184,1357,0.4659582841401023,0.5340417158598977
E01001865,1682,887,795,0.5273483947681332,0.47265160523186683
E01001927,1504,811,693,0.5392287234042553,0.4607712765957447
E01001930,1854,889,965,0.47950377562028046,0.5204962243797195
E01001895,1594,805,789,0.5050188205771644,0.49498117942283565
E01001896,1548,823,725,0.5316537467700259,0.46834625322997414
E01001897,1461,731,730,0.5003422313483915,0.4996577686516085
E01001929,1260,613,647,0.4865079365079365,0.5134920634920634
E01001851,1632,775,857,0.47487745098039214,0.5251225490196079
E01001855,1677,791,886,0.47167561121049495,0.528324388789505
E01001856,1675,824,851,0.4919402985074627,0.5080597014925373
E01001869,1334,628,706,0.4707646176911544,0.5292353823088456
E01001873,1450,692,758,0.4772413793103448,0.5227586206896552
E01001928,1724,855,869,0.49593967517401394,0.5040603248259861
E01001931,1498,722,776,0.4819759679572764,0.5180240320427236
E01001932,1621,895,726,0.5521283158544109,0.44787168414558914
E01001933,1324,647,677,0.48867069486404835,0.5113293051359517
E01001866,1579,746,833,0.47245091830272323,0.5275490816972768
E01001867,1362,607,755,0.4456681350954479,0.5543318649045521
E01001868,1341,636,705,0.4742729306487696,0.5257270693512305
E01001870,1932,992,940,0.5134575569358178,0.4865424430641822
E01001871,1604,813,791,0.506857855361596,0.493142144638404
E01001872,1614,806,808,0.4993804213135068,0.5006195786864932
E01001893,1244,604,640,0.4855305466237942,0.5144694533762058
E01001894,1320,669,651,0.5068181818181818,0.49318181818181817
E01001898,1591,831,760,0.5223130106851037,0.4776869893148963
E01001899,1380,629,751,0.4557971014492754,0.5442028985507247
E01001900,1785,872,913,0.48851540616246497,0.511484593837535
E01001889,1390,714,676,0.5136690647482014,0.48633093525179855
E01001910,1512,765,747,0.5059523809523809,0.49404761904761907
E01001913,1545,770,775,0.49838187702265374,0.5016181229773463
E01001914,1715,874,841,0.5096209912536444,0.4903790087463557
E01001885,1319,603,716,0.45716451857467777,0.5428354814253222
E01001908,1636,845,791,0.5165036674816625,0.4834963325183374
E01001909,1822,918,904,0.5038419319429198,0.4961580680570801
E01001911,1761,837,924,0.4752981260647359,0.524701873935264
E01001912,1598,843,755,0.5275344180225282,0.47246558197747185
E01001886,1572,766,806,0.4872773536895674,0.5127226463104325
E01001887,1519,751,768,0.49440421329822254,0.5055957867017775
E01001890,1815,903,912,0.4975206611570248,0.5024793388429752
E01001892,1366,675,691,0.49414348462664714,0.5058565153733529
E01001880,1497,715,782,0.47762191048764197,0.5223780895123581
E01001881,1615,775,840,0.47987616099071206,0.5201238390092879
E01001882,1762,830,932,0.47105561861521,0.52894438138479
E01001883,1485,736,749,0.49562289562289563,0.5043771043771044
E01001884,1843,909,934,0.4932175800325556,0.5067824199674443
E01001888,1614,810,804,0.5018587360594795,0.49814126394052044
E01001891,2030,989,1041,0.48719211822660097,0.512807881773399
E01001917,1462,708,754,0.4842681258549932,0.5157318741450069
E01001918,1519,691,828,0.4549045424621461,0.5450954575378538
E01001919,1630,756,874,0.4638036809815951,0.5361963190184049
E01001879,1475,717,758,0.48610169491525423,0.5138983050847458
E01001901,1625,781,844,0.4806153846153846,0.5193846153846153
E01001902,1699,824,875,0.4849911712772219,0.5150088287227781
E01001903,1649,838,811,0.5081867798665858,0.49181322013341416
E01001920,1513,796,717,0.5261070720423001,0.47389292795769994
E01001921,1536,765,771,0.498046875,0.501953125
E01001922,1605,768,837,0.4785046728971963,0.5214953271028038
E01001923,1479,717,762,0.4847870182555781,0.5152129817444219
E01001924,1596,756,840,0.47368421052631576,0.5263157894736842
E01001947,1448,647,801,0.4468232044198895,0.5531767955801105
E01001948,2012,931,1081,0.46272365805168986,0.5372763419483101
E01001949,1547,745,802,0.48157724628312865,0.5184227537168714
E01001950,1596,769,827,0.4818295739348371,0.518170426065163
E01001951,1609,750,859,0.4661280298321939,0.5338719701678061
E01001953,1366,656,710,0.4802342606149341,0.5197657393850659
E01001904,1587,763,824,0.4807813484562067,0.5192186515437933
E01001905,1702,807,895,0.47414806110458285,0.5258519388954171
E01001906,1439,669,770,0.4649061848505907,0.5350938151494093
E01001907,1303,600,703,0.4604758250191865,0.5395241749808135
E01001935,2059,958,1101,0.46527440505099565,0.5347255949490044
E01001939,2321,1165,1156,0.5019388194743645,0.4980611805256355
E01032788,1106,489,617,0.4421338155515371,0.5578661844484629
E01032789,1151,529,622,0.4596003475238923,0.5403996524761078
E01032790,1118,539,579,0.4821109123434705,0.5178890876565295
E01001915,1482,706,776,0.47638326585695007,0.5236167341430499
E01001916,1390,642,748,0.4618705035971223,0.5381294964028777
E01001926,1456,726,730,0.49862637362637363,0.5013736263736264
E01001952,1623,788,835,0.48552064078866297,0.514479359211337
E01001925,1628,794,834,0.4877149877149877,0.5122850122850123
E01001934,1622,781,841,0.4815043156596794,0.5184956843403206
E01001937,1823,905,918,0.4964344487109161,0.503565551289084
E01001938,1560,746,814,0.4782051282051282,0.5217948717948718
E01001969,1888,900,988,0.4766949152542373,0.5233050847457628
E01001971,2012,1033,979,0.5134194831013916,0.4865805168986084
E01001974,2198,1118,1080,0.5086442220200182,0.4913557779799818
E01001975,1717,845,872,0.49213744903902157,0.5078625509609784
E01002036,1619,817,802,0.5046324891908586,0.49536751080914143
E01002037,1832,1025,807,0.5594978165938864,0.4405021834061135
E01002039,1610,738,872,0.4583850931677019,0.5416149068322982
E01002040,2062,1049,1013,0.508729388942774,0.49127061105722597
E01001962,1758,861,897,0.48976109215017066,0.5102389078498294
E01001970,1981,965,1016,0.4871277132761232,0.5128722867238769
E01001972,1672,844,828,0.5047846889952153,0.49521531100478466
E01001973,2257,1087,1170,0.4816127603012849,0.5183872396987151
E01002090,1601,790,811,0.4934415990006246,0.5065584009993754
E01002093,1795,826,969,0.46016713091922007,0.53983286908078
E01002096,1645,772,873,0.46930091185410333,0.5306990881458966
E01002097,1693,763,930,0.45067926757235677,0.5493207324276432
E01002091,1802,811,991,0.45005549389567145,0.5499445061043285
E01002092,1697,807,890,0.47554507955215086,0.5244549204478491
E01002094,1554,715,839,0.4601029601029601,0.5398970398970399
E01002095,1644,747,897,0.4543795620437956,0.5456204379562044
E01002098,1349,651,698,0.4825796886582654,0.5174203113417346
E01002101,1916,1041,875,0.5433194154488518,0.45668058455114824
E01002102,1882,878,1004,0.4665249734325186,0.5334750265674814
E01002105,2052,1030,1022,0.5019493177387915,0.4980506822612086
E01002099,2108,1019,1089,0.4833965844402277,0.5166034155597723
E01002100,1909,940,969,0.4924044002095338,0.5075955997904662
E01002103,1862,960,902,0.5155746509129968,0.48442534908700324
E01002104,1436,702,734,0.48885793871866295,0.5111420612813371
E01001963,1820,913,907,0.5016483516483516,0.49835164835164836
E01001964,1588,784,804,0.49370277078085645,0.5062972292191436
E01001965,1627,782,845,0.48063921327596804,0.519360786724032
E01001966,1513,758,755,0.5009914077990747,0.4990085922009253
E01002027,1537,738,799,0.4801561483409239,0.5198438516590761
E01002028,1767,871,896,0.49292586304470853,0.5070741369552915
E01002032,1813,866,947,0.47766133480419193,0.5223386651958081
E01002033,1908,905,1003,0.47431865828092246,0.5256813417190775
E01001976,1628,783,845,0.480958230958231,0.519041769041769
E01001977,1580,772,808,0.48860759493670886,0.5113924050632911
E01001978,1905,967,938,0.5076115485564304,0.4923884514435696
E01001979,2199,1102,1097,0.5011368804001819,0.4988631195998181
E01002074,2122,1042,1080,0.49104618284637136,0.5089538171536286
E01002077,2079,1027,1052,0.493987493987494,0.506012506012506
E01002079,1642,782,860,0.4762484774665043,0.5237515225334958
E01002081,1769,870,899,0.4918032786885246,0.5081967213114754
E01002082,1508,727,781,0.48209549071618035,0.5179045092838196
E01002086,1646,822,824,0.4993924665856622,0.5006075334143378
E01002088,1853,930,923,0.5018888289260658,0.49811117107393416
E01002089,1520,760,760,0.5,0.5
E01001967,1655,756,899,0.456797583081571,0.543202416918429
E01001968,1834,903,931,0.49236641221374045,0.5076335877862596
E01001996,1625,794,831,0.4886153846153846,0.5113846153846154
E01001997,1579,787,792,0.49841671944268523,0.5015832805573147
E01002075,1777,868,909,0.4884637028700056,0.5115362971299944
E01002076,1888,905,983,0.4793432203389831,0.520656779661017
E01002078,2194,1098,1096,0.5004557885141294,0.4995442114858706
E01002080,1593,891,702,0.559322033898305,0.4406779661016949
E01002026,1619,777,842,0.47992588017294624,0.5200741198270538
E01002029,1725,790,935,0.4579710144927536,0.5420289855072464
E01002030,1640,863,777,0.526219512195122,0.473780487804878
E01002031,1930,974,956,0.5046632124352332,0.49533678756476685
E01001991,1693,750,943,0.44300059066745423,0.5569994093325458
E01001992,1709,850,859,0.497366881217086,0.502633118782914
E01001993,1686,818,868,0.4851720047449585,0.5148279952550415
E01001995,2412,1106,1306,0.45854063018242125,0.5414593698175788
E01001980,1986,1061,925,0.5342396777442094,0.46576032225579056
E01001981,1761,883,878,0.501419647927314,0.498580352072686
E01001982,1772,912,860,0.5146726862302483,0.4853273137697517
E01001983,1652,796,856,0.48184019370460046,0.5181598062953995
E01002083,1440,729,711,0.50625,0.49375
E01002084,1623,838,785,0.5163277880468269,0.4836722119531731
E01002085,2168,1079,1089,0.4976937269372694,0.5023062730627307
E01002087,1614,848,766,0.5254027261462205,0.4745972738537794
E01002014,1719,850,869,0.4944735311227458,0.5055264688772542
E01002015,1480,713,767,0.4817567567567568,0.5182432432432432
E01002018,1420,681,739,0.4795774647887324,0.5204225352112676
E01033085,1780,921,859,0.5174157303370787,0.48258426966292134
E01033086,1091,506,585,0.46379468377635197,0.536205316223648
E01002020,1564,745,819,0.47634271099744246,0.5236572890025576
E01002022,1921,935,986,0.48672566371681414,0.5132743362831859
E01002023,1474,704,770,0.47761194029850745,0.5223880597014925
E01002025,1717,866,851,0.5043680838672102,0.49563191613278973
E01002013,1401,642,759,0.4582441113490364,0.5417558886509636
E01002019,1309,625,684,0.4774637127578304,0.5225362872421696
E01002021,1479,696,783,0.47058823529411764,0.5294117647058824
E01002024,1320,640,680,0.48484848484848486,0.5151515151515151
E01001998,2058,1100,958,0.5344995140913509,0.4655004859086492
E01001999,2001,1030,971,0.5147426286856571,0.4852573713143428
E01002003,2160,1047,1113,0.4847222222222222,0.5152777777777777
E01002004,1889,974,915,0.5156167284277395,0.48438327157226047
E01002067,1694,836,858,0.4935064935064935,0.5064935064935064
E01002069,1937,950,987,0.490449148167269,0.5095508518327311
E01002070,2038,1019,1019,0.5,0.5
E01002073,1763,884,879,0.5014180374361883,0.4985819625638117
E01002066,1843,815,1028,0.44221378187737387,0.5577862181226262
E01002068,1822,974,848,0.5345773874862788,0.4654226125137212
E01002071,1615,787,828,0.4873065015479876,0.5126934984520124
E01002072,1868,906,962,0.48501070663811563,0.5149892933618844
E01002043,2020,1032,988,0.5108910891089109,0.4891089108910891
E01002045,2199,1219,980,0.5543428831286948,0.44565711687130516
E01002046,1725,843,882,0.48869565217391303,0.5113043478260869
E01002049,1881,914,967,0.4859117490696438,0.5140882509303561
E01002042,1459,766,693,0.5250171350239891,0.47498286497601094
E01002044,1729,893,836,0.5164835164835165,0.4835164835164835
E01002047,1670,824,846,0.4934131736526946,0.5065868263473053
E01002048,1955,1044,911,0.5340153452685422,0.4659846547314578
E01002016,1959,930,1029,0.47473200612557426,0.5252679938744257
E01002017,1809,946,863,0.5229408512990602,0.47705914870093974
E01002059,1671,825,846,0.49371633752244165,0.5062836624775583
E01002060,1759,855,904,0.4860716316088687,0.5139283683911313
E01002050,1895,957,938,0.5050131926121372,0.49498680738786277
E01002051,1683,853,830,0.5068330362448009,0.49316696375519903
E01002052,2020,993,1027,0.4915841584158416,0.5084158415841584
E01002055,1658,849,809,0.5120627261761158,0.4879372738238842
E01001994,1784,871,913,0.4882286995515695,0.5117713004484304
E01002008,1571,728,843,0.4633991088478676,0.5366008911521324
E01002010,1658,771,887,0.4650180940892642,0.5349819059107358
E01002011,1718,908,810,0.5285215366705471,0.47147846332945287
E01002000,1697,829,868,0.48850913376546845,0.5114908662345315
E01002001,1661,866,795,0.5213726670680313,0.4786273329319687
E01002002,1806,976,830,0.540420819490587,0.45957918050941304
E01002058,1690,877,813,0.5189349112426036,0.48106508875739645
E01002053,1745,863,882,0.49455587392550143,0.5054441260744985
E01002054,1732,876,856,0.5057736720554272,0.4942263279445728
E01002056,1964,1007,957,0.5127291242362525,0.48727087576374745
E01002057,1581,780,801,0.49335863377609107,0.5066413662239089
E01001984,1590,820,770,0.5157232704402516,0.48427672955974843
E01001985,1690,832,858,0.49230769230769234,0.5076923076923077
E01001987,1847,940,907,0.5089334055224689,0.49106659447753115
E01001989,1725,812,913,0.4707246376811594,0.5292753623188405
E01001986,1635,795,840,0.48623853211009177,0.5137614678899083
E01001988,1771,844,927,0.47656691134952006,0.52343308865048
E01001990,2137,1136,1001,0.5315863359850257,0.46841366401497425
E01002062,1874,958,916,0.5112059765208111,0.4887940234791889
E01002005,1688,883,805,0.5231042654028436,0.4768957345971564
E01002006,1602,765,837,0.47752808988764045,0.5224719101123596
E01002007,1676,827,849,0.493436754176611,0.5065632458233891
E01002009,1719,881,838,0.5125072716695753,0.4874927283304247
E01002061,1687,842,845,0.4991108476585655,0.5008891523414345
E01002063,1587,787,800,0.4959042218021424,0.5040957781978576
E01002064,1514,736,778,0.4861294583883752,0.5138705416116248
E01002065,1666,856,810,0.5138055222088835,0.48619447779111646
E01002034,1859,938,921,0.5045723507261969,0.4954276492738031
E01002038,1653,808,845,0.48880822746521474,0.5111917725347852
E01002041,1886,921,965,0.4883351007423118,0.5116648992576882
E01032575,1908,891,1017,0.4669811320754717,0.5330188679245284
E01002755,1326,640,686,0.48265460030165913,0.5173453996983409
E01002756,1332,642,690,0.481981981981982,0.5180180180180181
E01002758,1576,783,793,0.49682741116751267,0.5031725888324873
E01002804,1669,813,856,0.48711803475134813,0.5128819652486519
E01002807,1734,781,953,0.45040369088811993,0.5495963091118801
E01002811,1545,728,817,0.47119741100323626,0.5288025889967638
E01002753,1429,686,743,0.4800559832050385,0.5199440167949615
E01002754,1508,719,789,0.47679045092838196,0.523209549071618
E01002757,1433,646,787,0.45080251221214235,0.5491974877878576
E01002759,1647,771,876,0.4681238615664845,0.5318761384335154
E01002760,1543,714,829,0.4627349319507453,0.5372650680492547
E01002772,1848,913,935,0.49404761904761907,0.5059523809523809
E01002735,1645,832,813,0.505775075987842,0.49422492401215806
E01002805,1569,792,777,0.5047801147227533,0.49521988527724664
E01002806,1595,758,837,0.47523510971786836,0.5247648902821317
E01002808,1907,916,991,0.48033560566334554,0.5196643943366545
E01002809,1640,808,832,0.4926829268292683,0.5073170731707317
E01002810,1652,816,836,0.4939467312348668,0.5060532687651331
E01002768,1604,755,849,0.4706982543640898,0.5293017456359103
E01002770,1541,755,786,0.4899415963659961,0.5100584036340039
E01002771,1483,684,799,0.4612272420768712,0.5387727579231288
E01002773,1386,670,716,0.4834054834054834,0.5165945165945166
E01002774,2110,1014,1096,0.48056872037914694,0.5194312796208531
E01002732,1845,936,909,0.5073170731707317,0.4926829268292683
E01002734,1692,847,845,0.5005910165484634,0.49940898345153667
E01002736,1580,751,829,0.4753164556962025,0.5246835443037975
E01002737,1957,916,1041,0.4680633622892182,0.5319366377107818
E01002751,1796,913,883,0.5083518930957683,0.4916481069042316
E01002742,1561,789,772,0.5054452274183215,0.4945547725816784
E01002747,1635,882,753,0.5394495412844037,0.46055045871559636
E01002748,1467,726,741,0.4948875255623722,0.5051124744376279
E01002749,1316,608,708,0.46200607902735563,0.5379939209726444
E01033493,1301,737,564,0.5664873174481169,0.4335126825518832
E01033494,1498,754,744,0.5033377837116155,0.49666221628838453
E01002730,1781,900,881,0.5053340819764177,0.49466591802358223
E01002731,2466,1311,1155,0.5316301703163017,0.4683698296836983
E01002733,1392,664,728,0.47701149425287354,0.5229885057471264
E01002763,1437,739,698,0.5142658315935977,0.4857341684064022
E01002769,2053,952,1101,0.4637116415002435,0.5362883584997564
E01002785,1968,978,990,0.4969512195121951,0.5030487804878049
E01002788,1851,935,916,0.5051323608860075,0.49486763911399245
E01002789,1874,915,959,0.48826040554962646,0.5117395944503735
E01002738,1785,845,940,0.4733893557422969,0.5266106442577031
E01002741,1513,718,795,0.47455386649041637,0.5254461335095836
E01002743,1672,819,853,0.48983253588516745,0.5101674641148325
E01002744,1442,749,693,0.5194174757281553,0.48058252427184467
E01002752,1522,703,819,0.461892247043364,0.538107752956636
E01002764,1779,879,900,0.49409780775716694,0.5059021922428331
E01002783,1487,751,736,0.5050437121721587,0.4949562878278413
E01002784,1795,889,906,0.49526462395543175,0.5047353760445682
E01002786,1805,909,896,0.503601108033241,0.496398891966759
E01002787,1620,647,973,0.3993827160493827,0.6006172839506173
E01002762,1949,967,982,0.4961518727552591,0.5038481272447409
E01002767,2044,961,1083,0.47015655577299414,0.5298434442270059
E01033486,1036,490,546,0.47297297297297297,0.527027027027027
E01033487,1226,619,607,0.5048939641109299,0.49510603588907015
E01033488,1205,571,634,0.4738589211618257,0.5261410788381743
E01033491,1680,866,814,0.5154761904761904,0.4845238095238095
E01033492,1348,710,638,0.526706231454006,0.4732937685459941
E01002777,1626,776,850,0.47724477244772445,0.5227552275522755
E01002778,1787,847,940,0.4739787353105764,0.5260212646894236
E01002779,1891,893,998,0.47223691168693815,0.5277630883130618
E01002781,1350,650,700,0.48148148148148145,0.5185185185185185
E01002782,1533,738,795,0.48140900195694714,0.5185909980430529
E01002739,1835,884,951,0.4817438692098093,0.5182561307901907
E01002740,1826,911,915,0.49890470974808326,0.5010952902519168
E01002745,1467,697,770,0.47511929107021134,0.5248807089297887
E01002795,1997,1004,993,0.5027541311967952,0.4972458688032048
E01002796,1039,496,543,0.4773820981713186,0.5226179018286814
E01002716,2300,1006,1294,0.4373913043478261,0.5626086956521739
E01002718,1661,829,832,0.4990969295605057,0.5009030704394943
E01002721,1667,802,865,0.48110377924415115,0.5188962207558488
E01002775,1429,689,740,0.4821553533939818,0.5178446466060181
E01002776,1661,791,870,0.47621914509331725,0.5237808549066827
E01002780,1640,771,869,0.47012195121951217,0.5298780487804878
E01002708,1979,979,1000,0.4946942900454775,0.5053057099545225
E01002712,1780,1172,608,0.6584269662921348,0.3415730337078652
E01002713,1559,743,816,0.4765875561257216,0.5234124438742784
E01002765,2513,1196,1317,0.475925189017111,0.524074810982889
E01002766,1794,855,939,0.4765886287625418,0.5234113712374582
E01002717,1315,648,667,0.49277566539923956,0.5072243346007604
E01002719,1490,690,800,0.46308724832214765,0.5369127516778524
E01002720,2334,1040,1294,0.44558697514995715,0.5544130248500428
E01002790,1435,678,757,0.47247386759581883,0.5275261324041812
E01002791,1543,778,765,0.5042125729099157,0.4957874270900843
E01002793,1905,935,970,0.49081364829396323,0.5091863517060368
E01002698,2063,1035,1028,0.5016965584100824,0.4983034415899176
E01002699,1507,764,743,0.5069674850696748,0.4930325149303251
E01002700,1478,771,707,0.5216508795669824,0.4783491204330176
E01002714,1698,836,862,0.4923439340400471,0.5076560659599529
E01002792,1869,897,972,0.4799357945425361,0.5200642054574639
E01002722,1305,648,657,0.496551724137931,0.503448275862069
E01002797,1873,919,954,0.4906567004805125,0.5093432995194874
E01002798,1965,1013,952,0.5155216284987277,0.48447837150127226
E01002799,1839,860,979,0.4676454594888526,0.5323545405111474
E01002800,1049,508,541,0.48427073403241183,0.5157292659675882
E01002694,1532,685,847,0.4471279373368146,0.5528720626631853
E01002697,2098,991,1107,0.4723546234509056,0.5276453765490944
E01002709,1754,887,867,0.5057012542759407,0.4942987457240593
E01002710,1676,786,890,0.46897374701670647,0.5310262529832935
E01002715,1511,722,789,0.47782925215089345,0.5221707478491066
E01002696,1813,889,924,0.49034749034749037,0.5096525096525096
E01002794,1765,887,878,0.5025495750708215,0.49745042492917846
E01002801,1553,798,755,0.5138441725692209,0.4861558274307791
E01002802,1480,730,750,0.49324324324324326,0.5067567567567568
E01002803,2063,1064,999,0.5157537566650509,0.4842462433349491
E01002695,1710,816,894,0.47719298245614034,0.5228070175438596
E01002711,1939,1018,921,0.5250128932439402,0.4749871067560598
E01002727,1624,820,804,0.5049261083743842,0.49507389162561577
E01002728,1635,777,858,0.47522935779816516,0.5247706422018349
E01002729,1593,767,826,0.48148148148148145,0.5185185185185185
E01002707,1726,914,812,0.52954808806489,0.4704519119351101
E01002723,1529,784,745,0.512753433616743,0.48724656638325703
E01002724,1973,1094,879,0.5544855549923974,0.4455144450076026
E01002725,1444,761,683,0.5270083102493075,0.4729916897506925
E01002726,1692,887,805,0.5242316784869976,0.47576832151300236
E01033489,1832,951,881,0.5191048034934498,0.4808951965065502
E01033490,1693,835,858,0.4932073242764324,0.5067926757235677
E01002701,1582,788,794,0.49810366624525915,0.5018963337547409
E01002702,1957,985,972,0.5033214103219213,0.4966785896780787
E01002703,1635,847,788,0.5180428134556575,0.4819571865443425
E01002704,2198,1207,991,0.5491355777979982,0.45086442220200185
E01002706,2016,984,1032,0.4880952380952381,0.5119047619047619
E01002852,1908,912,996,0.4779874213836478,0.5220125786163522
E01002853,1093,541,552,0.494967978042086,0.505032021957914
E01002854,1121,532,589,0.4745762711864407,0.5254237288135594
E01002855,1728,872,856,0.5046296296296297,0.49537037037037035
E01002857,1349,666,683,0.4936990363232024,0.5063009636767977
E01002904,1173,583,590,0.49701619778346123,0.5029838022165388
E01002905,1568,708,860,0.45153061224489793,0.548469387755102
E01002906,1681,817,864,0.4860202260559191,0.5139797739440809
E01002907,1376,644,732,0.4680232558139535,0.5319767441860465
E01002876,1732,849,883,0.49018475750577367,0.5098152424942263
E01002877,1710,790,920,0.4619883040935672,0.5380116959064327
E01002878,1629,776,853,0.476365868631062,0.523634131368938
E01002908,1391,648,743,0.46585190510424157,0.5341480948957584
E01002909,2154,1028,1126,0.47725162488393685,0.5227483751160631
E01002829,1466,748,718,0.5102319236016372,0.4897680763983629
E01002830,1773,906,867,0.5109983079526227,0.4890016920473773
E01002831,1977,937,1040,0.47395042994436015,0.5260495700556399
E01002832,1701,793,908,0.466196355085244,0.5338036449147561
E01002856,1738,862,876,0.49597238204833144,0.5040276179516686
E01002870,1386,667,719,0.48124098124098125,0.5187590187590188
E01002872,1446,672,774,0.46473029045643155,0.5352697095435685
E01002879,1528,691,837,0.45222513089005234,0.5477748691099477
E01002880,1540,702,838,0.45584415584415583,0.5441558441558442
E01002881,1398,683,715,0.488555078683834,0.5114449213161659
E01002882,1334,584,750,0.43778110944527737,0.5622188905547226
E01002883,1836,881,955,0.4798474945533769,0.5201525054466231
E01002884,1403,749,654,0.533856022808268,0.466143977191732
E01002885,1538,788,750,0.5123537061118335,0.48764629388816644
E01002886,1548,756,792,0.4883720930232558,0.5116279069767442
E01002833,1460,696,764,0.4767123287671233,0.5232876712328767
E01002871,1685,819,866,0.486053412462908,0.513946587537092
E01002873,1331,634,697,0.4763335837716003,0.5236664162283997
E01002874,1439,701,738,0.4871438498957609,0.512856150104239
E01002875,1388,635,753,0.45749279538904897,0.542507204610951
E01002824,1519,732,787,0.4818959842001317,0.5181040157998683
E01002825,1941,873,1068,0.44976816074188564,0.5502318392581144
E01002826,1551,774,777,0.4990328820116054,0.5009671179883946
E01002827,1835,908,927,0.4948228882833787,0.5051771117166213
E01002828,1332,685,647,0.5142642642642643,0.48573573573573575
E01002864,1500,676,824,0.45066666666666666,0.5493333333333333
E01002866,1744,843,901,0.4833715596330275,0.5166284403669725
E01002867,1981,968,1013,0.48864209994952046,0.5113579000504795
E01002868,1652,838,814,0.5072639225181598,0.4927360774818402
E01002869,1507,769,738,0.5102853351028533,0.48971466489714666
E01002887,1401,728,673,0.5196288365453248,0.48037116345467523
E01002889,1279,622,657,0.48631743549648165,0.5136825645035183
E01002890,1812,851,961,0.4696467991169978,0.5303532008830022
E01002891,1446,735,711,0.508298755186722,0.491701244813278
E01002892,1831,976,855,0.5330420535226652,0.4669579464773348
E01002813,1767,924,843,0.5229202037351444,0.4770797962648557
E01002815,1424,711,713,0.49929775280898875,0.5007022471910112
E01002816,1355,673,682,0.4966789667896679,0.5033210332103321
E01002817,1594,762,832,0.4780426599749059,0.5219573400250941
E01002865,1383,673,710,0.4866232827187274,0.5133767172812725
E01002818,2002,1071,931,0.534965034965035,0.46503496503496505
E01002819,1586,827,759,0.521437578814628,0.478562421185372
E01002859,1628,845,783,0.519041769041769,0.480958230958231
E01002860,1502,743,759,0.49467376830892146,0.5053262316910786
E01002863,1441,739,702,0.5128383067314365,0.4871616932685635
E01002812,1917,1002,915,0.5226917057902973,0.47730829420970267
E01002834,1430,736,694,0.5146853146853146,0.4853146853146853
E01002839,1568,861,707,0.5491071428571429,0.45089285714285715
E01002850,1451,781,670,0.538249483115093,0.461750516884907
E01002888,2078,1140,938,0.548604427333975,0.45139557266602504
E01002821,1425,695,730,0.48771929824561405,0.512280701754386
E01002823,1369,647,722,0.47260774287801316,0.5273922571219869
E01002858,1254,553,701,0.4409888357256778,0.5590111642743222
E01002861,1424,711,713,0.49929775280898875,0.5007022471910112
E01002862,1543,724,819,0.4692158133506157,0.5307841866493843
E01002814,1956,957,999,0.4892638036809816,0.5107361963190185
E01002847,1599,837,762,0.5234521575984991,0.47654784240150094
E01002848,1572,825,747,0.5248091603053435,0.4751908396946565
E01002851,1642,858,784,0.5225334957369062,0.4774665042630938
E01002820,1251,611,640,0.48840927258193445,0.5115907274180655
E01002822,1206,577,629,0.478441127694859,0.521558872305141
E01002835,1555,771,784,0.4958199356913183,0.5041800643086817
E01002836,1390,724,666,0.520863309352518,0.479136690647482
E01002837,1359,686,673,0.5047829286239882,0.4952170713760118
E01002846,1315,674,641,0.5125475285171103,0.4874524714828897
E01002849,1525,797,728,0.5226229508196721,0.47737704918032786
E01002893,1775,918,857,0.5171830985915493,0.4828169014084507
E01002894,1400,734,666,0.5242857142857142,0.4757142857142857
E01002898,1609,785,824,0.48788067122436296,0.512119328775637
E01002899,1355,664,691,0.4900369003690037,0.5099630996309963
E01002900,1430,676,754,0.4727272727272727,0.5272727272727272
E01002901,1250,699,551,0.5592,0.4408
E01002902,1704,844,860,0.4953051643192488,0.5046948356807511
E01002903,1513,742,771,0.4904163912756114,0.5095836087243887
E01002844,1370,671,699,0.4897810218978102,0.5102189781021897
E01002845,1358,681,677,0.5014727540500736,0.49852724594992637
E01002910,1388,628,760,0.45244956772334294,0.547550432276657
E01002911,1651,770,881,0.4663840096910963,0.5336159903089037
E01002914,1564,722,842,0.4616368286445013,0.5383631713554987
E01002838,1631,909,722,0.5573267933782955,0.44267320662170445
E01002895,1395,678,717,0.4860215053763441,0.513978494623656
E01002896,1752,894,858,0.5102739726027398,0.4897260273972603
E01002897,1314,648,666,0.4931506849315068,0.5068493150684932
E01002912,1690,771,919,0.45621301775147927,0.5437869822485207
E01002840,1383,629,754,0.45480838756326825,0.5451916124367318
E01002841,1368,694,674,0.5073099415204678,0.4926900584795322
E01002842,1253,568,685,0.4533120510774142,0.5466879489225858
E01002843,1232,554,678,0.4496753246753247,0.5503246753246753
E01002913,1894,932,962,0.49208025343189016,0.5079197465681098
E01003015,1594,739,855,0.46361355081555833,0.5363864491844417
E01003108,1555,811,744,0.5215434083601286,0.47845659163987136
E01003110,1873,965,908,0.5152162306460224,0.4847837693539776
E01003111,1530,771,759,0.503921568627451,0.49607843137254903
E01003112,1502,783,719,0.5213049267643143,0.4786950732356858
E01003101,1568,812,756,0.5178571428571429,0.48214285714285715
E01003105,1673,835,838,0.49910340705319783,0.5008965929468021
E01003106,1962,1001,961,0.5101936799184505,0.48980632008154945
E01003107,1912,1049,863,0.5486401673640168,0.4513598326359833
E01003109,2255,1198,1057,0.5312638580931264,0.4687361419068736
E01003102,1738,953,785,0.5483314154200231,0.451668584579977
E01003104,1608,883,725,0.5491293532338308,0.45087064676616917
E01003122,1813,976,837,0.5383342526199669,0.4616657473800331
E01003129,1839,964,875,0.5241979336595977,0.4758020663404024
E01033207,1708,928,780,0.5433255269320844,0.4566744730679157
E01033208,1723,945,778,0.5484619849100406,0.4515380150899594
E01003098,1558,828,730,0.5314505776636713,0.4685494223363286
E01003099,1590,857,733,0.5389937106918239,0.4610062893081761
E01003100,1942,1090,852,0.5612770339855818,0.4387229660144181
E01003180,1506,749,757,0.49734395750332006,0.50265604249668
E01003183,1498,753,745,0.5026702269692924,0.49732977303070763
E01003097,1671,854,817,0.5110712148414124,0.4889287851585877
E01003121,1624,795,829,0.4895320197044335,0.5104679802955665
E01003123,1489,791,698,0.5312290127602418,0.46877098723975824
E01003124,1444,778,666,0.538781163434903,0.46121883656509693
E01003125,1762,831,931,0.4716231555051078,0.5283768444948922
E01003181,1472,737,735,0.5006793478260869,0.499320652173913
E01003184,1414,668,746,0.4724186704384724,0.5275813295615276
E01003185,1655,860,795,0.5196374622356495,0.48036253776435045
E01003186,1948,1047,901,0.5374743326488707,0.4625256673511294
E01003187,1487,713,774,0.47948890383322124,0.5205110961667787
E01003089,1874,956,918,0.5101387406616862,0.48986125933831376
E01003091,1667,855,812,0.5128974205158968,0.4871025794841032
E01003092,1787,873,914,0.4885282596530498,0.5114717403469502
E01003126,1532,781,751,0.5097911227154047,0.4902088772845953
E01003128,1501,774,727,0.5156562291805463,0.4843437708194537
E01003046,1741,839,902,0.48190695002871914,0.5180930499712809
E01003048,1764,848,916,0.48072562358276644,0.5192743764172335
E01003075,1633,795,838,0.48683404776484995,0.51316595223515
E01003182,1822,939,883,0.5153677277716795,0.4846322722283205
E01003188,1341,646,695,0.4817300521998509,0.5182699478001491
E01003088,1817,876,941,0.48211337369290036,0.5178866263070996
E01003093,2371,1116,1255,0.47068747363981445,0.5293125263601856
E01003094,1539,739,800,0.4801819363222872,0.5198180636777128
E01003096,2071,1143,928,0.5519072911636891,0.44809270883631097
E01003127,1773,963,810,0.5431472081218274,0.45685279187817257
E01003045,1971,976,995,0.49518011161846776,0.5048198883815322
E01003047,1627,824,803,0.5064535955746773,0.49354640442532266
E01003049,1695,816,879,0.4814159292035398,0.5185840707964602
E01003059,1634,826,808,0.5055079559363526,0.4944920440636475
E01003060,1558,774,784,0.496790757381258,0.503209242618742
E01003061,1246,658,588,0.5280898876404494,0.47191011235955055
E01003034,1751,898,853,0.5128498001142204,0.48715019988577957
E01003035,1557,759,798,0.48747591522157996,0.51252408477842
E01003036,1608,808,800,0.5024875621890548,0.4975124378109453
E01003090,2279,1197,1082,0.5252303641948223,0.4747696358051777
E01003095,1838,908,930,0.4940152339499456,0.5059847660500544
E01003037,1387,628,759,0.4527757750540735,0.5472242249459265
E01003038,1506,757,749,0.50265604249668,0.49734395750332006
E01003039,2042,1092,950,0.534769833496572,0.465230166503428
E01003040,1288,618,670,0.4798136645962733,0.5201863354037267
E01003042,1043,514,529,0.4928092042186002,0.5071907957813998
E01003072,1848,895,953,0.4843073593073593,0.5156926406926406
E01003073,1697,805,892,0.474366529169122,0.525633470830878
E01003076,1915,946,969,0.4939947780678851,0.5060052219321148
E01003077,1792,871,921,0.48604910714285715,0.5139508928571429
E01003078,1580,773,807,0.4892405063291139,0.510759493670886
E01003019,2090,1063,1027,0.5086124401913875,0.49138755980861243
E01003053,1728,895,833,0.5179398148148148,0.4820601851851852
E01003054,1832,905,927,0.49399563318777295,0.506004366812227
E01003056,1935,954,981,0.4930232558139535,0.5069767441860465
E01003058,1931,1012,919,0.5240807871569135,0.47591921284308647
E01003020,1775,848,927,0.47774647887323946,0.5222535211267606
E01003050,1650,832,818,0.5042424242424243,0.49575757575757573
E01003052,1821,933,888,0.5123558484349259,0.4876441515650741
E01003055,1490,783,707,0.525503355704698,0.47449664429530203
E01003176,1906,890,1016,0.4669464847848898,0.5330535152151101
E01003029,1808,916,892,0.5066371681415929,0.49336283185840707
E01003032,1747,867,880,0.4962793360045793,0.5037206639954207
E01003041,1613,784,829,0.486050836949783,0.513949163050217
E01003057,1678,825,853,0.49165673420738976,0.5083432657926102
E01003043,1634,793,841,0.48531211750305997,0.51468788249694
E01003044,1238,637,601,0.5145395799676898,0.48546042003231016
E01003051,1643,776,867,0.4723067559342666,0.5276932440657334
E01003071,2278,1155,1123,0.5070237050043899,0.4929762949956102
E01003074,2364,1207,1157,0.510575296108291,0.48942470389170895
E01003026,1484,760,724,0.5121293800539084,0.48787061994609165
E01003027,1373,667,706,0.4857975236707939,0.5142024763292061
E01003028,1469,751,718,0.5112321307011573,0.48876786929884275
E01003030,1795,895,900,0.4986072423398329,0.5013927576601671
E01003033,1518,756,762,0.4980237154150198,0.5019762845849802
E01003018,2079,1063,1016,0.5113035113035113,0.4886964886964887
E01003171,1745,873,872,0.5002865329512894,0.4997134670487106
E01003173,1610,818,792,0.5080745341614907,0.4919254658385093
E01003177,1648,849,799,0.5151699029126213,0.4848300970873786
E01003178,1605,824,781,0.5133956386292835,0.4866043613707165
E01003021,1903,1065,838,0.5596426694692591,0.44035733053074094
E01003022,1746,839,907,0.4805269186712486,0.5194730813287515
E01003023,2380,1154,1226,0.48487394957983193,0.515126050420168
E01003024,1798,854,944,0.474972191323693,0.525027808676307
E01003025,2071,1047,1024,0.5055528730082086,0.4944471269917914
E01003136,1583,753,830,0.4756790903348073,0.5243209096651926
E01003137,1475,727,748,0.4928813559322034,0.5071186440677966
E01003159,1473,732,741,0.4969450101832994,0.5030549898167006
E01003160,1462,705,757,0.48221614227086185,0.5177838577291382
E01003162,2126,1008,1118,0.47412982126058323,0.5258701787394168
E01003031,1658,818,840,0.49336550060313633,0.5066344993968637
E01003156,1555,733,822,0.47138263665594854,0.5286173633440514
E01003157,1549,739,810,0.47708198837959975,0.5229180116204003
E01003158,1596,728,868,0.45614035087719296,0.543859649122807
E01003161,1250,592,658,0.4736,0.5264
E01003163,1515,726,789,0.4792079207920792,0.5207920792079208
E01003132,1522,709,813,0.46583442838370565,0.5341655716162943
E01003172,1949,990,959,0.5079527963057978,0.49204720369420213
E01003174,2045,919,1126,0.4493887530562347,0.5506112469437653
E01003175,1610,758,852,0.47080745341614905,0.529192546583851
E01003179,1653,762,891,0.46098003629764067,0.5390199637023594
E01003164,2120,1050,1070,0.49528301886792453,0.5047169811320755
E01003165,1610,757,853,0.47018633540372673,0.5298136645962733
E01003168,1584,752,832,0.47474747474747475,0.5252525252525253
E01003169,2455,1228,1227,0.50020366598778,0.49979633401221996
E01003170,1859,905,954,0.4868208714362561,0.5131791285637439
E01003130,1740,902,838,0.5183908045977011,0.48160919540229885
E01003131,1447,704,743,0.4865238424326192,0.5134761575673807
E01003135,1684,803,881,0.47684085510688834,0.5231591448931117
E01003138,1537,759,778,0.49381912817176316,0.5061808718282368
E01003151,1961,846,1115,0.43141254462009176,0.5685874553799082
E01003079,1797,846,951,0.4707846410684474,0.5292153589315526
E01003080,1603,801,802,0.49968808484092325,0.5003119151590767
E01003133,1719,882,837,0.5130890052356021,0.4869109947643979
E01003134,1556,747,809,0.4800771208226221,0.5199228791773779
E01003152,1945,937,1008,0.4817480719794344,0.5182519280205655
E01003064,1536,756,780,0.4921875,0.5078125
E01003066,1688,810,878,0.47985781990521326,0.5201421800947867
E01003081,1783,903,880,0.5064498037016265,0.49355019629837354
E01003166,2290,1117,1173,0.4877729257641921,0.5122270742358078
E01003167,1723,838,885,0.4863609982588508,0.5136390017411492
E01003116,1598,768,830,0.4806007509386733,0.5193992490613266
E01003117,1926,941,985,0.4885773624091381,0.5114226375908619
E01003118,1735,873,862,0.5031700288184437,0.4968299711815562
E01003153,2066,1027,1039,0.49709583736689256,0.5029041626331074
E01003155,1796,902,894,0.5022271714922049,0.4977728285077951
E01003083,1508,732,776,0.4854111405835544,0.5145888594164456
E01003084,1611,802,809,0.4978274363749224,0.5021725636250776
E01003085,1734,840,894,0.4844290657439446,0.5155709342560554
E01003149,1791,883,908,0.49302065884980456,0.5069793411501954
E01003154,1839,922,917,0.5013594344752583,0.49864056552474173
E01003065,1472,659,813,0.4476902173913043,0.5523097826086957
E01003068,1592,744,848,0.46733668341708545,0.5326633165829145
E01003082,1452,700,752,0.4820936639118457,0.5179063360881543
E01003086,1611,712,899,0.4419615145872129,0.5580384854127871
E01003087,1664,764,900,0.45913461538461536,0.5408653846153846
E01003113,1988,979,1009,0.4924547283702213,0.5075452716297787
E01003114,1817,902,915,0.4964226747385801,0.50357732526142
E01003119,1885,930,955,0.493368700265252,0.506631299734748
E01003120,1983,1026,957,0.5173978819969742,0.4826021180030257
E01003148,1792,897,895,0.5005580357142857,0.4994419642857143
E01003150,1716,833,883,0.48543123543123545,0.5145687645687645
E01003062,1668,784,884,0.47002398081534774,0.5299760191846523
E01003063,1432,658,774,0.4594972067039106,0.5405027932960894
E01003067,1471,707,764,0.4806254248810333,0.5193745751189667
E01003069,1361,619,742,0.4548126377663483,0.5451873622336517
E01003070,1492,704,788,0.4718498659517426,0.5281501340482574
E01003115,1618,764,854,0.4721878862793572,0.5278121137206427
E01003141,1715,849,866,0.49504373177842564,0.5049562682215744
E01003144,1569,799,770,0.5092415551306565,0.49075844486934356
E01003145,1699,831,868,0.4891112419070041,0.5108887580929958
E01003147,1990,1017,973,0.5110552763819095,0.48894472361809044
E01003139,1564,760,804,0.4859335038363171,0.5140664961636828
E01003140,1489,740,749,0.49697783747481533,0.5030221625251847
E01003142,1359,687,672,0.5055187637969095,0.49448123620309054
E01003143,1434,679,755,0.4735006973500697,0.5264993026499303
E01003146,1517,767,750,0.5056031641397495,0.4943968358602505
E01003013,1639,873,766,0.5326418547895058,0.4673581452104942
E01003014,1534,787,747,0.5130378096479792,0.4869621903520209
E01003016,1352,661,691,0.488905325443787,0.511094674556213
E01003017,1663,895,768,0.5381840048105833,0.46181599518941674
E01032582,1893,1022,871,0.5398837823560486,0.4601162176439514
E01003244,1629,805,824,0.4941682013505218,0.5058317986494782
E01003245,1559,723,836,0.463758819756254,0.536241180243746
E01003247,1673,875,798,0.5230125523012552,0.4769874476987448
E01003249,1928,992,936,0.5145228215767634,0.4854771784232365
E01003250,1755,913,842,0.5202279202279202,0.47977207977207975
E01003246,1439,709,730,0.4927032661570535,0.5072967338429465
E01003248,1622,768,854,0.47348951911220716,0.5265104808877928
E01003251,2003,936,1067,0.4672990514228657,0.5327009485771343
E01003252,1557,742,815,0.4765574823378292,0.5234425176621709
E01003253,1438,701,737,0.4874826147426982,0.5125173852573018
E01003297,1538,769,769,0.5,0.5
E01003299,1623,784,839,0.48305606900800985,0.5169439309919901
E01003301,2166,1125,1041,0.5193905817174516,0.4806094182825485
E01003302,1509,740,769,0.49039098740888004,0.5096090125911199
E01003305,1372,651,721,0.4744897959183674,0.5255102040816326
E01003207,1399,705,694,0.5039313795568263,0.4960686204431737
E01003209,2007,978,1029,0.4872944693572496,0.5127055306427504
E01003210,1746,942,804,0.5395189003436426,0.46048109965635736
E01003212,1976,994,982,0.5030364372469636,0.49696356275303644
E01003215,1950,921,1029,0.4723076923076923,0.5276923076923077
E01003338,1784,881,903,0.4938340807174888,0.5061659192825112
E01003339,1760,940,820,0.5340909090909091,0.4659090909090909
E01003340,1906,1040,866,0.5456453305351522,0.45435466946484787
E01003341,1508,764,744,0.506631299734748,0.493368700265252
E01003343,1356,685,671,0.5051622418879056,0.4948377581120944
E01003199,1728,813,915,0.4704861111111111,0.5295138888888888
E01003201,1664,745,919,0.44771634615384615,0.5522836538461539
E01003204,1391,682,709,0.49029475197699496,0.509705248023005
E01003205,1332,655,677,0.49174174174174173,0.5082582582582582
E01003206,1582,779,803,0.49241466498103664,0.5075853350189633
E01003211,1566,783,783,0.5,0.5
E01003213,1938,942,996,0.48606811145510836,0.5139318885448917
E01003214,1772,841,931,0.47460496613995484,0.5253950338600452
E01033324,1597,745,852,0.4664996869129618,0.5335003130870382
E01033325,1205,707,498,0.5867219917012448,0.41327800829875516
E01003198,1461,654,807,0.44763860369609854,0.5523613963039015
E01003200,1553,820,733,0.5280103026400516,0.4719896973599485
E01003202,1559,740,819,0.4746632456703015,0.5253367543296985
E01003203,1769,902,867,0.5098925946862635,0.4901074053137366
E01003336,1378,653,725,0.47387518142235124,0.5261248185776488
E01003337,1636,755,881,0.4614914425427873,0.5385085574572127
E01003342,1641,842,799,0.5131017672151127,0.48689823278488725
E01003344,1731,748,983,0.43212016175621026,0.5678798382437897
E01003345,1714,861,853,0.5023337222870479,0.49766627771295213
E01003273,2000,1192,808,0.596,0.404
E01003277,1714,874,840,0.5099183197199533,0.49008168028004667
E01003278,1887,943,944,0.49973502914679385,0.5002649708532061
E01003279,1593,752,841,0.47206528562460764,0.5279347143753923
E01003288,1810,909,901,0.5022099447513813,0.4977900552486188
E01003290,1730,917,813,0.5300578034682081,0.4699421965317919
E01003291,1512,755,757,0.49933862433862436,0.5006613756613757
E01003296,2046,1046,1000,0.5112414467253177,0.4887585532746823
E01033327,1527,787,740,0.5153896529142109,0.48461034708578915
E01033341,1303,648,655,0.49731389102072143,0.5026861089792786
E01003282,2418,1230,1188,0.5086848635235732,0.4913151364764268
E01003283,2108,1064,1044,0.5047438330170778,0.4952561669829222
E01003284,1757,880,877,0.5008537279453614,0.4991462720546386
E01003286,1633,776,857,0.47519902020820576,0.5248009797917943
E01003272,1966,906,1060,0.46083418107833163,0.5391658189216684
E01003274,1724,831,893,0.4820185614849188,0.5179814385150812
E01003275,1727,822,905,0.47596988998262885,0.5240301100173712
E01003276,1904,864,1040,0.453781512605042,0.5462184873949579
E01003225,1507,706,801,0.4684804246848042,0.5315195753151958
E01003231,1606,791,815,0.4925280199252802,0.5074719800747198
E01003232,1719,778,941,0.4525887143688191,0.5474112856311809
E01003233,1702,826,876,0.48531139835487663,0.5146886016451234
E01003280,1606,801,805,0.4987546699875467,0.5012453300124533
E01003281,1534,767,767,0.5,0.5
E01003285,1608,794,814,0.4937810945273632,0.5062189054726368
E01003287,1909,947,962,0.4960712414876899,0.5039287585123101
E01003292,1565,792,773,0.5060702875399361,0.4939297124600639
E01003293,1518,742,776,0.4888010540184453,0.5111989459815547
E01003295,1672,855,817,0.5113636363636364,0.48863636363636365
E01033320,1496,731,765,0.48863636363636365,0.5113636363636364
E01033322,1267,651,616,0.5138121546961326,0.4861878453038674
E01003319,1831,880,951,0.4806116876024031,0.519388312397597
E01003320,1494,712,782,0.47657295850066933,0.5234270414993306
E01003323,1485,740,745,0.4983164983164983,0.5016835016835017
E01003325,1729,811,918,0.46905725853094277,0.5309427414690573
E01003226,1742,874,868,0.5017221584385764,0.49827784156142363
E01003227,1658,839,819,0.5060313630880579,0.4939686369119421
E01003228,1512,731,781,0.4834656084656085,0.5165343915343915
E01003229,1558,744,814,0.47753530166880614,0.5224646983311938
E01003230,1933,910,1023,0.47077082255561303,0.5292291774443869
E01003317,1882,987,895,0.524442082890542,0.47555791710945805
E01003318,1638,848,790,0.5177045177045178,0.4822954822954823
E01003321,1961,992,969,0.5058643549209587,0.4941356450790413
E01003322,1429,741,688,0.5185444366689993,0.4814555633310007
E01003324,1467,745,722,0.5078391274710293,0.49216087252897067
E01003254,1437,727,710,0.5059151009046625,0.4940848990953375
E01003255,1886,988,898,0.5238600212089077,0.47613997879109227
E01003260,1824,946,878,0.518640350877193,0.48135964912280704
E01003261,1495,752,743,0.5030100334448161,0.49698996655518396
E01003262,1365,647,718,0.473992673992674,0.526007326007326
E01003217,1670,775,895,0.46407185628742514,0.5359281437125748
E01003218,1498,708,790,0.472630173564753,0.527369826435247
E01003220,1554,711,843,0.4575289575289575,0.5424710424710425
E01003222,1632,779,853,0.47732843137254904,0.522671568627451
E01003224,1661,800,861,0.481637567730283,0.518362432269717
E01003263,1675,780,895,0.46567164179104475,0.5343283582089552
E01003268,1670,834,836,0.4994011976047904,0.5005988023952096
E01003269,1554,726,828,0.4671814671814672,0.5328185328185329
E01003270,1638,788,850,0.4810744810744811,0.518925518925519
E01003271,1667,825,842,0.4949010197960408,0.5050989802039592
E01003307,1521,742,779,0.4878369493754109,0.5121630506245891
E01003308,1824,873,951,0.4786184210526316,0.5213815789473685
E01003314,1599,786,813,0.4915572232645403,0.5084427767354597
E01003315,1287,651,636,0.5058275058275058,0.49417249417249415
E01003316,1482,722,760,0.48717948717948717,0.5128205128205128
E01003216,1875,947,928,0.5050666666666667,0.49493333333333334
E01003219,1647,776,871,0.4711596842744384,0.5288403157255617
E01003221,1962,981,981,0.5,0.5
E01003223,1715,857,858,0.49970845481049564,0.5002915451895044
E01003346,1537,718,819,0.4671437865972674,0.5328562134027326
E01003349,1412,646,766,0.45750708215297453,0.5424929178470255
E01003351,1463,654,809,0.4470266575529733,0.5529733424470267
E01003354,1675,822,853,0.49074626865671644,0.5092537313432836
E01003309,1510,754,756,0.49933774834437084,0.5006622516556292
E01003310,1559,814,745,0.5221295702373316,0.47787042976266836
E01003311,1546,755,791,0.4883570504527814,0.5116429495472187
E01003312,1760,825,935,0.46875,0.53125
E01003313,1530,783,747,0.5117647058823529,0.48823529411764705
E01003256,2055,1073,982,0.5221411192214112,0.4778588807785888
E01003257,1678,806,872,0.4803337306317044,0.5196662693682956
E01003258,1499,732,767,0.4883255503669113,0.5116744496330887
E01003259,1615,769,846,0.4761609907120743,0.5238390092879257
E01003193,1568,754,814,0.48086734693877553,0.5191326530612245
E01003194,1678,799,879,0.4761620977353993,0.5238379022646007
E01003195,1547,746,801,0.48222365869424694,0.5177763413057531
E01003196,1673,796,877,0.4757919904363419,0.5242080095636581
E01003197,1628,758,870,0.4656019656019656,0.5343980343980343
E01003347,1735,756,979,0.43573487031700286,0.5642651296829971
E01003348,1459,700,759,0.47978067169294036,0.5202193283070596
E01003350,1412,641,771,0.45396600566572237,0.5460339943342776
E01003352,1816,905,911,0.4983480176211454,0.5016519823788547
E01003353,1740,854,886,0.4908045977011494,0.5091954022988506
E01003264,1610,765,845,0.4751552795031056,0.5248447204968945
E01003265,1531,721,810,0.47093403004572176,0.5290659699542782
E01003266,1735,796,939,0.45878962536023055,0.5412103746397694
E01003267,1568,741,827,0.4725765306122449,0.5274234693877551
E01003329,1590,762,828,0.47924528301886793,0.5207547169811321
E01003330,1550,675,875,0.43548387096774194,0.5645161290322581
E01003331,1412,653,759,0.46246458923512745,0.5375354107648725
E01003332,1467,721,746,0.49147920927062033,0.5085207907293797
E01003334,1660,816,844,0.491566265060241,0.5084337349397591
E01003189,1670,775,895,0.46407185628742514,0.5359281437125748
E01003190,1878,870,1008,0.46325878594249204,0.536741214057508
E01003191,1494,694,800,0.464524765729585,0.535475234270415
E01003192,1639,793,846,0.4838316046369738,0.5161683953630263
E01003326,1475,688,787,0.46644067796610167,0.5335593220338983
E01003327,1796,1004,792,0.5590200445434298,0.44097995545657015
E01003328,1718,830,888,0.4831199068684517,0.5168800931315483
E01003333,1542,790,752,0.5123216601815823,0.4876783398184176
E01003335,1395,654,741,0.46881720430107526,0.5311827956989247
E01003236,1590,765,825,0.4811320754716981,0.5188679245283019
E01003237,1471,669,802,0.45479265805574437,0.5452073419442556
E01003238,1407,621,786,0.44136460554371004,0.55863539445629
E01003239,1428,676,752,0.4733893557422969,0.5266106442577031
E01032564,1312,602,710,0.45884146341463417,0.5411585365853658
E01003235,1279,605,674,0.4730258014073495,0.5269741985926505
E01003240,1789,823,966,0.46003353828954724,0.5399664617104528
E01003241,1541,735,806,0.47696301103179756,0.5230369889682025
E01003243,1358,622,736,0.4580265095729013,0.5419734904270986
E01032565,1392,649,743,0.46623563218390807,0.5337643678160919
E01003298,1292,607,685,0.4698142414860681,0.5301857585139319
E01003300,1356,666,690,0.4911504424778761,0.5088495575221239
E01003303,1550,813,737,0.5245161290322581,0.4754838709677419
E01003304,1890,953,937,0.5042328042328043,0.49576719576719575
E01032579,1460,741,719,0.5075342465753425,0.49246575342465754
E01003543,2475,1268,1207,0.5123232323232323,0.48767676767676765
E01003544,1938,1027,911,0.5299277605779154,0.47007223942208465
E01003546,1940,935,1005,0.48195876288659795,0.5180412371134021
E01003550,1780,934,846,0.5247191011235955,0.4752808988764045
E01003576,1954,1001,953,0.5122824974411464,0.48771750255885365
E01003581,1848,988,860,0.5346320346320347,0.4653679653679654
E01003582,1613,821,792,0.5089894606323621,0.49101053936763794
E01003583,1966,1019,947,0.5183112919633774,0.48168870803662256
E01003578,1944,1069,875,0.5498971193415638,0.45010288065843623
E01003584,2073,1090,983,0.5258080077182827,0.4741919922817173
E01003586,1751,986,765,0.5631067961165048,0.4368932038834951
E01003590,1586,767,819,0.48360655737704916,0.5163934426229508
E01003579,1850,987,863,0.5335135135135135,0.4664864864864865
E01003585,1649,849,800,0.5148574893875075,0.4851425106124924
E01003587,2436,1303,1133,0.5348932676518884,0.4651067323481117
E01003591,2166,1166,1000,0.5383194829178208,0.4616805170821791
E01003528,1386,682,704,0.49206349206349204,0.5079365079365079
E01003575,1702,899,803,0.5282021151586369,0.4717978848413631
E01003577,1920,915,1005,0.4765625,0.5234375
E01003580,1836,933,903,0.5081699346405228,0.4918300653594771
E01003545,1727,847,880,0.49044585987261147,0.5095541401273885
E01003548,2353,1214,1139,0.5159371015724606,0.4840628984275393
E01003549,2105,1075,1030,0.5106888361045131,0.48931116389548696
E01003557,2031,1107,924,0.5450516986706057,0.4549483013293944
E01003547,1939,987,952,0.5090252707581228,0.49097472924187724
E01003555,1842,1037,805,0.5629750271444083,0.4370249728555918
E01003561,1880,1060,820,0.5638297872340425,0.43617021276595747
E01003567,1822,1020,802,0.5598243688254665,0.44017563117453345
E01003556,1913,1009,904,0.527443805541035,0.47255619445896496
E01003558,1631,903,728,0.5536480686695279,0.44635193133047213
E01003570,2065,1132,933,0.54818401937046,0.4518159806295399
E01003571,2277,1239,1038,0.544137022397892,0.45586297760210803
E01003572,1779,960,819,0.5396290050590219,0.46037099494097805
E01003551,1833,950,883,0.5182760501909438,0.4817239498090562
E01003553,1927,993,934,0.5153087701089777,0.4846912298910223
E01003554,1861,949,912,0.5099408919935519,0.49005910800644814
E01003559,2605,1363,1242,0.5232245681381957,0.4767754318618042
E01003529,2379,1329,1050,0.5586380832282472,0.44136191677175285
E01003530,1827,1023,804,0.5599343185550082,0.4400656814449918
E01003531,1997,1107,890,0.5543314972458688,0.4456685027541312
E01003532,2002,1038,964,0.5184815184815185,0.48151848151848153
E01003534,2395,1282,1113,0.5352818371607516,0.46471816283924844
E01003533,1880,1031,849,0.5484042553191489,0.45159574468085106
E01003560,1842,993,849,0.5390879478827362,0.4609120521172638
E01003563,2036,1145,891,0.56237721021611,0.43762278978388996
E01003588,1786,1009,777,0.56494960806271,0.43505039193729006
E01003589,1871,1025,846,0.5478353821485836,0.4521646178514164
E01003616,1650,899,751,0.5448484848484848,0.45515151515151514
E01003617,2769,1390,1379,0.501986276634164,0.49801372336583605
E01003618,2193,1091,1102,0.49749202006383947,0.5025079799361605
E01003619,2264,1132,1132,0.5,0.5
E01003615,1835,924,911,0.5035422343324251,0.49645776566757494
E01033578,1273,710,563,0.5577376276512176,0.4422623723487824
E01033579,1293,683,610,0.5282289249806651,0.4717710750193349
E01033583,3081,1687,1394,0.5475494969165855,0.4524505030834145
E01033586,1410,735,675,0.5212765957446809,0.4787234042553192
E01003562,2200,1242,958,0.5645454545454546,0.4354545454545454
E01003564,2460,1383,1077,0.5621951219512196,0.4378048780487805
E01003565,1853,1073,780,0.5790609821910415,0.4209390178089584
E01003566,1792,1012,780,0.5647321428571429,0.43526785714285715
E01003625,1697,910,787,0.5362404242781379,0.4637595757218621
E01003626,1590,862,728,0.5421383647798742,0.4578616352201258
E01003627,1603,867,736,0.5408608858390518,0.4591391141609482
E01003628,1665,902,763,0.5417417417417417,0.4582582582582583
E01003629,1672,899,773,0.5376794258373205,0.4623205741626794
E01003552,1719,884,835,0.5142524723676556,0.4857475276323444
E01003596,1777,935,842,0.526167698368036,0.473832301631964
E01003597,1639,857,782,0.5228798047589994,0.47712019524100063
E01003635,1945,1036,909,0.5326478149100257,0.4673521850899743
E01003568,2302,1309,993,0.5686359687228497,0.4313640312771503
E01003569,1899,1105,794,0.5818852027382833,0.4181147972617167
E01003573,2154,1174,980,0.5450324976787372,0.45496750232126276
E01003574,2637,1438,1199,0.5453166477057262,0.4546833522942738
E01003520,2001,1142,859,0.5707146426786607,0.4292853573213393
E01003521,2259,1374,885,0.6082337317397079,0.39176626826029215
E01003522,1908,1047,861,0.5487421383647799,0.45125786163522014
E01003525,1978,1137,841,0.5748230535894844,0.4251769464105157
E01003526,1927,1018,909,0.5282823040996367,0.4717176959003633
E01003488,1874,953,921,0.508537886872999,0.49146211312700105
E01003489,1807,943,864,0.5218594355285002,0.4781405644714997
E01003490,1857,1029,828,0.5541195476575121,0.4458804523424879
E01003524,2028,1127,901,0.5557199211045365,0.4442800788954635
E01003631,1832,950,882,0.5185589519650655,0.4814410480349345
E01003632,2268,1096,1172,0.48324514991181655,0.5167548500881834
E01003633,1871,944,927,0.5045430251202565,0.49545697487974344
E01003634,1805,913,892,0.5058171745152354,0.49418282548476455
E01003636,1978,996,982,0.5035389282103134,0.49646107178968657
E01003598,1897,956,941,0.503953610964681,0.49604638903531895
E01003600,1893,944,949,0.49867934495509775,0.5013206550449023
E01003630,2011,1026,985,0.5101939333664843,0.48980606663351567
E01003637,1841,1006,835,0.5464421510048887,0.45355784899511137
E01003491,1977,1112,865,0.5624683864441072,0.43753161355589276
E01003592,1842,977,865,0.5304017372421281,0.46959826275787186
E01003599,1611,857,754,0.531967721911856,0.468032278088144
E01003606,2152,1143,1009,0.5311338289962825,0.46886617100371747
E01003535,1691,835,856,0.4937906564163217,0.5062093435836783
E01003536,1843,894,949,0.48507867607162236,0.5149213239283776
E01003621,1667,899,768,0.5392921415716857,0.46070785842831435
E01003622,1613,841,772,0.5213887166769994,0.4786112833230006
E01003623,1757,923,834,0.5253272623790552,0.4746727376209448
E01003523,2043,1079,964,0.5281448849730788,0.4718551150269212
E01003527,1773,900,873,0.5076142131979695,0.49238578680203043
E01003537,2062,1027,1035,0.4980601357904947,0.5019398642095053
E01003542,1974,968,1006,0.49037487335359675,0.5096251266464032
E01003624,1582,789,793,0.49873577749683945,0.5012642225031606
E01003492,2010,1076,934,0.5353233830845772,0.4646766169154229
E01003493,2299,1240,1059,0.5393649412788168,0.4606350587211831
E01003494,2048,1014,1034,0.4951171875,0.5048828125
E01003495,2110,1075,1035,0.509478672985782,0.490521327014218
E01003594,1729,897,832,0.518796992481203,0.48120300751879697
E01003595,1532,807,725,0.5267624020887729,0.47323759791122716
E01003602,1985,1014,971,0.510831234256927,0.48916876574307305
E01003607,1648,811,837,0.49211165048543687,0.5078883495145631
E01003496,1445,748,697,0.5176470588235295,0.4823529411764706
E01003498,1741,895,846,0.5140723721998851,0.4859276278001149
E01003500,2043,976,1067,0.4777288301517376,0.5222711698482624
E01003593,1550,726,824,0.46838709677419355,0.5316129032258065
E01003601,2130,1052,1078,0.49389671361502346,0.5061032863849765
E01003603,1947,958,989,0.49203903441191577,0.5079609655880842
E01003605,2112,1126,986,0.5331439393939394,0.4668560606060606
E01003608,2072,1047,1025,0.5053088803088803,0.4946911196911197
E01003538,2084,1043,1041,0.5004798464491362,0.4995201535508637
E01003539,2217,1118,1099,0.5042850699142986,0.4957149300857014
E01003540,1833,920,913,0.5019094380796508,0.4980905619203492
E01003541,1871,921,950,0.4922501336183859,0.5077498663816141
E01003499,2280,1152,1128,0.5052631578947369,0.49473684210526314
E01003501,2040,1031,1009,0.5053921568627451,0.4946078431372549
E01003502,1836,910,926,0.49564270152505446,0.5043572984749455
E01003503,1710,833,877,0.4871345029239766,0.5128654970760234
E01003507,2113,1078,1035,0.5101751064836725,0.4898248935163275
E01003508,1605,789,816,0.491588785046729,0.508411214953271
E01003509,1953,936,1017,0.4792626728110599,0.5207373271889401
E01003604,2358,1148,1210,0.4868532654792197,0.5131467345207803
E01003483,1486,698,788,0.4697173620457604,0.5302826379542396
E01003484,1621,797,824,0.49167180752621836,0.5083281924737816
E01003516,1859,882,977,0.4744486282947821,0.5255513717052178
E01003518,1595,803,792,0.503448275862069,0.496551724137931
E01003519,1580,781,799,0.49430379746835446,0.5056962025316456
E01003480,2172,1040,1132,0.47882136279926335,0.5211786372007366
E01003482,2634,1305,1329,0.49544419134396356,0.5045558086560364
E01003486,1205,523,682,0.4340248962655602,0.5659751037344398
E01003487,1371,644,727,0.4697301239970824,0.5302698760029175
E01003497,1715,842,873,0.4909620991253644,0.5090379008746355
E01003506,1480,688,792,0.4648648648648649,0.5351351351351351
E01033574,1095,655,440,0.5981735159817352,0.4018264840182648
E01033575,1021,614,407,0.6013712047012733,0.39862879529872675
E01033576,1295,713,582,0.5505791505791506,0.4494208494208494
E01033584,1595,786,809,0.4927899686520376,0.5072100313479624
E01033585,2445,1256,1189,0.5137014314928425,0.48629856850715747
E01003479,1505,747,758,0.4963455149501661,0.5036544850498339
E01003481,1574,764,810,0.48538754764930114,0.5146124523506989
E01003485,1573,755,818,0.4799745708836618,0.5200254291163382
E01003513,1588,790,798,0.49748110831234255,0.5025188916876574
E01003511,1394,634,760,0.45480631276901007,0.5451936872309899
E01003512,1805,887,918,0.49141274238227145,0.5085872576177285
E01003514,1512,749,763,0.49537037037037035,0.5046296296296297
E01003515,1798,892,906,0.4961067853170189,0.5038932146829811
E01003517,1674,795,879,0.47491039426523296,0.525089605734767
E01003609,2702,1355,1347,0.5014803849000741,0.498519615099926
E01003611,1803,855,948,0.47420965058236275,0.5257903494176372
E01033577,1489,801,688,0.5379449294828744,0.4620550705171256
E01033580,1522,875,647,0.5749014454664915,0.42509855453350853
E01033581,1782,875,907,0.4910213243546577,0.5089786756453423
E01033582,1381,744,637,0.5387400434467777,0.46125995655322233
E01004029,1835,937,898,0.5106267029972752,0.4893732970027248
E01004032,1695,879,816,0.5185840707964602,0.4814159292035398
E01004053,1836,970,866,0.528322440087146,0.47167755991285404
E01004054,1656,885,771,0.5344202898550725,0.46557971014492755
E01004055,1291,607,684,0.4701781564678544,0.5298218435321457
E01003927,2377,1227,1150,0.5161968868321414,0.4838031131678586
E01003929,2111,1173,938,0.5556608242539081,0.4443391757460919
E01003934,1422,723,699,0.5084388185654009,0.49156118143459915
E01003935,1342,692,650,0.5156482861400894,0.4843517138599106
E01003939,1850,897,953,0.48486486486486485,0.5151351351351351
E01003976,1955,988,967,0.5053708439897698,0.49462915601023016
E01004027,2072,1069,1003,0.515926640926641,0.4840733590733591
E01032637,1247,689,558,0.5525260625501203,0.44747393744987973
E01032638,1159,648,511,0.5591026747195859,0.44089732528041414
E01032640,1248,751,497,0.6017628205128205,0.39823717948717946
E01032646,1569,909,660,0.5793499043977055,0.42065009560229444
E01032803,1331,747,584,0.5612321562734786,0.4387678437265214
E01032834,1130,649,481,0.5743362831858407,0.42566371681415927
E01003975,1630,753,877,0.4619631901840491,0.5380368098159509
E01003978,1840,881,959,0.47880434782608694,0.5211956521739131
E01004022,2483,1232,1251,0.49617398308497784,0.5038260169150222
E01004023,1540,764,776,0.4961038961038961,0.5038961038961038
E01004028,1651,822,829,0.49788007268322226,0.5021199273167777
E01003938,1814,902,912,0.4972436604189636,0.5027563395810364
E01003940,1483,692,791,0.466621712744437,0.533378287255563
E01003941,1897,996,901,0.5250395361096468,0.4749604638903532
E01003942,1637,793,844,0.4844227244960293,0.5155772755039707
E01003979,1784,865,919,0.4848654708520179,0.5151345291479821
E01003981,1675,829,846,0.4949253731343284,0.5050746268656716
E01004030,1457,728,729,0.49965682910089226,0.5003431708991077
E01004031,2060,985,1075,0.47815533980582525,0.5218446601941747
E01004033,1519,750,769,0.4937458854509546,0.5062541145490455
E01004034,1541,742,799,0.48150551589876706,0.518494484101233
E01004036,2014,957,1057,0.47517378351539225,0.5248262164846077
E01004056,2065,1037,1028,0.502179176755448,0.49782082324455207
E01004057,1500,724,776,0.4826666666666667,0.5173333333333333
E01004058,1699,930,769,0.5473808122424956,0.4526191877575044
E01004059,1487,777,710,0.5225285810356423,0.47747141896435774
E01004060,1901,929,972,0.4886901630720673,0.5113098369279326
E01003936,1845,878,967,0.47588075880758807,0.5241192411924119
E01003937,1553,853,700,0.5492594977462975,0.4507405022537025
E01003943,1367,681,686,0.4981711777615216,0.5018288222384785
E01032720,1732,930,802,0.5369515011547344,0.4630484988452656
E01003977,1672,814,858,0.4868421052631579,0.5131578947368421
E01004037,1953,996,957,0.5099846390168971,0.49001536098310294
E01004038,2340,1065,1275,0.4551282051282051,0.5448717948717948
E01004042,1712,830,882,0.4848130841121495,0.5151869158878505
E01004043,1366,674,692,0.493411420204978,0.5065885797950219
E01003986,1235,558,677,0.4518218623481781,0.5481781376518219
E01003987,1777,886,891,0.4985931344963421,0.5014068655036579
E01004024,1860,932,928,0.5010752688172043,0.4989247311827957
E01004035,1622,777,845,0.4790382244143033,0.5209617755856967
E01003960,1863,944,919,0.5067096081588836,0.4932903918411165
E01003961,2045,1003,1042,0.4904645476772616,0.5095354523227383
E01003994,1493,758,735,0.5077026121902211,0.49229738780977894
E01032722,2133,1053,1080,0.4936708860759494,0.5063291139240507
E01003980,1906,953,953,0.5,0.5
E01004039,1568,821,747,0.5235969387755102,0.4764030612244898
E01004040,1780,853,927,0.47921348314606743,0.5207865168539326
E01004041,1660,850,810,0.5120481927710844,0.4879518072289157
E01004044,1401,705,696,0.5032119914346895,0.49678800856531047
E01003992,1492,677,815,0.45375335120643434,0.5462466487935657
E01003995,1384,697,687,0.5036127167630058,0.4963872832369942
E01003998,1331,723,608,0.5432006010518408,0.4567993989481593
E01003999,1442,727,715,0.5041608876560333,0.4958391123439667
E01032639,1643,888,755,0.5404747413268411,0.45952525867315885
E01032719,1211,683,528,0.5639966969446738,0.4360033030553262
E01003964,1927,965,962,0.5007784120394395,0.49922158796056043
E01003966,1941,974,967,0.5018031942297785,0.4981968057702215
E01003968,1441,694,747,0.4816099930603747,0.5183900069396252
E01003971,1809,878,931,0.4853510226644555,0.5146489773355445
E01003974,1268,620,648,0.4889589905362776,0.5110410094637224
E01003963,1648,806,842,0.4890776699029126,0.5109223300970874
E01003967,1673,882,791,0.5271966527196653,0.47280334728033474
E01003970,1486,712,774,0.4791386271870794,0.5208613728129206
E01003972,1654,831,823,0.5024183796856106,0.49758162031438935
E01003973,1650,774,876,0.4690909090909091,0.5309090909090909
E01003923,1735,859,876,0.49510086455331415,0.5048991354466859
E01003969,1858,957,901,0.515069967707212,0.48493003229278797
E01003991,1208,583,625,0.4826158940397351,0.5173841059602649
E01003993,1713,817,896,0.47694103911266783,0.5230589608873322
E01003997,1219,585,634,0.47990155865463496,0.5200984413453651
E01003983,2022,927,1095,0.45845697329376855,0.5415430267062314
E01003988,2193,1114,1079,0.5079799361605107,0.49202006383948926
E01003989,1960,945,1015,0.48214285714285715,0.5178571428571429
E01003990,2132,1031,1101,0.48358348968105064,0.5164165103189493
E01004007,1261,592,669,0.46946867565424266,0.5305313243457573
E01003912,1595,805,790,0.5047021943573667,0.4952978056426332
E01004011,2112,980,1132,0.4640151515151515,0.5359848484848485
E01004012,2502,1269,1233,0.5071942446043165,0.49280575539568344
E01004013,1656,761,895,0.45954106280193235,0.5404589371980676
E01004014,1784,887,897,0.4971973094170404,0.5028026905829597
E01003911,1985,945,1040,0.4760705289672544,0.5239294710327456
E01003916,2190,1101,1089,0.5027397260273972,0.49726027397260275
E01003917,1775,876,899,0.49352112676056337,0.5064788732394366
E01003918,1602,734,868,0.4581772784019975,0.5418227215980025
E01003925,1336,632,704,0.47305389221556887,0.5269461077844312
E01003919,1776,896,880,0.5045045045045045,0.4954954954954955
E01003920,1854,926,928,0.4994606256742179,0.5005393743257821
E01003921,1461,765,696,0.5236139630390144,0.47638603696098564
E01003922,1917,927,990,0.4835680751173709,0.5164319248826291
E01003924,1928,1009,919,0.5233402489626556,0.4766597510373444
E01003926,1423,686,737,0.4820801124385102,0.5179198875614898
E01004008,2141,1059,1082,0.49462867818776274,0.5053713218122373
E01004010,1526,768,758,0.5032765399737876,0.4967234600262123
E01004067,2165,1088,1077,0.502540415704388,0.497459584295612
E01032805,2551,1230,1321,0.4821638573108585,0.5178361426891415
E01003984,1997,1027,970,0.514271407110666,0.485728592889334
E01004003,1702,830,872,0.48766157461809634,0.5123384253819037
E01004004,2499,1317,1182,0.5270108043217286,0.4729891956782713
E01004005,2223,1113,1110,0.5006747638326585,0.4993252361673414
E01004006,1968,1016,952,0.516260162601626,0.483739837398374
E01003913,1847,904,943,0.4894423389279913,0.5105576610720086
E01003914,1842,871,971,0.4728555917480999,0.5271444082519001
E01003915,1940,954,986,0.4917525773195876,0.5082474226804123
E01004050,1475,745,730,0.5050847457627119,0.49491525423728816
E01004052,1766,861,905,0.48754246885617214,0.5124575311438279
E01004061,1750,847,903,0.484,0.516
E01004062,1985,985,1000,0.49622166246851385,0.5037783375314862
E01004063,1959,993,966,0.5068912710566615,0.49310872894333846
E01004065,1525,727,798,0.47672131147540986,0.5232786885245901
E01004066,2159,1039,1120,0.4812413154238073,0.5187586845761927
E01004000,1881,908,973,0.48272195640616694,0.5172780435938331
E01004001,1738,817,921,0.4700805523590334,0.5299194476409667
E01004019,2319,1135,1184,0.4894351013367831,0.5105648986632169
E01004064,1975,944,1031,0.4779746835443038,0.5220253164556962
E01004068,2047,955,1092,0.46653639472398634,0.5334636052760137
E01004045,1518,705,813,0.4644268774703557,0.5355731225296443
E01004047,1595,744,851,0.4664576802507837,0.5335423197492163
E01004048,1587,675,912,0.42533081285444235,0.5746691871455577
E01004049,1672,765,907,0.45753588516746413,0.5424641148325359
E01004051,1383,686,697,0.4960231381055676,0.5039768618944324
E01003953,2082,963,1119,0.46253602305475505,0.537463976945245
E01003955,1817,890,927,0.4898183819482664,0.5101816180517337
E01004015,1558,757,801,0.4858793324775353,0.5141206675224647
E01004021,2109,1003,1106,0.47558084400189665,0.5244191559981034
E01004046,1633,767,866,0.4696876913655848,0.5303123086344151
E01004002,1609,787,822,0.4891236793039155,0.5108763206960846
E01004016,2349,1109,1240,0.4721157939548744,0.5278842060451255
E01004017,1548,737,811,0.4760981912144703,0.5239018087855297
E01004020,1730,836,894,0.48323699421965316,0.5167630057803468
E01003952,1640,809,831,0.49329268292682926,0.5067073170731707
E01003954,1598,786,812,0.4918648310387985,0.5081351689612015
E01003956,1685,798,887,0.47359050445103856,0.5264094955489614
E01004071,1579,756,823,0.47878404053198226,0.5212159594680177
E01004072,1738,836,902,0.4810126582278481,0.5189873417721519
E01004069,1437,720,717,0.5010438413361169,0.4989561586638831
E01004070,1985,945,1040,0.4760705289672544,0.5239294710327456
E01004073,1931,935,996,0.4842050750906266,0.5157949249093734
E01004074,1883,910,973,0.483271375464684,0.516728624535316
E01004075,1849,880,969,0.4759329367225527,0.5240670632774472
E01003949,1870,896,974,0.47914438502673795,0.520855614973262
E01003950,1906,866,1040,0.45435466946484787,0.5456453305351522
E01003957,1788,850,938,0.4753914988814318,0.5246085011185683
E01003958,1711,798,913,0.4663939216832262,0.5336060783167739
E01004018,1905,907,998,0.47611548556430444,0.5238845144356955
E01003945,1663,821,842,0.4936861094407697,0.5063138905592303
E01003946,1768,853,915,0.4824660633484163,0.5175339366515838
E01003947,1517,687,830,0.45286750164798945,0.5471324983520105
E01003948,1566,766,800,0.4891443167305236,0.5108556832694764
E01003951,1522,800,722,0.5256241787122208,0.4743758212877792
E01003930,1496,790,706,0.5280748663101604,0.47192513368983957
E01003932,1573,835,738,0.5308328035600763,0.4691671964399237
E01003933,1751,886,865,0.5059965733866362,0.49400342661336377
E01032583,1587,778,809,0.4902331442974165,0.5097668557025835
E01032584,1282,671,611,0.5234009360374415,0.4765990639625585
E01004222,2480,1225,1255,0.4939516129032258,0.5060483870967742
E01004223,2079,976,1103,0.46945646945646946,0.5305435305435305
E01004224,2000,993,1007,0.4965,0.5035
E01004226,1738,826,912,0.475258918296893,0.5247410817031071
E01004197,2329,1150,1179,0.49377415199656505,0.506225848003435
E01004198,1529,733,796,0.47939829954218444,0.5206017004578156
E01004199,1637,818,819,0.49969456322541234,0.5003054367745876
E01004201,1556,773,783,0.4967866323907455,0.5032133676092545
E01004228,1857,881,976,0.47442110931610126,0.5255788906838987
E01004230,2101,1064,1037,0.5064255116611137,0.49357448833888623
E01004232,1665,824,841,0.4948948948948949,0.5051051051051051
E01004233,1821,884,937,0.485447556287754,0.5145524437122461
E01004234,2218,1125,1093,0.5072137060414789,0.4927862939585212
E01004225,2178,1140,1038,0.5234159779614325,0.4765840220385675
E01004229,1484,762,722,0.5134770889487871,0.4865229110512129
E01004231,1793,856,937,0.4774121583937535,0.5225878416062465
E01032764,1302,658,644,0.5053763440860215,0.4946236559139785
E01032765,1488,759,729,0.5100806451612904,0.4899193548387097
E01032784,1516,725,791,0.4782321899736148,0.5217678100263852
E01004200,1566,793,773,0.5063856960408685,0.49361430395913153
E01004202,1705,879,826,0.5155425219941349,0.4844574780058651
E01004203,1779,902,877,0.507026419336706,0.492973580663294
E01004204,1582,767,815,0.48482932996207334,0.5151706700379267
E01004311,1518,749,769,0.49341238471673254,0.5065876152832675
E01004314,1100,545,555,0.4954545454545455,0.5045454545454545
E01004315,1628,863,765,0.5300982800982801,0.4699017199017199
E01004318,1459,799,660,0.5476353666895134,0.45236463331048665
E01004259,1723,893,830,0.518282066163668,0.481717933836332
E01004260,1790,924,866,0.5162011173184358,0.48379888268156424
E01004263,1419,698,721,0.4918957011980268,0.5081042988019733
E01004266,1545,727,818,0.47055016181229775,0.5294498381877023
E01004235,1372,722,650,0.5262390670553936,0.4737609329446064
E01004236,1679,860,819,0.5122096486003573,0.48779035139964266
E01004237,1158,578,580,0.4991364421416235,0.5008635578583766
E01004238,2733,1382,1351,0.5056714233443103,0.49432857665568974
E01004239,1649,837,812,0.5075803517283202,0.49241964827167983
E01004312,1614,861,753,0.533457249070632,0.46654275092936803
E01004313,2043,988,1055,0.4836025452765541,0.5163974547234459
E01004316,1138,592,546,0.5202108963093146,0.4797891036906854
E01004317,2706,1460,1246,0.5395417590539542,0.4604582409460458
E01004261,2525,1177,1348,0.46613861386138616,0.5338613861386139
E01004262,1742,864,878,0.49598163030998854,0.5040183696900115
E01004264,1537,790,747,0.5139882888744307,0.4860117111255693
E01032785,1348,709,639,0.5259643916913946,0.47403560830860536
E01032786,1561,775,786,0.4964766175528507,0.5035233824471492
E01004207,1416,704,712,0.4971751412429379,0.5028248587570622
E01004209,1366,697,669,0.5102489019033675,0.48975109809663253
E01004212,1780,933,847,0.5241573033707865,0.47584269662921347
E01032787,2567,1298,1269,0.5056486170627191,0.49435138293728087
E01004240,1815,890,925,0.4903581267217631,0.509641873278237
E01004241,1621,773,848,0.4768661320172733,0.5231338679827268
E01004242,2453,1267,1186,0.5165103954341622,0.4834896045658377
E01004267,1767,926,841,0.5240520656479909,0.47594793435200905
E01004268,1784,925,859,0.5184977578475336,0.48150224215246634
E01004205,2106,1143,963,0.5427350427350427,0.45726495726495725
E01004206,1492,751,741,0.5033512064343163,0.49664879356568364
E01004208,1976,1066,910,0.5394736842105263,0.4605263157894737
E01004211,1463,788,675,0.5386192754613808,0.4613807245386193
E01004269,1975,1023,952,0.5179746835443038,0.4820253164556962
E01004270,2236,1181,1055,0.528175313059034,0.471824686940966
E01004271,1589,769,820,0.4839521711768408,0.5160478288231592
E01004272,2099,1061,1038,0.5054787994282992,0.4945212005717008
E01004273,1904,935,969,0.49107142857142855,0.5089285714285714
E01004306,1799,968,831,0.5380767092829349,0.46192329071706506
E01004307,2186,1175,1011,0.5375114364135407,0.4624885635864593
E01004308,1478,765,713,0.5175913396481732,0.4824086603518268
E01004309,2852,1470,1382,0.5154277699859747,0.4845722300140252
E01004310,1971,1114,857,0.56519533231862,0.43480466768138
E01004283,2317,1153,1164,0.49762624082865775,0.5023737591713423
E01004287,2171,1113,1058,0.5126669737448181,0.48733302625518193
E01004289,1844,936,908,0.5075921908893709,0.4924078091106291
E01004290,1302,637,665,0.489247311827957,0.510752688172043
E01004322,1292,681,611,0.5270897832817337,0.4729102167182663
E01004323,1466,757,709,0.5163710777626194,0.48362892223738063
E01004324,1574,825,749,0.5241423125794155,0.4758576874205845
E01004326,1444,759,685,0.525623268698061,0.4743767313019391
E01004245,1539,746,793,0.48473034437946716,0.5152696556205328
E01004246,1977,1026,951,0.5189681335356601,0.48103186646433993
E01004248,1344,636,708,0.4732142857142857,0.5267857142857143
E01004249,2049,1040,1009,0.5075646656905808,0.4924353343094192
E01004284,2302,1153,1149,0.5008688097306689,0.499131190269331
E01004285,2318,1165,1153,0.502588438308887,0.497411561691113
E01004286,2364,1201,1163,0.5080372250423012,0.4919627749576988
E01004288,1620,821,799,0.5067901234567901,0.49320987654320986
E01004243,1789,890,899,0.4974846282839575,0.5025153717160424
E01004244,1885,993,892,0.526790450928382,0.47320954907161805
E01004247,1934,976,958,0.5046535677352637,0.4953464322647363
E01004250,2342,1118,1224,0.47736976942783943,0.5226302305721605
E01004319,1886,999,887,0.5296924708377518,0.47030752916224816
E01004321,1822,970,852,0.5323819978046103,0.4676180021953897
E01004325,2487,1402,1085,0.5637314032971451,0.43626859670285484
E01032766,1307,731,576,0.5592960979342004,0.4407039020657995
E01032767,1584,958,626,0.6047979797979798,0.3952020202020202
E01004298,1637,798,839,0.48747709224190594,0.5125229077580941
E01004300,1349,703,646,0.5211267605633803,0.4788732394366197
E01004304,1957,986,971,0.5038323965252938,0.4961676034747062
E01004305,1952,1015,937,0.5199795081967213,0.4800204918032787
E01004251,2082,1105,977,0.5307396733909702,0.4692603266090298
E01004254,2120,1178,942,0.5556603773584906,0.44433962264150945
E01004255,1618,847,771,0.5234857849196539,0.4765142150803461
E01004258,1506,801,705,0.5318725099601593,0.4681274900398406
E01004252,2707,1420,1287,0.5245659401551533,0.4754340598448467
E01004253,2340,1160,1180,0.49572649572649574,0.5042735042735043
E01004256,1729,874,855,0.5054945054945055,0.4945054945054945
E01004257,1884,905,979,0.48036093418259024,0.5196390658174098
E01004301,1324,685,639,0.5173716012084593,0.4826283987915408
E01004302,1987,1035,952,0.5208857574232512,0.4791142425767489
E01004303,2362,1220,1142,0.5165114309906859,0.48348856900931414
E01032768,1307,750,557,0.5738332058148432,0.42616679418515685
E01032769,1235,671,564,0.5433198380566802,0.45668016194331984
E01004292,1738,973,765,0.5598388952819332,0.44016110471806674
E01004294,1757,1004,753,0.5714285714285714,0.42857142857142855
E01004295,1516,769,747,0.5072559366754618,0.49274406332453824
E01004296,1605,861,744,0.5364485981308411,0.4635514018691589
E01004291,1844,1013,831,0.5493492407809111,0.4506507592190889
E01004293,2125,1160,965,0.5458823529411765,0.4541176470588235
E01004297,1826,979,847,0.536144578313253,0.463855421686747
E01004215,2756,1422,1334,0.5159651669085631,0.48403483309143686
E01004219,2294,1187,1107,0.5174367916303401,0.48256320836966
E01004221,1881,1007,874,0.5353535353535354,0.46464646464646464
E01032776,1076,606,470,0.5631970260223048,0.4368029739776952
E01032777,1141,585,556,0.5127081507449606,0.48729184925503943
E01032778,1108,602,506,0.5433212996389891,0.4566787003610108
E01032779,1089,574,515,0.527089072543618,0.472910927456382
E01032780,1333,736,597,0.5521380345086272,0.44786196549137286
E01004214,1669,828,841,0.49610545236668663,0.5038945476333133
E01004216,1619,859,760,0.5305744286596664,0.4694255713403335
E01004217,1745,850,895,0.4871060171919771,0.5128939828080229
E01004218,1750,873,877,0.49885714285714283,0.5011428571428571
E01004274,1973,1014,959,0.5139381652306133,0.48606183476938675
E01004275,1879,948,931,0.5045236828100054,0.4954763171899947
E01004276,2024,1096,928,0.541501976284585,0.45849802371541504
E01004281,1770,944,826,0.5333333333333333,0.4666666666666667
E01032775,1108,625,483,0.5640794223826715,0.4359205776173285
E01032783,1383,693,690,0.5010845986984815,0.49891540130151846
E01004280,1879,941,938,0.5007982969664715,0.49920170303352845
E01032770,1191,610,581,0.5121746431570109,0.4878253568429891
E01032772,1135,622,513,0.5480176211453744,0.45198237885462555
E01032773,1561,860,701,0.5509288917360666,0.44907110826393337
E01032774,1298,647,651,0.4984591679506934,0.5015408320493067
E01004277,1630,938,692,0.5754601226993865,0.4245398773006135
E01032771,1104,584,520,0.5289855072463768,0.47101449275362317
E01032781,1535,838,697,0.545928338762215,0.45407166123778503
E01032782,1614,891,723,0.5520446096654275,0.4479553903345725
E01004560,1954,983,971,0.5030706243602866,0.4969293756397134
E01004566,1567,764,803,0.48755583918315254,0.5124441608168475
E01004582,2147,1113,1034,0.5183977643223102,0.4816022356776898
E01004583,1806,861,945,0.47674418604651164,0.5232558139534884
E01004562,1764,890,874,0.5045351473922902,0.4954648526077097
E01004563,1961,957,1004,0.48801631820499747,0.5119836817950025
E01004564,1768,831,937,0.47002262443438914,0.5299773755656109
E01004567,2343,1081,1262,0.461374306444729,0.538625693555271
E01033098,1012,545,467,0.5385375494071146,0.4614624505928854
E01033100,1243,617,626,0.49637972646822204,0.503620273531778
E01033132,1040,525,515,0.5048076923076923,0.4951923076923077
E01004539,2098,999,1099,0.47616777883698763,0.5238322211630124
E01004540,2083,990,1093,0.47527604416706676,0.5247239558329333
E01004577,1957,901,1056,0.46039856923863054,0.5396014307613695
E01004584,1710,819,891,0.4789473684210526,0.5210526315789473
E01004579,1615,805,810,0.4984520123839009,0.5015479876160991
E01004580,2092,1043,1049,0.498565965583174,0.501434034416826
E01004581,1817,885,932,0.4870665932856357,0.5129334067143644
E01033099,1028,498,530,0.48443579766536965,0.5155642023346303
E01033101,1191,670,521,0.5625524769101595,0.4374475230898405
E01033133,1193,622,571,0.5213746856663872,0.4786253143336127
E01004565,1679,794,885,0.4729005360333532,0.5270994639666469
E01004590,1749,870,879,0.4974271012006861,0.5025728987993139
E01004591,1734,842,892,0.4855824682814302,0.5144175317185697
E01004592,1628,751,877,0.46130221130221133,0.5386977886977887
E01004604,1686,816,870,0.48398576512455516,0.5160142348754448
E01004605,1728,794,934,0.45949074074074076,0.5405092592592593
E01004606,1633,800,833,0.4898958971218616,0.5101041028781383
E01004607,1729,827,902,0.4783111625216888,0.5216888374783112
E01004608,1682,780,902,0.4637336504161712,0.5362663495838288
E01004535,1758,814,944,0.4630261660978385,0.5369738339021616
E01004537,1881,872,1009,0.4635832004253057,0.5364167995746943
E01004538,2001,964,1037,0.4817591204397801,0.5182408795602199
E01004541,1637,720,917,0.4398289554062309,0.5601710445937691
E01004534,1850,878,972,0.4745945945945946,0.5254054054054054
E01004536,2050,983,1067,0.4795121951219512,0.5204878048780488
E01004552,1982,973,1009,0.4909182643794147,0.5090817356205852
E01004585,1840,853,987,0.46358695652173915,0.5364130434782609
E01004588,1954,992,962,0.5076765609007164,0.4923234390992835
E01004554,1607,797,810,0.49595519601742377,0.5040448039825762
E01004556,1612,804,808,0.4987593052109181,0.5012406947890818
E01004586,1812,859,953,0.47406181015452536,0.5259381898454746
E01004587,1743,858,885,0.49225473321858865,0.5077452667814114
E01004589,1700,859,841,0.5052941176470588,0.49470588235294116
E01004509,2190,1133,1057,0.517351598173516,0.482648401826484
E01004511,1722,851,871,0.49419279907084784,0.5058072009291521
E01004602,1640,761,879,0.46402439024390246,0.5359756097560976
E01004609,2147,1048,1099,0.488122962272939,0.5118770377270611
E01033093,1526,782,744,0.5124508519003932,0.4875491480996068
E01033135,1071,521,550,0.4864612511671335,0.5135387488328664
E01004506,1923,921,1002,0.4789391575663027,0.5210608424336973
E01004638,1449,706,743,0.48723257418909593,0.5127674258109041
E01004639,1724,821,903,0.4762180974477958,0.5237819025522041
E01004640,1775,879,896,0.4952112676056338,0.5047887323943662
E01004641,1910,898,1012,0.4701570680628272,0.5298429319371728
E01004508,2019,1000,1019,0.4952947003467063,0.5047052996532937
E01004510,1945,966,979,0.4966580976863753,0.5033419023136246
E01004514,1685,859,826,0.5097922848664689,0.4902077151335312
E01004515,1692,819,873,0.48404255319148937,0.5159574468085106
E01004551,1764,840,924,0.47619047619047616,0.5238095238095238
E01004568,1665,684,981,0.41081081081081083,0.5891891891891892
E01004574,1811,792,1019,0.43732744340143564,0.5626725565985643
E01004575,1810,818,992,0.45193370165745855,0.5480662983425414
E01004576,1564,784,780,0.5012787723785166,0.49872122762148335
E01004500,1622,773,849,0.47657213316892727,0.5234278668310728
E01004501,1582,743,839,0.4696586599241466,0.5303413400758533
E01004503,1672,786,886,0.4700956937799043,0.5299043062200957
E01004505,1616,776,840,0.4801980198019802,0.5198019801980198
E01004507,1838,874,964,0.47551686615886835,0.5244831338411317
E01004553,1640,826,814,0.5036585365853659,0.49634146341463414
E01004557,1540,744,796,0.4831168831168831,0.5168831168831168
E01004558,1710,841,869,0.49181286549707603,0.508187134502924
E01004559,1397,679,718,0.4860415175375805,0.5139584824624195
E01004619,1437,701,736,0.48782185107863607,0.5121781489213639
E01004572,1662,802,860,0.4825511432009627,0.5174488567990373
E01004642,1856,827,1029,0.44558189655172414,0.5544181034482759
E01004643,2013,923,1090,0.4585196224540487,0.5414803775459514
E01004644,1937,870,1067,0.44914816726897266,0.5508518327310273
E01004645,2078,968,1110,0.465832531280077,0.534167468719923
E01004477,1672,829,843,0.4958133971291866,0.5041866028708134
E01004478,1526,733,793,0.4803407601572739,0.5196592398427261
E01004479,1548,773,775,0.49935400516795864,0.5006459948320413
E01004550,1534,688,846,0.4485006518904824,0.5514993481095176
E01004555,1688,867,821,0.5136255924170616,0.4863744075829384
E01004494,1666,799,867,0.47959183673469385,0.5204081632653061
E01004513,1866,887,979,0.4753483386923901,0.5246516613076099
E01004600,2062,1000,1062,0.48496605237633367,0.5150339476236664
E01004601,2241,1114,1127,0.4970995091477019,0.502900490852298
E01004493,1761,846,915,0.4804088586030664,0.5195911413969335
E01004512,1494,731,763,0.4892904953145917,0.5107095046854083
E01004620,1647,855,792,0.5191256830601093,0.4808743169398907
E01004621,1686,828,858,0.49110320284697506,0.5088967971530249
E01004623,1733,834,899,0.4812463935372187,0.5187536064627813
E01004627,1620,766,854,0.4728395061728395,0.5271604938271605
E01004499,1591,731,860,0.4594594594594595,0.5405405405405406
E01004502,1655,821,834,0.4960725075528701,0.5039274924471299
E01004504,1523,768,755,0.5042678923177938,0.49573210768220616
E01004594,1657,789,868,0.47616173808086903,0.523838261919131
E01004596,1621,796,825,0.4910549043800123,0.5089450956199877
E01004629,1618,802,816,0.4956736711990111,0.5043263288009888
E01004472,1746,838,908,0.47995418098510884,0.5200458190148912
E01004474,1866,926,940,0.4962486602357985,0.5037513397642015
E01004476,1636,854,782,0.5220048899755502,0.4779951100244499
E01004542,1621,818,803,0.5046267735965454,0.49537322640345466
E01004544,1533,756,777,0.4931506849315068,0.5068493150684932
E01004628,2300,1143,1157,0.4969565217391304,0.5030434782608696
E01004630,1751,775,976,0.442604226156482,0.557395773843518
E01004631,1537,731,806,0.47560182173064414,0.5243981782693559
E01004633,1618,740,878,0.4573547589616811,0.5426452410383189
E01004569,2439,1077,1362,0.44157441574415746,0.5584255842558425
E01004570,1904,868,1036,0.45588235294117646,0.5441176470588235
E01004571,1681,797,884,0.4741225461035098,0.5258774538964902
E01004573,1596,793,803,0.4968671679197995,0.5031328320802005
E01004495,1536,710,826,0.4622395833333333,0.5377604166666666
E01004496,1956,968,988,0.4948875255623722,0.5051124744376279
E01004497,1445,659,786,0.4560553633217993,0.5439446366782007
E01004622,2266,1701,565,0.7506619593998235,0.24933804060017653
E01004624,1592,772,820,0.4849246231155779,0.5150753768844221
E01004593,1830,870,960,0.47540983606557374,0.5245901639344263
E01004595,1757,825,932,0.4695503699487763,0.5304496300512237
E01004597,1813,846,967,0.46662989520132375,0.5333701047986762
E01004598,1760,862,898,0.48977272727272725,0.5102272727272728
E01004599,1515,727,788,0.47986798679867987,0.5201320132013202
E01004473,1698,817,881,0.48115429917550057,0.5188457008244994
E01004475,1406,705,701,0.5014224751066856,0.49857752489331436
E01004480,1653,773,880,0.4676346037507562,0.5323653962492438
E01004483,2119,1070,1049,0.5049551675318547,0.49504483246814535
E01004484,1523,723,800,0.4747209455022981,0.525279054497702
E01004486,1478,702,776,0.4749661705006766,0.5250338294993234
E01004543,1791,862,929,0.4812953657174763,0.5187046342825238
E01004545,1578,760,818,0.4816223067173637,0.5183776932826363
E01004546,1506,710,796,0.4714475431606906,0.5285524568393094
E01004549,1664,842,822,0.5060096153846154,0.49399038461538464
E01004625,1397,670,727,0.47959914101646384,0.5204008589835362
E01004626,1869,934,935,0.49973247726056713,0.5002675227394329
E01004632,1527,702,825,0.45972495088408644,0.5402750491159135
E01004634,1473,728,745,0.4942294636795655,0.5057705363204344
E01004635,1645,809,836,0.4917933130699088,0.5082066869300912
E01004636,1462,715,747,0.4890560875512996,0.5109439124487004
E01004637,1471,702,769,0.4772263766145479,0.5227736233854521
E01004481,1687,791,896,0.46887966804979253,0.5311203319502075
E01004488,1511,746,765,0.4937127729980146,0.5062872270019855
E01004547,1400,642,758,0.4585714285714286,0.5414285714285715
E01004548,2052,1020,1032,0.49707602339181284,0.5029239766081871
E01004482,1588,745,843,0.46914357682619645,0.5308564231738035
E01004485,1668,839,829,0.5029976019184652,0.4970023980815348
E01004487,1560,777,783,0.4980769230769231,0.5019230769230769
E01004489,1441,700,741,0.4857737682165163,0.5142262317834837
E01004490,1510,711,799,0.47086092715231787,0.5291390728476821
E01004491,2150,964,1186,0.4483720930232558,0.5516279069767441
E01004492,1719,812,907,0.4723676556137289,0.527632344386271
E01004498,1705,767,938,0.4498533724340176,0.5501466275659824
E01004532,1487,697,790,0.468728984532616,0.531271015467384
E01004611,1602,776,826,0.484394506866417,0.5156054931335831
E01004612,1788,888,900,0.4966442953020134,0.5033557046979866
E01004618,1552,756,796,0.48711340206185566,0.5128865979381443
E01004531,1724,785,939,0.45533642691415316,0.5446635730858469
E01004533,1398,623,775,0.4456366237482117,0.5543633762517882
E01004610,1978,1039,939,0.525278058645096,0.4747219413549039
E01004613,1614,785,829,0.48636926889714993,0.5136307311028501
E01004614,2065,925,1140,0.44794188861985473,0.5520581113801453
E01004615,1798,835,963,0.46440489432703,0.53559510567297
E01004616,2162,1064,1098,0.4921369102682701,0.5078630897317299
E01004617,1680,815,865,0.4851190476190476,0.5148809523809523
E01004525,1850,952,898,0.5145945945945946,0.4854054054054054
E01004526,1599,804,795,0.5028142589118199,0.4971857410881801
E01004527,1648,778,870,0.4720873786407767,0.5279126213592233
E01004528,1520,692,828,0.45526315789473687,0.5447368421052632
E01004529,2086,991,1095,0.475071907957814,0.524928092042186
E01004530,1886,947,939,0.5021208907741251,0.49787910922587486
E01004516,1810,891,919,0.4922651933701657,0.5077348066298343
E01004518,1746,829,917,0.47479954180985107,0.5252004581901489
E01004519,1767,862,905,0.4878324844368987,0.5121675155631012
E01004520,1366,640,726,0.4685212298682284,0.5314787701317716
E01004523,1582,752,830,0.47534766118836913,0.5246523388116309
E01004517,1964,990,974,0.5040733197556008,0.4959266802443992
E01004521,1952,962,990,0.492827868852459,0.507172131147541
E01004522,1646,787,859,0.4781287970838396,0.5218712029161604
E01004524,1671,815,856,0.48773189706762415,0.5122681029323758
E01004647,1480,677,803,0.4574324324324324,0.5425675675675675
E01004649,1708,804,904,0.4707259953161593,0.5292740046838408
E01004724,1761,848,913,0.48154457694491765,0.5184554230550823
E01004730,1671,784,887,0.46918013165769,0.53081986834231
E01004646,1653,792,861,0.4791288566243194,0.5208711433756806
E01004648,2398,1144,1254,0.47706422018348627,0.5229357798165137
E01004650,1996,963,1033,0.48246492985971945,0.5175350701402806
E01004710,1648,771,877,0.4678398058252427,0.5321601941747572
E01004711,1747,814,933,0.4659416141957642,0.5340583858042358
E01004651,2015,975,1040,0.4838709677419355,0.5161290322580645
E01004725,1615,786,829,0.486687306501548,0.513312693498452
E01004726,1798,880,918,0.489432703003337,0.5105672969966629
E01004728,1558,770,788,0.4942233632862644,0.5057766367137355
E01004729,1638,790,848,0.4822954822954823,0.5177045177045178
E01004718,1962,901,1061,0.45922528032619775,0.5407747196738022
E01004719,1909,878,1031,0.45992666317443687,0.5400733368255631
E01004720,2000,950,1050,0.475,0.525
E01004721,1998,936,1062,0.46846846846846846,0.5315315315315315
E01004722,2494,1202,1292,0.48195669607056935,0.5180433039294307
E01004674,2107,1000,1107,0.47460844803037494,0.5253915519696251
E01004675,2284,1134,1150,0.4964973730297723,0.5035026269702276
E01004677,1815,883,932,0.48650137741046834,0.5134986225895317
E01004678,2000,966,1034,0.483,0.517
E01004679,2143,1024,1119,0.47783481101259917,0.5221651889874008
E01004723,2200,1056,1144,0.48,0.52
E01004676,1685,863,822,0.5121661721068249,0.4878338278931751
E01004706,1600,775,825,0.484375,0.515625
E01004707,1954,959,995,0.4907881269191402,0.5092118730808598
E01004708,1588,804,784,0.5062972292191436,0.49370277078085645
E01004756,1800,882,918,0.49,0.51
E01004701,1618,793,825,0.4901112484548826,0.5098887515451175
E01004703,2308,1152,1156,0.49913344887348354,0.5008665511265165
E01004705,1469,739,730,0.5030633083730429,0.49693669162695714
E01004709,1673,783,890,0.46802151823072324,0.5319784817692768
E01033600,1224,629,595,0.5138888888888888,0.4861111111111111
E01033608,1416,743,673,0.5247175141242938,0.4752824858757062
E01004659,1802,937,865,0.5199778024417314,0.4800221975582686
E01004660,1781,904,877,0.5075800112296462,0.49241998877035376
E01004712,1680,892,788,0.530952380952381,0.46904761904761905
E01004727,2026,1026,1000,0.506416584402764,0.49358341559723595
E01004670,2709,1289,1420,0.47582133628645257,0.5241786637135475
E01004702,2598,1268,1330,0.4880677444187837,0.5119322555812164
E01033598,1242,599,643,0.4822866344605475,0.5177133655394525
E01033601,1569,745,824,0.4748247291268324,0.5251752708731676
E01033602,1625,777,848,0.47815384615384615,0.5218461538461538
E01033603,1333,616,717,0.46211552888222057,0.5378844711177795
E01033604,1236,681,555,0.5509708737864077,0.44902912621359226
E01033605,2046,1018,1028,0.4975562072336266,0.5024437927663734
E01004754,1629,779,850,0.478207489257213,0.521792510742787
E01004755,2207,1090,1117,0.4938830992297236,0.5061169007702764
E01004757,1598,762,836,0.47684605757196497,0.523153942428035
E01032512,2540,1250,1290,0.4921259842519685,0.5078740157480315
E01032513,1355,659,696,0.4863468634686347,0.5136531365313654
E01004713,1829,954,875,0.5215965008201203,0.47840349917987973
E01004714,2150,1154,996,0.5367441860465116,0.46325581395348836
E01004716,1423,737,686,0.5179198875614898,0.4820801124385102
E01004717,1511,801,710,0.5301125082726671,0.4698874917273329
E01004762,2070,1118,952,0.5400966183574879,0.4599033816425121
E01004657,1480,834,646,0.5635135135135135,0.43648648648648647
E01004658,1557,817,740,0.5247270391779062,0.47527296082209375
E01004661,1847,998,849,0.5403356794802382,0.45966432051976175
E01004662,1876,1037,839,0.552771855010661,0.447228144989339
E01004663,1648,837,811,0.5078883495145631,0.49211165048543687
E01004715,1773,890,883,0.5019740552735477,0.49802594472645234
E01004763,2127,1276,851,0.5999059708509638,0.4000940291490362
E01004765,2023,1098,925,0.5427582797825012,0.45724172021749876
E01033595,1175,708,467,0.6025531914893617,0.3974468085106383
E01033596,1235,736,499,0.5959514170040486,0.4040485829959514
E01004653,1812,890,922,0.4911699779249448,0.5088300220750552
E01004654,2274,1161,1113,0.5105540897097626,0.4894459102902375
E01004656,2107,1107,1000,0.5253915519696251,0.47460844803037494
E01004760,1630,768,862,0.47116564417177914,0.5288343558282208
E01033606,1068,560,508,0.5243445692883895,0.4756554307116105
E01033607,1199,588,611,0.49040867389491244,0.5095913261050876
E01004680,1488,758,730,0.5094086021505376,0.4905913978494624
E01004683,1662,851,811,0.5120336943441637,0.4879663056558363
E01004684,1617,928,689,0.5739022881880025,0.4260977118119975
E01004686,1529,899,630,0.5879659908436887,0.41203400915631133
E01033593,1130,663,467,0.5867256637168141,0.41327433628318583
E01033594,1368,772,596,0.564327485380117,0.43567251461988304
E01004681,2126,1133,993,0.532925682031985,0.4670743179680151
E01004682,1542,852,690,0.5525291828793775,0.4474708171206226
E01004694,1813,960,853,0.5295091009376723,0.47049089906232766
E01004697,1513,783,730,0.5175148711169861,0.48248512888301387
E01004700,1763,903,860,0.5121951219512195,0.4878048780487805
E01004652,1840,926,914,0.5032608695652174,0.4967391304347826
E01004693,1398,723,675,0.5171673819742489,0.48283261802575106
E01004695,1297,699,598,0.5389360061680802,0.4610639938319198
E01004696,1586,770,816,0.4854981084489281,0.5145018915510718
E01004698,1558,836,722,0.5365853658536586,0.4634146341463415
E01004699,2267,1202,1065,0.5302161446846052,0.4697838553153948
E01004734,1972,1120,852,0.5679513184584178,0.43204868154158216
E01004735,1829,999,830,0.5462001093493712,0.45379989065062876
E01004736,1744,1058,686,0.606651376146789,0.393348623853211
E01004761,1945,1120,825,0.5758354755784062,0.4241645244215938
E01004687,1669,824,845,0.493708807669263,0.5062911923307369
E01004688,1950,1135,815,0.5820512820512821,0.41794871794871796
E01004689,1173,699,474,0.5959079283887468,0.4040920716112532
E01004690,1400,701,699,0.5007142857142857,0.4992857142857143
E01004691,1508,790,718,0.5238726790450928,0.4761273209549072
E01004692,1570,800,770,0.5095541401273885,0.49044585987261147
E01004731,1781,966,815,0.5423919146546884,0.4576080853453116
E01004732,1456,765,691,0.5254120879120879,0.47458791208791207
E01004733,2046,1177,869,0.5752688172043011,0.42473118279569894
E01004744,1347,664,683,0.4929472902746845,0.5070527097253155
E01004748,1451,792,659,0.5458304617505169,0.45416953824948314
E01004740,1494,736,758,0.4926372155287818,0.5073627844712182
E01004743,1396,731,665,0.5236389684813754,0.47636103151862463
E01004745,2114,1070,1044,0.5061494796594135,0.4938505203405866
E01004746,1440,714,726,0.49583333333333335,0.5041666666666667
E01004747,2240,1117,1123,0.4986607142857143,0.5013392857142858
E01004742,1391,715,676,0.514018691588785,0.48598130841121495
E01004749,2445,1215,1230,0.49693251533742333,0.5030674846625767
E01004751,1773,924,849,0.5211505922165821,0.47884940778341795
E01004752,1569,790,779,0.5035054174633524,0.4964945825366475
E01004753,1813,902,911,0.49751792608935463,0.5024820739106454
E01004666,1103,540,563,0.48957388939256574,0.5104261106074343
E01004667,1348,654,694,0.48516320474777447,0.5148367952522255
E01004668,1443,678,765,0.4698544698544699,0.5301455301455301
E01004750,1769,904,865,0.5110231769361221,0.4889768230638779
E01033597,990,529,461,0.5343434343434343,0.46565656565656566
E01033599,1573,706,867,0.4488239033693579,0.551176096630642
E01004665,1478,701,777,0.4742895805142084,0.5257104194857916
E01004669,1683,826,857,0.49079025549613786,0.5092097445038621
E01004737,1301,635,666,0.4880860876249039,0.5119139123750961
E01004738,1351,676,675,0.5003700962250185,0.4996299037749815
E01004739,1348,675,673,0.5007418397626113,0.4992581602373887
E01004741,1273,631,642,0.4956794972505892,0.5043205027494109
E01000027,1709,774,935,0.4528964306612054,0.5471035693387947
E01000028,1549,715,834,0.4615881213686249,0.5384118786313751
E01000029,1602,765,837,0.47752808988764045,0.5224719101123596
E01000030,1915,902,1013,0.4710182767624021,0.528981723237598
E01000031,1617,784,833,0.48484848484848486,0.5151515151515151
E01000032,1629,816,813,0.5009208103130756,0.4990791896869245
E01000110,1416,696,720,0.4915254237288136,0.5084745762711864
E01000111,1833,832,1001,0.45390070921985815,0.5460992907801419
E01000112,1871,917,954,0.4901122394441475,0.5098877605558525
E01000113,1679,799,880,0.47587849910661106,0.5241215008933889
E01000034,1444,653,791,0.45221606648199447,0.5477839335180056
E01000037,1688,852,836,0.504739336492891,0.495260663507109
E01000038,1447,687,760,0.474775397373877,0.525224602626123
E01000039,1603,758,845,0.4728633811603244,0.5271366188396757
E01000063,1620,805,815,0.49691358024691357,0.5030864197530864
E01000100,1653,779,874,0.47126436781609193,0.5287356321839081
E01000101,1513,704,809,0.465300727032386,0.534699272967614
E01000109,1686,823,863,0.48813760379596677,0.5118623962040332
E01000114,2090,1023,1067,0.48947368421052634,0.5105263157894737
E01000033,1361,652,709,0.4790595150624541,0.520940484937546
E01000060,1809,848,961,0.46876727473742397,0.531232725262576
E01000061,1776,822,954,0.46283783783783783,0.5371621621621622
E01000062,1952,905,1047,0.4636270491803279,0.5363729508196722
E01000064,1893,872,1021,0.4606444796619123,0.5393555203380876
E01000065,1736,815,921,0.4694700460829493,0.5305299539170507
E01000078,1666,767,899,0.46038415366146457,0.5396158463385354
E01000080,1556,720,836,0.46272493573264784,0.5372750642673522
E01000081,1688,844,844,0.5,0.5
E01000082,1683,799,884,0.47474747474747475,0.5252525252525253
E01000083,1700,790,910,0.4647058823529412,0.5352941176470588
E01000102,1540,715,825,0.4642857142857143,0.5357142857142857
E01000021,1579,803,776,0.5085497150094996,0.4914502849905003
E01000022,1314,618,696,0.4703196347031963,0.5296803652968036
E01000023,1112,583,529,0.5242805755395683,0.47571942446043164
E01000024,1336,616,720,0.46107784431137727,0.5389221556886228
E01000025,1609,773,836,0.48042262274704783,0.5195773772529522
E01000077,1445,687,758,0.4754325259515571,0.524567474048443
E01000015,2241,1049,1192,0.4680946006247211,0.5319053993752789
E01000016,1637,804,833,0.49114233353695785,0.5088576664630422
E01000017,1594,773,821,0.4849435382685069,0.5150564617314931
E01000018,1597,751,846,0.47025673137132123,0.5297432686286788
E01000079,1546,708,838,0.4579560155239327,0.5420439844760673
E01000035,1610,782,828,0.4857142857142857,0.5142857142857142
E01000036,1353,683,670,0.5048041389504804,0.49519586104951957
E01000107,1666,810,856,0.48619447779111646,0.5138055222088835
E01000108,1558,771,787,0.49486521181001286,0.5051347881899871
E01000066,1928,924,1004,0.47925311203319504,0.520746887966805
E01000067,1969,985,984,0.500253936008126,0.49974606399187405
E01000069,1763,875,888,0.4963131026659104,0.5036868973340897
E01000070,1975,912,1063,0.46177215189873416,0.5382278481012658
E01000071,2253,1101,1152,0.48868175765645805,0.511318242343542
E01000057,1496,698,798,0.46657754010695185,0.5334224598930482
E01000073,1619,746,873,0.46077825818406426,0.5392217418159357
E01000074,1567,717,850,0.45756222080408426,0.5424377791959157
E01000075,1732,859,873,0.4959584295612009,0.504041570438799
E01000076,1988,1013,975,0.5095573440643864,0.4904426559356137
E01000013,1660,797,863,0.48012048192771084,0.5198795180722892
E01000014,1656,777,879,0.4692028985507246,0.5307971014492754
E01000059,1582,720,862,0.45512010113780027,0.5448798988621998
E01000084,1355,634,721,0.46789667896678966,0.5321033210332103
E01000085,1718,798,920,0.46449359720605354,0.5355064027939465
E01000086,1431,687,744,0.480083857442348,0.519916142557652
E01000103,1685,777,908,0.4611275964391691,0.5388724035608309
E01000104,1781,875,906,0.4912970241437395,0.5087029758562606
E01000105,2129,1011,1118,0.474870831376233,0.525129168623767
E01000106,1968,972,996,0.49390243902439024,0.5060975609756098
E01000007,1391,707,684,0.5082674335010784,0.49173256649892166
E01000008,1544,817,727,0.5291450777202072,0.47085492227979275
E01000010,2840,1525,1315,0.5369718309859155,0.4630281690140845
E01000012,1901,983,918,0.5170962651236192,0.48290373487638083
E01000006,1703,866,837,0.5085143863769818,0.4914856136230182
E01000009,1773,999,774,0.5634517766497462,0.4365482233502538
E01000011,1634,925,709,0.5660954712362302,0.4339045287637699
E01000044,1798,915,883,0.5088987764182424,0.4911012235817575
E01000068,1590,819,771,0.5150943396226415,0.4849056603773585
E01000041,1682,818,864,0.4863258026159334,0.5136741973840666
E01000042,1788,862,926,0.48210290827740493,0.5178970917225951
E01000045,1650,802,848,0.4860606060606061,0.5139393939393939
E01000046,1779,861,918,0.4839797639123103,0.5160202360876898
E01000072,1991,965,1026,0.48468106479156203,0.515318935208438
E01000054,1718,829,889,0.48253783469150174,0.5174621653084982
E01000055,1553,758,795,0.4880875724404379,0.5119124275595621
E01000056,1584,748,836,0.4722222222222222,0.5277777777777778
E01000058,1849,905,944,0.48945375878853437,0.5105462412114656
E01000095,1572,757,815,0.4815521628498728,0.5184478371501272
E01000040,1569,761,808,0.48502230720203954,0.5149776927979605
E01000043,1358,680,678,0.5007363770250368,0.4992636229749632
E01000050,1661,865,796,0.5207706201083685,0.47922937989163156
E01000052,2014,990,1024,0.4915590863952334,0.5084409136047666
E01000092,2674,1339,1335,0.5007479431563201,0.4992520568436799
E01000053,1485,688,797,0.4632996632996633,0.5367003367003367
E01000087,1341,624,717,0.465324384787472,0.5346756152125279
E01000088,1828,878,950,0.4803063457330416,0.5196936542669585
E01000089,1666,838,828,0.503001200480192,0.4969987995198079
E01000090,1584,769,815,0.48547979797979796,0.514520202020202
E01000048,1783,880,903,0.49355019629837354,0.5064498037016265
E01000049,1820,946,874,0.5197802197802198,0.48021978021978023
E01000051,1927,983,944,0.5101193565127141,0.48988064348728594
E01033587,1630,821,809,0.503680981595092,0.496319018404908
E01033588,1617,779,838,0.48175633889919606,0.518243661100804
E01000091,1714,810,904,0.4725787631271879,0.5274212368728122
E01000093,1547,781,766,0.5048480930833872,0.4951519069166128
E01000094,1326,663,663,0.5,0.5
E01000096,1895,906,989,0.47810026385224275,0.5218997361477573
E01000019,1407,654,753,0.464818763326226,0.535181236673774
E01000020,1834,914,920,0.4983642311886587,0.5016357688113413
E01000097,1683,787,896,0.46761734997029114,0.5323826500297089
E01000098,1746,831,915,0.47594501718213056,0.5240549828178694
E01000099,1732,812,920,0.46882217090069284,0.5311778290993071
E01032580,1354,655,699,0.48375184638109303,0.516248153618907
E01000248,1661,826,835,0.49729078868151716,0.5027092113184829
E01000249,1525,730,795,0.4786885245901639,0.521311475409836
E01000250,2232,1071,1161,0.4798387096774194,0.5201612903225806
E01000254,1549,717,832,0.46287927695287284,0.5371207230471272
E01000292,1467,690,777,0.4703476482617587,0.5296523517382413
E01000293,1722,820,902,0.47619047619047616,0.5238095238095238
E01000167,1307,643,664,0.49196633511859217,0.5080336648814078
E01000246,1503,714,789,0.4750499001996008,0.5249500998003992
E01000247,1691,803,888,0.47486694263749263,0.5251330573625074
E01000251,1846,905,941,0.490249187432286,0.5097508125677139
E01000252,1609,758,851,0.47110006215040395,0.528899937849596
E01000166,1582,750,832,0.4740834386852086,0.5259165613147914
E01000168,1564,788,776,0.5038363171355499,0.4961636828644501
E01000169,1490,738,752,0.49530201342281877,0.5046979865771812
E01000172,1677,826,851,0.49254621347644606,0.507453786523554
E01000285,1449,670,779,0.46238785369220153,0.5376121463077985
E01000287,1589,735,854,0.46255506607929514,0.5374449339207048
E01000288,1569,804,765,0.5124282982791587,0.4875717017208413
E01000289,1817,837,980,0.46064942212438087,0.5393505778756191
E01000291,1575,760,815,0.48253968253968255,0.5174603174603175
E01000294,1599,742,857,0.4640400250156348,0.5359599749843652
E01000267,1520,753,767,0.4953947368421053,0.5046052631578948
E01000268,1739,845,894,0.48591144335825187,0.5140885566417481
E01000269,1425,689,736,0.48350877192982455,0.5164912280701754
E01000270,1482,747,735,0.5040485829959515,0.4959514170040486
E01000170,1636,774,862,0.4731051344743276,0.5268948655256723
E01000171,1849,929,920,0.5024337479718767,0.4975662520281233
E01000173,1719,841,878,0.48923792902850494,0.5107620709714951
E01000174,1728,824,904,0.47685185185185186,0.5231481481481481
E01000175,1585,769,816,0.48517350157728706,0.5148264984227129
E01000228,1481,729,752,0.4922349763673194,0.5077650236326806
E01000253,1691,798,893,0.47191011235955055,0.5280898876404494
E01000279,1449,714,735,0.4927536231884058,0.5072463768115942
E01000280,1381,646,735,0.4677769732078204,0.5322230267921796
E01000286,1571,711,860,0.452577975811585,0.547422024188415
E01000290,1557,734,823,0.4714193962748876,0.5285806037251124
E01000271,1469,720,749,0.4901293396868618,0.5098706603131382
E01000272,1340,646,694,0.48208955223880595,0.517910447761194
E01000273,1520,699,821,0.4598684210526316,0.5401315789473684
E01000281,1260,602,658,0.4777777777777778,0.5222222222222223
E01000282,1705,836,869,0.49032258064516127,0.5096774193548387
E01000115,1484,708,776,0.477088948787062,0.522911051212938
E01000116,1718,833,885,0.4848661233993015,0.5151338766006985
E01000119,1680,812,868,0.48333333333333334,0.5166666666666667
E01000120,1504,742,762,0.4933510638297872,0.5066489361702128
E01000122,1471,718,753,0.48810333106730114,0.5118966689326988
E01000117,1819,889,930,0.4887300714678395,0.5112699285321606
E01000118,1936,955,981,0.49328512396694213,0.5067148760330579
E01000121,1497,678,819,0.4529058116232465,0.5470941883767535
E01000123,1664,841,823,0.5054086538461539,0.49459134615384615
E01000124,1621,777,844,0.4793337446020975,0.5206662553979026
E01000265,1927,901,1026,0.46756616502335235,0.5324338349766476
E01000266,1527,748,779,0.48984937786509497,0.510150622134905
E01000274,1862,908,954,0.48764769065520946,0.5123523093447906
E01000320,1475,717,758,0.48610169491525423,0.5138983050847458
E01000322,1717,785,932,0.45719277810133957,0.5428072218986605
E01000275,1637,748,889,0.45693341478313987,0.5430665852168601
E01000277,1591,740,851,0.46511627906976744,0.5348837209302325
E01000283,1430,690,740,0.4825174825174825,0.5174825174825175
E01000284,1672,806,866,0.4820574162679426,0.5179425837320574
E01000321,1635,811,824,0.4960244648318043,0.5039755351681957
E01000195,1788,860,928,0.4809843400447427,0.5190156599552572
E01000229,1667,814,853,0.48830233953209357,0.5116976604679064
E01000230,1785,846,939,0.47394957983193275,0.5260504201680672
E01000231,1849,892,957,0.4824229313142239,0.5175770686857761
E01000232,1837,910,927,0.4953728905824714,0.5046271094175285
E01000233,1817,893,924,0.4914694551458448,0.5085305448541552
E01000186,1612,770,842,0.47766749379652607,0.5223325062034739
E01000187,1657,820,837,0.4948702474351237,0.5051297525648762
E01000188,1554,782,772,0.5032175032175032,0.4967824967824968
E01000189,1814,818,996,0.45093715545755236,0.5490628445424476
E01000190,1579,753,826,0.47688410386320457,0.5231158961367954
E01000191,1525,746,779,0.48918032786885246,0.5108196721311475
E01000158,1470,699,771,0.47551020408163264,0.5244897959183673
E01000159,1777,852,925,0.47945976364659537,0.5205402363534046
E01000160,2061,1057,1004,0.5128578360019408,0.4871421639980592
E01000161,1821,945,876,0.5189456342668863,0.48105436573311366
E01000162,1599,785,814,0.490931832395247,0.5090681676047529
E01000324,1786,882,904,0.49384098544232924,0.5061590145576708
E01000256,1788,857,931,0.47930648769574946,0.5206935123042505
E01000258,1658,806,852,0.48612786489746684,0.5138721351025332
E01000263,1581,749,832,0.4737507906388362,0.5262492093611638
E01000264,1648,846,802,0.5133495145631068,0.4866504854368932
E01000255,1481,714,767,0.48210668467251855,0.5178933153274814
E01000257,1855,827,1028,0.445822102425876,0.554177897574124
E01000261,1601,772,829,0.4821986258588382,0.5178013741411618
E01000262,2260,1097,1163,0.4853982300884956,0.5146017699115044
E01000192,1850,913,937,0.4935135135135135,0.5064864864864865
E01000193,1709,844,865,0.4938560561732007,0.5061439438267993
E01000194,1640,827,813,0.5042682926829268,0.49573170731707317
E01000226,1758,873,885,0.49658703071672355,0.5034129692832765
E01000227,1854,889,965,0.47950377562028046,0.5204962243797195
E01000299,1809,871,938,0.48148148148148145,0.5185185185185185
E01000300,1632,806,826,0.49387254901960786,0.5061274509803921
E01000302,1763,844,919,0.47872943845717525,0.5212705615428247
E01000317,1613,803,810,0.49783013019218847,0.5021698698078115
E01000318,1840,904,936,0.49130434782608695,0.508695652173913
E01000323,1982,1013,969,0.5110998990918264,0.48890010090817354
E01000276,1520,728,792,0.4789473684210526,0.5210526315789473
E01000278,1514,753,761,0.49735799207397624,0.5026420079260238
E01000301,1539,733,806,0.4762833008447043,0.5237166991552956
E01000303,1567,745,822,0.47543075941289087,0.5245692405871091
E01000304,1556,769,787,0.49421593830334193,0.5057840616966581
E01000130,1603,736,867,0.4591391141609482,0.5408608858390518
E01000132,1478,692,786,0.46820027063599456,0.5317997293640054
E01000133,1601,744,857,0.4647095565271705,0.5352904434728295
E01000234,1701,792,909,0.4656084656084656,0.5343915343915344
E01000235,1688,808,880,0.4786729857819905,0.5213270142180095
E01000156,1875,903,972,0.4816,0.5184
E01000157,1541,742,799,0.48150551589876706,0.518494484101233
E01000163,1558,763,795,0.48973042362002567,0.5102695763799743
E01000164,1686,822,864,0.4875444839857651,0.5124555160142349
E01000165,1862,949,913,0.5096670247046187,0.49033297529538133
E01000315,1715,823,892,0.47988338192419827,0.5201166180758018
E01000197,1830,908,922,0.4961748633879781,0.5038251366120219
E01000295,1714,819,895,0.47782963827304553,0.5221703617269545
E01000296,1707,837,870,0.4903339191564148,0.5096660808435852
E01000298,1812,881,931,0.48620309050772625,0.5137969094922737
E01000125,2779,1335,1444,0.4803886290032386,0.5196113709967615
E01000127,1505,697,808,0.46312292358803986,0.5368770764119601
E01000128,1869,903,966,0.48314606741573035,0.5168539325842697
E01000129,1782,839,943,0.4708193041526375,0.5291806958473625
E01000131,1806,888,918,0.49169435215946844,0.5083056478405316
E01000134,1632,774,858,0.4742647058823529,0.5257352941176471
E01000198,1893,941,952,0.497094558901215,0.502905441098785
E01000199,1617,754,863,0.46629560915275203,0.533704390847248
E01000204,1728,837,891,0.484375,0.515625
E01000259,2597,1238,1359,0.4767038891028109,0.5232961108971891
E01000260,1982,943,1039,0.47578203834510596,0.5242179616548941
E01000126,2162,1002,1160,0.46345975948196116,0.5365402405180388
E01000151,1711,840,871,0.49094097019286964,0.5090590298071304
E01000152,1729,793,936,0.45864661654135336,0.5413533834586466
E01000153,1541,703,838,0.4561972744970798,0.5438027255029202
E01000154,1360,664,696,0.48823529411764705,0.5117647058823529
E01000176,1613,747,866,0.463112213267204,0.536887786732796
E01000178,1791,861,930,0.4807370184254606,0.5192629815745393
E01000184,1414,693,721,0.4900990099009901,0.5099009900990099
E01000297,1434,711,723,0.49581589958158995,0.50418410041841
E01000316,2312,1117,1195,0.48313148788927335,0.5168685121107266
E01000319,1500,734,766,0.48933333333333334,0.5106666666666667
E01000196,1802,866,936,0.48057713651498335,0.5194228634850167
E01000200,1845,883,962,0.4785907859078591,0.5214092140921409
E01000201,1531,740,791,0.48334421946440237,0.5166557805355977
E01000202,1751,848,903,0.4842946887492861,0.5157053112507138
E01000203,1718,831,887,0.48370197904540163,0.5162980209545984
E01000177,1628,790,838,0.48525798525798525,0.5147420147420148
E01000179,1614,788,826,0.4882280049566295,0.5117719950433705
E01000180,1607,726,881,0.4517734909769757,0.5482265090230243
E01000181,1711,845,866,0.4938632378725891,0.5061367621274109
E01000182,1691,850,841,0.5026611472501479,0.4973388527498522
E01000185,1447,696,751,0.4809951624049758,0.5190048375950241
E01000147,1734,874,860,0.5040369088811996,0.49596309111880044
E01000148,1873,965,908,0.5152162306460224,0.4847837693539776
E01000155,1880,966,914,0.5138297872340426,0.48617021276595745
E01033572,1588,842,746,0.5302267002518891,0.46977329974811083
E01033573,1622,773,849,0.47657213316892727,0.5234278668310728
E01000239,1970,963,1007,0.4888324873096447,0.5111675126903553
E01000240,1670,830,840,0.49700598802395207,0.5029940119760479
E01000241,1744,857,887,0.4913990825688073,0.5086009174311926
E01000309,1822,902,920,0.4950603732162459,0.5049396267837541
E01000237,2038,1029,1009,0.5049067713444554,0.49509322865554467
E01000242,1656,793,863,0.4788647342995169,0.5211352657004831
E01000243,1884,967,917,0.5132696390658175,0.4867303609341826
E01000244,1705,845,860,0.49560117302052786,0.5043988269794721
E01000245,1982,980,1002,0.4944500504540868,0.5055499495459133
E01000314,1865,900,965,0.48257372654155495,0.517426273458445
E01000183,1473,687,786,0.4663951120162933,0.5336048879837068
E01000206,1576,724,852,0.4593908629441624,0.5406091370558376
E01000207,1583,761,822,0.48073278584965257,0.5192672141503475
E01000208,1594,773,821,0.4849435382685069,0.5150564617314931
E01000210,1548,713,835,0.46059431524547806,0.539405684754522
E01000213,1438,661,777,0.45966620305980527,0.5403337969401947
E01000236,1860,895,965,0.48118279569892475,0.5188172043010753
E01000238,1963,977,986,0.4977075904228222,0.5022924095771778
E01000310,2029,1014,1015,0.49975357318876296,0.5002464268112371
E01000311,1632,811,821,0.49693627450980393,0.5030637254901961
E01000205,1522,719,803,0.4724047306176084,0.5275952693823915
E01000209,1563,701,862,0.4484964811260397,0.5515035188739603
E01000211,2014,940,1074,0.4667328699106256,0.5332671300893744
E01000212,1428,653,775,0.4572829131652661,0.5427170868347339
E01000216,1968,917,1051,0.4659552845528455,0.5340447154471545
E01000217,1725,875,850,0.5072463768115942,0.4927536231884058
E01000150,2060,1006,1054,0.4883495145631068,0.5116504854368932
E01000305,1657,829,828,0.5003017501508751,0.4996982498491249
E01000306,1696,872,824,0.5141509433962265,0.4858490566037736
E01000308,1516,718,798,0.4736147757255937,0.5263852242744064
E01000312,1672,811,861,0.48504784688995217,0.5149521531100478
E01000313,1858,953,905,0.5129171151776103,0.48708288482238965
E01000145,1517,751,766,0.4950560316413975,0.5049439683586026
E01000215,2033,988,1045,0.48598130841121495,0.514018691588785
E01000218,1818,903,915,0.4966996699669967,0.5033003300330033
E01000219,1905,945,960,0.49606299212598426,0.5039370078740157
E01000220,1871,917,954,0.4901122394441475,0.5098877605558525
E01000225,1776,860,916,0.48423423423423423,0.5157657657657657
E01000135,1564,741,823,0.47378516624040923,0.5262148337595908
E01000136,1532,739,793,0.48237597911227154,0.5176240208877284
E01000144,1538,774,764,0.5032509752925878,0.4967490247074122
E01000146,1716,842,874,0.49067599067599066,0.5093240093240093
E01000214,1663,822,841,0.49428743235117256,0.5057125676488274
E01000141,2104,1033,1071,0.4909695817490494,0.5090304182509505
E01000221,1294,617,677,0.4768160741885626,0.5231839258114374
E01000223,1287,614,673,0.47707847707847706,0.5229215229215229
E01000307,1655,827,828,0.49969788519637465,0.5003021148036254
E01000138,1449,690,759,0.47619047619047616,0.5238095238095238
E01000142,2381,1166,1215,0.4897102057958841,0.5102897942041159
E01000222,1582,788,794,0.49810366624525915,0.5018963337547409
E01000224,1559,806,753,0.5169980756895446,0.4830019243104554
E01000137,1729,816,913,0.4719491035280509,0.5280508964719491
E01000139,1429,701,728,0.4905528341497551,0.509447165850245
E01000140,1631,774,857,0.47455548743102394,0.5254445125689761
E01000143,1459,723,736,0.49554489376285127,0.5044551062371487
E01000466,1655,823,832,0.4972809667673716,0.5027190332326285
E01000467,1634,765,869,0.46817625458996326,0.5318237454100367
E01000468,2723,1299,1424,0.47704737421961074,0.5229526257803893
E01000469,1654,821,833,0.496372430471584,0.5036275695284159
E01000416,1547,741,806,0.4789915966386555,0.5210084033613446
E01000418,1937,914,1023,0.47186370676303563,0.5281362932369644
E01000422,1729,825,904,0.47715442452284557,0.5228455754771544
E01000464,1443,677,766,0.46916146916146917,0.5308385308385308
E01000465,1542,776,766,0.503242542153048,0.496757457846952
E01000470,1443,660,783,0.4573804573804574,0.5426195426195426
E01000333,1666,769,897,0.4615846338535414,0.5384153661464586
E01000335,1794,847,947,0.4721293199554069,0.5278706800445931
E01000336,1886,911,975,0.48303287380699894,0.5169671261930011
E01000337,1653,793,860,0.47973381730187536,0.5202661826981246
E01000338,1751,886,865,0.5059965733866362,0.49400342661336377
E01000403,2108,965,1143,0.4577798861480076,0.5422201138519924
E01000404,2234,1119,1115,0.500895255147717,0.4991047448522829
E01000405,1410,706,704,0.500709219858156,0.49929078014184397
E01000408,1636,808,828,0.4938875305623472,0.5061124694376528
E01000332,1529,708,821,0.4630477436232832,0.5369522563767168
E01000402,1536,743,793,0.4837239583333333,0.5162760416666666
E01000406,1649,826,823,0.5009096422073984,0.4990903577926016
E01000407,1480,714,766,0.48243243243243245,0.5175675675675676
E01000334,1611,749,862,0.4649286157666046,0.5350713842333954
E01000417,1639,809,830,0.4935936546674802,0.5064063453325198
E01000419,1461,702,759,0.4804928131416838,0.5195071868583162
E01000420,1551,758,793,0.4887169568020632,0.5112830431979368
E01000442,1613,770,843,0.4773713577185369,0.5226286422814631
E01000437,1322,618,704,0.46747352496217853,0.5325264750378215
E01000438,1599,802,797,0.5015634771732332,0.4984365228267667
E01000439,1368,681,687,0.49780701754385964,0.5021929824561403
E01000440,1413,684,729,0.4840764331210191,0.5159235668789809
E01000441,1598,746,852,0.4668335419274093,0.5331664580725908
E01000373,1574,752,822,0.4777636594663278,0.5222363405336722
E01000429,1639,825,814,0.5033557046979866,0.4966442953020134
E01000430,1782,879,903,0.49326599326599324,0.5067340067340067
E01000431,1672,808,864,0.48325358851674644,0.5167464114832536
E01000432,1673,789,884,0.47160789001793185,0.5283921099820681
E01000433,1810,857,953,0.4734806629834254,0.5265193370165746
E01000434,1584,710,874,0.44823232323232326,0.5517676767676768
E01000356,1546,763,783,0.4935316946959897,0.5064683053040103
E01000357,1457,706,751,0.48455730954015097,0.515442690459849
E01000359,1280,629,651,0.49140625,0.50859375
E01000421,1482,703,779,0.47435897435897434,0.5256410256410257
E01000450,1832,879,953,0.4798034934497817,0.5201965065502183
E01000451,1699,819,880,0.4820482636845203,0.5179517363154797
E01000452,1428,704,724,0.49299719887955185,0.5070028011204482
E01000367,1575,739,836,0.4692063492063492,0.5307936507936508
E01000368,1539,701,838,0.4554905782975958,0.5445094217024041
E01000372,1680,790,890,0.47023809523809523,0.5297619047619048
E01000380,1455,677,778,0.4652920962199313,0.5347079037800687
E01000435,1406,669,737,0.47581792318634425,0.5241820768136558
E01000353,1686,840,846,0.498220640569395,0.501779359430605
E01000354,1505,698,807,0.46378737541528237,0.5362126245847176
E01000355,1464,713,751,0.4870218579234973,0.5129781420765027
E01000358,1608,776,832,0.48258706467661694,0.5174129353233831
E01000436,1685,838,847,0.4973293768545994,0.5026706231454006
E01000401,1647,767,880,0.46569520340012144,0.5343047965998786
E01000453,1472,725,747,0.49252717391304346,0.5074728260869565
E01000454,1572,740,832,0.4707379134860051,0.5292620865139949
E01000455,1705,814,891,0.4774193548387097,0.5225806451612903
E01000456,1427,702,725,0.49194113524877364,0.5080588647512263
E01000325,1610,784,826,0.48695652173913045,0.5130434782608696
E01000326,1295,612,683,0.4725868725868726,0.5274131274131274
E01000369,1618,797,821,0.4925834363411619,0.507416563658838
E01000370,1597,789,808,0.4940513462742642,0.5059486537257357
E01000371,1545,736,809,0.47637540453074434,0.5236245954692557
E01000360,1662,821,841,0.49398315282791816,0.5060168471720818
E01000362,1482,696,786,0.46963562753036436,0.5303643724696356
E01000365,1678,761,917,0.4535160905840286,0.5464839094159714
E01000366,1585,756,829,0.4769716088328076,0.5230283911671925
E01000394,1458,694,764,0.47599451303155005,0.52400548696845
E01000388,1531,742,789,0.4846505551926845,0.5153494448073155
E01000392,1646,763,883,0.46354799513973266,0.5364520048602673
E01000409,1649,800,849,0.4851425106124924,0.5148574893875075
E01000411,1398,654,744,0.4678111587982833,0.5321888412017167
E01000414,1708,842,866,0.4929742388758782,0.5070257611241218
E01000415,1498,745,753,0.49732977303070763,0.5026702269692924
E01000327,1543,752,791,0.4873622812702528,0.5126377187297473
E01000328,1480,739,741,0.49932432432432433,0.5006756756756757
E01000329,1316,625,691,0.4749240121580547,0.5250759878419453
E01000330,1544,714,830,0.46243523316062174,0.5375647668393783
E01000331,1630,823,807,0.5049079754601227,0.4950920245398773
E01000340,1502,736,766,0.49001331557922767,0.5099866844207723
E01000395,1428,708,720,0.4957983193277311,0.5042016806722689
E01000396,1399,689,710,0.49249463902787705,0.507505360972123
E01000410,1568,750,818,0.47831632653061223,0.5216836734693877
E01000412,1678,817,861,0.4868891537544696,0.5131108462455304
E01000413,1301,638,663,0.49039200614911604,0.509607993850884
E01000374,1533,747,786,0.487279843444227,0.512720156555773
E01000375,1476,726,750,0.491869918699187,0.508130081300813
E01000376,1541,731,810,0.4743672939649578,0.5256327060350422
E01000377,1420,701,719,0.4936619718309859,0.5063380281690141
E01000378,2121,1058,1063,0.4988213107024988,0.5011786892975012
E01000379,1680,820,860,0.4880952380952381,0.5119047619047619
E01000348,1481,755,726,0.5097906819716408,0.4902093180283592
E01000349,1659,802,857,0.48342374924653403,0.5165762507534659
E01000361,1540,784,756,0.509090909090909,0.4909090909090909
E01000363,1441,705,736,0.4892435808466343,0.5107564191533657
E01000389,1649,805,844,0.4881746513038205,0.5118253486961795
E01000390,1290,627,663,0.48604651162790696,0.513953488372093
E01000393,1581,779,802,0.4927261227071474,0.5072738772928527
E01000346,1622,800,822,0.4932182490752158,0.5067817509247842
E01000347,1486,692,794,0.46567967698519513,0.5343203230148048
E01000350,1501,743,758,0.4950033311125916,0.5049966688874084
E01000352,1575,731,844,0.4641269841269841,0.5358730158730158
E01000391,1709,799,910,0.4675248683440609,0.5324751316559392
E01000341,1490,735,755,0.49328859060402686,0.5067114093959731
E01000342,1595,763,832,0.47836990595611284,0.5216300940438872
E01000343,1535,752,783,0.48990228013029313,0.5100977198697069
E01000345,1355,654,701,0.4826568265682657,0.5173431734317343
E01000460,1353,680,673,0.5025868440502587,0.49741315594974134
E01000364,1577,782,795,0.49587824984147116,0.5041217501585289
E01000444,1637,802,835,0.4899205864386072,0.5100794135613927
E01000447,1535,744,791,0.48469055374592834,0.5153094462540717
E01000448,1335,668,667,0.500374531835206,0.49962546816479403
E01000449,1495,720,775,0.4816053511705686,0.5183946488294314
E01000351,1586,766,820,0.48297604035308955,0.5170239596469105
E01000443,1276,627,649,0.49137931034482757,0.5086206896551724
E01000445,1641,825,816,0.5027422303473492,0.49725776965265084
E01000446,1572,749,823,0.47646310432569977,0.5235368956743003
E01000461,1662,823,839,0.49518652226233456,0.5048134777376655
E01000339,1530,735,795,0.4803921568627451,0.5196078431372549
E01000344,1609,774,835,0.4810441267868241,0.5189558732131759
E01000423,1638,786,852,0.47985347985347987,0.5201465201465202
E01000425,1752,834,918,0.476027397260274,0.523972602739726
E01000463,1254,608,646,0.48484848484848486,0.5151515151515151
E01000424,1693,820,873,0.48434731246308327,0.5156526875369167
E01000426,1675,822,853,0.49074626865671644,0.5092537313432836
E01000427,1932,852,1080,0.4409937888198758,0.5590062111801242
E01000457,1783,787,996,0.44139091418956816,0.5586090858104319
E01000462,1643,740,903,0.45039561777236764,0.5496043822276324
E01000382,1524,747,777,0.49015748031496065,0.5098425196850394
E01000384,1722,809,913,0.46980255516840885,0.5301974448315911
E01000387,1535,726,809,0.47296416938110747,0.5270358306188925
E01000428,1752,768,984,0.4383561643835616,0.5616438356164384
E01000458,1462,689,773,0.47127222982216144,0.5287277701778386
E01000459,1687,801,886,0.4748073503260225,0.5251926496739775
E01000381,1598,758,840,0.47434292866082606,0.5256570713391739
E01000383,1505,724,781,0.48106312292358805,0.518936877076412
E01000385,1866,875,991,0.46891747052518756,0.5310825294748124
E01000386,1457,643,814,0.4413177762525738,0.5586822237474263
E01000398,1599,779,820,0.48717948717948717,0.5128205128205128
E01000399,1554,736,818,0.47361647361647363,0.5263835263835264
E01000400,1547,754,793,0.48739495798319327,0.5126050420168067
E01032566,1684,804,880,0.47743467933491684,0.5225653206650831
E01000587,1708,848,860,0.4964871194379391,0.5035128805620609
E01000589,1932,956,976,0.494824016563147,0.505175983436853
E01000590,1789,863,926,0.4823923979877026,0.5176076020122974
E01000592,1622,826,796,0.5092478421701603,0.4907521578298397
E01000593,2134,1053,1081,0.49343955014058105,0.506560449859419
E01000594,1698,858,840,0.5053003533568905,0.49469964664310956
E01000513,1693,849,844,0.5014766686355582,0.4985233313644418
E01000514,1512,789,723,0.5218253968253969,0.4781746031746032
E01000516,1707,881,826,0.5161101347393088,0.4838898652606913
E01000520,1637,824,813,0.5033598045204642,0.49664019547953575
E01000588,2197,1045,1152,0.4756486117432863,0.5243513882567137
E01000515,1702,823,879,0.4835487661574618,0.5164512338425382
E01000517,1609,789,820,0.490366687383468,0.509633312616532
E01000543,1596,820,776,0.5137844611528822,0.48621553884711777
E01000591,2075,1057,1018,0.5093975903614458,0.4906024096385542
E01033463,2939,1456,1483,0.49540660088465466,0.5045933991153454
E01000536,1573,789,784,0.501589319771138,0.49841068022886204
E01000538,1582,777,805,0.4911504424778761,0.5088495575221239
E01000539,1541,755,786,0.4899415963659961,0.5100584036340039
E01000540,1496,733,763,0.4899732620320856,0.5100267379679144
E01000541,1406,691,715,0.4914651493598862,0.5085348506401138
E01000518,1662,859,803,0.5168471720818292,0.4831528279181709
E01000519,1923,975,948,0.5070202808112324,0.49297971918876754
E01000623,1772,909,863,0.5129796839729119,0.48702031602708806
E01000624,1690,819,871,0.4846153846153846,0.5153846153846153
E01000629,1911,997,914,0.521716378859236,0.478283621140764
E01000480,1749,897,852,0.5128644939965694,0.48713550600343053
E01000484,1228,594,634,0.4837133550488599,0.5162866449511401
E01000485,1375,691,684,0.5025454545454545,0.4974545454545454
E01000486,1702,895,807,0.5258519388954171,0.47414806110458285
E01000487,1890,963,927,0.5095238095238095,0.49047619047619045
E01000572,1481,738,743,0.49831195138419987,0.5016880486158002
E01000573,1596,767,829,0.4805764411027569,0.5194235588972431
E01000574,1355,677,678,0.4996309963099631,0.5003690036900369
E01000575,1855,943,912,0.508355795148248,0.49164420485175203
E01000577,2420,1164,1256,0.4809917355371901,0.5190082644628099
E01000562,1548,755,793,0.4877260981912145,0.5122739018087855
E01000563,1480,757,723,0.5114864864864865,0.4885135135135135
E01000566,1535,775,760,0.504885993485342,0.495114006514658
E01000568,2260,1031,1229,0.4561946902654867,0.5438053097345132
E01000569,1565,774,791,0.49456869009584664,0.5054313099041533
E01000479,1659,828,831,0.49909584086799275,0.5009041591320073
E01000481,1538,776,762,0.5045513654096229,0.49544863459037713
E01000482,2886,1430,1456,0.4954954954954955,0.5045045045045045
E01000483,1745,873,872,0.5002865329512894,0.4997134670487106
E01000625,1504,734,770,0.488031914893617,0.511968085106383
E01000498,1680,840,840,0.5,0.5
E01000622,1585,778,807,0.4908517350157729,0.5091482649842272
E01000626,1500,703,797,0.4686666666666667,0.5313333333333333
E01033464,3022,1491,1531,0.4933818663136995,0.5066181336863005
E01000497,1756,855,901,0.4869020501138952,0.5130979498861048
E01000499,1732,876,856,0.5057736720554272,0.4942263279445728
E01000501,1874,903,971,0.4818569903948773,0.5181430096051227
E01000502,1393,689,704,0.4946159368269921,0.5053840631730079
E01000503,1968,988,980,0.5020325203252033,0.49796747967479676
E01000570,1579,783,796,0.49588347055098164,0.5041165294490184
E01000571,1707,884,823,0.517867603983597,0.48213239601640306
E01000576,1660,835,825,0.5030120481927711,0.49698795180722893
E01000578,1821,929,892,0.5101592531576057,0.4898407468423943
E01000564,1570,853,717,0.543312101910828,0.456687898089172
E01000565,1473,757,716,0.5139171758316361,0.4860828241683639
E01000607,2223,1160,1063,0.5218173639226271,0.47818263607737294
E01000608,2263,1176,1087,0.5196641626159965,0.48033583738400354
E01000613,1673,863,810,0.515839808726838,0.484160191273162
E01000506,1671,831,840,0.49730700179533216,0.5026929982046678
E01000509,1453,754,699,0.5189263592567103,0.48107364074328973
E01000510,1673,871,802,0.5206216377764495,0.4793783622235505
E01000511,1629,792,837,0.4861878453038674,0.5138121546961326
E01000627,1900,931,969,0.49,0.51
E01000628,1891,947,944,0.5007932310946589,0.4992067689053411
E01000553,2100,1093,1007,0.5204761904761904,0.4795238095238095
E01000554,1857,929,928,0.5002692514808832,0.49973074851911686
E01000555,1497,766,731,0.511690046760187,0.48830995323981297
E01000556,1869,1009,860,0.5398608881754949,0.46013911182450506
E01000557,1861,949,912,0.5099408919935519,0.49005910800644814
E01000558,1508,763,745,0.5059681697612732,0.49403183023872677
E01000567,1380,690,690,0.5,0.5
E01000606,1710,886,824,0.5181286549707602,0.4818713450292398
E01000609,2079,1058,1021,0.5088985088985089,0.4911014911014911
E01000611,1415,755,660,0.5335689045936396,0.4664310954063604
E01000615,1603,828,775,0.5165315034310668,0.48346849656893326
E01000617,1750,930,820,0.5314285714285715,0.4685714285714286
E01000618,1639,816,823,0.4978645515558267,0.5021354484441732
E01000619,1652,842,810,0.5096852300242131,0.49031476997578693
E01033424,1508,861,647,0.5709549071618037,0.4290450928381963
E01033457,1712,908,804,0.530373831775701,0.4696261682242991
E01000504,1676,861,815,0.5137231503579952,0.4862768496420048
E01000505,1660,834,826,0.5024096385542168,0.4975903614457831
E01000507,1634,829,805,0.50734394124847,0.49265605875153
E01000512,1702,866,836,0.5088131609870741,0.491186839012926
E01000559,1415,724,691,0.511660777385159,0.488339222614841
E01000610,1935,949,986,0.4904392764857881,0.5095607235142119
E01000612,1652,818,834,0.49515738498789347,0.5048426150121066
E01000631,1882,980,902,0.5207226354941552,0.47927736450584485
E01000633,1970,1082,888,0.5492385786802031,0.45076142131979696
E01000634,2343,1230,1113,0.5249679897567221,0.47503201024327785
E01000616,1747,929,818,0.5317687464224384,0.4682312535775615
E01000620,1715,880,835,0.5131195335276968,0.4868804664723032
E01000621,1779,950,829,0.5340078695896571,0.4659921304103429
E01000635,2415,1310,1105,0.5424430641821946,0.4575569358178054
E01000636,1776,948,828,0.5337837837837838,0.46621621621621623
E01000596,1694,845,849,0.4988193624557261,0.5011806375442739
E01000601,1505,710,795,0.4717607973421927,0.5282392026578073
E01000602,1541,738,803,0.4789097988319273,0.5210902011680727
E01000603,1487,701,786,0.4714189643577673,0.5285810356422327
E01000604,1766,814,952,0.4609286523216308,0.5390713476783692
E01000605,1662,807,855,0.4855595667870036,0.5144404332129964
E01000488,1576,775,801,0.491751269035533,0.508248730964467
E01000637,1675,834,841,0.49791044776119403,0.502089552238806
E01000639,1757,886,871,0.504268639726807,0.4957313602731929
E01000642,2054,1055,999,0.5136319376825705,0.4863680623174294
E01000644,1948,969,979,0.49743326488706363,0.5025667351129364
E01000490,1606,768,838,0.47820672478206727,0.5217932752179327
E01000494,1738,878,860,0.5051783659378596,0.4948216340621404
E01000495,1574,844,730,0.5362134688691232,0.46378653113087676
E01000560,1617,828,789,0.5120593692022264,0.48794063079777367
E01000561,1805,960,845,0.5318559556786704,0.46814404432132967
E01000638,1939,1009,930,0.520371325425477,0.47962867457452296
E01000640,2123,1108,1015,0.5219029674988224,0.4780970325011776
E01000641,1945,956,989,0.4915167095115681,0.5084832904884319
E01000643,2146,1014,1132,0.4725069897483691,0.527493010251631
E01000508,1961,965,996,0.49209586945436,0.50790413054564
E01000521,2179,1082,1097,0.4965580541532813,0.5034419458467186
E01000522,1923,903,1020,0.46957878315132606,0.5304212168486739
E01000526,2279,1057,1222,0.4637999122422115,0.5362000877577885
E01000527,2178,1086,1092,0.4986225895316804,0.5013774104683195
E01000528,1493,746,747,0.4996651038178165,0.5003348961821835
E01000471,1638,855,783,0.521978021978022,0.47802197802197804
E01000474,1999,1029,970,0.5147573786893447,0.4852426213106553
E01000476,1618,844,774,0.5216316440049443,0.4783683559950556
E01000477,1916,1015,901,0.5297494780793319,0.4702505219206681
E01000630,2254,1180,1074,0.5235137533274179,0.4764862466725821
E01000595,1685,838,847,0.4973293768545994,0.5026706231454006
E01000599,1308,643,665,0.49159021406727826,0.5084097859327217
E01000600,2047,1046,1001,0.5109916951636542,0.4890083048363459
E01033456,2208,1031,1177,0.46693840579710144,0.5330615942028986
E01000545,1809,907,902,0.5013819789939193,0.4986180210060807
E01000546,1645,784,861,0.4765957446808511,0.5234042553191489
E01000547,1780,868,912,0.48764044943820223,0.5123595505617977
E01000548,2044,1046,998,0.5117416829745597,0.4882583170254403
E01000549,1936,936,1000,0.4834710743801653,0.5165289256198347
E01000472,1346,711,635,0.5282317979197623,0.47176820208023773
E01000473,1883,978,905,0.5193839617631439,0.48061603823685606
E01000475,1976,997,979,0.5045546558704453,0.49544534412955465
E01000478,1641,836,805,0.5094454600853139,0.49055453991468617
E01000632,2087,1062,1025,0.5088643986583613,0.4911356013416387
E01000489,1581,729,852,0.46110056925996207,0.538899430740038
E01000491,1996,1019,977,0.5105210420841684,0.4894789579158317
E01000492,1315,641,674,0.4874524714828897,0.5125475285171103
E01000493,1637,783,854,0.47831398900427613,0.5216860109957239
E01000581,1550,729,821,0.4703225806451613,0.5296774193548387
E01000523,2610,1309,1301,0.5015325670498084,0.4984674329501916
E01000524,2514,1269,1245,0.5047732696897375,0.49522673031026254
E01000525,1986,975,1011,0.4909365558912387,0.5090634441087614
E01000533,2259,1173,1086,0.5192563081009296,0.4807436918990704
E01000535,2170,1083,1087,0.49907834101382487,0.5009216589861751
E01033455,1189,635,554,0.5340622371740958,0.4659377628259041
E01033485,1991,1009,982,0.5067805123053741,0.4932194876946258
E01000579,1665,824,841,0.4948948948948949,0.5051051051051051
E01000580,1980,998,982,0.5040404040404041,0.49595959595959593
E01000582,1847,898,949,0.48619382782891174,0.5138061721710883
E01000583,2273,1133,1140,0.49846018477782666,0.5015398152221734
E01000586,2457,1235,1222,0.5026455026455027,0.4973544973544973
E01000530,1824,888,936,0.4868421052631579,0.5131578947368421
E01000531,2077,1017,1060,0.48964853153586907,0.5103514684641309
E01000532,1630,828,802,0.5079754601226993,0.4920245398773006
E01000534,1775,834,941,0.46985915492957747,0.5301408450704226
E01000584,1695,846,849,0.49911504424778763,0.5008849557522124
E01000585,1814,907,907,0.5,0.5
E01000544,1777,896,881,0.5042205965109735,0.49577940348902644
E01000550,1966,966,1000,0.491353001017294,0.508646998982706
E01000551,2215,1129,1086,0.509706546275395,0.490293453724605
E01000552,1817,906,911,0.49862410566868465,0.5013758943313154
E01000779,1233,590,643,0.47850770478507704,0.5214922952149229
E01000780,1480,679,801,0.45878378378378376,0.5412162162162162
E01000781,1445,652,793,0.45121107266435984,0.5487889273356401
E01000782,1441,672,769,0.46634281748785567,0.5336571825121443
E01000783,1503,680,823,0.4524284763805722,0.5475715236194278
E01000785,1381,642,739,0.46488052136133234,0.5351194786386676
E01000689,1375,659,716,0.4792727272727273,0.5207272727272727
E01000690,1402,682,720,0.4864479315263909,0.5135520684736091
E01000691,1438,675,763,0.4694019471488178,0.5305980528511822
E01000692,1575,748,827,0.4749206349206349,0.525079365079365
E01000784,1504,730,774,0.4853723404255319,0.5146276595744681
E01000799,1642,819,823,0.4987819732034105,0.5012180267965896
E01000802,1729,833,896,0.4817813765182186,0.5182186234817814
E01000803,1596,726,870,0.4548872180451128,0.5451127819548872
E01000804,1436,719,717,0.5006963788300836,0.49930362116991645
E01000805,1511,722,789,0.47782925215089345,0.5221707478491066
E01000740,1734,871,863,0.5023068050749712,0.49769319492502884
E01000741,1586,809,777,0.5100882723833543,0.48991172761664564
E01000742,2019,988,1031,0.4893511639425458,0.5106488360574541
E01000745,1757,830,927,0.4723961297666477,0.5276038702333523
E01000746,1858,915,943,0.492465016146394,0.5075349838536061
E01000709,1317,644,673,0.48899012908124523,0.5110098709187547
E01000710,1605,754,851,0.46978193146417446,0.5302180685358255
E01000711,1719,847,872,0.4927283304246655,0.5072716695753345
E01000714,1865,939,926,0.503485254691689,0.49651474530831097
E01000718,2061,979,1082,0.4750121300339641,0.5249878699660359
E01000645,1375,666,709,0.4843636363636364,0.5156363636363637
E01000649,1981,948,1033,0.4785461887935386,0.5214538112064614
E01000694,1627,760,867,0.46711739397664415,0.5328826060233559
E01000695,1494,706,788,0.4725568942436412,0.5274431057563588
E01000696,1514,719,795,0.4749009247027741,0.5250990752972259
E01000697,1615,801,814,0.49597523219814244,0.5040247678018576
E01000674,1564,725,839,0.4635549872122762,0.5364450127877238
E01000676,1735,831,904,0.4789625360230548,0.5210374639769453
E01000820,1405,664,741,0.47259786476868326,0.5274021352313167
E01000822,1614,763,851,0.47273853779429986,0.5272614622057001
E01000823,1676,836,840,0.4988066825775656,0.5011933174224343
E01000824,1206,595,611,0.49336650082918737,0.5066334991708126
E01000825,1573,756,817,0.480610298792117,0.5193897012078831
E01000743,1770,847,923,0.47853107344632767,0.5214689265536723
E01000744,1531,744,787,0.48595689092096667,0.5140431090790333
E01000796,1630,769,861,0.4717791411042945,0.5282208588957055
E01000798,1464,702,762,0.47950819672131145,0.5204918032786885
E01000800,1618,788,830,0.48702101359703337,0.5129789864029666
E01000806,1721,838,883,0.48692620569436373,0.5130737943056363
E01000693,1609,777,832,0.4829086389061529,0.5170913610938471
E01000698,1182,582,600,0.49238578680203043,0.5076142131979695
E01000736,1560,766,794,0.491025641025641,0.5089743589743589
E01000737,1377,599,778,0.43500363108206247,0.5649963689179376
E01000672,1520,715,805,0.47039473684210525,0.5296052631578947
E01000673,1571,761,810,0.48440483768300446,0.5155951623169955
E01000716,1542,742,800,0.48119325551232167,0.5188067444876784
E01000717,1609,771,838,0.4791796146674953,0.5208203853325046
E01000828,1584,736,848,0.46464646464646464,0.5353535353535354
E01000712,1641,826,815,0.5033516148689823,0.49664838513101767
E01000713,1693,838,855,0.4949793266391022,0.5050206733608978
E01000715,1657,809,848,0.48823174411587206,0.5117682558841279
E01000770,1429,661,768,0.4625612316305108,0.5374387683694891
E01000772,1516,704,812,0.46437994722955145,0.5356200527704486
E01000700,1509,725,784,0.4804506295559973,0.5195493704440026
E01000702,1321,642,679,0.48599545798637395,0.514004542013626
E01000703,1599,755,844,0.4721701063164478,0.5278298936835523
E01000706,1293,602,691,0.46558391337973704,0.534416086620263
E01000797,1562,744,818,0.47631241997439183,0.5236875800256082
E01000729,1783,852,931,0.47784632641615254,0.5221536735838475
E01000730,1724,775,949,0.4495359628770302,0.5504640371229699
E01000735,1484,702,782,0.47304582210242585,0.5269541778975741
E01000738,1527,725,802,0.4747871643745907,0.5252128356254093
E01000739,1523,697,826,0.4576493762311228,0.5423506237688772
E01000699,1442,704,738,0.4882108183079057,0.5117891816920943
E01000701,1327,649,678,0.48907309721175585,0.5109269027882442
E01000704,1444,686,758,0.47506925207756234,0.5249307479224377
E01000705,1310,640,670,0.48854961832061067,0.5114503816793893
E01000801,1417,669,748,0.4721242060691602,0.5278757939308398
E01000646,1641,778,863,0.4741011578305911,0.5258988421694089
E01000647,1609,773,836,0.48042262274704783,0.5195773772529522
E01000648,1744,853,891,0.48910550458715596,0.510894495412844
E01000653,1584,722,862,0.45580808080808083,0.5441919191919192
E01000678,1707,835,872,0.48916227299355597,0.510837727006444
E01000670,1932,972,960,0.5031055900621118,0.4968944099378882
E01000675,1624,818,806,0.5036945812807881,0.4963054187192118
E01000677,1769,836,933,0.47258338044092707,0.5274166195590729
E01000762,1623,789,834,0.48613678373382624,0.5138632162661737
E01000829,1733,823,910,0.4748990190421235,0.5251009809578765
E01000719,1896,864,1032,0.45569620253164556,0.5443037974683544
E01000720,1632,735,897,0.45036764705882354,0.5496323529411765
E01000721,1327,602,725,0.45365486058779203,0.546345139412208
E01000724,1760,863,897,0.4903409090909091,0.5096590909090909
E01000728,1471,692,779,0.47042828008157717,0.5295717199184229
E01000651,1628,716,912,0.4398034398034398,0.5601965601965602
E01000668,1620,816,804,0.5037037037037037,0.4962962962962963
E01000669,1672,776,896,0.46411483253588515,0.5358851674641149
E01000671,1744,859,885,0.49254587155963303,0.507454128440367
E01000679,1660,821,839,0.49457831325301205,0.505421686746988
E01000826,1625,810,815,0.49846153846153846,0.5015384615384615
E01000827,1692,809,883,0.4781323877068558,0.5218676122931442
E01000830,1550,786,764,0.5070967741935484,0.49290322580645163
E01000831,1640,790,850,0.4817073170731707,0.5182926829268293
E01000833,1462,717,745,0.4904240766073871,0.5095759233926128
E01000650,1911,909,1002,0.47566718995290425,0.5243328100470958
E01000652,1625,774,851,0.4763076923076923,0.5236923076923077
E01000807,1532,755,777,0.49281984334203655,0.5071801566579635
E01000809,1517,723,794,0.47659854976928145,0.5234014502307185
E01000722,1636,784,852,0.4792176039119804,0.5207823960880196
E01000725,1641,767,874,0.4673979280926264,0.5326020719073735
E01000731,1363,650,713,0.4768892149669846,0.5231107850330154
E01000732,1475,702,773,0.4759322033898305,0.5240677966101694
E01000733,1593,784,809,0.4921531701192718,0.5078468298807282
E01000769,1417,716,701,0.5052928722653494,0.4947071277346507
E01000773,1521,691,830,0.4543063773833005,0.5456936226166995
E01000775,2266,1094,1172,0.48278905560458957,0.5172109443954104
E01000777,1567,758,809,0.4837268666241225,0.5162731333758774
E01000778,1580,732,848,0.46329113924050636,0.5367088607594936
E01000808,1604,770,834,0.4800498753117207,0.5199501246882793
E01000810,1503,720,783,0.47904191616766467,0.5209580838323353
E01000811,1320,631,689,0.478030303030303,0.521969696969697
E01000813,1610,770,840,0.4782608695652174,0.5217391304347826
E01000815,1537,737,800,0.47950553025374104,0.5204944697462589
E01000661,1594,744,850,0.46675031367628605,0.533249686323714
E01000662,1741,845,896,0.48535324526134405,0.514646754738656
E01000663,1627,759,868,0.4665027658266749,0.5334972341733252
E01000664,1610,780,830,0.484472049689441,0.515527950310559
E01000763,1452,705,747,0.4855371900826446,0.5144628099173554
E01000764,1615,753,862,0.4662538699690402,0.5337461300309597
E01000766,1714,841,873,0.49066511085180864,0.5093348891481914
E01000767,1646,812,834,0.4933171324422843,0.5066828675577156
E01000834,1328,639,689,0.4811746987951807,0.5188253012048193
E01000727,1553,738,815,0.4752092723760464,0.5247907276239536
E01000734,1360,660,700,0.4852941176470588,0.5147058823529411
E01000790,2018,994,1024,0.49256689791873143,0.5074331020812686
E01000812,1497,724,773,0.48363393453573816,0.5163660654642619
E01000814,1531,760,771,0.496407576747224,0.503592423252776
E01000723,1247,602,645,0.4827586206896552,0.5172413793103449
E01000726,1282,648,634,0.5054602184087363,0.49453978159126366
E01000787,1405,660,745,0.4697508896797153,0.5302491103202847
E01000788,1526,733,793,0.4803407601572739,0.5196592398427261
E01000791,1445,695,750,0.4809688581314879,0.5190311418685121
E01000832,1488,742,746,0.4986559139784946,0.5013440860215054
E01000835,1614,755,859,0.4677819083023544,0.5322180916976456
E01000836,1419,698,721,0.4918957011980268,0.5081042988019733
E01000837,1512,730,782,0.4828042328042328,0.5171957671957672
E01000838,1462,706,756,0.4829001367989056,0.5170998632010944
E01000839,1488,724,764,0.48655913978494625,0.5134408602150538
E01000840,1552,706,846,0.45489690721649484,0.5451030927835051
E01000841,1559,756,803,0.48492623476587554,0.5150737652341244
E01000753,1806,902,904,0.4994462901439646,0.5005537098560354
E01000754,1675,773,902,0.4614925373134328,0.5385074626865671
E01000755,1505,703,802,0.467109634551495,0.532890365448505
E01000757,1499,740,759,0.49366244162775186,0.5063375583722481
E01000758,1479,708,771,0.4787018255578093,0.5212981744421906
E01000786,1421,708,713,0.49824067558057705,0.501759324419423
E01000789,1800,829,971,0.46055555555555555,0.5394444444444444
E01000792,1142,535,607,0.46847635726795095,0.531523642732049
E01000793,1589,764,825,0.4808055380742605,0.5191944619257395
E01000795,1412,689,723,0.48796033994334276,0.5120396600566572
E01000665,1815,850,965,0.46831955922865015,0.5316804407713499
E01000666,1814,884,930,0.48732083792723263,0.5126791620727673
E01000667,1620,790,830,0.4876543209876543,0.5123456790123457
E01000756,1563,754,809,0.48240563019833654,0.5175943698016635
E01000759,1542,753,789,0.4883268482490272,0.5116731517509727
E01000760,1503,675,828,0.4491017964071856,0.5508982035928144
E01000761,1552,775,777,0.4993556701030928,0.5006443298969072
E01000765,1704,844,860,0.4953051643192488,0.5046948356807511
E01000768,1555,769,786,0.4945337620578778,0.5054662379421222
E01000681,1705,824,881,0.48328445747800586,0.5167155425219941
E01000682,1524,736,788,0.48293963254593175,0.5170603674540682
E01000683,1592,750,842,0.47110552763819097,0.5288944723618091
E01000684,2036,1011,1025,0.49656188605108054,0.5034381139489195
E01000794,1553,745,808,0.47971667739858337,0.5202833226014166
E01000749,1588,788,800,0.49622166246851385,0.5037783375314862
E01000750,1492,651,841,0.4363270777479893,0.5636729222520107
E01000751,2007,947,1060,0.4718485301444943,0.5281514698555058
E01000752,1606,730,876,0.45454545454545453,0.5454545454545454
E01000680,1609,813,796,0.5052827843380981,0.4947172156619018
E01000685,1565,771,794,0.4926517571884984,0.5073482428115016
E01000686,1508,732,776,0.4854111405835544,0.5145888594164456
E01000687,1603,772,831,0.4815970056144729,0.5184029943855272
E01000688,1365,661,704,0.48424908424908425,0.5157509157509158
E01000654,1273,639,634,0.5019638648860958,0.49803613511390415
E01000655,1323,640,683,0.4837490551776266,0.5162509448223734
E01000656,1400,692,708,0.4942857142857143,0.5057142857142857
E01000657,1587,748,839,0.47132955261499687,0.5286704473850031
E01000659,1462,747,715,0.5109439124487004,0.4890560875512996
E01000816,1481,718,763,0.48480756245779877,0.5151924375422012
E01000818,1467,718,749,0.4894342194955692,0.5105657805044308
E01000819,1710,813,897,0.47543859649122805,0.5245614035087719
E01032562,1507,695,812,0.46118115461181153,0.5388188453881885
E01032563,1483,686,797,0.46257585974376264,0.5374241402562373
E01000707,1455,717,738,0.4927835051546392,0.5072164948453608
E01000708,1543,750,793,0.4860661049902787,0.5139338950097213
E01000771,1635,785,850,0.4801223241590214,0.5198776758409785
E01000774,1473,697,776,0.47318397827562797,0.526816021724372
E01032568,1488,683,805,0.459005376344086,0.540994623655914
E01000658,1358,673,685,0.4955817378497791,0.5044182621502209
E01000747,1920,946,974,0.49270833333333336,0.5072916666666667
E01000748,1602,783,819,0.4887640449438202,0.5112359550561798
E01032570,1548,735,813,0.4748062015503876,0.5251937984496124
E01001137,1769,890,879,0.5031091011871114,0.4968908988128886
E01001138,1582,789,793,0.49873577749683945,0.5012642225031606
E01001156,1718,836,882,0.48661233993015135,0.5133876600698487
E01001162,1724,765,959,0.4437354988399072,0.5562645011600929
E01001164,1903,969,934,0.509196006305833,0.4908039936941671
E01001084,1828,920,908,0.5032822757111597,0.49671772428884026
E01001157,1703,836,867,0.4908984145625367,0.5091015854374633
E01001159,1801,894,907,0.4963908939478068,0.5036091060521932
E01001160,1881,911,970,0.48431685273790537,0.5156831472620946
E01001163,1939,944,995,0.48684889118102115,0.5131511088189789
E01001083,1609,808,801,0.5021752641392169,0.4978247358607831
E01001086,1750,868,882,0.496,0.504
E01001087,2195,1093,1102,0.4979498861047836,0.5020501138952164
E01001161,1849,859,990,0.4645754461871282,0.5354245538128718
E01001085,1606,789,817,0.4912826899128269,0.5087173100871731
E01001088,1709,815,894,0.47688706846108836,0.5231129315389117
E01001089,1907,893,1014,0.46827477713686416,0.5317252228631358
E01001090,2287,1081,1206,0.47267162221250547,0.5273283777874945
E01001091,1585,804,781,0.5072555205047319,0.4927444794952681
E01001147,1622,767,855,0.47287299630086316,0.5271270036991369
E01001148,1613,770,843,0.4773713577185369,0.5226286422814631
E01001151,1600,753,847,0.470625,0.529375
E01001152,1671,815,856,0.48773189706762415,0.5122681029323758
E01001158,1564,765,799,0.4891304347826087,0.5108695652173914
E01001146,1615,736,879,0.45572755417956656,0.5442724458204334
E01001149,1572,756,816,0.48091603053435117,0.5190839694656488
E01001150,1655,788,867,0.4761329305135952,0.5238670694864048
E01001153,1619,768,851,0.474366893143916,0.525633106856084
E01001154,1969,918,1051,0.4662265109192483,0.5337734890807516
E01001136,1880,951,929,0.5058510638297873,0.49414893617021277
E01001139,1602,751,851,0.46878901373283394,0.531210986267166
E01001140,1613,800,813,0.49597024178549287,0.5040297582145071
E01001142,1526,724,802,0.4744429882044561,0.5255570117955439
E01001144,1673,819,854,0.4895397489539749,0.5104602510460251
E01001141,1246,603,643,0.4839486356340289,0.5160513643659711
E01001143,1941,902,1039,0.46470891293147865,0.5352910870685214
E01001145,1686,834,852,0.49466192170818507,0.505338078291815
E01001191,1764,910,854,0.5158730158730159,0.48412698412698413
E01001192,1644,746,898,0.4537712895377129,0.5462287104622872
E01000994,1592,789,803,0.4956030150753769,0.5043969849246231
E01000995,1631,823,808,0.5045984058859595,0.49540159411404044
E01000996,1254,614,640,0.48963317384370014,0.5103668261562998
E01000997,1396,668,728,0.4785100286532951,0.5214899713467048
E01000999,1332,665,667,0.49924924924924924,0.5007507507507507
E01001002,1343,657,686,0.4892032762472077,0.5107967237527923
E01000998,1551,790,761,0.5093488072211476,0.49065119277885233
E01001000,1267,637,630,0.5027624309392266,0.4972375690607735
E01001003,1511,703,808,0.46525479814692255,0.5347452018530774
E01001111,1607,765,842,0.4760423148724331,0.5239576851275669
E01001155,1603,754,849,0.4703680598877105,0.5296319401122894
E01001174,1620,758,862,0.4679012345679012,0.5320987654320988
E01001175,1542,755,787,0.4896238651102464,0.5103761348897535
E01001176,1902,917,985,0.482124079915878,0.517875920084122
E01001182,1422,714,708,0.5021097046413502,0.4978902953586498
E01001183,1572,762,810,0.4847328244274809,0.5152671755725191
E01001184,1349,622,727,0.46108228317272054,0.5389177168272795
E01001001,1195,573,622,0.4794979079497908,0.5205020920502093
E01001109,2039,1004,1035,0.4923982344286415,0.5076017655713585
E01001112,1718,803,915,0.46740395809080326,0.5325960419091967
E01001113,1828,874,954,0.47811816192560175,0.5218818380743983
E01001114,1400,691,709,0.49357142857142855,0.5064285714285715
E01001116,1359,686,673,0.5047829286239882,0.4952170713760118
E01000992,1978,986,992,0.49848331648129424,0.5015166835187057
E01001185,1636,800,836,0.4889975550122249,0.511002444987775
E01001186,1745,866,879,0.4962750716332378,0.5037249283667622
E01001188,1833,855,978,0.4664484451718494,0.5335515548281505
E01001193,1807,812,995,0.44936358605423354,0.5506364139457665
E01001004,2129,984,1145,0.46218882104274306,0.5378111789572569
E01001115,1706,864,842,0.5064478311840562,0.4935521688159437
E01001117,2761,1359,1402,0.492212966316552,0.507787033683448
E01001178,1365,685,680,0.5018315018315018,0.4981684981684982
E01001181,1829,848,981,0.46364133406232916,0.5363586659376709
E01001006,1558,738,820,0.47368421052631576,0.5263157894736842
E01001007,1968,974,994,0.4949186991869919,0.5050813008130082
E01001177,1617,795,822,0.49165120593692024,0.5083487940630798
E01001179,1534,747,787,0.4869621903520209,0.5130378096479792
E01001180,1737,850,887,0.48934945308002303,0.510650546919977
E01000980,1407,650,757,0.4619758351101635,0.5380241648898365
E01000981,1642,769,873,0.46833130328867234,0.5316686967113277
E01000982,1604,798,806,0.4975062344139651,0.5024937655860349
E01000983,1712,849,863,0.495911214953271,0.5040887850467289
E01001187,1945,914,1031,0.4699228791773779,0.5300771208226221
E01000989,1707,804,903,0.4710017574692443,0.5289982425307557
E01000991,1649,829,820,0.5027289266221953,0.49727107337780474
E01001131,1563,721,842,0.46129238643634035,0.5387076135636596
E01001132,1464,720,744,0.4918032786885246,0.5081967213114754
E01001134,1617,777,840,0.4805194805194805,0.5194805194805194
E01001005,1687,850,837,0.5038529934795495,0.4961470065204505
E01001008,1608,760,848,0.472636815920398,0.527363184079602
E01001009,1846,910,936,0.49295774647887325,0.5070422535211268
E01001010,1514,713,801,0.4709379128137384,0.5290620871862616
E01001011,1868,969,899,0.5187366167023555,0.48126338329764456
E01001012,1922,969,953,0.5041623309053069,0.495837669094693
E01001013,2018,1008,1010,0.49950445986124875,0.5004955401387512
E01001048,1942,996,946,0.5128733264675592,0.48712667353244077
E01001110,1787,906,881,0.5069949636261891,0.4930050363738109
E01001118,1882,901,981,0.47874601487778956,0.5212539851222104
E01000985,1447,727,720,0.502418797512094,0.497581202487906
E01000986,1738,852,886,0.4902186421173763,0.5097813578826237
E01000987,1431,721,710,0.5038434661076171,0.49615653389238296
E01000993,1620,816,804,0.5037037037037037,0.4962962962962963
E01000975,1613,818,795,0.5071295722256665,0.49287042777433354
E01000976,1867,972,895,0.5206213176218533,0.47937868237814674
E01000977,1731,907,824,0.5239745811669555,0.4760254188330445
E01000978,1775,931,844,0.5245070422535211,0.4754929577464789
E01000979,1703,894,809,0.5249559600704639,0.4750440399295361
E01000984,1829,903,926,0.49371241115363584,0.5062875888463642
E01001044,1922,971,951,0.5052029136316337,0.4947970863683663
E01001046,1751,892,859,0.5094231867504283,0.4905768132495717
E01001049,1419,699,720,0.492600422832981,0.507399577167019
E01001050,1646,770,876,0.46780072904009723,0.5321992709599028
E01001014,2663,1301,1362,0.4885467517837026,0.5114532482162975
E01001042,1818,889,929,0.488998899889989,0.511001100110011
E01001165,1656,807,849,0.48731884057971014,0.5126811594202898
E01001166,1814,914,900,0.503858875413451,0.4961411245865491
E01001168,1737,865,872,0.49798503166378816,0.5020149683362118
E01001127,1607,784,823,0.4878655880522713,0.5121344119477287
E01001128,1611,717,894,0.4450651769087523,0.5549348230912476
E01001130,1776,790,986,0.44481981981981983,0.5551801801801802
E01001135,1646,807,839,0.49027946537059536,0.5097205346294046
E01001062,1567,774,793,0.49393746011486916,0.5060625398851308
E01001063,1539,731,808,0.47498375568551005,0.5250162443144899
E01001064,1568,757,811,0.48278061224489793,0.517219387755102
E01001129,1455,690,765,0.4742268041237113,0.5257731958762887
E01001133,1557,697,860,0.4476557482337829,0.552344251766217
E01001035,1760,890,870,0.5056818181818182,0.4943181818181818
E01001043,2578,1359,1219,0.5271528316524438,0.47284716834755625
E01001045,1820,971,849,0.5335164835164835,0.4664835164835165
E01001047,1673,867,806,0.5182307232516438,0.48176927674835623
E01001170,2050,988,1062,0.4819512195121951,0.5180487804878049
E01001167,2193,1056,1137,0.48153214774281805,0.518467852257182
E01001169,1680,769,911,0.4577380952380952,0.5422619047619047
E01001171,1638,739,899,0.45115995115995117,0.5488400488400489
E01001172,1748,833,915,0.4765446224256293,0.5234553775743707
E01001173,2561,1252,1309,0.48887153455681376,0.5111284654431862
E01001036,1521,746,775,0.4904667981591059,0.5095332018408941
E01001037,1396,652,744,0.4670487106017192,0.5329512893982808
E01001038,1792,926,866,0.5167410714285714,0.48325892857142855
E01001039,1474,731,743,0.49592944369063774,0.5040705563093623
E01001040,1708,864,844,0.5058548009367682,0.49414519906323184
E01001051,1549,697,852,0.4499677211103938,0.5500322788896062
E01001052,1447,636,811,0.4395300621976503,0.5604699378023497
E01001054,1710,788,922,0.4608187134502924,0.5391812865497077
E01001056,1851,822,1029,0.44408427876823336,0.5559157212317666
E01001057,1814,782,1032,0.4310915104740904,0.5689084895259096
E01001033,1616,798,818,0.4938118811881188,0.5061881188118812
E01001034,1516,763,753,0.5032981530343008,0.4967018469656992
E01001041,1611,801,810,0.4972067039106145,0.5027932960893855
E01001095,1468,721,747,0.49114441416893734,0.5088555858310627
E01001100,1473,730,743,0.4955872369314325,0.5044127630685675
E01001053,1513,718,795,0.47455386649041637,0.5254461335095836
E01001055,1595,755,840,0.47335423197492166,0.5266457680250783
E01001077,1396,663,733,0.47492836676217765,0.5250716332378224
E01001078,1404,658,746,0.4686609686609687,0.5313390313390314
E01001082,1627,749,878,0.4603564843269822,0.5396435156730178
E01001120,1263,638,625,0.5051464766429137,0.4948535233570863
E01001122,1539,783,756,0.5087719298245614,0.49122807017543857
E01001123,1514,738,776,0.48745046235138706,0.512549537648613
E01001124,1573,761,812,0.4837889383343929,0.5162110616656072
E01001125,1650,820,830,0.49696969696969695,0.503030303030303
E01001058,1326,586,740,0.4419306184012066,0.5580693815987934
E01001059,1396,669,727,0.4792263610315186,0.5207736389684814
E01001060,1581,768,813,0.4857685009487666,0.5142314990512334
E01001061,1533,731,802,0.47684279191128504,0.5231572080887149
E01001065,1334,654,680,0.49025487256371814,0.5097451274362819
E01001066,1369,595,774,0.4346238130021914,0.5653761869978087
E01001119,1470,710,760,0.48299319727891155,0.5170068027210885
E01001126,1402,667,735,0.47574893009985736,0.5242510699001427
E01001032,1396,688,708,0.49283667621776506,0.5071633237822349
E01001101,1423,686,737,0.4820801124385102,0.5179198875614898
E01001102,1463,687,776,0.46958304853041694,0.530416951469583
E01001107,1616,812,804,0.5024752475247525,0.4975247524752475
E01001108,1711,831,880,0.4856808883693746,0.5143191116306254
E01001076,1606,749,857,0.4663760896637609,0.5336239103362391
E01001079,1681,792,889,0.4711481261154075,0.5288518738845925
E01001080,1678,774,904,0.4612634088200238,0.5387365911799762
E01001081,1409,675,734,0.47906316536550747,0.5209368346344926
E01001073,1441,714,727,0.4954892435808466,0.5045107564191533
E01001092,1777,854,923,0.4805852560495217,0.5194147439504784
E01001093,1738,854,884,0.49136939010356734,0.5086306098964327
E01001096,1534,769,765,0.5013037809647979,0.49869621903520206
E01001097,2103,1030,1073,0.4897765097479791,0.510223490252021
E01001098,1452,708,744,0.48760330578512395,0.512396694214876
E01001028,1630,793,837,0.4865030674846626,0.5134969325153375
E01001029,1593,784,809,0.4921531701192718,0.5078468298807282
E01001030,1411,702,709,0.49751948972360027,0.5024805102763997
E01001031,1466,735,731,0.5013642564802183,0.49863574351978174
E01001094,1585,781,804,0.4927444794952681,0.5072555205047319
E01001103,1680,807,873,0.48035714285714287,0.5196428571428572
E01001105,1729,839,890,0.4852515905147484,0.5147484094852516
E01001106,1490,727,763,0.4879194630872483,0.5120805369127517
E01001121,1308,610,698,0.46636085626911317,0.5336391437308868
E01001069,1385,676,709,0.488086642599278,0.511913357400722
E01001070,1726,839,887,0.4860950173812283,0.5139049826187717
E01001075,1547,739,808,0.4776987718164189,0.5223012281835812
E01001099,1477,701,776,0.4746106973595125,0.5253893026404874
E01001015,1440,681,759,0.47291666666666665,0.5270833333333333
E01001016,1705,834,871,0.48914956011730204,0.510850439882698
E01001023,1314,638,676,0.4855403348554033,0.5144596651445966
E01001067,1631,823,808,0.5045984058859595,0.49540159411404044
E01001074,1933,921,1012,0.47646145887221936,0.5235385411277806
E01001068,1924,929,995,0.48284823284823286,0.5171517671517671
E01001071,1891,905,986,0.4785827604442094,0.5214172395557906
E01001072,1488,715,773,0.48051075268817206,0.519489247311828
E01001104,1665,805,860,0.48348348348348347,0.5165165165165165
E01001017,1624,818,806,0.5036945812807881,0.4963054187192118
E01001024,1428,691,737,0.4838935574229692,0.5161064425770309
E01001025,1296,624,672,0.48148148148148145,0.5185185185185185
E01001026,1729,815,914,0.47137073452862926,0.5286292654713707
E01001027,1582,795,787,0.5025284450063211,0.4974715549936789
E01001018,1556,742,814,0.4768637532133676,0.5231362467866324
E01001019,1511,751,760,0.49702183984116477,0.5029781601588352
E01001020,1630,746,884,0.45766871165644174,0.5423312883435583
E01001021,1332,602,730,0.4519519519519519,0.5480480480480481
E01001022,1446,715,731,0.49446749654218536,0.5055325034578146
E01000990,1420,657,763,0.46267605633802816,0.5373239436619718
E01001189,1211,557,654,0.4599504541701073,0.5400495458298926
E01001190,1586,699,887,0.4407313997477932,0.5592686002522068
E01001194,1572,747,825,0.4751908396946565,0.5248091603053435
E01032569,1731,778,953,0.4494511842865396,0.5505488157134605
E01001269,1983,1023,960,0.5158850226928896,0.48411497730711045
E01001271,1804,939,865,0.520509977827051,0.479490022172949
E01001309,1830,940,890,0.5136612021857924,0.48633879781420764
E01001310,1801,921,880,0.5113825652415325,0.48861743475846753
E01001311,2082,1042,1040,0.5004803073967339,0.49951969260326606
E01001307,1833,970,863,0.5291871249318058,0.4708128750681942
E01001308,2042,1005,1037,0.4921645445641528,0.5078354554358472
E01001312,1839,919,920,0.49972811310494836,0.5002718868950516
E01001313,1701,863,838,0.5073486184597296,0.49265138154027044
E01001314,1585,806,779,0.5085173501577287,0.4914826498422713
E01001315,1461,707,754,0.4839151266255989,0.5160848733744011
E01001316,1583,760,823,0.4801010739102969,0.5198989260897031
E01001317,1862,908,954,0.48764769065520946,0.5123523093447906
E01001318,1790,879,911,0.4910614525139665,0.5089385474860335
E01001320,1548,690,858,0.44573643410852715,0.5542635658914729
E01001321,2021,1010,1011,0.4997525977238991,0.500247402276101
E01001270,1721,880,841,0.5113306217315514,0.4886693782684486
E01001319,1498,716,782,0.4779706275033378,0.5220293724966623
E01001322,1692,841,851,0.49704491725768324,0.5029550827423168
E01001323,1728,851,877,0.49247685185185186,0.5075231481481481
E01001341,1712,908,804,0.530373831775701,0.4696261682242991
E01001342,1867,958,909,0.513122656668452,0.4868773433315479
E01001343,1504,769,735,0.5113031914893617,0.4886968085106383
E01001345,1680,892,788,0.530952380952381,0.46904761904761905
E01001265,1692,844,848,0.4988179669030733,0.5011820330969267
E01001266,1832,948,884,0.517467248908297,0.48253275109170307
E01001267,1953,941,1012,0.48182283666154635,0.5181771633384537
E01001272,1628,833,795,0.5116707616707616,0.4883292383292383
E01001349,1404,720,684,0.5128205128205128,0.48717948717948717
E01001344,2161,1083,1078,0.5011568718186025,0.4988431281813975
E01001346,1878,940,938,0.5005324813631523,0.4994675186368477
E01001347,1534,806,728,0.5254237288135594,0.4745762711864407
E01001348,1599,838,761,0.5240775484677924,0.47592245153220764
E01001257,1783,846,937,0.47448121144139094,0.5255187885586091
E01001324,1553,779,774,0.501609787508049,0.4983902124919511
E01001326,1719,798,921,0.4642233856893543,0.5357766143106457
E01001330,1598,805,793,0.5037546933667084,0.49624530663329164
E01001332,1503,699,804,0.46506986027944114,0.5349301397205589
E01001325,1758,860,898,0.4891922639362912,0.5108077360637088
E01001327,1803,903,900,0.5008319467554077,0.49916805324459235
E01001328,1730,849,881,0.4907514450867052,0.5092485549132948
E01001329,1783,869,914,0.48738081884464385,0.5126191811553561
E01001331,1674,812,862,0.4850657108721625,0.5149342891278376
E01001258,1690,833,857,0.4928994082840237,0.5071005917159763
E01001262,1592,758,834,0.47613065326633164,0.5238693467336684
E01001263,1672,833,839,0.49820574162679426,0.5017942583732058
E01001264,1655,796,859,0.4809667673716012,0.5190332326283988
E01032743,2173,1007,1166,0.4634146341463415,0.5365853658536586
E01032744,1526,725,801,0.4750982961992136,0.5249017038007864
E01001276,1788,896,892,0.5011185682326622,0.4988814317673378
E01001277,1844,947,897,0.5135574837310195,0.4864425162689805
E01001278,1962,952,1010,0.48521916411824667,0.5147808358817533
E01001280,1740,848,892,0.48735632183908045,0.5126436781609195
E01001218,1908,922,986,0.4832285115303983,0.5167714884696016
E01001260,1899,938,961,0.4939441811479726,0.5060558188520273
E01001261,2178,1123,1055,0.5156106519742883,0.48438934802571165
E01001268,1736,859,877,0.49481566820276496,0.505184331797235
E01001209,1712,829,883,0.4842289719626168,0.5157710280373832
E01001211,1702,809,893,0.47532314923619273,0.5246768507638073
E01001279,1473,712,761,0.48336727766463,0.5166327223353699
E01001281,1600,743,857,0.464375,0.535625
E01001217,1539,788,751,0.5120207927225471,0.48797920727745286
E01001259,1457,725,732,0.49759780370624573,0.5024021962937543
E01001291,1642,839,803,0.5109622411693058,0.4890377588306943
E01001292,1708,850,858,0.49765807962529274,0.5023419203747073
E01001293,1598,806,792,0.5043804755944932,0.4956195244055069
E01001196,1766,857,909,0.485277463193658,0.5147225368063421
E01001238,2868,1580,1288,0.5509065550906556,0.4490934449093445
E01001239,1542,793,749,0.5142671854734111,0.48573281452658884
E01001246,1360,669,691,0.4919117647058823,0.5080882352941176
E01001247,2170,1174,996,0.5410138248847927,0.4589861751152074
E01001210,1679,833,846,0.49612864800476475,0.5038713519952353
E01001282,1557,746,811,0.47912652536929995,0.5208734746307001
E01001283,1595,753,842,0.47210031347962383,0.5278996865203762
E01001285,1690,842,848,0.4982248520710059,0.5017751479289941
E01001286,1674,794,880,0.4743130227001195,0.5256869772998806
E01001287,1437,647,790,0.45024356297842727,0.5497564370215727
E01001294,1894,941,953,0.4968321013727561,0.503167898627244
E01001295,1826,923,903,0.5054764512595837,0.4945235487404162
E01001296,1481,764,717,0.5158676569885212,0.4841323430114787
E01001297,1814,910,904,0.5016538037486218,0.49834619625137816
E01001298,1934,1004,930,0.5191313340227508,0.4808686659772492
E01001204,1589,776,813,0.4883574575204531,0.5116425424795469
E01001205,1559,738,821,0.4733803720333547,0.5266196279666453
E01001206,1714,802,912,0.4679113185530922,0.5320886814469078
E01001207,1570,781,789,0.49745222929936306,0.5025477707006369
E01001208,1366,655,711,0.479502196193265,0.5204978038067349
E01001212,1667,831,836,0.498500299940012,0.501499700059988
E01001222,2384,1202,1182,0.5041946308724832,0.49580536912751677
E01001224,1616,790,826,0.48886138613861385,0.5111386138613861
E01001226,1535,757,778,0.49315960912052115,0.5068403908794789
E01001227,1514,756,758,0.49933949801849403,0.5006605019815059
E01001228,1812,876,936,0.48344370860927155,0.5165562913907285
E01001221,1861,900,961,0.4836109618484686,0.5163890381515315
E01001223,1517,773,744,0.5095583388266315,0.4904416611733685
E01001225,1790,851,939,0.47541899441340785,0.5245810055865922
E01001235,1597,817,780,0.5115842204132749,0.4884157795867251
E01001236,1590,810,780,0.5094339622641509,0.49056603773584906
E01001273,1623,800,823,0.4929143561306223,0.5070856438693777
E01001274,1630,797,833,0.48895705521472393,0.5110429447852761
E01001275,1901,955,946,0.5023671751709626,0.49763282482903737
E01001195,1833,962,871,0.524822695035461,0.475177304964539
E01001197,1753,852,901,0.4860239589275528,0.5139760410724472
E01001198,1440,739,701,0.5131944444444444,0.48680555555555555
E01001199,1704,860,844,0.5046948356807511,0.4953051643192488
E01001284,1539,762,777,0.4951267056530214,0.5048732943469786
E01001288,1498,722,776,0.4819759679572764,0.5180240320427236
E01001289,1383,660,723,0.4772234273318872,0.5227765726681128
E01001290,1856,901,955,0.4854525862068966,0.5145474137931034
E01001213,1830,966,864,0.5278688524590164,0.4721311475409836
E01001214,1749,902,847,0.5157232704402516,0.48427672955974843
E01001215,1765,868,897,0.49178470254957507,0.5082152974504249
E01001216,1564,818,746,0.5230179028132992,0.47698209718670076
E01001361,1802,946,856,0.5249722530521642,0.4750277469478357
E01001240,1615,802,813,0.496594427244582,0.503405572755418
E01001241,1501,786,715,0.5236508994003998,0.4763491005996003
E01001242,1455,703,752,0.4831615120274914,0.5168384879725086
E01001243,1742,850,892,0.48794489092996557,0.5120551090700345
E01001244,2539,1205,1334,0.47459629775502166,0.5254037022449783
E01001245,1914,926,988,0.48380355276907,0.51619644723093
E01001200,1516,768,748,0.5065963060686016,0.49340369393139843
E01001201,1561,734,827,0.47021140294682895,0.529788597053171
E01001202,2120,1093,1027,0.5155660377358491,0.4844339622641509
E01001203,1734,880,854,0.5074971164936563,0.4925028835063437
E01001351,1994,981,1013,0.49197592778335003,0.5080240722166499
E01001359,2201,1190,1011,0.5406633348477965,0.45933666515220356
E01001360,1923,994,929,0.516900676027041,0.4830993239729589
E01001362,1935,1061,874,0.5483204134366925,0.4516795865633075
E01001363,1685,879,806,0.5216617210682493,0.47833827893175074
E01001364,1676,844,832,0.5035799522673031,0.4964200477326969
E01001365,2217,1205,1012,0.5435272891294542,0.4564727108705458
E01001231,1866,957,909,0.5128617363344051,0.4871382636655949
E01001234,1401,701,700,0.5003568879371877,0.49964311206281226
E01001350,1486,728,758,0.4899057873485868,0.5100942126514132
E01001352,1510,750,760,0.4966887417218543,0.5033112582781457
E01001354,1840,904,936,0.49130434782608695,0.508695652173913
E01001249,2370,1159,1211,0.4890295358649789,0.5109704641350211
E01001250,2041,1001,1040,0.49044585987261147,0.5095541401273885
E01001255,1610,760,850,0.4720496894409938,0.5279503105590062
E01001383,1791,933,858,0.5209380234505863,0.47906197654941374
E01001388,1640,840,800,0.5121951219512195,0.4878048780487805
E01001389,1667,849,818,0.5092981403719257,0.4907018596280744
E01001219,2046,985,1061,0.4814271749755621,0.5185728250244379
E01001220,1509,692,817,0.4585818422796554,0.5414181577203446
E01001334,1623,809,814,0.4984596426370918,0.5015403573629081
E01001337,1470,719,751,0.4891156462585034,0.5108843537414965
E01001338,1953,1023,930,0.5238095238095238,0.47619047619047616
E01001339,1841,887,954,0.48180336773492666,0.5181966322650733
E01001340,1889,1026,863,0.5431445209105347,0.45685547908946533
E01001251,1654,798,856,0.48246674727932287,0.5175332527206772
E01001252,1938,1003,935,0.5175438596491229,0.4824561403508772
E01001253,1649,804,845,0.48756822316555487,0.5124317768344451
E01001254,1685,798,887,0.47359050445103856,0.5264094955489614
E01001229,1522,706,816,0.46386333771353483,0.5361366622864652
E01001230,1488,740,748,0.49731182795698925,0.5026881720430108
E01001232,1538,778,760,0.505851755526658,0.494148244473342
E01001233,1424,709,715,0.4978932584269663,0.5021067415730337
E01001237,1593,843,750,0.5291902071563088,0.4708097928436911
E01001386,1793,890,903,0.4963747908533185,0.5036252091466815
E01001303,1639,785,854,0.47895057962172055,0.5210494203782794
E01001382,1566,772,794,0.4929757343550447,0.5070242656449553
E01001384,1645,798,847,0.4851063829787234,0.5148936170212766
E01001385,1682,807,875,0.4797859690844233,0.5202140309155767
E01001387,1546,785,761,0.5077619663648124,0.4922380336351876
E01001353,1667,802,865,0.48110377924415115,0.5188962207558488
E01001355,1664,837,827,0.5030048076923077,0.4969951923076923
E01001356,1969,924,1045,0.4692737430167598,0.5307262569832403
E01001357,1141,529,612,0.4636283961437336,0.5363716038562665
E01001358,1602,791,811,0.4937578027465668,0.5062421972534332
E01001375,1665,803,862,0.48228228228228226,0.5177177177177177
E01001377,1770,871,899,0.492090395480226,0.507909604519774
E01001379,1679,802,877,0.4776652769505658,0.5223347230494342
E01001381,1649,855,794,0.5184960582171013,0.48150394178289874
E01001248,1592,778,814,0.4886934673366834,0.5113065326633166
E01001299,1833,904,929,0.49318057828696127,0.5068194217130387
E01001305,1716,848,868,0.49417249417249415,0.5058275058275058
E01001306,1607,788,819,0.4903546981953951,0.5096453018046049
E01001366,1923,1016,907,0.5283411336453459,0.4716588663546542
E01001367,1764,1015,749,0.5753968253968254,0.4246031746031746
E01001368,1723,916,807,0.5316308763784098,0.4683691236215902
E01001370,1980,1038,942,0.5242424242424243,0.47575757575757577
E01001371,2081,1068,1013,0.5132148005766458,0.48678519942335413
E01001372,1763,970,793,0.5501985252410664,0.4498014747589336
E01001373,1499,823,676,0.5490326884589727,0.45096731154102737
E01001333,1903,1022,881,0.5370467682606411,0.46295323173935893
E01001335,1781,866,915,0.4862436833239753,0.5137563166760247
E01001336,1572,794,778,0.5050890585241731,0.494910941475827
E01001369,1846,949,897,0.5140845070422535,0.4859154929577465
E01001300,1692,855,837,0.5053191489361702,0.4946808510638298
E01001301,1782,944,838,0.5297418630751964,0.4702581369248036
E01001302,1621,844,777,0.5206662553979026,0.4793337446020975
E01001304,1627,806,821,0.4953902888752305,0.5046097111247695
E01001374,1798,876,922,0.4872080088987764,0.5127919911012235
E01001376,1579,785,794,0.49715009499683344,0.5028499050031665
E01001380,1759,869,890,0.49403069926094373,0.5059693007390563
E01032572,1575,784,791,0.49777777777777776,0.5022222222222222
E01001444,1676,784,892,0.4677804295942721,0.5322195704057279
E01001446,1817,895,922,0.4925701706108971,0.507429829389103
E01001546,1783,861,922,0.482893998878295,0.517106001121705
E01001552,1805,851,954,0.4714681440443213,0.5285318559556786
E01001442,1684,768,916,0.45605700712589076,0.5439429928741093
E01001545,1843,867,976,0.4704286489419425,0.5295713510580575
E01001547,1758,861,897,0.48976109215017066,0.5102389078498294
E01001548,1819,887,932,0.4876305662451897,0.5123694337548104
E01001551,1733,792,941,0.4570109636468552,0.5429890363531449
E01001445,2284,1088,1196,0.4763572679509632,0.5236427320490368
E01001447,1936,921,1015,0.4757231404958678,0.5242768595041323
E01001448,1831,888,943,0.4849808847624249,0.515019115237575
E01001449,1635,787,848,0.4813455657492355,0.5186544342507645
E01033148,1950,906,1044,0.4646153846153846,0.5353846153846153
E01033150,1656,738,918,0.44565217391304346,0.5543478260869565
E01001408,1646,759,887,0.46111786148238154,0.5388821385176185
E01001411,1840,856,984,0.4652173913043478,0.5347826086956522
E01001412,1834,900,934,0.49073064340239914,0.5092693565976009
E01001413,1632,782,850,0.4791666666666667,0.5208333333333334
E01001414,1563,726,837,0.46449136276391556,0.5355086372360844
E01001407,1637,781,856,0.4770922419059255,0.5229077580940745
E01001409,1889,916,973,0.4849126521969296,0.5150873478030704
E01001410,1721,812,909,0.4718187100522952,0.5281812899477049
E01001516,1834,879,955,0.4792802617230098,0.5207197382769901
E01001537,1754,812,942,0.4629418472063854,0.5370581527936146
E01001439,2075,965,1110,0.4650602409638554,0.5349397590361445
E01001441,1514,716,798,0.47291941875825627,0.5270805812417437
E01001517,1890,893,997,0.4724867724867725,0.5275132275132275
E01001549,1975,934,1041,0.4729113924050633,0.5270886075949367
E01001550,1661,737,924,0.44370860927152317,0.5562913907284768
E01001433,1827,842,985,0.4608648056923919,0.5391351943076081
E01001434,1572,783,789,0.49809160305343514,0.5019083969465649
E01001435,1480,708,772,0.4783783783783784,0.5216216216216216
E01001436,1886,911,975,0.48303287380699894,0.5169671261930011
E01001438,1659,778,881,0.4689572031344183,0.5310427968655816
E01001469,1645,818,827,0.4972644376899696,0.5027355623100304
E01001536,1717,835,882,0.48631333721607456,0.5136866627839255
E01001540,1763,849,914,0.4815655133295519,0.5184344866704481
E01001541,1504,735,769,0.4886968085106383,0.5113031914893617
E01001542,1571,743,828,0.47294716740929343,0.5270528325907066
E01001538,1660,799,861,0.48132530120481926,0.5186746987951807
E01001539,1668,783,885,0.4694244604316547,0.5305755395683454
E01001543,1672,837,835,0.5005980861244019,0.49940191387559807
E01001544,1597,785,812,0.4915466499686913,0.5084533500313086
E01001457,1633,793,840,0.4856093080220453,0.5143906919779547
E01001468,1339,712,627,0.5317401045556386,0.4682598954443615
E01001471,1737,846,891,0.48704663212435234,0.5129533678756477
E01001472,1682,782,900,0.464922711058264,0.535077288941736
E01001474,1767,878,889,0.4968873797396718,0.5031126202603282
E01001415,1541,735,806,0.47696301103179756,0.5230369889682025
E01001417,1974,921,1053,0.46656534954407297,0.5334346504559271
E01001418,1650,809,841,0.4903030303030303,0.5096969696969696
E01001422,1658,828,830,0.49939686369119424,0.5006031363088058
E01001440,1641,794,847,0.4838513101767215,0.5161486898232784
E01001504,1549,751,798,0.48482892188508714,0.5151710781149128
E01001505,1727,845,882,0.48928778228141284,0.5107122177185871
E01001507,1870,927,943,0.49572192513368984,0.5042780748663102
E01001508,1933,925,1008,0.4785307811691671,0.5214692188308329
E01001513,1770,848,922,0.47909604519774013,0.5209039548022599
E01001416,1733,843,890,0.4864396999422966,0.5135603000577034
E01001470,1598,745,853,0.4662077596996245,0.5337922403003754
E01001473,1534,738,796,0.4810951760104302,0.5189048239895697
E01001475,1704,819,885,0.48063380281690143,0.5193661971830986
E01001437,2373,1133,1240,0.47745469869363677,0.5225453013063632
E01001506,1635,776,859,0.4746177370030581,0.5253822629969419
E01001509,1738,838,900,0.48216340621403914,0.5178365937859609
E01001510,1496,725,771,0.48462566844919786,0.5153743315508021
E01001405,1691,839,852,0.4961561206386753,0.5038438793613247
E01001406,1629,768,861,0.4714548802946593,0.5285451197053407
E01001450,1878,949,929,0.5053248136315229,0.4946751863684771
E01001512,1780,869,911,0.48820224719101124,0.5117977528089888
E01001515,1946,949,997,0.48766700924974304,0.512332990750257
E01001401,1323,633,690,0.47845804988662133,0.5215419501133787
E01001478,1538,765,773,0.49739921976592977,0.5026007802340702
E01001484,1371,661,710,0.48212983223924144,0.5178701677607586
E01001511,1751,815,936,0.46544831524842945,0.5345516847515706
E01001514,1768,849,919,0.4802036199095023,0.5197963800904978
E01001518,1767,854,913,0.4833050367855122,0.5166949632144878
E01001451,1641,837,804,0.5100548446069469,0.489945155393053
E01001452,1356,685,671,0.5051622418879056,0.4948377581120944
E01001453,1677,832,845,0.49612403100775193,0.5038759689922481
E01001454,1633,792,841,0.484996938150643,0.515003061849357
E01001476,1666,800,866,0.4801920768307323,0.5198079231692677
E01001477,1850,884,966,0.47783783783783784,0.5221621621621622
E01001481,1647,780,867,0.47358834244080145,0.5264116575591985
E01001502,1872,900,972,0.4807692307692308,0.5192307692307693
E01001503,1844,876,968,0.4750542299349241,0.5249457700650759
E01001520,1680,804,876,0.4785714285714286,0.5214285714285715
E01001522,1805,863,942,0.4781163434903047,0.5218836565096953
E01001523,1739,854,885,0.49108683151236343,0.5089131684876366
E01001524,1531,707,824,0.46178967994774656,0.5382103200522534
E01001526,1619,780,839,0.4817788758492897,0.5182211241507103
E01001419,1946,897,1049,0.46094552929085303,0.5390544707091469
E01001420,1570,735,835,0.4681528662420382,0.5318471337579618
E01001421,1716,788,928,0.4592074592074592,0.5407925407925408
E01001519,2496,1240,1256,0.4967948717948718,0.5032051282051282
E01001525,1807,851,956,0.47094631986718316,0.5290536801328168
E01001398,1392,686,706,0.492816091954023,0.507183908045977
E01001399,1437,713,724,0.49617258176757134,0.5038274182324287
E01001400,1543,718,825,0.46532728451069344,0.5346727154893065
E01001402,1833,904,929,0.49318057828696127,0.5068194217130387
E01001403,1602,773,829,0.48252184769038703,0.517478152309613
E01001455,1491,738,753,0.4949698189134809,0.5050301810865191
E01001456,1400,719,681,0.5135714285714286,0.48642857142857143
E01001564,1666,794,872,0.4765906362545018,0.5234093637454982
E01001567,1583,782,801,0.4939987365761213,0.5060012634238787
E01001568,1583,802,781,0.5066329753632344,0.4933670246367656
E01001569,1744,881,863,0.5051605504587156,0.4948394495412844
E01001479,1730,854,876,0.4936416184971098,0.5063583815028901
E01001482,1854,915,939,0.4935275080906149,0.5064724919093851
E01001487,1949,909,1040,0.4663930220625962,0.5336069779374037
E01001489,1803,880,923,0.48807542983915697,0.511924570160843
E01001491,1976,936,1040,0.47368421052631576,0.5263157894736842
E01001459,1675,820,855,0.48955223880597015,0.5104477611940299
E01001460,1711,823,888,0.4810052600818235,0.5189947399181765
E01001462,1339,639,700,0.4772218073188947,0.5227781926811053
E01001480,1549,752,797,0.4854744996772111,0.5145255003227889
E01001488,1883,899,984,0.4774296335634626,0.5225703664365374
E01001483,1150,577,573,0.5017391304347826,0.49826086956521737
E01001485,1815,854,961,0.47052341597796143,0.5294765840220386
E01001486,2106,974,1132,0.4624881291547958,0.5375118708452041
E01001492,1930,898,1032,0.46528497409326425,0.5347150259067357
E01033146,1586,776,810,0.489281210592686,0.510718789407314
E01033151,1483,708,775,0.47741065407956845,0.5225893459204316
E01001404,1473,715,758,0.48540393754243044,0.5145960624575696
E01001493,1773,883,890,0.49802594472645234,0.5019740552735477
E01001494,1520,725,795,0.4769736842105263,0.5230263157894737
E01001496,1705,794,911,0.4656891495601173,0.5343108504398827
E01001570,1855,914,941,0.492722371967655,0.507277628032345
E01001423,1805,854,951,0.4731301939058172,0.5268698060941829
E01001425,1862,873,989,0.46885069817400643,0.5311493018259935
E01001428,1677,808,869,0.48181276088252833,0.5181872391174717
E01001461,1716,789,927,0.4597902097902098,0.5402097902097902
E01001464,1330,643,687,0.48345864661654137,0.5165413533834586
E01001521,1777,834,943,0.46933033202025887,0.5306696679797411
E01001531,1498,752,746,0.5020026702269693,0.4979973297730307
E01001532,1764,873,891,0.49489795918367346,0.5051020408163265
E01001533,1568,747,821,0.4764030612244898,0.5235969387755102
E01001535,1482,730,752,0.4925775978407557,0.5074224021592443
E01001495,1715,868,847,0.5061224489795918,0.49387755102040815
E01001498,1946,979,967,0.5030832476875642,0.49691675231243576
E01001563,1615,816,799,0.5052631578947369,0.49473684210526314
E01001565,1636,783,853,0.4786063569682152,0.5213936430317848
E01001566,1721,864,857,0.5020337013364323,0.4979662986635677
E01001424,1210,564,646,0.46611570247933887,0.5338842975206611
E01001426,1821,878,943,0.48215266337177376,0.5178473366282262
E01001427,1840,880,960,0.4782608695652174,0.5217391304347826
E01001429,2394,1111,1283,0.4640768588137009,0.5359231411862991
E01001430,1884,854,1030,0.45329087048832273,0.5467091295116773
E01001463,1573,769,804,0.4888747616020343,0.5111252383979656
E01001465,1505,733,772,0.4870431893687708,0.5129568106312292
E01001466,1795,830,965,0.4623955431754875,0.5376044568245125
E01001467,1874,936,938,0.4994663820704376,0.5005336179295624
E01001497,1476,706,770,0.47831978319783197,0.521680216802168
E01001499,1650,800,850,0.48484848484848486,0.5151515151515151
E01001392,1824,921,903,0.5049342105263158,0.49506578947368424
E01001528,1445,673,772,0.4657439446366782,0.5342560553633218
E01001529,1546,808,738,0.5226390685640362,0.47736093143596375
E01001530,1290,658,632,0.5100775193798449,0.48992248062015503
E01001534,1631,821,810,0.5033721643163703,0.49662783568362967
E01001431,1549,764,785,0.4932214331826985,0.5067785668173015
E01001432,1907,949,958,0.4976402726796015,0.5023597273203986
E01001555,1783,889,894,0.498597868760516,0.501402131239484
E01001557,1586,777,809,0.48991172761664564,0.5100882723833543
E01001558,1613,780,833,0.48357098574085555,0.5164290142591444
E01001559,2051,967,1084,0.4714773281326182,0.5285226718673818
E01001394,1653,802,851,0.485178463399879,0.514821536600121
E01001395,1590,727,863,0.45723270440251573,0.5427672955974843
E01001397,1924,975,949,0.5067567567567568,0.49324324324324326
E01001500,1527,749,778,0.4905042567125082,0.5094957432874918
E01001556,1579,758,821,0.48005066497783405,0.5199493350221659
E01001560,1599,766,833,0.4790494058786742,0.5209505941213258
E01001390,1971,1016,955,0.5154743784880771,0.48452562151192285
E01001391,1564,801,763,0.5121483375959079,0.48785166240409206
E01001393,2112,1068,1044,0.5056818181818182,0.4943181818181818
E01001396,1413,680,733,0.48124557678697805,0.5187544232130219
E01001501,1850,897,953,0.48486486486486485,0.5151351351351351
E01001527,1563,797,766,0.5099168266154831,0.49008317338451696
E01001458,1745,836,909,0.47908309455587395,0.520916905444126
E01001553,1597,761,836,0.4765184721352536,0.5234815278647464
E01001554,1791,817,974,0.45616973757677276,0.5438302624232273
E01001562,1716,783,933,0.4562937062937063,0.5437062937062938
E01032574,2059,950,1109,0.46138902379796015,0.5386109762020398
E01001690,1932,960,972,0.4968944099378882,0.5031055900621118
E01001692,1391,697,694,0.501078360891445,0.49892163910855497
E01001693,1558,790,768,0.5070603337612324,0.49293966623876767
E01001694,1685,843,842,0.5002967359050445,0.49970326409495547
E01001687,1206,587,619,0.4867330016583748,0.5132669983416253
E01001688,2623,1231,1392,0.46930995043842927,0.5306900495615707
E01033739,1443,712,731,0.4934164934164934,0.5065835065835066
E01033740,1577,776,801,0.4920735573874445,0.5079264426125555
E01033741,2457,1594,863,0.6487586487586487,0.35124135124135125
E01033743,2038,969,1069,0.47546614327772324,0.5245338567222767
E01033745,1820,876,944,0.48131868131868133,0.5186813186813187
E01001575,1707,794,913,0.4651435266549502,0.5348564733450498
E01001576,1739,830,909,0.4772857964347326,0.5227142035652674
E01001577,1857,880,977,0.47388260635433493,0.526117393645665
E01001578,2131,1053,1078,0.4941342092914125,0.5058657907085875
E01001579,1646,774,872,0.47023086269744835,0.5297691373025516
E01001709,1170,578,592,0.49401709401709404,0.505982905982906
E01001711,1413,738,675,0.5222929936305732,0.47770700636942676
E01001712,2137,1086,1051,0.5081890500701919,0.4918109499298081
E01033731,1017,508,509,0.4995083579154376,0.5004916420845624
E01033734,1320,660,660,0.5,0.5
E01033735,1073,586,487,0.5461323392357875,0.4538676607642125
E01033736,1125,627,498,0.5573333333333333,0.44266666666666665
E01033737,1495,776,719,0.5190635451505017,0.4809364548494983
E01001705,1993,1019,974,0.5112895132965379,0.4887104867034621
E01001706,1340,663,677,0.49477611940298505,0.505223880597015
E01001708,1595,783,812,0.4909090909090909,0.509090909090909
E01001710,1694,822,872,0.4852420306965762,0.5147579693034239
E01001713,1748,847,901,0.4845537757437071,0.5154462242562929
E01001672,2049,1083,966,0.5285505124450952,0.47144948755490484
E01001673,1892,988,904,0.5221987315010571,0.47780126849894294
E01001674,1973,989,984,0.5012671059300557,0.49873289406994425
E01001675,1980,1021,959,0.5156565656565657,0.48434343434343435
E01001677,1948,977,971,0.5015400410677618,0.4984599589322382
E01001631,2072,1042,1030,0.502895752895753,0.4971042471042471
E01001632,2319,1157,1162,0.4989219491159983,0.5010780508840017
E01001635,1661,873,788,0.5255869957856713,0.4744130042143287
E01001636,1722,961,761,0.5580720092915215,0.4419279907084785
E01033742,1352,726,626,0.5369822485207101,0.4630177514792899
E01033744,1845,909,936,0.4926829268292683,0.5073170731707317
E01001571,1639,775,864,0.47284929835265405,0.5271507016473459
E01001572,1711,810,901,0.4734073641145529,0.5265926358854471
E01001573,1505,762,743,0.506312292358804,0.493687707641196
E01001574,1769,860,909,0.4861503674392312,0.5138496325607688
E01001629,2176,1061,1115,0.4875919117647059,0.5124080882352942
E01001633,1607,827,780,0.5146235220908525,0.48537647790914745
E01001634,1714,792,922,0.4620770128354726,0.5379229871645275
E01001637,1703,855,848,0.5020551967116853,0.49794480328831475
E01001695,1626,857,769,0.527060270602706,0.47293972939729395
E01001696,1350,670,680,0.4962962962962963,0.5037037037037037
E01001697,2094,1072,1022,0.5119388729703916,0.4880611270296084
E01001700,2019,1031,988,0.5106488360574541,0.4893511639425458
E01001703,1934,970,964,0.5015511892450879,0.4984488107549121
E01001704,1651,854,797,0.5172622652937614,0.48273773470623865
E01001588,1692,797,895,0.4710401891252955,0.5289598108747045
E01001589,1604,826,778,0.5149625935162094,0.4850374064837905
E01001591,2040,973,1067,0.4769607843137255,0.5230392156862745
E01001595,1979,927,1052,0.46841839312784234,0.5315816068721576
E01001590,1777,883,894,0.49690489589195275,0.5030951041080473
E01001592,1718,821,897,0.4778812572759022,0.5221187427240978
E01001593,1638,792,846,0.4835164835164835,0.5164835164835165
E01001594,1937,913,1024,0.47134744450180693,0.5286525554981931
E01001698,1777,896,881,0.5042205965109735,0.49577940348902644
E01001699,1848,1111,737,0.6011904761904762,0.39880952380952384
E01001701,1524,766,758,0.5026246719160105,0.4973753280839895
E01001702,1676,766,910,0.45704057279236276,0.5429594272076372
E01001581,1693,816,877,0.4819846426461902,0.5180153573538098
E01001585,1532,765,767,0.4993472584856397,0.5006527415143603
E01001586,1491,694,797,0.46545942320590206,0.5345405767940979
E01001587,1890,957,933,0.5063492063492063,0.4936507936507937
E01001678,1667,839,828,0.5032993401319736,0.4967006598680264
E01001683,1519,788,731,0.5187623436471362,0.48123765635286375
E01001684,1472,703,769,0.47758152173913043,0.5224184782608695
E01001685,1522,772,750,0.507227332457293,0.492772667542707
E01001646,2829,1351,1478,0.47755390597384234,0.5224460940261576
E01001650,1733,853,880,0.49221004039238314,0.5077899596076169
E01001651,1714,852,862,0.4970828471411902,0.5029171528588098
E01001652,1555,749,806,0.4816720257234727,0.5183279742765273
E01001679,1346,653,693,0.4851411589895988,0.5148588410104011
E01001680,1573,798,775,0.5073108709472346,0.4926891290527654
E01001681,1224,614,610,0.5016339869281046,0.49836601307189543
E01001682,1333,657,676,0.49287321830457614,0.5071267816954238
E01001686,1777,882,895,0.49634214969048956,0.5036578503095104
E01001580,1642,833,809,0.5073081607795371,0.49269183922046283
E01001582,1475,695,780,0.4711864406779661,0.5288135593220339
E01001583,1603,812,791,0.5065502183406113,0.49344978165938863
E01001584,1549,747,802,0.48224661071659136,0.5177533892834086
E01001645,1697,821,876,0.48379493223335296,0.516205067766647
E01001647,1491,742,749,0.49765258215962443,0.5023474178403756
E01001648,1751,878,873,0.5014277555682467,0.4985722444317533
E01001649,1530,738,792,0.4823529411764706,0.5176470588235295
E01001605,1584,772,812,0.48737373737373735,0.5126262626262627
E01001606,1637,813,824,0.49664019547953575,0.5033598045204642
E01001610,1669,815,854,0.48831635710005994,0.5116836428999401
E01001611,1659,829,830,0.49969861362266427,0.5003013863773358
E01001620,1591,783,808,0.49214330609679446,0.5078566939032055
E01001621,1491,719,772,0.48222669349429914,0.5177733065057009
E01001623,1696,837,859,0.49351415094339623,0.5064858490566038
E01001624,1551,724,827,0.46679561573178596,0.533204384268214
E01001625,1577,758,819,0.4806594800253646,0.5193405199746354
E01001604,1440,736,704,0.5111111111111111,0.4888888888888889
E01001607,1474,671,803,0.4552238805970149,0.5447761194029851
E01001608,1454,721,733,0.4958734525447043,0.5041265474552957
E01001609,1602,798,804,0.49812734082397003,0.50187265917603
E01001613,1586,762,824,0.48045397225725095,0.519546027742749
E01001614,1409,683,726,0.48474095102909864,0.5152590489709014
E01001615,1519,783,736,0.5154707044107966,0.48452929558920343
E01001617,1574,749,825,0.4758576874205845,0.5241423125794155
E01001653,1547,731,816,0.4725274725274725,0.5274725274725275
E01001654,1546,711,835,0.45989650711513586,0.5401034928848641
E01001655,1465,723,742,0.49351535836177474,0.5064846416382253
E01001660,1600,763,837,0.476875,0.523125
E01001661,1525,728,797,0.47737704918032786,0.5226229508196721
E01001618,1604,789,815,0.4918952618453865,0.5081047381546134
E01001619,1880,925,955,0.4920212765957447,0.5079787234042553
E01033729,2969,1306,1663,0.43987874705287977,0.5601212529471202
E01001597,1560,797,763,0.5108974358974359,0.4891025641025641
E01001598,1587,817,770,0.5148078134845621,0.48519218651543794
E01001602,1873,874,999,0.46663107314468766,0.5333689268553123
E01001603,1655,784,871,0.47371601208459213,0.5262839879154079
E01001596,1564,772,792,0.4936061381074169,0.5063938618925832
E01001599,1701,830,871,0.4879482657260435,0.5120517342739564
E01001600,1561,799,762,0.5118513773222293,0.48814862267777065
E01001601,1561,749,812,0.4798206278026906,0.5201793721973094
E01001669,1874,928,946,0.4951974386339381,0.5048025613660619
E01001671,1578,767,811,0.48605830164765523,0.5139416983523447
E01001676,1791,924,867,0.5159128978224455,0.48408710217755446
E01032567,1651,826,825,0.5003028467595396,0.4996971532404603
E01001656,1272,623,649,0.48977987421383645,0.5102201257861635
E01001657,1547,755,792,0.48804137039431156,0.5119586296056884
E01001658,1549,732,817,0.4725629438347321,0.5274370561652679
E01001659,1454,739,715,0.5082530949105915,0.49174690508940855
E01033726,2493,1216,1277,0.4877657440834336,0.5122342559165664
E01001640,2334,1099,1235,0.4708654670094259,0.5291345329905741
E01033727,2567,1250,1317,0.4869497467861317,0.5130502532138683
E01033728,1226,647,579,0.5277324632952691,0.4722675367047308
E01033730,1214,636,578,0.5238879736408567,0.47611202635914335
E01001666,1470,750,720,0.5102040816326531,0.4897959183673469
E01001667,1564,746,818,0.47698209718670076,0.5230179028132992
E01001668,2269,1091,1178,0.48082855883649184,0.5191714411635081
E01033732,1053,535,518,0.5080721747388414,0.4919278252611586
E01033733,1134,576,558,0.5079365079365079,0.49206349206349204
E01001662,1608,800,808,0.4975124378109453,0.5024875621890548
E01001664,1870,946,924,0.5058823529411764,0.49411764705882355
E01001665,1867,941,926,0.5040171397964649,0.4959828602035351
E01033738,1216,628,588,0.5164473684210527,0.48355263157894735
E01001638,1974,953,1021,0.4827760891590679,0.5172239108409321
E01001641,1755,853,902,0.486039886039886,0.513960113960114
E01001642,1781,873,908,0.4901740595171252,0.5098259404828748
E01001644,2212,1182,1030,0.5343580470162749,0.4656419529837251
E01033746,1464,696,768,0.47540983606557374,0.5245901639344263
E01002112,1890,895,995,0.47354497354497355,0.5264550264550265
E01002114,1993,884,1109,0.4435524335173106,0.5564475664826894
E01002225,1575,716,859,0.4546031746031746,0.5453968253968254
E01002226,2228,1035,1193,0.46454219030520644,0.5354578096947935
E01002113,1547,735,812,0.4751131221719457,0.5248868778280543
E01002115,1509,730,779,0.48376408217362493,0.5162359178263751
E01002116,1668,809,859,0.48501199040767384,0.5149880095923262
E01002117,2105,1017,1088,0.4831353919239905,0.5168646080760095
E01002118,1759,879,880,0.49971574758385445,0.5002842524161455
E01002227,1809,890,919,0.4919845218352681,0.5080154781647319
E01002228,2105,1010,1095,0.47980997624703087,0.5201900237529691
E01002229,1717,797,920,0.46418171228887595,0.535818287711124
E01002230,1795,897,898,0.49972144846796657,0.5002785515320334
E01002144,1571,775,796,0.49331635900700194,0.5066836409929981
E01002146,1481,717,764,0.4841323430114787,0.5158676569885212
E01002147,1369,651,718,0.47552958363769177,0.5244704163623083
E01002149,1361,669,692,0.49155033063923587,0.5084496693607642
E01002140,1706,847,859,0.49648300117233296,0.5035169988276671
E01002141,1763,840,923,0.476460578559274,0.5235394214407261
E01002142,1779,844,935,0.4744238336143901,0.5255761663856099
E01002143,1571,763,808,0.4856779121578612,0.5143220878421387
E01002145,1558,731,827,0.469191270860077,0.5308087291399229
E01002139,1428,660,768,0.46218487394957986,0.5378151260504201
E01002148,1449,710,739,0.48999309868875085,0.5100069013112492
E01002150,1883,883,1000,0.4689325544344132,0.5310674455655868
E01002151,1526,719,807,0.4711664482306684,0.5288335517693316
E01002152,1624,761,863,0.4685960591133005,0.5314039408866995
E01002119,1708,838,870,0.49063231850117095,0.509367681498829
E01002120,1296,622,674,0.4799382716049383,0.5200617283950617
E01002121,1761,862,899,0.4894946053378762,0.5105053946621237
E01002122,1706,877,829,0.5140679953106683,0.4859320046893318
E01002123,1735,878,857,0.5060518731988473,0.49394812680115274
E01002106,2027,1000,1027,0.493339911198816,0.506660088801184
E01002108,1819,883,936,0.48543155579989006,0.5145684442001099
E01002109,1789,896,893,0.5008384572386808,0.4991615427613192
E01002110,1762,873,889,0.49545970488081725,0.5045402951191827
E01002111,2172,1092,1080,0.5027624309392266,0.4972375690607735
E01002185,1543,720,823,0.4666234607906675,0.5333765392093325
E01002186,1656,785,871,0.47403381642512077,0.5259661835748792
E01002187,1843,862,981,0.46771568095496474,0.5322843190450353
E01002190,1672,826,846,0.49401913875598086,0.5059808612440191
E01002124,1769,837,932,0.47314867156585644,0.5268513284341436
E01002125,1678,882,796,0.5256257449344458,0.47437425506555425
E01002198,1820,929,891,0.5104395604395604,0.48956043956043954
E01002200,1688,865,823,0.5124407582938388,0.48755924170616116
E01002203,1751,867,884,0.49514563106796117,0.5048543689320388
E01002232,1973,978,995,0.49569183983781046,0.5043081601621896
E01002233,2031,992,1039,0.48842934515017233,0.5115706548498277
E01002234,1741,871,870,0.5002871912693854,0.4997128087306146
E01002235,1922,908,1014,0.4724245577523413,0.5275754422476587
E01002236,1803,901,902,0.4997226844148641,0.5002773155851359
E01002107,1774,865,909,0.48759864712514095,0.5124013528748591
E01002197,1394,682,712,0.48923959827833574,0.5107604017216643
E01002199,1533,761,772,0.4964122635355512,0.5035877364644488
E01002201,1742,848,894,0.48679678530424797,0.513203214695752
E01002202,2056,1028,1028,0.5,0.5
E01002179,2250,1165,1085,0.5177777777777778,0.4822222222222222
E01002180,2085,1052,1033,0.5045563549160671,0.49544364508393285
E01002183,2106,1053,1053,0.5,0.5
E01002184,1885,945,940,0.5013262599469496,0.4986737400530504
E01002231,1924,974,950,0.5062370062370062,0.49376299376299376
E01002154,2021,999,1022,0.4943097476496784,0.5056902523503216
E01002156,1522,745,777,0.4894875164257556,0.5105124835742444
E01002162,1879,930,949,0.494944119212347,0.505055880787653
E01002163,1636,782,854,0.4779951100244499,0.5220048899755502
E01002188,1651,790,861,0.47849788007268323,0.5215021199273168
E01002189,1661,805,856,0.48464780252859724,0.5153521974714028
E01002192,1532,735,797,0.47976501305483027,0.5202349869451697
E01002193,1797,841,956,0.46800222593210905,0.531997774067891
E01002165,1734,903,831,0.5207612456747405,0.47923875432525953
E01002166,1663,857,806,0.5153337342152736,0.4846662657847264
E01002167,1629,807,822,0.4953959484346225,0.5046040515653776
E01002168,1492,700,792,0.4691689008042895,0.5308310991957105
E01002169,1619,805,814,0.4972205064854849,0.5027794935145151
E01002153,1763,857,906,0.48610323312535453,0.5138967668746455
E01002155,1643,813,830,0.49482653682288497,0.505173463177115
E01002157,1687,826,861,0.4896265560165975,0.5103734439834025
E01002158,1457,717,740,0.4921070693205216,0.5078929306794784
E01002128,2025,1005,1020,0.4962962962962963,0.5037037037037037
E01002130,2260,1170,1090,0.5176991150442478,0.4823008849557522
E01002181,1884,985,899,0.522823779193206,0.47717622080679406
E01002182,2049,1102,947,0.5378233284529038,0.46217667154709613
E01002159,1860,930,930,0.5,0.5
E01002160,1967,1004,963,0.5104219623792577,0.48957803762074226
E01002161,2030,980,1050,0.4827586206896552,0.5172413793103449
E01002164,1763,868,895,0.4923425978445831,0.5076574021554169
E01002191,1964,955,1009,0.4862525458248472,0.5137474541751528
E01002194,1724,832,892,0.48259860788863107,0.5174013921113689
E01002195,1635,799,836,0.4886850152905199,0.5113149847094801
E01002196,1759,870,889,0.49459920409323477,0.5054007959067652
E01002126,2781,1406,1375,0.5055735346997483,0.4944264653002517
E01002127,1687,782,905,0.46354475400118555,0.5364552459988144
E01002129,2043,1066,977,0.521781693587861,0.478218306412139
E01002131,1624,814,810,0.5012315270935961,0.4987684729064039
E01002237,1626,809,817,0.497539975399754,0.502460024600246
E01002238,1804,904,900,0.5011086474501109,0.49889135254988914
E01002240,1739,830,909,0.4772857964347326,0.5227142035652674
E01002242,1890,940,950,0.4973544973544973,0.5026455026455027
E01002208,1357,679,678,0.5003684598378777,0.49963154016212236
E01002209,1643,838,805,0.5100426049908704,0.48995739500912966
E01002239,1678,796,882,0.47437425506555425,0.5256257449344458
E01002241,1636,833,803,0.5091687041564792,0.4908312958435208
E01002133,2031,993,1038,0.48892171344165436,0.5110782865583456
E01002136,1741,879,862,0.504882251579552,0.49511774842044803
E01002138,1551,779,772,0.5022566086395873,0.4977433913604126
E01002213,2912,1428,1484,0.49038461538461536,0.5096153846153846
E01002211,1544,764,780,0.4948186528497409,0.5051813471502591
E01002212,1749,864,885,0.4939965694682676,0.5060034305317325
E01002216,1699,876,823,0.5155974102413184,0.48440258975868156
E01002217,1526,696,830,0.45609436435124506,0.5439056356487549
E01002132,2012,990,1022,0.49204771371769385,0.5079522862823062
E01002134,1462,759,703,0.5191518467852257,0.48084815321477425
E01002135,1765,867,898,0.4912181303116147,0.5087818696883852
E01002137,1708,1208,500,0.7072599531615925,0.2927400468384075
E01002218,1647,813,834,0.4936247723132969,0.5063752276867031
E01002219,1813,912,901,0.5030336458907887,0.49696635410921125
E01002221,1564,800,764,0.5115089514066496,0.4884910485933504
E01002222,1608,795,813,0.4944029850746269,0.5055970149253731
E01002214,1863,937,926,0.5029522275899088,0.49704777241009124
E01002215,1535,713,822,0.46449511400651466,0.5355048859934853
E01002220,1628,840,788,0.515970515970516,0.48402948402948404
E01002223,1873,926,947,0.49439402028830753,0.5056059797116925
E01002224,1530,745,785,0.4869281045751634,0.5130718954248366
E01002204,1736,873,863,0.5028801843317973,0.4971198156682028
E01002206,1387,708,679,0.5104542177361211,0.48954578226387885
E01002207,1730,873,857,0.5046242774566474,0.4953757225433526
E01002210,1604,778,826,0.4850374064837905,0.5149625935162094
E01032576,1667,808,859,0.48470305938812236,0.5152969406118776
E01002170,1324,634,690,0.4788519637462236,0.5211480362537765
E01002171,1677,826,851,0.49254621347644606,0.507453786523554
E01002172,1579,780,799,0.49398353388220395,0.506016466117796
E01002173,1742,865,877,0.4965556831228473,0.5034443168771527
E01002174,1582,788,794,0.49810366624525915,0.5018963337547409
E01002175,1402,717,685,0.5114122681883024,0.48858773181169757
E01002176,1746,839,907,0.4805269186712486,0.5194730813287515
E01002177,1443,731,712,0.5065835065835066,0.4934164934164934
E01002178,1679,829,850,0.4937462775461584,0.5062537224538416
E01002276,1926,905,1021,0.4698857736240914,0.5301142263759087
E01002278,1599,770,829,0.4815509693558474,0.5184490306441526
E01002312,1400,661,739,0.47214285714285714,0.5278571428571428
E01002313,1526,735,791,0.481651376146789,0.518348623853211
E01002277,1494,746,748,0.499330655957162,0.500669344042838
E01002279,1584,737,847,0.4652777777777778,0.5347222222222222
E01002281,1614,790,824,0.48946716232961585,0.5105328376703842
E01002283,1517,750,767,0.4943968358602505,0.5056031641397495
E01002299,1721,815,906,0.47356188262638,0.52643811737362
E01002301,1561,776,785,0.4971172325432415,0.5028827674567585
E01002303,2043,927,1116,0.45374449339207046,0.5462555066079295
E01002304,1414,669,745,0.47312588401697314,0.5268741159830269
E01002306,1596,727,869,0.45551378446115287,0.5444862155388471
E01002307,1673,806,867,0.48176927674835623,0.5182307232516438
E01002280,1522,720,802,0.4730617608409987,0.5269382391590013
E01002282,1594,776,818,0.4868255959849435,0.5131744040150564
E01002284,1842,862,980,0.46796959826275786,0.5320304017372421
E01002297,1484,772,712,0.5202156334231806,0.4797843665768194
E01002314,1656,750,906,0.4528985507246377,0.5471014492753623
E01002316,1545,720,825,0.46601941747572817,0.5339805825242718
E01002302,1563,711,852,0.45489443378119004,0.54510556621881
E01002305,1519,716,803,0.47136273864384465,0.5286372613561554
E01002308,1631,782,849,0.47946045370938073,0.5205395462906193
E01002326,1496,715,781,0.47794117647058826,0.5220588235294118
E01002331,1573,767,806,0.48760330578512395,0.512396694214876
E01002309,1539,755,784,0.49057829759584143,0.5094217024041585
E01002310,1677,756,921,0.45080500894454384,0.5491949910554562
E01002311,1690,802,888,0.47455621301775147,0.5254437869822485
E01002315,1537,723,814,0.4703968770331815,0.5296031229668184
E01002293,1591,790,801,0.4965430546825896,0.5034569453174105
E01002294,1492,732,760,0.4906166219839142,0.5093833780160858
E01002296,1673,825,848,0.4931261207411835,0.5068738792588166
E01002298,1538,745,793,0.48439531859557866,0.5156046814044213
E01002300,1593,750,843,0.4708097928436911,0.5291902071563088
E01002333,1320,625,695,0.4734848484848485,0.5265151515151515
E01002334,1663,804,859,0.4834636199639206,0.5165363800360794
E01002336,1492,709,783,0.47520107238605896,0.524798927613941
E01002339,1610,792,818,0.4919254658385093,0.5080745341614907
E01002341,1372,651,721,0.4744897959183674,0.5255102040816326
E01002327,1476,687,789,0.4654471544715447,0.5345528455284553
E01002328,1685,847,838,0.5026706231454006,0.4973293768545994
E01002332,1631,761,870,0.46658491722869405,0.5334150827713059
E01002335,1445,689,756,0.47681660899653977,0.5231833910034602
E01002338,1371,673,698,0.4908825674690007,0.5091174325309993
E01002340,1381,688,693,0.498189717595945,0.501810282404055
E01002268,1350,631,719,0.4674074074074074,0.5325925925925926
E01002269,1785,850,935,0.47619047619047616,0.5238095238095238
E01002295,1558,739,819,0.4743260590500642,0.5256739409499358
E01002377,1638,787,851,0.4804639804639805,0.5195360195360196
E01002378,1678,821,857,0.4892729439809297,0.5107270560190703
E01002383,1579,780,799,0.49398353388220395,0.506016466117796
E01002244,1697,824,873,0.48556275780789626,0.5144372421921037
E01002245,1592,744,848,0.46733668341708545,0.5326633165829145
E01002325,1709,748,961,0.4376828554710357,0.5623171445289643
E01002329,1615,777,838,0.48111455108359136,0.5188854489164086
E01002330,1730,868,862,0.5017341040462427,0.4982658959537572
E01002337,1301,629,672,0.48347425057647964,0.5165257494235204
E01002354,1372,662,710,0.48250728862973763,0.5174927113702624
E01002376,1442,722,720,0.5006934812760055,0.49930651872399445
E01002379,1466,706,760,0.4815825375170532,0.5184174624829468
E01002380,2076,1003,1073,0.48314065510597304,0.516859344894027
E01002381,1539,692,847,0.44964262508122155,0.5503573749187785
E01002243,1873,903,970,0.48211425520555257,0.5178857447944474
E01002353,2010,1010,1000,0.5024875621890548,0.4975124378109453
E01002356,2143,1034,1109,0.4825011665888941,0.5174988334111059
E01032741,1078,562,516,0.5213358070500927,0.47866419294990725
E01032742,1310,621,689,0.47404580152671755,0.5259541984732824
E01002272,1319,631,688,0.4783927217589083,0.5216072782410918
E01002274,1638,799,839,0.4877899877899878,0.5122100122100122
E01002317,1541,737,804,0.4782608695652174,0.5217391304347826
E01002318,1616,777,839,0.4808168316831683,0.5191831683168316
E01002355,1470,730,740,0.4965986394557823,0.5034013605442177
E01002382,1776,876,900,0.49324324324324326,0.5067567567567568
E01002270,1673,808,865,0.4829647340107591,0.5170352659892409
E01002271,1491,749,742,0.5023474178403756,0.49765258215962443
E01002273,1362,678,684,0.4977973568281938,0.5022026431718062
E01002275,1359,666,693,0.4900662251655629,0.5099337748344371
E01002319,1596,733,863,0.4592731829573935,0.5407268170426065
E01002350,1551,752,799,0.48484848484848486,0.5151515151515151
E01002351,1580,753,827,0.47658227848101264,0.5234177215189874
E01002352,1635,780,855,0.47706422018348627,0.5229357798165137
E01002358,1772,853,919,0.4813769751693002,0.5186230248306998
E01002246,1700,797,903,0.4688235294117647,0.5311764705882352
E01002247,1800,892,908,0.4955555555555556,0.5044444444444445
E01002248,1397,634,763,0.45382963493199713,0.5461703650680029
E01002249,1905,975,930,0.5118110236220472,0.4881889763779528
E01002250,1563,773,790,0.4945617402431222,0.5054382597568778
E01002251,1430,694,736,0.4853146853146853,0.5146853146853146
E01002252,1511,725,786,0.4798146922567836,0.5201853077432164
E01002256,1498,699,799,0.4666221628838451,0.5333778371161548
E01002258,1676,750,926,0.44749403341288785,0.5525059665871122
E01002259,1486,692,794,0.46567967698519513,0.5343203230148048
E01002391,1622,771,851,0.4753390875462392,0.5246609124537608
E01002253,1539,752,787,0.48862897985705,0.51137102014295
E01002254,1616,797,819,0.4931930693069307,0.5068069306930693
E01002257,1719,824,895,0.47934845840605,0.52065154159395
E01002384,1522,754,768,0.49540078843626806,0.5045992115637319
E01002359,1322,644,678,0.48714069591527986,0.5128593040847201
E01002360,1429,646,783,0.45206438068579424,0.5479356193142058
E01002361,1700,802,898,0.4717647058823529,0.528235294117647
E01002363,1590,762,828,0.47924528301886793,0.5207547169811321
E01002367,1573,752,821,0.4780673871582963,0.5219326128417038
E01002320,1480,698,782,0.47162162162162163,0.5283783783783784
E01002321,1642,817,825,0.49756394640682094,0.502436053593179
E01002322,1940,994,946,0.5123711340206185,0.48762886597938143
E01002323,1682,845,837,0.5023781212841855,0.4976218787158145
E01002324,1455,687,768,0.47216494845360824,0.5278350515463918
E01002255,1483,686,797,0.46257585974376264,0.5374241402562373
E01002289,1614,773,841,0.47893432465923175,0.5210656753407683
E01002292,1549,715,834,0.4615881213686249,0.5384118786313751
E01002362,1494,715,779,0.4785809906291834,0.5214190093708166
E01002386,1846,903,943,0.4891657638136511,0.5108342361863488
E01002287,1558,760,798,0.4878048780487805,0.5121951219512195
E01002291,1582,785,797,0.49620733249051835,0.5037926675094817
E01002364,1446,684,762,0.4730290456431535,0.5269709543568465
E01002365,1316,656,660,0.49848024316109424,0.5015197568389058
E01002366,1464,695,769,0.47472677595628415,0.5252732240437158
E01002385,1596,788,808,0.49373433583959897,0.506265664160401
E01002387,1605,764,841,0.47601246105919004,0.52398753894081
E01002388,1658,782,876,0.47165259348612787,0.5283474065138721
E01002389,1535,732,803,0.47687296416938113,0.5231270358306189
E01002390,1449,705,744,0.4865424430641822,0.5134575569358178
E01002265,1472,693,779,0.47078804347826086,0.5292119565217391
E01002285,1245,624,621,0.5012048192771085,0.4987951807228916
E01002286,1650,790,860,0.47878787878787876,0.5212121212121212
E01002288,1548,766,782,0.49483204134366926,0.5051679586563308
E01002290,1516,728,788,0.48021108179419525,0.5197889182058048
E01002260,1535,765,770,0.498371335504886,0.501628664495114
E01002261,1649,799,850,0.4845360824742268,0.5154639175257731
E01002262,1626,772,854,0.4747847478474785,0.5252152521525215
E01002263,1599,798,801,0.49906191369606,0.50093808630394
E01002264,1475,658,817,0.44610169491525425,0.5538983050847458
E01002266,1439,686,753,0.47671994440583737,0.5232800555941626
E01002267,1671,766,905,0.45840813883901854,0.5415918611609815
E01002372,1611,775,836,0.48106765983860955,0.5189323401613904
E01002373,1581,768,813,0.4857685009487666,0.5142314990512334
E01002374,1526,733,793,0.4803407601572739,0.5196592398427261
E01002368,1594,839,755,0.526348808030113,0.4736511919698871
E01002369,1891,923,968,0.4881015335801163,0.5118984664198837
E01002370,1973,1003,970,0.508362899138368,0.49163710086163204
E01002371,1627,823,804,0.505838967424708,0.4941610325752919
E01002375,1741,818,923,0.4698449167145319,0.5301550832854681
E01002343,1705,833,872,0.48856304985337246,0.5114369501466276
E01002344,1528,739,789,0.4836387434554974,0.5163612565445026
E01002348,1531,755,776,0.4931417374265186,0.5068582625734814
E01002349,1508,749,759,0.496684350132626,0.503315649867374
E01002342,1588,787,801,0.49559193954659947,0.5044080604534005
E01002345,1679,771,908,0.4592019058963669,0.5407980941036331
E01002346,1503,692,811,0.46041250831669994,0.5395874916833001
E01002347,1440,693,747,0.48125,0.51875
E01002473,1547,746,801,0.48222365869424694,0.5177763413057531
E01002475,1497,680,817,0.45424181696726784,0.5457581830327322
E01002476,1576,781,795,0.49555837563451777,0.5044416243654822
E01002477,1252,583,669,0.46565495207667734,0.5343450479233227
E01002482,1607,769,838,0.47853142501555695,0.5214685749844431
E01002472,1571,747,824,0.475493316359007,0.524506683640993
E01002474,1507,693,814,0.45985401459854014,0.5401459854014599
E01002478,1519,745,774,0.49045424621461486,0.5095457537853851
E01002483,1739,820,919,0.4715353651523864,0.5284646348476135
E01002484,1424,693,731,0.4866573033707865,0.5133426966292135
E01002485,1713,816,897,0.4763572679509632,0.5236427320490368
E01002438,1325,641,684,0.48377358490566036,0.5162264150943396
E01002439,1571,761,810,0.48440483768300446,0.5155951623169955
E01002440,1441,698,743,0.48438584316446914,0.5156141568355309
E01002441,1550,736,814,0.47483870967741937,0.5251612903225806
E01002442,1512,729,783,0.48214285714285715,0.5178571428571429
E01002433,1826,849,977,0.4649507119386637,0.5350492880613362
E01002436,1608,801,807,0.498134328358209,0.5018656716417911
E01002479,1702,774,928,0.45475910693301996,0.54524089306698
E01002480,1760,865,895,0.4914772727272727,0.5085227272727273
E01002481,1633,793,840,0.4856093080220453,0.5143906919779547
E01002533,1462,707,755,0.4835841313269494,0.5164158686730507
E01002534,1465,714,751,0.48737201365187716,0.5126279863481229
E01002538,1569,722,847,0.46016571064372214,0.5398342893562779
E01002539,1524,776,748,0.5091863517060368,0.49081364829396323
E01002418,1789,873,916,0.4879821129122415,0.5120178870877585
E01002419,1531,729,802,0.4761593729588504,0.5238406270411495
E01002431,1415,683,732,0.4826855123674912,0.5173144876325089
E01002432,1561,757,804,0.4849455477258168,0.5150544522741832
E01002437,1469,732,737,0.4982981620149762,0.5017018379850239
E01002430,1469,707,762,0.48127978216473793,0.5187202178352621
E01002434,1358,656,702,0.48306332842415317,0.5169366715758469
E01002435,1436,728,708,0.5069637883008357,0.49303621169916434
E01002470,1684,852,832,0.505938242280285,0.49406175771971494
E01002535,1767,886,881,0.5014148273910582,0.4985851726089417
E01002416,1741,851,890,0.488799540493969,0.511200459506031
E01002417,1596,752,844,0.47117794486215536,0.5288220551378446
E01002420,1595,759,836,0.47586206896551725,0.5241379310344828
E01002421,1696,796,900,0.4693396226415094,0.5306603773584906
E01002471,1619,786,833,0.48548486720197653,0.5145151327980235
E01002465,1576,729,847,0.46256345177664976,0.5374365482233503
E01002467,1517,699,818,0.46077785102175345,0.5392221489782465
E01002494,1696,832,864,0.49056603773584906,0.5094339622641509
E01002536,1420,676,744,0.476056338028169,0.523943661971831
E01002537,1404,714,690,0.5085470085470085,0.49145299145299143
E01002415,1710,835,875,0.48830409356725146,0.5116959064327485
E01002466,1680,822,858,0.48928571428571427,0.5107142857142857
E01002468,1696,837,859,0.49351415094339623,0.5064858490566038
E01002469,1670,842,828,0.5041916167664671,0.49580838323353293
E01002495,2230,1222,1008,0.5479820627802691,0.45201793721973094
E01002458,1416,689,727,0.4865819209039548,0.5134180790960452
E01002459,1624,771,853,0.4747536945812808,0.5252463054187192
E01002460,1338,661,677,0.4940209267563528,0.5059790732436472
E01002462,1418,710,708,0.5007052186177715,0.4992947813822285
E01002464,1586,770,816,0.4854981084489281,0.5145018915510718
E01002461,1435,683,752,0.4759581881533101,0.5240418118466899
E01002463,1570,776,794,0.4942675159235669,0.5057324840764331
E01002512,1741,872,869,0.5008615738081562,0.4991384261918438
E01002513,1341,650,691,0.48471290082028334,0.5152870991797166
E01002516,1454,711,743,0.4889958734525447,0.5110041265474553
E01002450,1421,696,725,0.4897959183673469,0.5102040816326531
E01002451,1514,754,760,0.49801849405548215,0.5019815059445178
E01002452,1539,802,737,0.521117608836907,0.4788823911630929
E01002453,1692,832,860,0.491725768321513,0.508274231678487
E01002454,1777,858,919,0.48283624085537424,0.5171637591446258
E01002414,3314,1912,1402,0.5769462884731442,0.4230537115268558
E01002514,1876,981,895,0.5229211087420043,0.47707889125799574
E01002515,1608,753,855,0.46828358208955223,0.5317164179104478
E01033725,2386,1236,1150,0.5180217937971501,0.48197820620285
E01002520,1549,784,765,0.5061329890251776,0.49386701097482244
E01002521,1716,887,829,0.5168997668997669,0.4831002331002331
E01002523,1625,796,829,0.4898461538461538,0.5101538461538462
E01033724,4933,2459,2474,0.49847962700182447,0.5015203729981755
E01002410,1694,853,841,0.5035419126328218,0.4964580873671783
E01002412,2291,1180,1111,0.515058926233086,0.48494107376691403
E01002456,1675,806,869,0.4811940298507463,0.5188059701492538
E01002509,1452,707,745,0.4869146005509642,0.5130853994490359
E01002511,1522,721,801,0.47371879106438897,0.526281208935611
E01002422,1436,723,713,0.5034818941504178,0.49651810584958217
E01002423,1645,831,814,0.5051671732522797,0.4948328267477204
E01002424,1574,782,792,0.49682337992376113,0.5031766200762389
E01002425,1795,919,876,0.5119777158774373,0.48802228412256266
E01002427,1506,715,791,0.4747675962815405,0.5252324037184595
E01002428,1470,747,723,0.5081632653061224,0.49183673469387756
E01002408,1527,773,754,0.5062213490504257,0.49377865094957435
E01002409,1773,884,889,0.49858996051889454,0.5014100394811055
E01002429,1413,721,692,0.5102618542108988,0.4897381457891012
E01002455,1728,852,876,0.4930555555555556,0.5069444444444444
E01002457,1560,774,786,0.49615384615384617,0.5038461538461538
E01002392,1675,783,892,0.46746268656716417,0.5325373134328358
E01002393,1988,977,1011,0.49144869215291753,0.5085513078470825
E01002540,1676,809,867,0.48269689737470167,0.5173031026252983
E01002542,1913,945,968,0.4939884997386304,0.5060115002613695
E01002543,1728,833,895,0.4820601851851852,0.5179398148148148
E01002394,1619,812,807,0.5015441630636195,0.49845583693638046
E01002395,1407,739,668,0.5252309879175551,0.47476901208244493
E01002397,1695,871,824,0.5138643067846608,0.4861356932153392
E01002398,1725,935,790,0.5420289855072464,0.4579710144927536
E01002399,1591,807,784,0.507228158390949,0.4927718416090509
E01002426,1783,867,916,0.48625911385305665,0.5137408861469434
E01002411,1712,877,835,0.5122663551401869,0.4877336448598131
E01002413,1530,748,782,0.4888888888888889,0.5111111111111111
E01002518,1333,665,668,0.4988747186796699,0.5011252813203301
E01002519,1491,766,725,0.5137491616364855,0.4862508383635144
E01002550,1810,932,878,0.5149171270718232,0.4850828729281768
E01002554,2563,1283,1280,0.500585251658213,0.49941474834178695
E01002541,1949,950,999,0.4874294510005131,0.512570548999487
E01002544,1678,882,796,0.5256257449344458,0.47437425506555425
E01002545,1503,686,817,0.4564204923486361,0.543579507651364
E01002546,1573,817,756,0.5193897012078831,0.480610298792117
E01002547,1566,788,778,0.5031928480204342,0.49680715197956576
E01002400,1792,898,894,0.5011160714285714,0.49888392857142855
E01002401,1702,813,889,0.47767332549941244,0.5223266745005876
E01002402,1499,724,775,0.4829886591060707,0.5170113408939293
E01002403,1795,849,946,0.47298050139275766,0.5270194986072423
E01002404,1838,910,928,0.49510337323177367,0.5048966267682263
E01002548,1675,795,880,0.4746268656716418,0.5253731343283582
E01002549,1751,850,901,0.4854368932038835,0.5145631067961165
E01002551,1905,952,953,0.49973753280839894,0.5002624671916011
E01002552,1582,804,778,0.5082174462705437,0.4917825537294564
E01002553,1693,824,869,0.48670998227997636,0.5132900177200236
E01002396,1749,868,881,0.49628359062321326,0.5037164093767867
E01002501,1671,846,825,0.5062836624775583,0.49371633752244165
E01002502,1589,818,771,0.5147891755821271,0.4852108244178729
E01002505,1694,819,875,0.4834710743801653,0.5165289256198347
E01002508,1955,1025,930,0.5242966751918159,0.47570332480818417
E01002405,1919,974,945,0.5075560187597707,0.4924439812402293
E01002406,2135,1079,1056,0.5053864168618267,0.49461358313817333
E01002503,1681,851,830,0.5062462819750149,0.49375371802498513
E01002504,2024,986,1038,0.4871541501976285,0.5128458498023716
E01002506,1836,963,873,0.5245098039215687,0.47549019607843135
E01002507,1656,864,792,0.5217391304347826,0.4782608695652174
E01002486,2192,1090,1102,0.4972627737226277,0.5027372262773723
E01002487,1821,934,887,0.5129049972542559,0.4870950027457441
E01002526,1925,907,1018,0.4711688311688312,0.5288311688311689
E01002528,1685,807,878,0.47893175074183975,0.5210682492581602
E01002532,2289,1136,1153,0.4962865880297073,0.5037134119702927
E01002445,1703,804,899,0.4721080446271286,0.5278919553728714
E01002525,1613,796,817,0.4934903905765654,0.5065096094234346
E01002529,2086,1050,1036,0.5033557046979866,0.4966442953020134
E01002530,1634,761,873,0.46572827417380663,0.5342717258261934
E01002531,1617,824,793,0.5095856524427953,0.4904143475572047
E01002407,2354,1172,1182,0.49787595581988103,0.5021240441801189
E01002488,1729,892,837,0.5159051474840949,0.48409485251590517
E01002489,1824,951,873,0.5213815789473685,0.4786184210526316
E01002490,2082,1032,1050,0.4956772334293948,0.5043227665706052
E01002492,1647,819,828,0.4972677595628415,0.5027322404371585
E01002444,1833,1097,736,0.5984724495362793,0.4015275504637207
E01002446,1612,825,787,0.5117866004962779,0.4882133995037221
E01002447,1697,925,772,0.5450795521508545,0.45492044784914554
E01002527,1521,749,772,0.49243918474687703,0.5075608152531229
E01002443,1625,825,800,0.5076923076923077,0.49230769230769234
E01002448,1957,985,972,0.5033214103219213,0.4966785896780787
E01002449,1772,938,834,0.5293453724604966,0.4706546275395034
E01002491,1604,823,781,0.5130922693266833,0.4869077306733167
E01002493,1868,878,990,0.47002141327623126,0.5299785867237687
E01002496,1802,843,959,0.46781354051054386,0.5321864594894562
E01002497,1832,901,931,0.49181222707423583,0.5081877729257642
E01002498,1416,692,724,0.4887005649717514,0.5112994350282486
E01002499,1705,841,864,0.49325513196480936,0.5067448680351906
E01032577,1683,805,878,0.47831253713606653,0.5216874628639334
E01002569,1764,859,905,0.48696145124716556,0.5130385487528345
E01002570,1682,805,877,0.47859690844233055,0.5214030915576694
E01002573,1650,806,844,0.48848484848484847,0.5115151515151515
E01002574,1537,712,825,0.46324007807417045,0.5367599219258296
E01002575,1745,847,898,0.4853868194842407,0.5146131805157593
E01002562,1379,690,689,0.5003625815808557,0.49963741841914433
E01002564,1888,900,988,0.4766949152542373,0.5233050847457628
E01002566,2123,1062,1061,0.5002355157795573,0.4997644842204428
E01002568,2759,1306,1453,0.47335991301196084,0.5266400869880391
E01033081,1242,628,614,0.5056360708534622,0.4943639291465378
E01033082,1223,601,622,0.49141455437448894,0.508585445625511
E01002620,1851,937,914,0.5062128579146408,0.4937871420853593
E01002625,1681,854,827,0.5080309339678762,0.49196906603212376
E01002626,1626,822,804,0.5055350553505535,0.4944649446494465
E01002627,1662,842,820,0.50661853188929,0.49338146811071
E01002631,1628,844,784,0.5184275184275184,0.48157248157248156
E01002633,1643,792,851,0.48204503956177724,0.5179549604382228
E01002634,1712,820,892,0.47897196261682246,0.5210280373831776
E01002637,1659,843,816,0.5081374321880651,0.4918625678119349
E01002638,1823,903,920,0.4953373560065826,0.5046626439934174
E01002563,1642,823,819,0.5012180267965896,0.4987819732034105
E01002565,2829,1392,1437,0.49204665959703076,0.5079533404029692
E01002567,1733,857,876,0.49451817657241776,0.5054818234275822
E01002684,2368,1153,1215,0.48690878378378377,0.5130912162162162
E01002686,1765,837,928,0.47422096317280454,0.5257790368271955
E01002571,1325,690,635,0.5207547169811321,0.47924528301886793
E01002572,1643,782,861,0.4759586122945831,0.524041387705417
E01002577,1635,827,808,0.5058103975535169,0.4941896024464832
E01002578,1502,738,764,0.49134487350199735,0.5086551264980027
E01002689,1585,764,821,0.48201892744479496,0.5179810725552051
E01002690,1470,722,748,0.49115646258503404,0.508843537414966
E01002576,1746,889,857,0.5091638029782359,0.490836197021764
E01002579,1746,837,909,0.4793814432989691,0.520618556701031
E01002580,1386,704,682,0.5079365079365079,0.49206349206349204
E01002581,1860,949,911,0.5102150537634409,0.48978494623655916
E01002582,1668,837,831,0.5017985611510791,0.4982014388489209
E01002675,2456,1219,1237,0.4963355048859935,0.5036644951140065
E01002678,1855,940,915,0.5067385444743935,0.49326145552560646
E01002679,1781,896,885,0.5030881527231892,0.49691184727681076
E01002680,1952,1057,895,0.5414959016393442,0.45850409836065575
E01002619,1959,1025,934,0.523226135783563,0.47677386421643697
E01002622,1731,886,845,0.511842865395725,0.488157134604275
E01002632,1832,942,890,0.5141921397379913,0.48580786026200873
E01002635,1753,904,849,0.515687393040502,0.484312606959498
E01002636,2016,1022,994,0.5069444444444444,0.4930555555555556
E01002618,1758,897,861,0.5102389078498294,0.48976109215017066
E01002621,1817,931,886,0.5123830489818382,0.4876169510181618
E01002623,1667,862,805,0.5170965806838632,0.4829034193161368
E01002628,1940,985,955,0.5077319587628866,0.49226804123711343
E01002629,2087,1051,1036,0.5035936751317681,0.4964063248682319
E01002630,1695,882,813,0.5203539823008849,0.479646017699115
E01002639,1703,897,806,0.5267175572519084,0.4732824427480916
E01002640,1800,975,825,0.5416666666666666,0.4583333333333333
E01002674,1707,891,816,0.5219683655536028,0.4780316344463972
E01002676,1715,897,818,0.5230320699708455,0.4769679300291545
E01002583,1706,860,846,0.5041031652989449,0.4958968347010551
E01002584,1691,902,789,0.5334121821407452,0.4665878178592549
E01002585,1651,853,798,0.516656571774682,0.483343428225318
E01002586,1650,868,782,0.526060606060606,0.47393939393939394
E01002589,1982,1013,969,0.5110998990918264,0.48890010090817354
E01002668,2014,935,1079,0.4642502482621648,0.5357497517378351
E01002669,1782,863,919,0.48428731762065097,0.5157126823793491
E01002681,2063,993,1070,0.4813378574890936,0.5186621425109065
E01002682,2325,1133,1192,0.48731182795698924,0.5126881720430108
E01002683,2568,1267,1301,0.49338006230529596,0.506619937694704
E01002642,2005,1086,919,0.541645885286783,0.45835411471321696
E01002643,2289,1151,1138,0.5028396679772826,0.49716033202271737
E01002645,2054,1078,976,0.5248296007789679,0.47517039922103216
E01002658,1333,683,650,0.5123780945236309,0.4876219054763691
E01002677,1565,809,756,0.5169329073482428,0.4830670926517572
E01002587,1895,969,926,0.5113456464379947,0.48865435356200526
E01002588,1755,829,926,0.4723646723646724,0.5276353276353276
E01002660,1758,916,842,0.5210466439135382,0.4789533560864619
E01002661,1849,977,872,0.5283937263385614,0.4716062736614386
E01002665,1618,820,798,0.5067985166872683,0.4932014833127318
E01002624,1505,779,726,0.5176079734219269,0.48239202657807306
E01002646,2016,1012,1004,0.501984126984127,0.498015873015873
E01002662,1999,1076,923,0.5382691345672836,0.46173086543271635
E01002663,2074,1028,1046,0.4956605593056895,0.5043394406943105
E01002664,1802,930,872,0.516093229744728,0.4839067702552719
E01002641,1932,979,953,0.5067287784679089,0.4932712215320911
E01002648,2689,1412,1277,0.5251022685013016,0.4748977314986984
E01002649,1830,942,888,0.5147540983606558,0.4852459016393443
E01002657,1876,929,947,0.4952025586353945,0.5047974413646056
E01033083,1664,921,743,0.5534855769230769,0.4465144230769231
E01033084,1722,926,796,0.537746806039489,0.462253193960511
E01002653,1813,937,876,0.516822945394374,0.48317705460562604
E01002654,1785,875,910,0.49019607843137253,0.5098039215686274
E01002655,1885,954,931,0.5061007957559682,0.49389920424403183
E01002656,1318,652,666,0.4946889226100152,0.5053110773899848
E01002659,1398,675,723,0.48283261802575106,0.5171673819742489
E01002667,1573,779,794,0.49523204068658616,0.5047679593134139
E01002670,1737,839,898,0.4830166954519286,0.5169833045480714
E01002671,1659,771,888,0.46473779385171793,0.5352622061482821
E01002672,1578,770,808,0.4879594423320659,0.5120405576679341
E01002673,1634,788,846,0.48225214198286415,0.5177478580171359
E01002647,2213,1088,1125,0.49164030727519203,0.508359692724808
E01002650,2436,1203,1233,0.4938423645320197,0.5061576354679803
E01002651,1778,921,857,0.5179977502812149,0.48200224971878514
E01002652,1765,908,857,0.5144475920679886,0.4855524079320113
E01002666,1558,884,674,0.5673940949935815,0.4326059050064185
E01002555,1917,960,957,0.5007824726134585,0.49921752738654146
E01002556,1681,843,838,0.5014872099940512,0.49851279000594884
E01002590,1839,902,937,0.49048395867319194,0.5095160413268081
E01002592,1999,972,1027,0.48624312156078037,0.5137568784392196
E01002595,1924,971,953,0.5046777546777547,0.49532224532224534
E01002557,1785,908,877,0.5086834733893557,0.49131652661064423
E01002558,1945,953,992,0.489974293059126,0.510025706940874
E01002559,2279,1116,1163,0.4896884598508118,0.5103115401491882
E01002560,1715,841,874,0.4903790087463557,0.5096209912536444
E01002561,1379,650,729,0.4713560551124003,0.5286439448875997
E01002591,1729,853,876,0.4933487565066512,0.5066512434933488
E01002593,2118,1073,1045,0.5066100094428706,0.49338999055712934
E01002594,1954,975,979,0.49897645854657113,0.5010235414534289
E01002611,1785,880,905,0.49299719887955185,0.5070028011204482
E01002612,1670,809,861,0.4844311377245509,0.5155688622754491
E01002613,1761,894,867,0.5076660988074957,0.49233390119250425
E01002598,1840,908,932,0.4934782608695652,0.5065217391304347
E01002599,1607,766,841,0.47666459240821407,0.523335407591786
E01002600,1524,761,763,0.49934383202099736,0.5006561679790026
E01002603,1924,931,993,0.4838877338877339,0.5161122661122661
E01033000,1785,833,952,0.4666666666666667,0.5333333333333333
E01033030,1723,918,805,0.5327916424840394,0.4672083575159605
E01002604,1733,865,868,0.49913444893248704,0.500865551067513
E01002605,1847,899,948,0.48673524634542503,0.513264753654575
E01002606,1641,808,833,0.49238269347958563,0.5076173065204144
E01002607,1923,945,978,0.4914196567862715,0.5085803432137286
E01002615,1470,729,741,0.4959183673469388,0.5040816326530613
E01002596,1996,1084,912,0.5430861723446894,0.45691382765531063
E01002601,1665,854,811,0.512912912912913,0.4870870870870871
E01002602,1477,719,758,0.4867975626269465,0.5132024373730535
E01002614,1746,873,873,0.5,0.5
E01002616,1382,692,690,0.5007235890014472,0.4992764109985528
E01002608,1717,831,886,0.48398369248689577,0.5160163075131042
E01002609,1730,869,861,0.5023121387283237,0.4976878612716763
E01002610,1564,748,816,0.4782608695652174,0.5217391304347826
E01002617,1594,782,812,0.4905897114178168,0.5094102885821832
E01002687,1707,872,835,0.510837727006444,0.48916227299355597
E01002691,1596,776,820,0.48621553884711777,0.5137844611528822
E01002692,1782,912,870,0.5117845117845118,0.4882154882154882
E01002693,1694,792,902,0.4675324675324675,0.5324675324675324
E01032573,1614,814,800,0.5043370508054523,0.49566294919454773
E01003006,1500,699,801,0.466,0.534
E01003007,1513,746,767,0.4930601454064772,0.5069398545935228
E01003008,1432,660,772,0.46089385474860334,0.5391061452513967
E01003009,1895,908,987,0.47915567282321897,0.520844327176781
E01003010,1497,739,758,0.49365397461589844,0.5063460253841016
E01002952,1541,705,836,0.45749513303049966,0.5425048669695003
E01002953,1308,660,648,0.5045871559633027,0.4954128440366973
E01002955,1377,649,728,0.4713144517066086,0.5286855482933914
E01002956,1611,768,843,0.4767225325884544,0.5232774674115456
E01002959,1433,698,735,0.4870900209351012,0.5129099790648988
E01002935,1770,901,869,0.5090395480225989,0.4909604519774011
E01002938,1935,929,1006,0.48010335917312663,0.5198966408268734
E01002951,1514,761,753,0.5026420079260238,0.49735799207397624
E01002954,1289,566,723,0.439100077579519,0.560899922420481
E01002957,1717,803,914,0.46767617938264416,0.5323238206173558
E01002933,1995,955,1040,0.47869674185463656,0.5213032581453634
E01002934,1821,923,898,0.5068643602416255,0.49313563975837454
E01002937,1729,859,870,0.496818970503181,0.503181029496819
E01003011,1741,847,894,0.4865020103388857,0.5134979896611143
E01033568,1461,727,734,0.4976043805612594,0.5023956194387406
E01033569,1662,845,817,0.5084235860409145,0.4915764139590854
E01002964,2231,1067,1164,0.4782608695652174,0.5217391304347826
E01002969,1748,871,877,0.4982837528604119,0.5017162471395881
E01002971,1709,842,867,0.49268578115857226,0.5073142188414277
E01002972,1809,913,896,0.5046987285793256,0.4953012714206744
E01002974,1893,909,984,0.48019017432646594,0.5198098256735341
E01002932,1757,841,916,0.4786568013659647,0.5213431986340353
E01002960,1627,771,856,0.47387830362630606,0.5261216963736939
E01002962,1528,733,795,0.47971204188481675,0.5202879581151832
E01002970,1576,760,816,0.48223350253807107,0.5177664974619289
E01002973,1372,645,727,0.47011661807580174,0.5298833819241983
E01002929,1633,790,843,0.48377219840783836,0.5162278015921616
E01002930,1709,816,893,0.47747220596840256,0.5225277940315974
E01002931,1850,907,943,0.49027027027027026,0.5097297297297297
E01002963,1732,835,897,0.4821016166281755,0.5178983833718245
E01002985,1662,820,842,0.49338146811071,0.50661853188929
E01002927,1556,746,810,0.4794344473007712,0.5205655526992288
E01002928,1604,747,857,0.46571072319201995,0.53428927680798
E01002958,1680,818,862,0.4869047619047619,0.513095238095238
E01002961,1750,825,925,0.4714285714285714,0.5285714285714286
E01002986,1273,648,625,0.5090337784760408,0.49096622152395913
E01002965,2325,1143,1182,0.4916129032258065,0.5083870967741936
E01002967,1858,922,936,0.49623250807319697,0.503767491926803
E01002968,2631,1343,1288,0.5104522995058913,0.48954770049410873
E01002990,1680,885,795,0.5267857142857143,0.4732142857142857
E01002991,1613,839,774,0.5201487910725356,0.47985120892746436
E01002922,1632,810,822,0.4963235294117647,0.5036764705882353
E01002926,1535,756,779,0.49250814332247556,0.5074918566775244
E01002966,1910,947,963,0.49581151832460735,0.5041884816753927
E01002992,1752,818,934,0.4668949771689498,0.5331050228310502
E01002921,1555,803,752,0.5163987138263666,0.48360128617363346
E01002987,1702,856,846,0.5029377203290247,0.4970622796709753
E01002988,1906,889,1017,0.4664218258132214,0.5335781741867786
E01002989,1830,935,895,0.5109289617486339,0.4890710382513661
E01002975,1381,691,690,0.500362056480811,0.499637943519189
E01002977,1673,793,880,0.4739988045427376,0.5260011954572624
E01002980,1413,668,745,0.4727530077848549,0.527246992215145
E01002981,1544,750,794,0.48575129533678757,0.5142487046632125
E01002984,1426,696,730,0.48807854137447404,0.511921458625526
E01002923,1570,782,788,0.4980891719745223,0.5019108280254777
E01002925,1615,789,826,0.4885448916408669,0.5114551083591331
E01002993,1519,775,744,0.5102040816326531,0.4897959183673469
E01002995,1476,713,763,0.4830623306233062,0.5169376693766937
E01002999,1449,730,719,0.5037957211870255,0.49620427881297446
E01002915,1304,665,639,0.5099693251533742,0.49003067484662577
E01002916,1478,743,735,0.5027063599458728,0.4972936400541272
E01002917,1397,688,709,0.4924838940586972,0.5075161059413028
E01002920,1604,790,814,0.4925187032418953,0.5074812967581047
E01002924,1530,776,754,0.5071895424836601,0.4928104575163399
E01002976,1654,768,886,0.46432889963724305,0.535671100362757
E01002978,1761,856,905,0.48608745031232253,0.5139125496876774
E01002979,1549,779,770,0.5029051000645578,0.4970948999354422
E01002982,1438,699,739,0.4860917941585535,0.5139082058414465
E01002983,1626,807,819,0.496309963099631,0.503690036900369
E01002994,1510,702,808,0.4649006622516556,0.5350993377483444
E01002996,1513,741,772,0.4897554527428949,0.5102445472571051
E01002997,1462,729,733,0.49863201094391246,0.5013679890560876
E01002998,1530,687,843,0.44901960784313727,0.5509803921568628
E01003002,1826,874,952,0.4786418400876232,0.5213581599123768
E01002918,1758,862,896,0.49032992036405004,0.5096700796359499
E01002919,1705,849,856,0.4979472140762463,0.5020527859237537
E01003000,1553,751,802,0.48358016741790083,0.5164198325820991
E01003001,1831,868,963,0.4740578918623703,0.5259421081376298
E01003003,1557,787,770,0.5054592164418754,0.4945407835581246
E01002939,1548,745,803,0.481266149870801,0.5187338501291989
E01002941,1487,704,783,0.4734364492266308,0.5265635507733692
E01002942,1370,692,678,0.5051094890510949,0.4948905109489051
E01003004,1578,763,815,0.4835234474017744,0.5164765525982256
E01003005,1488,738,750,0.4959677419354839,0.5040322580645161
E01002944,1360,653,707,0.4801470588235294,0.5198529411764706
E01002945,1559,778,781,0.4990378447722899,0.50096215522771
E01002946,1498,711,787,0.47463284379172227,0.5253671562082777
E01002947,1614,831,783,0.5148698884758365,0.4851301115241636
E01002940,1580,758,822,0.479746835443038,0.520253164556962
E01002943,1396,674,722,0.4828080229226361,0.5171919770773639
E01002948,2103,987,1116,0.4693295292439372,0.5306704707560628
E01002949,1862,942,920,0.505907626208378,0.4940923737916219
E01002950,1596,721,875,0.4517543859649123,0.5482456140350878
E01003472,1344,664,680,0.49404761904761907,0.5059523809523809
E01003473,1353,651,702,0.4811529933481153,0.5188470066518847
E01003474,1411,701,710,0.4968107725017718,0.5031892274982283
E01003475,2511,1212,1299,0.4826762246117085,0.5173237753882916
E01003478,1639,807,832,0.4923733984136669,0.5076266015863331
E01003460,1499,744,755,0.4963308872581721,0.5036691127418279
E01003462,1464,712,752,0.48633879781420764,0.5136612021857924
E01003464,1393,693,700,0.49748743718592964,0.5025125628140703
E01003465,1300,631,669,0.48538461538461536,0.5146153846153846
E01003400,1486,752,734,0.506056527590848,0.4939434724091521
E01003454,1362,650,712,0.47723935389133626,0.5227606461086637
E01003456,1547,802,745,0.5184227537168714,0.48157724628312865
E01003476,1404,699,705,0.49786324786324787,0.5021367521367521
E01003477,1535,760,775,0.495114006514658,0.504885993485342
E01003401,1346,628,718,0.46656760772659733,0.5334323922734027
E01003402,1552,760,792,0.4896907216494845,0.5103092783505154
E01003403,1546,749,797,0.4844760672703752,0.5155239327296248
E01003404,1674,820,854,0.48984468339307047,0.5101553166069295
E01003461,1544,763,781,0.49417098445595853,0.5058290155440415
E01003367,2401,1287,1114,0.5360266555601833,0.46397334443981675
E01003369,1656,809,847,0.4885265700483092,0.5114734299516909
E01003370,1979,1001,978,0.5058110156644771,0.494188984335523
E01003371,1558,792,766,0.5083440308087291,0.49165596919127086
E01003455,1579,821,758,0.5199493350221659,0.48005066497783405
E01003359,1733,842,891,0.48586266589728794,0.514137334102712
E01003360,1687,821,866,0.4866627148784825,0.5133372851215174
E01003457,1622,808,814,0.49815043156596794,0.5018495684340321
E01003458,1601,786,815,0.4909431605246721,0.5090568394753279
E01003459,2087,1016,1071,0.486823191183517,0.513176808816483
E01003394,1931,1049,882,0.5432418436043501,0.45675815639564993
E01003395,1471,744,727,0.5057783820530252,0.49422161794697483
E01003396,1592,834,758,0.5238693467336684,0.47613065326633164
E01003397,1552,828,724,0.5335051546391752,0.46649484536082475
E01003398,1741,882,859,0.5066053991958644,0.49339460080413555
E01003368,1586,805,781,0.5075662042875158,0.49243379571248425
E01003372,1532,775,757,0.5058746736292428,0.4941253263707572
E01003393,1529,805,724,0.52648790058862,0.47351209941138
E01003406,1641,782,859,0.4765386959171237,0.5234613040828763
E01003407,1784,892,892,0.5,0.5
E01003355,1581,803,778,0.5079063883617964,0.49209361163820364
E01003356,1757,872,885,0.49630051223676724,0.5036994877632328
E01003358,1823,907,916,0.4975315414152496,0.5024684585847504
E01003383,1535,785,750,0.511400651465798,0.48859934853420195
E01003384,1521,760,761,0.4996712689020381,0.5003287310979618
E01003442,1691,793,898,0.4689532820816085,0.5310467179183915
E01003443,1564,749,815,0.4789002557544757,0.5210997442455243
E01003444,1557,751,806,0.48233782915863843,0.5176621708413616
E01003445,1713,854,859,0.4985405720957385,0.5014594279042616
E01003463,1291,617,674,0.47792408985282725,0.5220759101471727
E01003380,1648,794,854,0.4817961165048544,0.5182038834951457
E01003382,1539,744,795,0.4834307992202729,0.5165692007797271
E01003385,1581,790,791,0.49968374446552816,0.5003162555344719
E01003399,1373,686,687,0.4996358339402768,0.5003641660597232
E01003423,1548,743,805,0.47997416020671835,0.5200258397932817
E01003357,1742,804,938,0.46153846153846156,0.5384615384615384
E01003376,1553,758,795,0.4880875724404379,0.5119124275595621
E01003377,1562,752,810,0.4814340588988476,0.5185659411011524
E01003408,1852,937,915,0.505939524838013,0.49406047516198703
E01003410,1581,755,826,0.4775458570524984,0.5224541429475016
E01003386,2204,1084,1120,0.49183303085299457,0.5081669691470054
E01003388,1439,654,785,0.45448227936066715,0.5455177206393329
E01003389,1764,913,851,0.5175736961451247,0.4824263038548753
E01003392,1299,675,624,0.5196304849884527,0.48036951501154734
E01003409,1710,821,889,0.4801169590643275,0.5198830409356725
E01003387,1604,778,826,0.4850374064837905,0.5149625935162094
E01003391,1333,652,681,0.4891222805701425,0.5108777194298575
E01003411,1729,837,892,0.48409485251590517,0.5159051474840949
E01003412,1660,810,850,0.4879518072289157,0.5120481927710844
E01003435,1312,628,684,0.47865853658536583,0.5213414634146342
E01003361,1646,845,801,0.5133657351154314,0.4866342648845686
E01003424,1533,760,773,0.4957599478147423,0.5042400521852577
E01003425,1440,706,734,0.49027777777777776,0.5097222222222222
E01003426,1749,880,869,0.5031446540880503,0.4968553459119497
E01003428,1457,735,722,0.5044612216884008,0.4955387783115992
E01003366,1502,767,735,0.5106524633821571,0.48934753661784286
E01003381,1451,696,755,0.47966919365954513,0.5203308063404548
E01003446,1668,836,832,0.5011990407673861,0.4988009592326139
E01003447,1545,734,811,0.47508090614886733,0.5249190938511327
E01003471,1576,766,810,0.4860406091370558,0.5139593908629442
E01003413,1900,917,983,0.4826315789473684,0.5173684210526316
E01003414,1591,778,813,0.48900062853551224,0.5109993714644877
E01003415,1632,782,850,0.4791666666666667,0.5208333333333334
E01003416,1512,748,764,0.4947089947089947,0.5052910052910053
E01003434,1489,729,760,0.4895903290799194,0.5104096709200806
E01003373,1465,693,772,0.47303754266211606,0.5269624573378839
E01003378,1992,941,1051,0.4723895582329317,0.5276104417670683
E01003379,1846,861,985,0.46641386782231853,0.5335861321776815
E01003390,1597,787,810,0.49279899812147776,0.5072010018785222
E01003405,1705,844,861,0.4950146627565982,0.5049853372434018
E01003429,1456,714,742,0.49038461538461536,0.5096153846153846
E01003430,1443,688,755,0.4767844767844768,0.5232155232155232
E01003431,1506,694,812,0.46082337317397076,0.5391766268260292
E01003432,1556,742,814,0.4768637532133676,0.5231362467866324
E01003433,1525,759,766,0.4977049180327869,0.5022950819672131
E01003466,1592,792,800,0.49748743718592964,0.5025125628140703
E01003467,1618,801,817,0.49505562422744126,0.5049443757725587
E01003468,1699,843,856,0.4961742201294879,0.503825779870512
E01003469,1620,799,821,0.49320987654320986,0.5067901234567901
E01003470,1757,850,907,0.48377916903813317,0.5162208309618668
E01003362,1323,639,684,0.48299319727891155,0.5170068027210885
E01003363,1638,813,825,0.49633699633699635,0.5036630036630036
E01003364,1731,847,884,0.48931253610629694,0.510687463893703
E01003365,1409,694,715,0.49254790631653655,0.5074520936834634
E01003421,1600,805,795,0.503125,0.496875
E01003374,1440,690,750,0.4791666666666667,0.5208333333333334
E01003375,1616,769,847,0.47586633663366334,0.5241336633663366
E01003437,1879,933,946,0.49654071314529,0.50345928685471
E01003440,1536,763,773,0.4967447916666667,0.5032552083333334
E01003441,1858,918,940,0.4940796555435953,0.5059203444564048
E01003427,1758,907,851,0.5159271899886234,0.4840728100113766
E01003436,1565,797,768,0.5092651757188499,0.4907348242811502
E01003439,1439,729,710,0.5066018068102849,0.49339819318971506
E01003448,1701,804,897,0.47266313932980597,0.527336860670194
E01003453,1695,836,859,0.49321533923303834,0.5067846607669616
E01003438,1691,822,869,0.4861028976936724,0.5138971023063276
E01003449,1759,892,867,0.5071063104036384,0.4928936895963616
E01003450,1611,776,835,0.48168839230291743,0.5183116076970825
E01003451,1666,806,860,0.4837935174069628,0.5162064825930373
E01003452,1982,984,998,0.496468213925328,0.5035317860746721
E01003417,1559,769,790,0.4932649134060295,0.5067350865939705
E01003418,1471,739,732,0.5023793337865398,0.49762066621346024
E01003419,1703,847,856,0.49735760422783326,0.5026423957721667
E01003420,1380,679,701,0.4920289855072464,0.5079710144927536
E01003422,1377,687,690,0.4989106753812636,0.5010893246187363
E01003744,1337,647,690,0.4839192221391174,0.5160807778608826
E01003745,1435,709,726,0.49407665505226483,0.5059233449477352
E01003746,1486,715,771,0.48115746971736206,0.5188425302826379
E01003747,1343,670,673,0.49888309754281457,0.5011169024571854
E01003748,1545,756,789,0.4893203883495146,0.5106796116504855
E01003749,1605,762,843,0.4747663551401869,0.525233644859813
E01003750,1671,806,865,0.4823459006582885,0.5176540993417116
E01003720,1777,823,954,0.4631401238041643,0.5368598761958356
E01003722,1772,866,906,0.4887133182844244,0.5112866817155757
E01003723,1742,804,938,0.46153846153846156,0.5384615384615384
E01003726,1524,722,802,0.473753280839895,0.526246719160105
E01003721,1659,788,871,0.47498493068113323,0.5250150693188668
E01003724,1381,668,713,0.4837074583635047,0.5162925416364953
E01003725,1498,690,808,0.4606141522029373,0.5393858477970628
E01003727,1600,751,849,0.469375,0.530625
E01003654,1563,745,818,0.47664747280870123,0.5233525271912988
E01003655,1510,730,780,0.48344370860927155,0.5165562913907285
E01003658,1649,804,845,0.48756822316555487,0.5124317768344451
E01003660,1718,880,838,0.5122235157159488,0.48777648428405124
E01003656,1489,707,782,0.4748153122901276,0.5251846877098724
E01003657,2089,1024,1065,0.49018669219722355,0.5098133078027764
E01003659,1640,807,833,0.4920731707317073,0.5079268292682927
E01003698,1385,695,690,0.5018050541516246,0.4981949458483754
E01003699,1415,681,734,0.4812720848056537,0.5187279151943462
E01003700,2240,1085,1155,0.484375,0.515625
E01003701,1788,890,898,0.49776286353467564,0.5022371364653244
E01003702,1620,779,841,0.4808641975308642,0.5191358024691358
E01003703,2501,1244,1257,0.4974010395841663,0.5025989604158336
E01003704,1681,795,886,0.4729327781082689,0.5270672218917312
E01003668,1622,767,855,0.47287299630086316,0.5271270036991369
E01003669,1528,751,777,0.49149214659685864,0.5085078534031413
E01003670,1496,763,733,0.5100267379679144,0.4899732620320856
E01003671,1533,758,775,0.49445531637312456,0.5055446836268754
E01003672,1430,670,760,0.46853146853146854,0.5314685314685315
E01003673,1778,902,876,0.5073115860517435,0.49268841394825647
E01003674,2129,1076,1053,0.5054015969938939,0.49459840300610614
E01003707,1335,669,666,0.501123595505618,0.49887640449438203
E01003708,1476,684,792,0.4634146341463415,0.5365853658536586
E01003709,1627,807,820,0.4960049170251998,0.5039950829748002
E01003710,1515,745,770,0.49174917491749176,0.5082508250825083
E01003759,1459,694,765,0.4756682659355723,0.5243317340644277
E01003760,1783,901,882,0.5053280987100393,0.49467190128996075
E01003761,1771,858,913,0.484472049689441,0.515527950310559
E01003762,1620,794,826,0.4901234567901235,0.5098765432098765
E01003763,1875,919,956,0.4901333333333333,0.5098666666666667
E01003764,1962,961,1001,0.48980632008154945,0.5101936799184505
E01003765,1574,767,807,0.4872935196950445,0.5127064803049556
E01003705,2192,1059,1133,0.4831204379562044,0.5168795620437956
E01003706,1594,740,854,0.4642409033877039,0.5357590966122961
E01003711,1812,876,936,0.48344370860927155,0.5165562913907285
E01003712,1359,645,714,0.4746136865342163,0.5253863134657837
E01003646,1749,907,842,0.5185820468839337,0.48141795311606633
E01003648,1437,723,714,0.5031315240083507,0.4968684759916493
E01003649,1633,833,800,0.5101041028781383,0.4898958971218616
E01003651,1471,716,755,0.486743711760707,0.513256288239293
E01003639,1758,832,926,0.4732650739476678,0.5267349260523322
E01003640,1771,867,904,0.48955392433653305,0.510446075663467
E01003641,1704,846,858,0.4964788732394366,0.5035211267605634
E01003642,1695,794,901,0.46843657817109147,0.5315634218289086
E01003774,1764,860,904,0.4875283446712018,0.5124716553287982
E01003775,1736,823,913,0.4740783410138249,0.5259216589861752
E01003776,1653,702,951,0.4246823956442831,0.5753176043557169
E01003777,1772,833,939,0.4700902934537246,0.5299097065462754
E01003778,1839,904,935,0.49157150625339857,0.5084284937466014
E01003779,1585,713,872,0.4498422712933754,0.5501577287066246
E01003780,1516,751,765,0.4953825857519789,0.5046174142480211
E01003647,1786,897,889,0.5022396416573348,0.4977603583426652
E01003650,1513,714,799,0.47191011235955055,0.5280898876404494
E01003652,1549,790,759,0.5100064557779213,0.48999354422207875
E01003653,1471,723,748,0.49150237933378654,0.5084976206662135
E01003638,1611,797,814,0.49472377405338297,0.505276225946617
E01003643,1833,874,959,0.4768139661756683,0.5231860338243317
E01003644,1562,765,797,0.48975672215108834,0.5102432778489117
E01003645,2610,1309,1301,0.5015325670498084,0.4984674329501916
E01003789,1444,711,733,0.49238227146814406,0.5076177285318559
E01003794,1472,712,760,0.483695652173913,0.5163043478260869
E01003795,1178,567,611,0.48132427843803055,0.5186757215619694
E01003796,1566,748,818,0.4776500638569604,0.5223499361430396
E01003661,1935,941,994,0.48630490956072353,0.5136950904392765
E01003662,1859,923,936,0.4965034965034965,0.5034965034965035
E01003663,1822,838,984,0.45993413830954993,0.54006586169045
E01003664,1776,869,907,0.48930180180180183,0.5106981981981982
E01003665,1648,796,852,0.4830097087378641,0.5169902912621359
E01003666,2198,1009,1189,0.45905368516833484,0.5409463148316651
E01033590,1111,547,564,0.49234923492349236,0.5076507650765076
E01033592,1908,945,963,0.49528301886792453,0.5047169811320755
E01003751,1954,952,1002,0.4872057318321392,0.5127942681678608
E01003753,1976,994,982,0.5030364372469636,0.49696356275303644
E01003754,1636,805,831,0.49205378973105135,0.5079462102689487
E01003757,1996,1009,987,0.5055110220440882,0.49448897795591185
E01003769,1730,923,807,0.5335260115606937,0.4664739884393064
E01003770,2609,1327,1282,0.5086239938673821,0.49137600613261784
E01003771,1934,944,990,0.48810754912099275,0.5118924508790073
E01003773,1673,839,834,0.5014943215780036,0.4985056784219964
E01003752,2492,1236,1256,0.4959871589085072,0.5040128410914928
E01003755,2002,1014,988,0.5064935064935064,0.4935064935064935
E01003756,2123,1053,1070,0.4959962317475271,0.504003768252473
E01003758,2581,1287,1294,0.49864393645873695,0.501356063541263
E01003766,1900,952,948,0.5010526315789474,0.49894736842105264
E01003767,1864,1016,848,0.5450643776824035,0.45493562231759654
E01003768,1754,911,843,0.5193842645381984,0.4806157354618016
E01003772,1700,856,844,0.5035294117647059,0.4964705882352941
E01003781,1662,831,831,0.5,0.5
E01003782,1755,877,878,0.4997150997150997,0.5002849002849002
E01003786,1419,680,739,0.4792107117688513,0.5207892882311487
E01003787,1536,763,773,0.4967447916666667,0.5032552083333334
E01003790,1417,695,722,0.49047282992237123,0.5095271700776288
E01003791,1488,732,756,0.49193548387096775,0.5080645161290323
E01003792,1422,685,737,0.48171589310829815,0.5182841068917018
E01003793,1556,710,846,0.45629820051413883,0.5437017994858612
E01003783,2235,1170,1065,0.5234899328859061,0.47651006711409394
E01003784,1760,918,842,0.5215909090909091,0.4784090909090909
E01003785,1904,993,911,0.5215336134453782,0.47846638655462187
E01003788,1852,1007,845,0.5437365010799136,0.4562634989200864
E01003683,2144,1115,1029,0.5200559701492538,0.47994402985074625
E01003684,1780,871,909,0.4893258426966292,0.5106741573033707
E01003685,1822,958,864,0.5257958287596048,0.47420417124039516
E01003686,1952,1013,939,0.5189549180327869,0.48104508196721313
E01003688,1804,910,894,0.5044345898004434,0.4955654101995565
E01003689,1580,817,763,0.5170886075949367,0.4829113924050633
E01033589,1676,888,788,0.5298329355608592,0.4701670644391408
E01033591,1908,951,957,0.49842767295597484,0.5015723270440252
E01003737,1793,871,922,0.4857780256553263,0.5142219743446738
E01003738,2108,1056,1052,0.5009487666034156,0.4990512333965844
E01003739,2121,1087,1034,0.5124941065535125,0.4875058934464875
E01003740,2055,997,1058,0.4851581508515815,0.5148418491484185
E01003741,1737,854,883,0.4916522740356937,0.5083477259643063
E01003742,2085,1095,990,0.5251798561151079,0.4748201438848921
E01003743,1773,884,889,0.49858996051889454,0.5014100394811055
E01003728,2423,1298,1125,0.5356995460173339,0.4643004539826661
E01003729,1751,917,834,0.5237007424328954,0.4762992575671045
E01003730,1693,878,815,0.5186060248080331,0.4813939751919669
E01003732,1655,710,945,0.42900302114803623,0.5709969788519638
E01003733,1767,897,870,0.5076400679117148,0.4923599320882852
E01003731,1461,767,694,0.5249828884325805,0.4750171115674196
E01003734,1796,906,890,0.5044543429844098,0.4955456570155902
E01003735,2339,1097,1242,0.46900384779820437,0.5309961522017956
E01003736,1659,860,799,0.5183845690174804,0.4816154309825196
E01003713,1744,883,861,0.5063073394495413,0.49369266055045874
E01003714,2168,1096,1072,0.5055350553505535,0.4944649446494465
E01003715,1988,1020,968,0.5130784708249497,0.4869215291750503
E01003716,1712,860,852,0.5023364485981309,0.4976635514018692
E01003718,1847,941,906,0.5094748240389821,0.49052517596101786
E01003719,1958,1000,958,0.5107252298263534,0.48927477017364657
E01032581,1652,836,816,0.5060532687651331,0.4939467312348668
E01003690,1711,865,846,0.5055523085914669,0.494447691408533
E01003691,1434,708,726,0.49372384937238495,0.5062761506276151
E01003692,1592,783,809,0.49183417085427134,0.5081658291457286
E01003693,1541,776,765,0.5035691109669046,0.4964308890330954
E01003694,1462,751,711,0.5136798905608755,0.48632010943912446
E01003695,1533,822,711,0.5362035225048923,0.4637964774951076
E01003696,1877,1036,841,0.5519445924347363,0.44805540756526374
E01003697,1630,833,797,0.5110429447852761,0.48895705521472393
E01003675,1619,785,834,0.4848672019765287,0.5151327980234712
E01003676,1690,847,843,0.5011834319526627,0.49881656804733726
E01003677,1547,787,760,0.5087265675500969,0.491273432449903
E01003678,1605,798,807,0.497196261682243,0.502803738317757
E01003679,1621,800,821,0.4935225169648365,0.5064774830351635
E01003680,1619,822,797,0.5077208153180975,0.4922791846819024
E01003681,1844,859,985,0.4658351409978308,0.5341648590021691
E01003682,1696,861,835,0.5076650943396226,0.49233490566037735
E01003797,1479,680,799,0.45977011494252873,0.5402298850574713
E01003798,1503,724,779,0.48170326014637393,0.5182967398536261
E01003799,1621,790,831,0.4873534855027761,0.512646514497224
E01003800,1573,753,820,0.47870311506675145,0.5212968849332485
E01003801,1321,653,668,0.4943224829674489,0.5056775170325511
E01003802,1328,681,647,0.5128012048192772,0.4871987951807229
E01003803,1474,699,775,0.47421981004070557,0.5257801899592944
E01003846,1734,846,888,0.48788927335640137,0.5121107266435986
E01003847,1582,755,827,0.47724399494311,0.52275600505689
E01003849,1534,763,771,0.4973924380704042,0.5026075619295959
E01003851,1688,799,889,0.47334123222748814,0.5266587677725119
E01003860,1691,862,829,0.5097575399172087,0.49024246008279126
E01003864,1466,699,767,0.4768076398362892,0.5231923601637107
E01003852,1324,675,649,0.5098187311178247,0.4901812688821752
E01003853,1535,737,798,0.48013029315960915,0.5198697068403909
E01003854,1413,678,735,0.47983014861995754,0.5201698513800425
E01003855,1689,817,872,0.4837181764357608,0.5162818235642392
E01003856,1568,725,843,0.46237244897959184,0.5376275510204082
E01003857,1752,802,950,0.4577625570776256,0.5422374429223744
E01003858,1638,781,857,0.47680097680097683,0.5231990231990232
E01003848,1808,878,930,0.4856194690265487,0.5143805309734514
E01003861,1751,856,895,0.48886350656767563,0.5111364934323244
E01003862,1388,657,731,0.473342939481268,0.526657060518732
E01003863,1420,655,765,0.4612676056338028,0.5387323943661971
E01003865,1311,627,684,0.4782608695652174,0.5217391304347826
E01033570,1552,801,751,0.5161082474226805,0.4838917525773196
E01033571,1538,751,787,0.488296488946684,0.511703511053316
E01003804,1758,841,917,0.47838452787258245,0.5216154721274175
E01003807,1795,888,907,0.4947075208913649,0.5052924791086351
E01003808,1782,829,953,0.46520763187429853,0.5347923681257014
E01003809,1735,850,885,0.4899135446685879,0.5100864553314121
E01003859,1622,798,824,0.4919852034525277,0.5080147965474723
E01003873,1660,827,833,0.49819277108433735,0.5018072289156627
E01003874,1529,740,789,0.4839764551994768,0.5160235448005233
E01003875,1613,801,812,0.49659020458772474,0.5034097954122753
E01003878,1394,637,757,0.4569583931133429,0.5430416068866571
E01003866,1587,816,771,0.5141776937618148,0.48582230623818523
E01003868,1506,766,740,0.5086321381142098,0.4913678618857902
E01003871,1649,797,852,0.4833232261976956,0.5166767738023045
E01003872,1451,731,720,0.503790489317712,0.4962095106822881
E01003821,1513,791,722,0.5228023793787178,0.47719762062128224
E01003876,1591,791,800,0.497171590194846,0.502828409805154
E01003877,1482,726,756,0.4898785425101215,0.5101214574898786
E01003879,1551,763,788,0.49194068343004516,0.5080593165699548
E01003892,2012,997,1015,0.4955268389662028,0.5044731610337972
E01003893,1616,800,816,0.49504950495049505,0.504950495049505
E01003894,1643,841,802,0.5118685331710287,0.4881314668289714
E01003895,1718,806,912,0.4691501746216531,0.5308498253783469
E01003905,1435,700,735,0.4878048780487805,0.5121951219512195
E01003906,1618,792,826,0.4894932014833127,0.5105067985166872
E01003907,1683,842,841,0.5002970885323826,0.49970291146761736
E01003908,1817,888,929,0.4887176664832141,0.5112823335167859
E01003909,1569,781,788,0.49776927979604846,0.5022307202039515
E01003867,1492,754,738,0.5053619302949062,0.49463806970509383
E01003869,1617,811,806,0.5015460729746444,0.49845392702535557
E01003870,1870,922,948,0.493048128342246,0.506951871657754
E01003910,1630,791,839,0.4852760736196319,0.5147239263803681
E01003805,1673,824,849,0.49252839210998206,0.5074716078900179
E01003806,1605,794,811,0.49470404984423677,0.5052959501557632
E01003816,1707,840,867,0.492091388400703,0.507908611599297
E01003817,1913,1004,909,0.5248301097752222,0.47516989022477785
E01003840,1584,780,804,0.49242424242424243,0.5075757575757576
E01003841,1932,975,957,0.5046583850931677,0.4953416149068323
E01003842,1677,808,869,0.48181276088252833,0.5181872391174717
E01003843,2044,1014,1030,0.49608610567514677,0.5039138943248532
E01003844,1450,704,746,0.48551724137931035,0.5144827586206897
E01003845,1626,798,828,0.4907749077490775,0.5092250922509225
E01003882,1797,875,922,0.4869226488592098,0.5130773511407902
E01003883,1775,905,870,0.5098591549295775,0.49014084507042255
E01003896,1646,858,788,0.5212636695018226,0.4787363304981774
E01003897,1761,845,916,0.4798409994321408,0.5201590005678591
E01003898,1490,718,772,0.4818791946308725,0.5181208053691275
E01003899,1377,660,717,0.4793028322440087,0.5206971677559913
E01003900,1562,752,810,0.4814340588988476,0.5185659411011524
E01003901,1640,798,842,0.4865853658536585,0.5134146341463415
E01003902,1296,643,653,0.49614197530864196,0.503858024691358
E01003903,1627,806,821,0.4953902888752305,0.5046097111247695
E01003904,1536,738,798,0.48046875,0.51953125
E01003880,1468,710,758,0.48365122615803813,0.5163487738419619
E01003881,1837,848,989,0.46162221012520416,0.5383777898747959
E01003884,1594,801,793,0.5025094102885822,0.4974905897114178
E01003885,1516,746,770,0.4920844327176781,0.5079155672823219
E01003818,1560,763,797,0.4891025641025641,0.5108974358974359
E01003819,1675,828,847,0.4943283582089552,0.5056716417910447
E01003820,1949,918,1031,0.4710107747562853,0.5289892252437147
E01003811,1548,755,793,0.4877260981912145,0.5122739018087855
E01003812,1836,886,950,0.48257080610021785,0.5174291938997821
E01003890,1509,707,802,0.4685222001325381,0.5314777998674619
E01003891,1715,822,893,0.4793002915451895,0.5206997084548105
E01003810,1605,800,805,0.4984423676012461,0.5015576323987538
E01003813,1630,809,821,0.496319018404908,0.503680981595092
E01003814,1714,778,936,0.4539089848308051,0.5460910151691949
E01003815,1798,868,930,0.4827586206896552,0.5172413793103449
E01003828,1517,729,788,0.48055372445616346,0.5194462755438365
E01003829,1675,804,871,0.48,0.52
E01003830,1760,864,896,0.4909090909090909,0.509090909090909
E01003831,1618,775,843,0.4789864029666255,0.5210135970333746
E01003832,1431,681,750,0.4758909853249476,0.5241090146750524
E01003833,1386,650,736,0.468975468975469,0.5310245310245311
E01003886,1699,828,871,0.48734549735138316,0.5126545026486168
E01003887,1724,827,897,0.4796983758700696,0.5203016241299304
E01003888,1907,892,1015,0.46775039328788676,0.5322496067121133
E01003889,1776,892,884,0.5022522522522522,0.49774774774774777
E01003834,1720,875,845,0.5087209302325582,0.49127906976744184
E01003835,1527,748,779,0.48984937786509497,0.510150622134905
E01003836,1505,702,803,0.4664451827242525,0.5335548172757475
E01003837,1812,878,934,0.4845474613686534,0.5154525386313465
E01003838,1786,869,917,0.486562150055991,0.513437849944009
E01003839,1871,902,969,0.4820951362907536,0.5179048637092464
E01003822,1444,680,764,0.4709141274238227,0.5290858725761773
E01003823,1638,795,843,0.48534798534798534,0.5146520146520146
E01003824,1661,807,854,0.4858518964479229,0.5141481035520771
E01003825,1762,859,903,0.4875141884222474,0.5124858115777525
E01003826,1768,814,954,0.4604072398190045,0.5395927601809954
E01003827,1712,839,873,0.49007009345794394,0.509929906542056
E01004125,1583,761,822,0.48073278584965257,0.5192672141503475
E01004183,1667,784,883,0.47030593881223753,0.5296940611877624
E01004184,1590,746,844,0.4691823899371069,0.5308176100628931
E01004185,1452,705,747,0.4855371900826446,0.5144628099173554
E01004189,1879,877,1002,0.4667376263970197,0.5332623736029803
E01004123,2126,1056,1070,0.4967074317968015,0.5032925682031985
E01004124,1826,905,921,0.49561883899233294,0.5043811610076671
E01004126,1509,697,812,0.461895294897283,0.538104705102717
E01004128,1488,705,783,0.4737903225806452,0.5262096774193549
E01004129,1772,840,932,0.47404063205417607,0.5259593679458239
E01004130,1598,776,822,0.4856070087609512,0.5143929912390488
E01004131,1632,780,852,0.47794117647058826,0.5220588235294118
E01004134,1435,704,731,0.4905923344947735,0.5094076655052264
E01004135,1448,708,740,0.4889502762430939,0.511049723756906
E01004136,1553,795,758,0.5119124275595621,0.4880875724404379
E01004164,1476,740,736,0.5013550135501355,0.4986449864498645
E01004166,1449,696,753,0.4803312629399586,0.5196687370600414
E01004169,1135,550,585,0.4845814977973568,0.5154185022026432
E01004186,1724,865,859,0.5017401392111369,0.4982598607888631
E01004188,1711,811,900,0.4739918176504968,0.5260081823495032
E01004127,1645,767,878,0.4662613981762918,0.5337386018237082
E01004163,1541,760,781,0.49318624269954575,0.5068137573004543
E01004165,1668,805,863,0.4826139088729017,0.5173860911270983
E01004167,1318,622,696,0.47192716236722304,0.5280728376327769
E01004187,1607,804,803,0.5003111387678905,0.49968886123210954
E01004117,1464,725,739,0.4952185792349727,0.5047814207650273
E01004121,1566,790,776,0.5044699872286079,0.4955300127713921
E01004192,1931,914,1017,0.4733298808907302,0.5266701191092699
E01004193,2328,1128,1200,0.4845360824742268,0.5154639175257731
E01004195,1578,779,799,0.49366286438529783,0.5063371356147022
E01004144,1627,826,801,0.5076828518746158,0.49231714812538413
E01004145,2131,1031,1100,0.48381041764429844,0.5161895823557016
E01004146,1710,815,895,0.4766081871345029,0.5233918128654971
E01004147,1585,751,834,0.47381703470031544,0.5261829652996846
E01004116,1608,757,851,0.47077114427860695,0.529228855721393
E01004122,1372,690,682,0.5029154518950437,0.4970845481049563
E01004190,1367,693,674,0.506949524506218,0.493050475493782
E01004191,1651,820,831,0.4966686856450636,0.5033313143549364
E01004194,1356,671,685,0.4948377581120944,0.5051622418879056
E01004196,1444,700,744,0.48476454293628807,0.5152354570637119
E01004115,1750,831,919,0.47485714285714287,0.5251428571428571
E01004118,1675,826,849,0.493134328358209,0.5068656716417911
E01004119,1418,722,696,0.5091678420310296,0.4908321579689704
E01004132,1536,754,782,0.4908854166666667,0.5091145833333334
E01004133,1510,751,759,0.49735099337748345,0.5026490066225165
E01004171,1518,739,779,0.4868247694334651,0.5131752305665349
E01004172,1549,742,807,0.4790187217559716,0.5209812782440284
E01004173,1385,668,717,0.48231046931407945,0.5176895306859206
E01004175,1614,770,844,0.4770755885997522,0.5229244114002478
E01004176,1419,670,749,0.47216349541930935,0.5278365045806906
E01004076,1487,722,765,0.4855413584398117,0.5144586415601883
E01004077,1560,772,788,0.4948717948717949,0.5051282051282051
E01004078,1617,807,810,0.49907235621521334,0.5009276437847866
E01004079,1399,713,686,0.509649749821301,0.49035025017869904
E01004080,1332,655,677,0.49174174174174173,0.5082582582582582
E01004081,1507,738,769,0.48971466489714666,0.5102853351028533
E01004082,1407,694,713,0.49324804548685147,0.5067519545131486
E01004137,1518,770,748,0.5072463768115942,0.4927536231884058
E01004140,1509,765,744,0.5069582504970179,0.49304174950298213
E01004141,1555,733,822,0.47138263665594854,0.5286173633440514
E01004142,2038,1012,1026,0.49656526005888124,0.5034347399411188
E01004149,1710,827,883,0.48362573099415207,0.5163742690058479
E01004101,1361,680,681,0.4996326230712711,0.5003673769287289
E01004103,1577,745,832,0.4724159797083069,0.527584020291693
E01004138,1552,768,784,0.4948453608247423,0.5051546391752577
E01004139,1368,669,699,0.48903508771929827,0.5109649122807017
E01004168,1576,769,807,0.4879441624365482,0.5120558375634517
E01004143,1453,680,773,0.4679972470750172,0.5320027529249828
E01004148,1592,750,842,0.47110552763819097,0.5288944723618091
E01004159,1528,787,741,0.5150523560209425,0.4849476439790576
E01004160,1575,794,781,0.5041269841269841,0.49587301587301585
E01004161,1444,685,759,0.4743767313019391,0.525623268698061
E01004097,1676,831,845,0.4958233890214797,0.5041766109785203
E01004098,1256,612,644,0.4872611464968153,0.5127388535031847
E01004099,1441,698,743,0.48438584316446914,0.5156141568355309
E01004100,1354,676,678,0.49926144756277696,0.5007385524372231
E01004102,1374,667,707,0.48544395924308587,0.5145560407569141
E01004110,1828,917,911,0.5016411378555798,0.49835886214442016
E01004111,1511,743,768,0.49172733289212445,0.5082726671078756
E01004112,1636,781,855,0.4773838630806846,0.5226161369193154
E01004120,1538,745,793,0.48439531859557866,0.5156046814044213
E01004157,1274,611,663,0.47959183673469385,0.5204081632653061
E01004087,1465,722,743,0.4928327645051195,0.5071672354948805
E01004170,1721,840,881,0.48808832074375363,0.5119116792562464
E01004174,1444,703,741,0.4868421052631579,0.5131578947368421
E01004178,1979,982,997,0.4962102071753411,0.503789792824659
E01004179,1567,774,793,0.49393746011486916,0.5060625398851308
E01004152,1562,724,838,0.46350832266325226,0.5364916773367477
E01004155,1628,789,839,0.48464373464373467,0.5153562653562653
E01004156,1687,808,879,0.47895672791938354,0.5210432720806165
E01004158,1479,734,745,0.49628127112914133,0.5037187288708587
E01004162,1549,745,804,0.48095545513234345,0.5190445448676565
E01004083,1420,662,758,0.46619718309859154,0.5338028169014084
E01004086,1617,785,832,0.48546691403834263,0.5145330859616574
E01004088,1818,835,983,0.4592959295929593,0.5407040704070407
E01004089,1290,608,682,0.47131782945736433,0.5286821705426357
E01004182,1546,713,833,0.4611901681759379,0.5388098318240621
E01004104,1528,753,775,0.49280104712041883,0.5071989528795812
E01004107,1529,711,818,0.4650098103335513,0.5349901896664486
E01004177,1754,767,987,0.4372862029646522,0.5627137970353477
E01004180,1711,815,896,0.47632963179427235,0.5236703682057277
E01004181,1643,793,850,0.48265368228849664,0.5173463177115033
E01004090,1193,587,606,0.4920368818105616,0.5079631181894384
E01004096,1426,680,746,0.47685834502103785,0.5231416549789621
E01004150,1560,749,811,0.48012820512820514,0.5198717948717949
E01004151,1711,843,868,0.49269433080070135,0.5073056691992986
E01004153,1708,878,830,0.5140515222482436,0.4859484777517564
E01004091,1282,623,659,0.4859594383775351,0.5140405616224649
E01004092,1437,691,746,0.48086290883785665,0.5191370911621433
E01004105,1819,900,919,0.4947773501924134,0.5052226498075866
E01004106,1529,744,785,0.486592544146501,0.513407455853499
E01004154,1430,729,701,0.5097902097902098,0.4902097902097902
E01004084,1462,724,738,0.4952120383036936,0.5047879616963065
E01004085,1595,777,818,0.4871473354231975,0.5128526645768025
E01004108,1714,835,879,0.4871645274212369,0.5128354725787632
E01004109,1596,779,817,0.4880952380952381,0.5119047619047619
E01004093,1522,729,793,0.47897503285151116,0.5210249671484888
E01004094,1677,808,869,0.48181276088252833,0.5181872391174717
E01004095,1511,754,757,0.4990072799470549,0.500992720052945
E01004114,1735,847,888,0.48818443804034584,0.5118155619596542
E01032623,1825,865,960,0.473972602739726,0.5260273972602739
E01004349,1439,676,763,0.4697706740792217,0.5302293259207783
E01004350,1753,811,942,0.46263548203080435,0.5373645179691957
E01004351,1601,775,826,0.4840724547158026,0.5159275452841974
E01004356,1630,801,829,0.49141104294478527,0.5085889570552147
E01004357,1556,741,815,0.4762210796915167,0.5237789203084833
E01004352,1920,974,946,0.5072916666666667,0.49270833333333336
E01004353,1806,840,966,0.46511627906976744,0.5348837209302325
E01004354,1768,856,912,0.4841628959276018,0.5158371040723982
E01004358,1647,766,881,0.4650880388585307,0.5349119611414693
E01004359,1673,825,848,0.4931261207411835,0.5068738792588166
E01004384,1823,850,973,0.46626439934174435,0.5337356006582556
E01004385,1384,635,749,0.4588150289017341,0.5411849710982659
E01004386,1661,815,846,0.4906682721252258,0.5093317278747742
E01004389,1613,777,836,0.48171109733415995,0.51828890266584
E01004390,1596,735,861,0.4605263157894737,0.5394736842105263
E01004355,1599,770,829,0.4815509693558474,0.5184490306441526
E01004360,1331,672,659,0.5048835462058603,0.49511645379413977
E01004413,1564,711,853,0.45460358056265987,0.5453964194373402
E01004415,1559,728,831,0.4669660038486209,0.5330339961513791
E01004416,1697,869,828,0.512080141426046,0.48791985857395404
E01004361,1294,647,647,0.5,0.5
E01004414,1607,774,833,0.48164281269446174,0.5183571873055383
E01004417,1663,779,884,0.46843054720384847,0.5315694527961515
E01004451,1726,823,903,0.4768250289687138,0.5231749710312862
E01004452,1630,786,844,0.4822085889570552,0.5177914110429448
E01004450,1655,814,841,0.4918429003021148,0.5081570996978853
E01004453,1625,799,826,0.4916923076923077,0.5083076923076923
E01004454,1714,828,886,0.4830805134189031,0.5169194865810969
E01004455,1537,742,795,0.4827586206896552,0.5172413793103449
E01004456,1557,711,846,0.45664739884393063,0.5433526011560693
E01004379,1430,689,741,0.4818181818181818,0.5181818181818182
E01004380,1511,694,817,0.45929847782925215,0.5407015221707479
E01004381,1815,891,924,0.4909090909090909,0.509090909090909
E01004383,1634,781,853,0.47796817625459,0.52203182374541
E01004387,1500,731,769,0.48733333333333334,0.5126666666666667
E01004388,1481,713,768,0.4814314652261985,0.5185685347738015
E01004343,1794,890,904,0.496098104793757,0.5039018952062431
E01004344,1840,947,893,0.5146739130434783,0.48532608695652174
E01004382,1350,625,725,0.46296296296296297,0.5370370370370371
E01004418,1653,803,850,0.48578342407743497,0.514216575922565
E01004419,1594,788,806,0.49435382685069007,0.5056461731493099
E01004398,1966,944,1022,0.4801627670396745,0.5198372329603256
E01004399,1733,797,936,0.4598961338718984,0.5401038661281016
E01004400,1723,868,855,0.5037724898432966,0.4962275101567034
E01004402,1804,907,897,0.5027716186252772,0.49722838137472286
E01004403,1817,907,910,0.4991744634012108,0.5008255365987893
E01004345,1925,939,986,0.4877922077922078,0.5122077922077922
E01004348,2688,1365,1323,0.5078125,0.4921875
E01004377,1782,862,920,0.4837261503928171,0.5162738496071829
E01004378,1833,939,894,0.5122749590834698,0.4877250409165303
E01004342,2143,1156,987,0.539430704619692,0.460569295380308
E01004346,1713,832,881,0.485697606538237,0.514302393461763
E01004347,1983,952,1031,0.4800806858295512,0.5199193141704488
E01004460,1955,973,982,0.49769820971867007,0.5023017902813299
E01004462,1795,893,902,0.49749303621169916,0.5025069637883008
E01004396,1854,939,915,0.5064724919093851,0.4935275080906149
E01004457,1894,959,935,0.5063357972544879,0.49366420274551215
E01004458,1862,915,947,0.49140708915145004,0.50859291084855
E01004459,1635,749,886,0.4581039755351682,0.5418960244648318
E01004463,2003,1002,1001,0.5002496255616575,0.49975037443834247
E01004407,1633,811,822,0.4966319657072872,0.5033680342927128
E01004410,1898,886,1012,0.46680716543730244,0.5331928345626976
E01004464,1579,789,790,0.499683343888537,0.5003166561114629
E01004469,1640,804,836,0.4902439024390244,0.5097560975609756
E01004470,1524,753,771,0.4940944881889764,0.5059055118110236
E01004471,1724,830,894,0.4814385150812065,0.5185614849187935
E01004391,1849,910,939,0.4921579232017307,0.5078420767982693
E01004393,2391,1520,871,0.6357172731074864,0.3642827268925136
E01004401,2102,1072,1030,0.5099904852521409,0.4900095147478592
E01004404,2049,1008,1041,0.49194729136163984,0.5080527086383602
E01004461,2125,1047,1078,0.49270588235294116,0.5072941176470588
E01004412,1739,830,909,0.4772857964347326,0.5227142035652674
E01004465,1502,711,791,0.4733688415446072,0.5266311584553928
E01004466,1623,798,825,0.49168207024029575,0.5083179297597042
E01004467,2155,1035,1120,0.4802784222737819,0.5197215777262181
E01004468,1621,814,807,0.5021591610117212,0.49784083898827886
E01004406,1859,952,907,0.5121032813340506,0.4878967186659494
E01004408,1749,855,894,0.4888507718696398,0.5111492281303602
E01004409,1661,843,818,0.5075255869957856,0.49247441300421435
E01004411,1721,905,816,0.5258570598489251,0.47414294015107494
E01004443,1833,923,910,0.5035460992907801,0.49645390070921985
E01004447,1875,960,915,0.512,0.488
E01004392,2283,1200,1083,0.5256241787122208,0.4743758212877792
E01004394,1821,922,899,0.5063152114222954,0.49368478857770454
E01004397,2316,1190,1126,0.5138169257340242,0.48618307426597585
E01004444,2537,1244,1293,0.4903429247142294,0.5096570752857706
E01004446,1915,971,944,0.5070496083550914,0.4929503916449086
E01004395,1613,823,790,0.5102293862368258,0.4897706137631742
E01004421,2149,1088,1061,0.5062819916240112,0.49371800837598884
E01004445,1741,871,870,0.5002871912693854,0.4997128087306146
E01004448,1897,918,979,0.48392198207696363,0.5160780179230364
E01004449,1838,882,956,0.47986942328618065,0.5201305767138193
E01004363,1565,790,775,0.5047923322683706,0.4952076677316294
E01004364,1738,883,855,0.5080552359033371,0.4919447640966628
E01004366,1891,978,913,0.5171866737176097,0.48281332628239026
E01004367,1637,851,786,0.5198533903481979,0.48014660965180206
E01004368,1875,964,911,0.5141333333333333,0.48586666666666667
E01004365,2289,1174,1115,0.5128877238968982,0.4871122761031018
E01004405,1652,815,837,0.4933414043583535,0.5066585956416465
E01004420,2134,1113,1021,0.5215557638238051,0.4784442361761949
E01004423,1903,985,918,0.5176037834997372,0.48239621650026276
E01033153,2616,1249,1367,0.47744648318042815,0.5225535168195719
E01004362,1614,855,759,0.5297397769516728,0.47026022304832715
E01004436,1712,898,814,0.5245327102803738,0.47546728971962615
E01004437,1885,987,898,0.523607427055703,0.4763925729442971
E01004439,1678,845,833,0.5035756853396901,0.4964243146603099
E01004442,1754,945,809,0.5387685290763968,0.46123147092360317
E01004422,1662,845,817,0.5084235860409145,0.4915764139590854
E01004424,1833,928,905,0.5062738679759956,0.49372613202400434
E01004425,2090,1024,1066,0.48995215311004786,0.5100478468899522
E01004426,1787,893,894,0.49972020145495244,0.5002797985450476
E01004427,2113,1057,1056,0.5002366303833412,0.4997633696166588
E01004369,1766,917,849,0.5192525481313703,0.48074745186862966
E01004370,1786,900,886,0.503919372900336,0.49608062709966405
E01004372,1831,931,900,0.5084653194975424,0.4915346805024577
E01004432,1755,869,886,0.49515669515669514,0.5048433048433049
E01004435,2033,971,1062,0.47761928184948355,0.5223807181505165
E01004333,1769,883,886,0.499152063312606,0.500847936687394
E01004334,1507,692,815,0.45919044459190445,0.5408095554080955
E01004438,2065,1138,927,0.5510895883777239,0.448910411622276
E01004440,2164,1164,1000,0.5378927911275416,0.46210720887245843
E01004441,1621,850,771,0.5243676742751388,0.4756323257248612
E01004371,1703,877,826,0.5149735760422783,0.48502642395772166
E01004373,1779,942,837,0.5295109612141653,0.47048903878583476
E01004374,1890,953,937,0.5042328042328043,0.49576719576719575
E01004375,1855,908,947,0.4894878706199461,0.5105121293800539
E01004376,1994,1016,978,0.5095285857572718,0.49047141424272817
E01004336,1699,868,831,0.5108887580929958,0.4891112419070041
E01004428,1763,827,936,0.4690867838910947,0.5309132161089053
E01004429,1772,877,895,0.494920993227991,0.505079006772009
E01004430,2200,1188,1012,0.54,0.46
E01004434,2045,1026,1019,0.5017114914425428,0.4982885085574572
E01004335,1843,866,977,0.4698860553445469,0.530113944655453
E01004337,1966,1013,953,0.5152594099694812,0.48474059003051884
E01004338,1772,921,851,0.5197516930022573,0.4802483069977427
E01004339,1814,931,883,0.5132304299889746,0.48676957001102533
E01004340,1849,918,931,0.4964845862628448,0.5035154137371552
E01004341,1757,872,885,0.49630051223676724,0.5036994877632328
E01004327,1213,622,591,0.5127782357790602,0.4872217642209398
E01004328,1840,994,846,0.5402173913043479,0.4597826086956522
E01004329,1931,1067,864,0.5525634386328327,0.44743656136716725
E01004330,1834,974,860,0.5310796074154853,0.46892039258451473
E01004331,1856,992,864,0.5344827586206896,0.46551724137931033
E01004332,1849,979,870,0.5294753921038399,0.4705246078961601
E01016252,1410,701,709,0.4971631205673759,0.5028368794326241
E01016253,1395,687,708,0.4924731182795699,0.5075268817204301
E01032727,3011,1421,1590,0.47193623380936567,0.5280637661906343
E01016184,2168,1063,1105,0.49031365313653136,0.5096863468634686
E01016185,1376,678,698,0.49273255813953487,0.5072674418604651
E01016186,1825,916,909,0.5019178082191781,0.4980821917808219
E01016187,1636,807,829,0.4932762836185819,0.5067237163814181
E01016188,1684,830,854,0.49287410926365793,0.5071258907363421
E01016190,1534,766,768,0.49934810951760106,0.500651890482399
E01016238,1234,602,632,0.4878444084278768,0.5121555915721232
E01016243,1498,751,747,0.5013351134846462,0.4986648865153538
E01016245,2363,1176,1187,0.49767245027507406,0.502327549724926
E01016246,1584,741,843,0.4678030303030303,0.5321969696969697
E01016247,1654,828,826,0.5006045949214026,0.49939540507859737
E01016239,1490,720,770,0.48322147651006714,0.5167785234899329
E01016240,1535,753,782,0.4905537459283388,0.5094462540716612
E01016241,1616,804,812,0.4975247524752475,0.5024752475247525
E01016242,1728,847,881,0.49016203703703703,0.5098379629629629
E01016180,1499,736,763,0.49099399599733157,0.5090060040026685
E01016181,1455,622,833,0.4274914089347079,0.5725085910652921
E01016182,1520,730,790,0.48026315789473684,0.5197368421052632
E01016183,1279,622,657,0.48631743549648165,0.5136825645035183
E01016222,1269,629,640,0.49566587864460204,0.5043341213553979
E01016191,1660,822,838,0.4951807228915663,0.5048192771084338
E01016223,1434,729,705,0.5083682008368201,0.4916317991631799
E01016224,1734,850,884,0.49019607843137253,0.5098039215686274
E01016226,1361,690,671,0.5069801616458487,0.49301983835415136
E01032724,1343,666,677,0.4959046909903202,0.5040953090096798
E01032728,1392,689,703,0.4949712643678161,0.5050287356321839
E01016225,2164,1070,1094,0.4944547134935305,0.5055452865064695
E01016233,2307,1130,1177,0.48981361074989166,0.5101863892501084
E01016248,1543,724,819,0.4692158133506157,0.5307841866493843
E01016249,1467,742,725,0.5057941376959781,0.4942058623040218
E01016250,1601,779,822,0.48657089319175517,0.5134291068082448
E01016200,1351,668,683,0.4944485566247224,0.5055514433752776
E01016201,1344,671,673,0.4992559523809524,0.5007440476190477
E01016202,1191,610,581,0.5121746431570109,0.4878253568429891
E01016203,1311,598,713,0.45614035087719296,0.543859649122807
E01016204,1212,591,621,0.4876237623762376,0.5123762376237624
E01016209,1491,735,756,0.49295774647887325,0.5070422535211268
E01016210,1224,592,632,0.48366013071895425,0.5163398692810458
E01016213,1143,558,585,0.4881889763779528,0.5118110236220472
E01016214,1374,670,704,0.487627365356623,0.512372634643377
E01016215,1255,613,642,0.48844621513944225,0.5115537848605578
E01032725,1585,774,811,0.48832807570977915,0.5116719242902208
E01032726,1421,690,731,0.48557353976073186,0.5144264602392681
E01016205,1327,657,670,0.49510173323285606,0.5048982667671439
E01016217,1404,697,707,0.4964387464387464,0.5035612535612536
E01016218,1375,693,682,0.504,0.496
E01016231,1894,966,928,0.5100316789862724,0.48996832101372756
E01016232,1410,687,723,0.48723404255319147,0.5127659574468085
E01016212,1301,651,650,0.5003843197540354,0.49961568024596464
E01016216,1296,632,664,0.4876543209876543,0.5123456790123457
E01016219,1341,663,678,0.49440715883668906,0.5055928411633109
E01016220,1379,686,693,0.49746192893401014,0.5025380710659898
E01016221,1264,620,644,0.49050632911392406,0.509493670886076
E01016206,1789,871,918,0.4868641699273337,0.5131358300726663
E01016208,1927,934,993,0.4846912298910223,0.5153087701089777
E01016229,1181,567,614,0.48010160880609654,0.5198983911939035
E01016230,1795,1006,789,0.5604456824512535,0.4395543175487465
E01016207,1537,816,721,0.5309043591411842,0.4690956408588159
E01016234,1150,570,580,0.4956521739130435,0.5043478260869565
E01016235,1339,669,670,0.4996265870052278,0.5003734129947722
E01016236,1436,698,738,0.4860724233983287,0.5139275766016713
E01016237,1191,596,595,0.5004198152812762,0.4995801847187238
E01016192,1400,704,696,0.5028571428571429,0.49714285714285716
E01016194,1251,613,638,0.49000799360511593,0.5099920063948841
E01016195,1138,557,581,0.48945518453427067,0.5105448154657294
E01016227,1340,665,675,0.4962686567164179,0.503731343283582
E01016228,1541,759,782,0.4925373134328358,0.5074626865671642
E01016193,1228,594,634,0.4837133550488599,0.5162866449511401
E01016196,2496,1580,916,0.6330128205128205,0.36698717948717946
E01016197,1351,663,688,0.49074759437453735,0.5092524056254626
E01016198,1211,575,636,0.47481420313790257,0.5251857968620974
E01016199,1242,627,615,0.5048309178743962,0.49516908212560384
E01016924,1518,714,804,0.47035573122529645,0.5296442687747036
E01016926,1530,741,789,0.4843137254901961,0.515686274509804
E01016927,1548,744,804,0.4806201550387597,0.5193798449612403
E01016929,1587,775,812,0.48834278512917456,0.5116572148708255
E01016931,1543,729,814,0.47245625405055086,0.5275437459494491
E01016898,2246,1110,1136,0.4942119323241318,0.5057880676758683
E01016899,3321,1568,1753,0.47214694369165916,0.5278530563083409
E01016914,2380,1101,1279,0.46260504201680674,0.5373949579831933
E01016915,1544,755,789,0.4889896373056995,0.5110103626943006
E01016923,1586,752,834,0.47414880201765447,0.5258511979823455
E01016928,1602,775,827,0.4837702871410737,0.5162297128589264
E01016998,1504,748,756,0.4973404255319149,0.5026595744680851
E01016999,1410,669,741,0.474468085106383,0.5255319148936171
E01017000,1722,833,889,0.483739837398374,0.516260162601626
E01016925,1520,743,777,0.4888157894736842,0.5111842105263158
E01016930,1843,893,950,0.4845360824742268,0.5154639175257731
E01017001,1504,730,774,0.4853723404255319,0.5146276595744681
E01017003,1647,779,868,0.4729811778992107,0.5270188221007893
E01016916,1457,714,743,0.4900480439258751,0.5099519560741249
E01016917,1368,678,690,0.4956140350877193,0.5043859649122807
E01016918,1425,671,754,0.4708771929824561,0.5291228070175439
E01016919,1379,662,717,0.48005801305293694,0.5199419869470631
E01016920,1571,745,826,0.47422024188415024,0.5257797581158498
E01016882,1454,650,804,0.4470426409903714,0.5529573590096286
E01016883,1455,701,754,0.481786941580756,0.518213058419244
E01016884,1594,782,812,0.4905897114178168,0.5094102885821832
E01016885,1370,615,755,0.4489051094890511,0.551094890510949
E01016886,1557,753,804,0.4836223506743738,0.5163776493256262
E01016980,1500,737,763,0.49133333333333334,0.5086666666666667
E01016982,1302,617,685,0.4738863287250384,0.5261136712749616
E01016983,1431,697,734,0.48707197763801535,0.5129280223619846
E01016984,1475,750,725,0.5084745762711864,0.4915254237288136
E01016985,1583,794,789,0.5015792798483891,0.4984207201516109
E01016900,1678,860,818,0.5125148986889154,0.48748510131108463
E01016902,1501,735,766,0.48967355096602266,0.5103264490339774
E01016904,1589,790,799,0.4971680302076778,0.5028319697923223
E01016905,1723,869,854,0.5043528728961114,0.4956471271038886
E01016909,1891,970,921,0.5129561078794289,0.48704389212057114
E01016906,1610,769,841,0.47763975155279503,0.522360248447205
E01016907,1811,910,901,0.5024848150193263,0.49751518498067365
E01016908,1535,744,791,0.48469055374592834,0.5153094462540717
E01016910,1527,746,781,0.4885396201702685,0.5114603798297315
E01016911,1539,752,787,0.48862897985705,0.51137102014295
E01016901,1661,774,887,0.46598434677904876,0.5340156532209512
E01016903,1962,965,997,0.49184505606523954,0.5081549439347605
E01016934,1404,685,719,0.4878917378917379,0.5121082621082621
E01016939,1631,769,862,0.4714898835070509,0.5285101164929491
E01016940,1702,812,890,0.4770857814336075,0.5229142185663925
E01016981,1657,811,846,0.4894387447193724,0.5105612552806277
E01017002,1703,838,865,0.4920728126834997,0.5079271873165003
E01017004,1688,855,833,0.5065165876777251,0.4934834123222749
E01017005,1702,833,869,0.4894242068155112,0.5105757931844889
E01017006,1572,812,760,0.5165394402035624,0.48346055979643765
E01016921,1553,727,826,0.46812620734063104,0.531873792659369
E01016922,1282,615,667,0.4797191887675507,0.5202808112324493
E01016973,1528,741,787,0.4849476439790576,0.5150523560209425
E01016977,1540,751,789,0.4876623376623377,0.5123376623376623
E01016978,1671,851,820,0.509275882704967,0.4907241172950329
E01016879,1527,728,799,0.4767518009168304,0.5232481990831697
E01016880,1357,650,707,0.47899778924097275,0.5210022107590273
E01016881,1510,744,766,0.49271523178807947,0.5072847682119205
E01016887,1425,671,754,0.4708771929824561,0.5291228070175439
E01016888,1495,710,785,0.47491638795986624,0.5250836120401338
E01016976,1660,828,832,0.4987951807228916,0.5012048192771085
E01016932,1635,824,811,0.5039755351681957,0.4960244648318043
E01016933,1506,727,779,0.48273572377158036,0.5172642762284196
E01016935,1574,765,809,0.48602287166454894,0.5139771283354511
E01016936,1634,832,802,0.5091799265605875,0.4908200734394125
E01016937,2041,1092,949,0.535031847133758,0.46496815286624205
E01016890,1747,900,847,0.5151688609044076,0.48483113909559244
E01016966,1796,909,887,0.5061247216035635,0.4938752783964365
E01016970,1636,777,859,0.47493887530562345,0.5250611246943765
E01016971,1955,991,964,0.5069053708439898,0.4930946291560102
E01016972,1850,874,976,0.47243243243243244,0.5275675675675676
E01016979,1654,812,842,0.4909310761789601,0.5090689238210399
E01016990,1678,833,845,0.4964243146603099,0.5035756853396901
E01016991,1765,822,943,0.46572237960339946,0.5342776203966005
E01016996,1663,779,884,0.46843054720384847,0.5315694527961515
E01017007,1623,771,852,0.47504621072088726,0.5249537892791127
E01017008,1635,795,840,0.48623853211009177,0.5137614678899083
E01017009,1536,732,804,0.4765625,0.5234375
E01017010,1782,852,930,0.4781144781144781,0.5218855218855218
E01017011,1408,659,749,0.4680397727272727,0.5319602272727273
E01017012,1809,901,908,0.498065229408513,0.5019347705914871
E01016892,1722,791,931,0.45934959349593496,0.540650406504065
E01016893,1900,943,957,0.4963157894736842,0.5036842105263157
E01016912,1890,937,953,0.49576719576719575,0.5042328042328043
E01016913,1745,861,884,0.49340974212034383,0.5065902578796562
E01016946,1484,766,718,0.5161725067385444,0.4838274932614555
E01016860,1524,770,754,0.505249343832021,0.494750656167979
E01016871,1785,908,877,0.5086834733893557,0.49131652661064423
E01016872,1826,963,863,0.5273822562979189,0.47261774370208104
E01016873,1698,881,817,0.5188457008244994,0.48115429917550057
E01016878,1871,917,954,0.4901122394441475,0.5098877605558525
E01016870,1597,813,784,0.509079524107702,0.49092047589229804
E01016874,1818,892,926,0.49064906490649063,0.5093509350935094
E01016875,1643,836,807,0.5088253195374315,0.49117468046256846
E01016876,1625,764,861,0.47015384615384614,0.5298461538461539
E01016877,1826,884,942,0.484118291347207,0.515881708652793
E01016974,1637,785,852,0.47953573610262673,0.5204642638973732
E01016975,1516,703,813,0.4637203166226913,0.5362796833773087
E01016992,1598,762,836,0.47684605757196497,0.523153942428035
E01016994,1653,791,862,0.4785238959467635,0.5214761040532365
E01016997,1582,738,844,0.4664981036662453,0.5335018963337548
E01016889,1867,962,905,0.5152651312265667,0.4847348687734333
E01016891,1770,935,835,0.5282485875706214,0.4717514124293785
E01016894,1894,944,950,0.498416050686378,0.5015839493136219
E01016896,1767,901,866,0.5099037917374081,0.490096208262592
E01016897,1781,880,901,0.4941044357102751,0.5058955642897248
E01016987,1857,898,959,0.48357565966612814,0.5164243403338719
E01016989,1610,766,844,0.47577639751552797,0.5242236024844721
E01016993,1438,690,748,0.47983310152990266,0.5201668984700973
E01016995,1714,809,905,0.4719953325554259,0.5280046674445741
E01016938,1784,974,810,0.5459641255605381,0.45403587443946186
E01016950,1712,868,844,0.5070093457943925,0.4929906542056075
E01016951,1435,754,681,0.5254355400696864,0.4745644599303136
E01016967,1921,1037,884,0.5398230088495575,0.46017699115044247
E01016968,1585,838,747,0.5287066246056782,0.47129337539432176
E01016864,1478,722,756,0.4884979702300406,0.5115020297699594
E01016865,1586,761,825,0.4798234552332913,0.5201765447667087
E01016866,1466,687,779,0.4686221009549795,0.5313778990450204
E01016867,1450,700,750,0.4827586206896552,0.5172413793103449
E01016868,1548,771,777,0.49806201550387597,0.501937984496124
E01016895,1558,737,821,0.4730423620025674,0.5269576379974326
E01016849,1539,840,699,0.5458089668615984,0.45419103313840153
E01016852,1593,873,720,0.5480225988700564,0.4519774011299435
E01016853,1872,975,897,0.5208333333333334,0.4791666666666667
E01016855,1733,957,776,0.5522215810732833,0.44777841892671666
E01016856,1629,832,797,0.5107427869858809,0.4892572130141191
E01016952,1625,921,704,0.5667692307692308,0.43323076923076925
E01016953,1627,878,749,0.5396435156730178,0.4603564843269822
E01016964,2101,1080,1021,0.5140409328891005,0.4859590671108996
E01016969,2019,1143,876,0.5661218424962853,0.4338781575037147
E01033328,1451,768,683,0.5292901447277739,0.47070985527222603
E01033329,1995,1037,958,0.5197994987468672,0.48020050125313285
E01016857,1523,774,749,0.5082074852265266,0.4917925147734734
E01016858,1439,752,687,0.5225851285615011,0.477414871438499
E01016859,1454,733,721,0.5041265474552957,0.4958734525447043
E01016986,1625,758,867,0.4664615384615385,0.5335384615384615
E01016988,1531,707,824,0.46178967994774656,0.5382103200522534
E01016850,1740,945,795,0.5431034482758621,0.45689655172413796
E01016851,1709,930,779,0.5441778818022235,0.45582211819777646
E01016854,1662,887,775,0.5336943441636582,0.46630565583634176
E01016954,1811,981,830,0.541689674213142,0.4583103257868581
E01016955,1747,1022,725,0.5850028620492272,0.41499713795077275
E01016941,1917,1096,821,0.5717266562336984,0.4282733437663015
E01016945,1623,956,667,0.5890326555760936,0.41096734442390637
E01016947,1607,844,763,0.5252022401991289,0.4747977598008712
E01016948,1775,880,895,0.49577464788732395,0.504225352112676
E01016949,1723,893,830,0.518282066163668,0.481717933836332
E01016861,1610,891,719,0.5534161490683229,0.446583850931677
E01016862,1578,854,724,0.541191381495564,0.458808618504436
E01016942,1727,861,866,0.49855240301100173,0.5014475969889982
E01016943,1585,796,789,0.5022082018927445,0.49779179810725555
E01016944,1583,862,721,0.5445356917245736,0.4554643082754264
E01016863,1579,811,768,0.5136162127929069,0.4863837872070931
E01016869,1788,910,878,0.5089485458612976,0.49105145413870244
E01016957,1774,874,900,0.4926719278466742,0.5073280721533259
E01016963,1906,1020,886,0.5351521511017838,0.4648478488982162
E01016956,1555,745,810,0.4790996784565916,0.5209003215434084
E01016958,1733,811,922,0.4679746105020196,0.5320253894979804
E01016959,1470,705,765,0.47959183673469385,0.5204081632653061
E01016960,1753,806,947,0.4597832287507131,0.5402167712492869
E01016961,1767,882,885,0.499151103565365,0.5008488964346349
E01016962,1693,792,901,0.4678086237448317,0.5321913762551683
E01017300,2234,1066,1168,0.477170993733214,0.5228290062667861
E01017303,1218,604,614,0.49589490968801314,0.5041050903119869
E01017305,1386,688,698,0.4963924963924964,0.5036075036075036
E01017306,1350,635,715,0.4703703703703704,0.5296296296296297
E01017309,1642,808,834,0.4920828258221681,0.5079171741778319
E01017301,1066,502,564,0.4709193245778612,0.5290806754221389
E01017302,1747,868,879,0.4968517458500286,0.5031482541499713
E01017304,1404,675,729,0.4807692307692308,0.5192307692307693
E01017316,1682,813,869,0.48335315101070153,0.5166468489892985
E01017329,2311,1129,1182,0.48853310255300736,0.5114668974469927
E01017307,1949,944,1005,0.4843509492047204,0.5156490507952797
E01017308,1766,838,928,0.47451868629671573,0.5254813137032842
E01033229,1381,661,720,0.4786386676321506,0.5213613323678494
E01033237,1363,651,712,0.4776228906823184,0.5223771093176816
E01017335,1520,754,766,0.49605263157894736,0.5039473684210526
E01017336,1604,811,793,0.5056109725685786,0.49438902743142144
E01017337,1611,800,811,0.4965859714463066,0.5034140285536933
E01017346,1498,714,784,0.4766355140186916,0.5233644859813084
E01017286,1537,758,779,0.49316851008458035,0.5068314899154196
E01017287,1648,771,877,0.4678398058252427,0.5321601941747572
E01017367,1918,909,1009,0.47393117831074033,0.5260688216892596
E01017368,1559,726,833,0.4656831302116741,0.5343168697883258
E01017282,1404,680,724,0.4843304843304843,0.5156695156695157
E01017283,1581,772,809,0.4882985452245414,0.5117014547754586
E01017338,1390,662,728,0.4762589928057554,0.5237410071942447
E01017341,1558,725,833,0.4653401797175867,0.5346598202824133
E01017342,1731,827,904,0.4777585210860774,0.5222414789139226
E01017339,1662,790,872,0.4753309265944645,0.5246690734055355
E01017340,1784,815,969,0.45683856502242154,0.5431614349775785
E01017343,1330,678,652,0.5097744360902255,0.49022556390977445
E01017344,1652,813,839,0.49213075060532685,0.5078692493946732
E01017345,1980,940,1040,0.47474747474747475,0.5252525252525253
E01017310,1411,675,736,0.47838412473423103,0.5216158752657689
E01017311,1515,728,787,0.48052805280528055,0.5194719471947195
E01017331,1473,712,761,0.48336727766463,0.5166327223353699
E01017332,1272,610,662,0.47955974842767296,0.5204402515723271
E01017334,1792,1161,631,0.6478794642857143,0.3521205357142857
E01017295,1265,595,670,0.47035573122529645,0.5296442687747036
E01017325,1305,628,677,0.4812260536398467,0.5187739463601533
E01017326,1580,785,795,0.49683544303797467,0.5031645569620253
E01017328,1444,705,739,0.48822714681440443,0.5117728531855956
E01017333,2900,1993,907,0.6872413793103448,0.31275862068965515
E01017284,1775,814,961,0.45859154929577467,0.5414084507042254
E01017285,1913,882,1031,0.4610559330893884,0.5389440669106116
E01017288,1213,563,650,0.46413849958779885,0.5358615004122012
E01017351,1402,670,732,0.47788873038516405,0.5221112696148359
E01017352,1147,536,611,0.4673060156931125,0.5326939843068875
E01017292,1594,770,824,0.48306148055207027,0.5169385194479298
E01017293,2017,981,1036,0.48636588993554786,0.5136341100644521
E01017296,1281,608,673,0.4746291959406714,0.5253708040593287
E01017321,1188,555,633,0.4671717171717172,0.5328282828282829
E01017322,1493,712,781,0.4768921634293369,0.5231078365706631
E01017327,1653,802,851,0.485178463399879,0.514821536600121
E01017312,1563,738,825,0.472168905950096,0.527831094049904
E01017315,1500,710,790,0.47333333333333333,0.5266666666666666
E01017354,1186,567,619,0.47807757166947723,0.5219224283305227
E01017361,1436,676,760,0.47075208913649025,0.5292479108635098
E01017362,1491,715,776,0.4795439302481556,0.5204560697518444
E01033239,2306,1082,1224,0.4692107545533391,0.5307892454466608
E01017290,1332,656,676,0.4924924924924925,0.5075075075075075
E01017291,1157,532,625,0.45980985306828004,0.54019014693172
E01017294,1594,788,806,0.49435382685069007,0.5056461731493099
E01017353,1225,605,620,0.49387755102040815,0.5061224489795918
E01017289,2034,967,1067,0.4754178957718781,0.5245821042281219
E01017347,1636,789,847,0.48227383863080686,0.5177261613691931
E01017348,1495,726,769,0.48561872909698994,0.51438127090301
E01017349,2149,1041,1108,0.4844113541181945,0.5155886458818055
E01017350,1905,921,984,0.48346456692913387,0.5165354330708661
E01017317,1549,751,798,0.48482892188508714,0.5151710781149128
E01017320,1091,492,599,0.4509624197983501,0.5490375802016498
E01017323,1158,576,582,0.49740932642487046,0.5025906735751295
E01017324,1464,729,735,0.4979508196721312,0.5020491803278688
E01017355,1528,741,787,0.4849476439790576,0.5150523560209425
E01017358,1295,598,697,0.4617760617760618,0.5382239382239382
E01017318,1186,564,622,0.47554806070826305,0.524451939291737
E01017319,1291,589,702,0.4562354763749032,0.5437645236250969
E01017356,1551,749,802,0.4829142488716957,0.5170857511283043
E01017357,1509,734,775,0.48641484426772696,0.513585155732273
E01017359,1483,735,748,0.49561699258260283,0.5043830074173972
E01017360,1706,857,849,0.5023446658851114,0.4976553341148886
E01017297,1437,693,744,0.4822546972860125,0.5177453027139874
E01017298,1502,729,773,0.48535286284953394,0.5146471371504661
E01017299,1219,609,610,0.4995898277276456,0.5004101722723544
E01017369,1459,717,742,0.4914324880054832,0.5085675119945168
E01017363,1543,761,782,0.4931950745301361,0.5068049254698639
E01017364,1509,739,770,0.4897282968853545,0.5102717031146454
E01017365,1455,695,760,0.47766323024054985,0.5223367697594502
E01017366,1469,693,776,0.4717494894486045,0.5282505105513955
E01017370,1753,848,905,0.4837421563034798,0.5162578436965203
E01016070,1676,833,843,0.4970167064439141,0.502983293556086
E01016071,1648,808,840,0.49029126213592233,0.5097087378640777
E01016072,1298,638,660,0.4915254237288136,0.5084745762711864
E01016074,1688,816,872,0.4834123222748815,0.5165876777251185
E01016142,1273,666,607,0.5231736056559309,0.47682639434406915
E01016144,1502,766,736,0.5099866844207723,0.49001331557922767
E01016145,1346,665,681,0.49405646359583955,0.5059435364041605
E01016149,1435,712,723,0.4961672473867596,0.5038327526132405
E01016073,2023,984,1039,0.48640632723677707,0.513593672763223
E01016075,1435,689,746,0.4801393728222996,0.5198606271777003
E01016076,2406,1190,1216,0.4945968412302577,0.5054031587697423
E01016077,1482,700,782,0.47233468286099867,0.5276653171390013
E01016143,2346,1149,1197,0.489769820971867,0.510230179028133
E01016146,2019,983,1036,0.4868746904408123,0.5131253095591877
E01016147,1916,929,987,0.4848643006263048,0.5151356993736952
E01016148,1968,994,974,0.5050813008130082,0.4949186991869919
E01016133,1372,678,694,0.49416909620991256,0.5058309037900874
E01016134,1429,702,727,0.4912526242127362,0.5087473757872638
E01016138,1514,720,794,0.47556142668428003,0.52443857331572
E01016139,1683,821,862,0.48781937017231136,0.5121806298276886
E01016135,1534,732,802,0.4771838331160365,0.5228161668839635
E01016136,1567,771,796,0.4920229738353542,0.5079770261646458
E01016137,1553,769,784,0.4951706374758532,0.5048293625241468
E01016140,1427,734,693,0.5143658023826209,0.48563419761737914
E01016141,1687,851,836,0.5044457617071725,0.4955542382928275
E01016035,1862,922,940,0.49516648764769067,0.5048335123523093
E01016112,2847,1483,1364,0.5208991921320688,0.47910080786793113
E01032798,3549,2134,1415,0.6012961397576783,0.3987038602423218
E01016151,1617,775,842,0.479282622139765,0.520717377860235
E01016152,1484,739,745,0.49797843665768193,0.5020215633423181
E01016153,1433,676,757,0.47173761339846476,0.5282623866015352
E01016155,1553,742,811,0.47778493238892467,0.5222150676110754
E01016033,1145,561,584,0.48995633187772925,0.5100436681222708
E01016036,2451,1245,1206,0.5079559363525091,0.4920440636474908
E01016037,1709,840,869,0.49151550614394385,0.5084844938560562
E01016039,1670,871,799,0.5215568862275449,0.4784431137724551
E01016030,1859,871,988,0.46853146853146854,0.5314685314685315
E01016032,1326,641,685,0.48340874811463047,0.5165912518853696
E01016034,2568,1348,1220,0.5249221183800623,0.4750778816199377
E01016038,1512,767,745,0.5072751322751323,0.49272486772486773
E01016150,1605,779,826,0.4853582554517134,0.5146417445482866
E01016154,1606,804,802,0.5006226650062267,0.49937733499377335
E01016156,1677,821,856,0.4895646988670245,0.5104353011329755
E01016157,1958,930,1028,0.47497446373850866,0.5250255362614913
E01016158,2143,1032,1111,0.4815678954736351,0.5184321045263649
E01016031,1752,900,852,0.5136986301369864,0.4863013698630137
E01016041,1660,870,790,0.5240963855421686,0.4759036144578313
E01016045,1666,864,802,0.5186074429771909,0.48139255702280914
E01016049,1922,1000,922,0.5202913631633714,0.4797086368366285
E01016040,1764,880,884,0.4988662131519274,0.5011337868480725
E01016042,1510,775,735,0.5132450331125827,0.4867549668874172
E01016043,1416,696,720,0.4915254237288136,0.5084745762711864
E01016177,1567,755,812,0.48181238034460755,0.5181876196553925
E01016178,1530,747,783,0.48823529411764705,0.5117647058823529
E01016117,1764,875,889,0.49603174603174605,0.503968253968254
E01016129,1924,1015,909,0.5275467775467776,0.47245322245322247
E01016130,1891,1004,887,0.5309360126916975,0.4690639873083025
E01016131,1735,827,908,0.47665706051873197,0.523342939481268
E01016016,1521,760,761,0.4996712689020381,0.5003287310979618
E01016017,1576,812,764,0.5152284263959391,0.4847715736040609
E01016019,1866,938,928,0.5026795284030011,0.49732047159699894
E01016110,2072,1014,1058,0.4893822393822394,0.5106177606177607
E01016111,1244,660,584,0.5305466237942122,0.4694533762057878
E01016044,1704,856,848,0.5023474178403756,0.49765258215962443
E01016046,1528,757,771,0.4954188481675393,0.5045811518324608
E01016047,1725,880,845,0.5101449275362319,0.48985507246376814
E01016048,1699,868,831,0.5108887580929958,0.4891112419070041
E01016113,1486,737,749,0.4959623149394347,0.5040376850605652
E01016114,1584,768,816,0.48484848484848486,0.5151515151515151
E01016115,1944,937,1007,0.48199588477366256,0.5180041152263375
E01016118,1741,855,886,0.4910970706490523,0.5089029293509477
E01016160,1474,703,771,0.4769335142469471,0.5230664857530529
E01016161,1543,706,837,0.457550226830849,0.542449773169151
E01016162,1646,821,825,0.49878493317132444,0.5012150668286756
E01016163,1331,644,687,0.4838467317806161,0.5161532682193839
E01016164,1495,707,788,0.4729096989966555,0.5270903010033445
E01016165,1300,637,663,0.49,0.51
E01016159,1381,637,744,0.46125995655322233,0.5387400434467777
E01016174,1400,711,689,0.5078571428571429,0.49214285714285716
E01016175,1840,916,924,0.49782608695652175,0.5021739130434782
E01016179,1381,694,687,0.502534395365677,0.49746560463432293
E01016061,1695,898,797,0.5297935103244837,0.4702064896755162
E01016063,1633,849,784,0.5199020208205756,0.4800979791794244
E01016064,1566,811,755,0.5178799489144317,0.4821200510855683
E01016069,1810,961,849,0.530939226519337,0.469060773480663
E01016020,1244,592,652,0.4758842443729904,0.5241157556270096
E01016021,1527,792,735,0.518664047151277,0.481335952848723
E01016022,1427,684,743,0.4793272599859846,0.5206727400140154
E01016125,1763,883,880,0.500850822461713,0.499149177538287
E01016018,1986,1006,980,0.5065458207452165,0.49345417925478346
E01016023,1686,812,874,0.4816132858837485,0.5183867141162515
E01016024,1958,981,977,0.5010214504596527,0.4989785495403473
E01016062,1505,740,765,0.49169435215946844,0.5083056478405316
E01016093,1548,770,778,0.4974160206718346,0.5025839793281653
E01016096,1430,677,753,0.4734265734265734,0.5265734265734265
E01016166,1450,722,728,0.4979310344827586,0.5020689655172413
E01016167,1428,710,718,0.49719887955182074,0.5028011204481793
E01016116,1832,874,958,0.47707423580786024,0.5229257641921398
E01016127,1519,748,771,0.4924292297564187,0.5075707702435813
E01016128,2068,1305,763,0.6310444874274661,0.36895551257253384
E01016132,1642,822,820,0.5006090133982948,0.4993909866017052
E01016094,1456,703,753,0.48282967032967034,0.5171703296703297
E01016095,1303,614,689,0.4712202609363008,0.5287797390636991
E01016097,1448,707,741,0.4882596685082873,0.5117403314917127
E01016098,1378,613,765,0.4448476052249637,0.5551523947750363
E01016102,1445,687,758,0.4754325259515571,0.524567474048443
E01016119,1522,745,777,0.4894875164257556,0.5105124835742444
E01016120,1374,681,693,0.49563318777292575,0.5043668122270742
E01016124,1690,825,865,0.4881656804733728,0.5118343195266272
E01016126,1691,820,871,0.48492016558249557,0.5150798344175045
E01016025,1622,760,862,0.468557336621455,0.531442663378545
E01016065,1410,691,719,0.4900709219858156,0.5099290780141844
E01016066,1490,701,789,0.4704697986577181,0.5295302013422819
E01016067,1611,777,834,0.4823091247672253,0.5176908752327747
E01016068,1659,788,871,0.47498493068113323,0.5250150693188668
E01016026,1258,630,628,0.5007949125596184,0.49920508744038156
E01016027,1528,752,776,0.49214659685863876,0.5078534031413613
E01016028,1357,652,705,0.48047162859248344,0.5195283714075166
E01016029,1305,639,666,0.4896551724137931,0.5103448275862069
E01016087,1681,830,851,0.49375371802498513,0.5062462819750149
E01016088,1514,738,776,0.48745046235138706,0.512549537648613
E01016089,1580,768,812,0.4860759493670886,0.5139240506329114
E01016090,1495,731,764,0.4889632107023411,0.5110367892976588
E01016085,1615,782,833,0.4842105263157895,0.5157894736842106
E01016086,1300,602,698,0.46307692307692305,0.536923076923077
E01016091,1514,746,768,0.49273447820343463,0.5072655217965654
E01016176,1525,754,771,0.4944262295081967,0.5055737704918033
E01016058,1473,719,754,0.4881194840461643,0.5118805159538357
E01016059,1344,649,695,0.48288690476190477,0.5171130952380952
E01016079,1353,678,675,0.5011086474501109,0.49889135254988914
E01016083,1334,626,708,0.46926536731634183,0.5307346326836582
E01016084,1518,727,791,0.47891963109354413,0.5210803689064558
E01016101,1470,722,748,0.49115646258503404,0.508843537414966
E01016103,1458,725,733,0.49725651577503427,0.5027434842249657
E01016104,1428,691,737,0.4838935574229692,0.5161064425770309
E01016107,1547,800,747,0.5171299288946348,0.48287007110536523
E01016121,1535,739,796,0.48143322475570033,0.5185667752442997
E01016122,1529,738,791,0.48266841072596467,0.5173315892740353
E01016123,1574,772,802,0.49047013977128334,0.5095298602287166
E01016173,1590,778,812,0.48930817610062893,0.5106918238993711
E01016078,1517,754,763,0.4970336189848385,0.5029663810151616
E01016080,1513,743,770,0.4910773298083278,0.5089226701916721
E01016081,1611,784,827,0.4866542520173805,0.5133457479826194
E01016082,1587,787,800,0.4959042218021424,0.5040957781978576
E01016050,1698,839,859,0.49411071849234395,0.5058892815076561
E01016051,1599,801,798,0.50093808630394,0.49906191369606
E01016052,1684,814,870,0.4833729216152019,0.5166270783847982
E01016053,1548,722,826,0.4664082687338501,0.5335917312661499
E01016054,1474,734,740,0.49796472184531887,0.5020352781546812
E01016092,1553,763,790,0.49130714745653575,0.5086928525434643
E01016099,1526,739,787,0.4842726081258191,0.5157273918741808
E01016100,1533,710,823,0.46314416177429873,0.5368558382257013
E01016105,1416,697,719,0.4922316384180791,0.507768361581921
E01016106,1450,713,737,0.4917241379310345,0.5082758620689655
E01016168,1556,758,798,0.487146529562982,0.512853470437018
E01016169,1709,854,855,0.49970743124634287,0.5002925687536571
E01016171,1578,748,830,0.4740177439797212,0.5259822560202788
E01016172,1448,723,725,0.4993093922651934,0.5006906077348067
E01016055,1552,776,776,0.5,0.5
E01016056,1391,676,715,0.48598130841121495,0.514018691588785
E01016057,1712,856,856,0.5,0.5
E01016060,1607,789,818,0.4909769757311761,0.5090230242688238
E01016170,1639,801,838,0.48871262965222695,0.511287370347773
E01016796,1526,725,801,0.4750982961992136,0.5249017038007864
E01016797,1782,822,960,0.4612794612794613,0.5387205387205387
E01016798,1924,962,962,0.5,0.5
E01016799,1871,926,945,0.4949225013361839,0.5050774986638161
E01016800,1632,798,834,0.4889705882352941,0.5110294117647058
E01016759,1378,677,701,0.49129172714078373,0.5087082728592163
E01016760,2386,1162,1224,0.48700754400670576,0.5129924559932942
E01016761,1368,702,666,0.5131578947368421,0.4868421052631579
E01016801,1350,654,696,0.48444444444444446,0.5155555555555555
E01016802,1433,690,743,0.48150732728541523,0.5184926727145848
E01016803,1319,649,670,0.4920394238059136,0.5079605761940864
E01016786,1432,671,761,0.4685754189944134,0.5314245810055865
E01016787,1658,778,880,0.4692400482509047,0.5307599517490953
E01016788,1611,794,817,0.4928615766604593,0.5071384233395406
E01016789,1334,637,697,0.4775112443778111,0.5224887556221889
E01016790,1357,655,702,0.48268238761974946,0.5173176123802505
E01016791,1437,696,741,0.48434237995824636,0.5156576200417536
E01016792,1299,631,668,0.4857582755966128,0.5142417244033872
E01016793,1948,975,973,0.5005133470225873,0.49948665297741274
E01016794,1483,750,733,0.5057316250842886,0.4942683749157114
E01016795,1559,760,799,0.48749198203976907,0.5125080179602309
E01016762,1278,619,659,0.4843505477308294,0.5156494522691706
E01016764,1431,713,718,0.49825296995108315,0.5017470300489169
E01016766,1352,650,702,0.4807692307692308,0.5192307692307693
E01016767,1324,645,679,0.4871601208459215,0.5128398791540786
E01016771,1370,639,731,0.4664233576642336,0.5335766423357664
E01016806,1955,957,998,0.4895140664961637,0.5104859335038363
E01016807,1733,872,861,0.5031736872475476,0.49682631275245237
E01016809,1424,669,755,0.46980337078651685,0.5301966292134831
E01016835,1632,780,852,0.47794117647058826,0.5220588235294118
E01016763,1340,653,687,0.4873134328358209,0.5126865671641792
E01016769,1400,696,704,0.49714285714285716,0.5028571428571429
E01016770,1674,824,850,0.4922341696535245,0.5077658303464755
E01016773,1801,867,934,0.4813992226540811,0.5186007773459189
E01016836,1677,863,814,0.5146094215861657,0.4853905784138342
E01016837,1858,942,916,0.5069967707212056,0.4930032292787944
E01016838,1606,795,811,0.4950186799501868,0.5049813200498132
E01016841,2117,1047,1070,0.49456778460085027,0.5054322153991497
E01016721,1666,847,819,0.5084033613445378,0.49159663865546216
E01016765,1672,779,893,0.4659090909090909,0.5340909090909091
E01016772,1385,674,711,0.4866425992779783,0.5133574007220216
E01016804,1648,779,869,0.47269417475728154,0.5273058252427184
E01016812,1562,761,801,0.4871959026888604,0.5128040973111395
E01016817,1523,737,786,0.48391332895600786,0.5160866710439921
E01016818,1699,802,897,0.4720423778693349,0.5279576221306651
E01016840,2598,1276,1322,0.4911470361816782,0.5088529638183218
E01016719,1458,718,740,0.4924554183813443,0.5075445816186557
E01016722,1634,812,822,0.4969400244798042,0.5030599755201959
E01016805,1342,693,649,0.5163934426229508,0.48360655737704916
E01016808,1367,665,702,0.4864667154352597,0.5135332845647403
E01016810,1319,635,684,0.48142532221379836,0.5185746777862017
E01016811,1507,740,767,0.49104180491041804,0.508958195089582
E01016819,1158,550,608,0.4749568221070812,0.5250431778929189
E01016839,1636,766,870,0.4682151589242054,0.5317848410757946
E01016717,1545,764,781,0.49449838187702266,0.5055016181229773
E01016720,1554,740,814,0.47619047619047616,0.5238095238095238
E01016723,1738,900,838,0.5178365937859609,0.48216340621403914
E01016724,1728,938,790,0.5428240740740741,0.45717592592592593
E01016718,1615,834,781,0.5164086687306502,0.48359133126934983
E01016729,2213,1154,1059,0.5214640759150474,0.47853592408495255
E01016768,2042,1121,921,0.548971596474045,0.45102840352595497
E01033499,1393,789,604,0.5664034458004307,0.4335965541995693
E01033500,1333,793,540,0.5948987246811703,0.4051012753188297
E01016776,1468,739,729,0.5034059945504087,0.49659400544959126
E01016813,1398,690,708,0.49356223175965663,0.5064377682403434
E01016815,1324,695,629,0.5249244712990937,0.47507552870090636
E01016816,1493,719,774,0.4815807099799062,0.5184192900200938
E01016731,1497,723,774,0.48296593186372744,0.5170340681362725
E01016732,1432,691,741,0.4825418994413408,0.5174581005586593
E01016784,1615,831,784,0.5145510835913313,0.4854489164086687
E01033501,2062,1053,1009,0.5106692531522793,0.48933074684772065
E01033506,2037,1059,978,0.5198821796759941,0.4801178203240059
E01016783,1944,947,997,0.48713991769547327,0.5128600823045267
E01016820,1648,801,847,0.48604368932038833,0.5139563106796117
E01016821,1465,674,791,0.46006825938566553,0.5399317406143345
E01016823,1703,839,864,0.4926600117439812,0.5073399882560188
E01033503,1554,751,803,0.48326898326898327,0.5167310167310167
E01033508,1716,867,849,0.5052447552447552,0.49475524475524474
E01033509,1665,841,824,0.5051051051051051,0.4948948948948949
E01033511,1514,803,711,0.5303830911492734,0.46961690885072654
E01033512,1668,841,827,0.5041966426858513,0.4958033573141487
E01016726,1709,926,783,0.5418373317729667,0.45816266822703333
E01016733,1911,1008,903,0.5274725274725275,0.4725274725274725
E01016845,1894,928,966,0.48996832101372756,0.5100316789862724
E01016846,1635,795,840,0.48623853211009177,0.5137614678899083
E01016848,1497,740,757,0.49432197728790916,0.5056780227120908
E01016780,1736,847,889,0.4879032258064516,0.5120967741935484
E01016781,1533,751,782,0.48988910632746246,0.5101108936725375
E01016814,1642,836,806,0.5091352009744214,0.49086479902557856
E01033505,1776,1091,685,0.6143018018018018,0.38569819819819817
E01033522,1448,759,689,0.524171270718232,0.47582872928176795
E01033523,1491,742,749,0.49765258215962443,0.5023474178403756
E01033525,1756,854,902,0.4863325740318907,0.5136674259681093
E01016774,1781,876,905,0.4918585064570466,0.5081414935429533
E01016775,1733,807,926,0.465666474321985,0.534333525678015
E01016777,1618,806,812,0.49814585908529047,0.5018541409147095
E01016778,1768,868,900,0.49095022624434387,0.5090497737556561
E01016725,1633,835,798,0.511328842620943,0.488671157379057
E01016727,1742,893,849,0.5126291618828932,0.4873708381171068
E01016728,1996,1051,945,0.5265531062124249,0.47344689378757515
E01016847,2065,998,1067,0.48329297820823247,0.5167070217917675
E01016822,1561,773,788,0.4951953875720692,0.5048046124279308
E01016824,1622,803,819,0.49506781750924783,0.5049321824907521
E01016825,1516,757,759,0.49934036939313986,0.5006596306068601
E01016827,1692,833,859,0.4923167848699764,0.5076832151300237
E01016828,1795,896,899,0.4991643454038997,0.5008356545961002
E01016842,1594,783,811,0.49121706398996234,0.5087829360100377
E01016843,1526,773,753,0.5065530799475754,0.49344692005242463
E01016844,1613,785,828,0.4866707997520149,0.5133292002479851
E01033497,1074,527,547,0.49068901303538176,0.5093109869646183
E01033498,1326,692,634,0.521870286576169,0.4781297134238311
E01016734,1219,607,612,0.49794913863822804,0.5020508613617719
E01016735,2071,1052,1019,0.5079671656204732,0.4920328343795268
E01016736,1382,618,764,0.447178002894356,0.552821997105644
E01016826,1557,778,779,0.49967886962106617,0.5003211303789339
E01016752,1742,838,904,0.48105625717566014,0.5189437428243399
E01016753,2242,1089,1153,0.4857270294380018,0.5142729705619982
E01016755,1905,942,963,0.494488188976378,0.5055118110236221
E01033514,1465,742,723,0.5064846416382253,0.49351535836177474
E01033515,1950,965,985,0.4948717948717949,0.5051282051282051
E01033517,1598,800,798,0.5006257822277848,0.49937421777221525
E01016754,1652,795,857,0.4812348668280872,0.5187651331719129
E01016756,2287,1064,1223,0.46523830345430695,0.534761696545693
E01016757,1579,803,776,0.5085497150094996,0.4914502849905003
E01016758,1725,840,885,0.48695652173913045,0.5130434782608696
E01016737,1641,793,848,0.48324192565508833,0.5167580743449116
E01016738,1815,797,1018,0.4391184573002755,0.5608815426997246
E01016739,1569,790,779,0.5035054174633524,0.4964945825366475
E01016740,1367,686,681,0.5018288222384785,0.4981711777615216
E01016741,1670,838,832,0.5017964071856288,0.49820359281437127
E01016748,1977,1005,972,0.5083459787556904,0.49165402124430957
E01016750,1629,802,827,0.4923265807243708,0.5076734192756293
E01016751,1614,787,827,0.4876084262701363,0.5123915737298637
E01033519,1870,909,961,0.48609625668449197,0.513903743315508
E01033520,1809,890,919,0.4919845218352681,0.5080154781647319
E01016829,1564,729,835,0.46611253196930946,0.5338874680306905
E01016831,1555,750,805,0.48231511254019294,0.5176848874598071
E01016832,1279,628,651,0.4910086004691165,0.5089913995308835
E01016833,1290,632,658,0.48992248062015503,0.5100775193798449
E01016834,1543,742,801,0.48088139987038236,0.5191186001296176
E01016710,1738,791,947,0.45512082853855007,0.5448791714614499
E01016714,1883,916,967,0.48645778013807756,0.5135422198619225
E01016716,1871,954,917,0.5098877605558525,0.4901122394441475
E01016745,1567,779,788,0.4971282705807275,0.5028717294192725
E01016711,2370,1213,1157,0.5118143459915612,0.48818565400843883
E01016713,1670,824,846,0.4934131736526946,0.5065868263473053
E01016715,1649,773,876,0.4687689508793208,0.5312310491206792
E01016830,1231,600,631,0.487408610885459,0.512591389114541
E01016742,1643,784,859,0.47717589774802194,0.5228241022519781
E01016743,2024,958,1066,0.4733201581027668,0.5266798418972332
E01016744,1603,799,804,0.4984404242046163,0.5015595757953837
E01016746,1726,805,921,0.466396292004635,0.533603707995365
E01017112,1838,912,926,0.4961915125136017,0.5038084874863983
E01017115,1359,674,685,0.49595290654893304,0.5040470934510669
E01017117,1570,753,817,0.47961783439490446,0.5203821656050955
E01017119,1730,848,882,0.49017341040462425,0.5098265895953757
E01017120,1492,723,769,0.48458445040214476,0.5154155495978552
E01017051,1907,928,979,0.48662821185107497,0.513371788148925
E01017052,1419,694,725,0.48907681465821,0.51092318534179
E01017053,1349,642,707,0.4759080800593032,0.5240919199406968
E01017118,1564,738,826,0.4718670076726343,0.5281329923273658
E01017050,1549,757,792,0.48870238863783083,0.5112976113621691
E01017061,1694,864,830,0.5100354191263282,0.4899645808736718
E01017063,1611,786,825,0.48789571694599626,0.5121042830540037
E01017064,1655,759,896,0.45861027190332326,0.5413897280966767
E01017054,1412,686,726,0.48583569405099153,0.5141643059490085
E01017113,1510,722,788,0.4781456953642384,0.5218543046357615
E01017114,1351,705,646,0.5218356772760918,0.47816432272390824
E01017116,1596,774,822,0.4849624060150376,0.5150375939849624
E01017055,1575,759,816,0.4819047619047619,0.518095238095238
E01017056,1371,665,706,0.4850474106491612,0.5149525893508388
E01017057,1517,770,747,0.5075807514831905,0.4924192485168095
E01017058,1731,848,883,0.4898902368573079,0.5101097631426921
E01017060,1549,741,808,0.47837314396384767,0.5216268560361523
E01017086,1325,639,686,0.48226415094339625,0.5177358490566037
E01017089,1604,745,859,0.4644638403990025,0.5355361596009975
E01017090,1557,766,791,0.4919717405266538,0.5080282594733462
E01017091,1546,714,832,0.46183699870633893,0.538163001293661
E01017092,1493,720,773,0.4822505023442733,0.5177494976557268
E01017014,1590,803,787,0.5050314465408805,0.4949685534591195
E01017046,1708,868,840,0.5081967213114754,0.4918032786885246
E01017047,1647,782,865,0.474802671523983,0.525197328476017
E01017048,1576,777,799,0.4930203045685279,0.506979695431472
E01017085,1428,684,744,0.4789915966386555,0.5210084033613446
E01017084,1429,717,712,0.5017494751574527,0.4982505248425472
E01017087,1459,737,722,0.5051405071967101,0.49485949280328995
E01017088,1711,860,851,0.5026300409117476,0.4973699590882525
E01017105,1402,699,703,0.4985734664764622,0.5014265335235378
E01017107,1537,768,769,0.4996746909564086,0.5003253090435914
E01017104,1163,577,586,0.4961306964746346,0.5038693035253654
E01017106,1498,710,788,0.4739652870493992,0.5260347129506008
E01017108,1551,760,791,0.49000644745325594,0.5099935525467441
E01017109,1358,656,702,0.48306332842415317,0.5169366715758469
E01017041,1398,703,695,0.5028612303290415,0.4971387696709585
E01017043,1465,712,753,0.48600682593856653,0.5139931740614334
E01017044,1537,799,738,0.5198438516590761,0.4801561483409239
E01017049,1498,763,735,0.5093457943925234,0.49065420560747663
E01017110,1465,716,749,0.4887372013651877,0.5112627986348123
E01017111,1454,708,746,0.48693259972489683,0.5130674002751031
E01017013,1605,775,830,0.48286604361370716,0.5171339563862928
E01017042,1412,691,721,0.48937677053824363,0.5106232294617564
E01017045,1367,676,691,0.49451353328456477,0.5054864667154353
E01017075,1629,802,827,0.4923265807243708,0.5076734192756293
E01017082,1744,903,841,0.5177752293577982,0.4822247706422018
E01017083,1734,827,907,0.47693194925028837,0.5230680507497116
E01017036,1568,755,813,0.4815051020408163,0.5184948979591837
E01017037,1492,703,789,0.47117962466487934,0.5288203753351206
E01017038,1631,791,840,0.48497854077253216,0.5150214592274678
E01017102,1570,802,768,0.510828025477707,0.489171974522293
E01017103,1252,599,653,0.4784345047923323,0.5215654952076677
E01017015,1467,727,740,0.49556918882072254,0.5044308111792775
E01017016,1587,783,804,0.4933837429111531,0.5066162570888468
E01017017,1522,739,783,0.4855453350854139,0.514454664914586
E01017018,1601,786,815,0.4909431605246721,0.5090568394753279
E01017019,1998,1073,925,0.5370370370370371,0.46296296296296297
E01017020,2293,1131,1162,0.4932402965547318,0.5067597034452682
E01017076,1627,825,802,0.5070682237246465,0.4929317762753534
E01017077,1729,854,875,0.4939271255060729,0.5060728744939271
E01017078,1570,791,779,0.5038216560509554,0.4961783439490446
E01017079,1579,862,717,0.545915136162128,0.45408486383787205
E01017080,2048,1052,996,0.513671875,0.486328125
E01017081,1654,812,842,0.4909310761789601,0.5090689238210399
E01017031,1939,973,966,0.5018050541516246,0.4981949458483754
E01017032,2607,1335,1272,0.5120828538550057,0.48791714614499426
E01017034,1892,1161,731,0.6136363636363636,0.38636363636363635
E01017039,1754,849,905,0.48403648802736604,0.515963511972634
E01017040,1479,750,729,0.5070993914807302,0.49290060851926976
E01033381,1401,786,615,0.5610278372591007,0.43897216274089934
E01033383,1295,626,669,0.4833976833976834,0.5166023166023166
E01017021,1458,685,773,0.46982167352537724,0.5301783264746228
E01017093,1617,856,761,0.5293753865182437,0.4706246134817563
E01017096,1404,673,731,0.4793447293447293,0.5206552706552706
E01017099,1631,799,832,0.489883507050889,0.510116492949111
E01017100,1459,718,741,0.49211788896504455,0.5078821110349554
E01017101,1550,758,792,0.4890322580645161,0.5109677419354839
E01017035,1584,721,863,0.4551767676767677,0.5448232323232324
E01017128,1652,923,729,0.5587167070217918,0.44128329297820823
E01017129,1918,1094,824,0.570385818561001,0.42961418143899893
E01017130,1917,942,975,0.49139280125195617,0.5086071987480438
E01017132,2689,1314,1375,0.48865749349200444,0.5113425065079955
E01017133,1868,986,882,0.5278372591006424,0.4721627408993576
E01017023,1694,889,805,0.5247933884297521,0.47520661157024796
E01017025,2066,1110,956,0.537270087124879,0.462729912875121
E01017026,1956,930,1026,0.4754601226993865,0.5245398773006135
E01017029,1752,922,830,0.526255707762557,0.4737442922374429
E01017030,1988,977,1011,0.49144869215291753,0.5085513078470825
E01017022,1423,740,683,0.5200281096275474,0.4799718903724526
E01017024,1810,985,825,0.5441988950276243,0.4558011049723757
E01017027,1794,998,796,0.5562987736900781,0.443701226309922
E01017028,2177,1175,1002,0.5397335783187873,0.4602664216812127
E01017124,1747,889,858,0.5088723526044648,0.4911276473955352
E01017094,1557,795,762,0.5105973025048169,0.48940269749518306
E01017095,1811,888,923,0.49033683048039756,0.5096631695196024
E01017097,1637,835,802,0.5100794135613927,0.4899205864386072
E01017098,1445,683,762,0.4726643598615917,0.5273356401384083
E01017122,1743,953,790,0.546758462421113,0.45324153757888697
E01017125,1796,896,900,0.49888641425389757,0.5011135857461024
E01017127,1924,1103,821,0.5732848232848233,0.4267151767151767
E01017135,1685,926,759,0.5495548961424332,0.45044510385756675
E01017067,1470,732,738,0.49795918367346936,0.5020408163265306
E01017068,1773,873,900,0.49238578680203043,0.5076142131979695
E01017069,1900,875,1025,0.4605263157894737,0.5394736842105263
E01017070,1520,762,758,0.5013157894736842,0.4986842105263158
E01017074,1862,957,905,0.5139634801288937,0.48603651987110635
E01017073,1737,877,860,0.5048934945308002,0.49510650546919976
E01017123,2002,1067,935,0.532967032967033,0.46703296703296704
E01017131,1967,1032,935,0.5246568378240977,0.4753431621759024
E01033380,1510,890,620,0.5894039735099338,0.4105960264900662
E01033384,1428,754,674,0.5280112044817927,0.47198879551820727
E01017071,1702,932,770,0.5475910693301997,0.45240893066980026
E01017072,1627,830,797,0.510141364474493,0.48985863552550707
E01017121,1706,909,797,0.5328253223915592,0.4671746776084408
E01017126,1761,953,808,0.5411697898921067,0.45883021010789327
E01017059,1543,740,803,0.4795852235904083,0.5204147764095917
E01017062,1621,801,820,0.49413942011104256,0.5058605798889574
E01017066,1825,892,933,0.48876712328767125,0.5112328767123288
E01032604,1556,792,764,0.5089974293059126,0.4910025706940874
E01016407,1512,736,776,0.48677248677248675,0.5132275132275133
E01016408,1503,748,755,0.4976713240186294,0.5023286759813705
E01016410,1646,804,842,0.488456865127582,0.511543134872418
E01016411,1571,752,819,0.47867600254614895,0.521323997453851
E01016412,1549,749,800,0.4835377663008393,0.5164622336991608
E01016386,1456,714,742,0.49038461538461536,0.5096153846153846
E01016387,1549,770,779,0.4970948999354422,0.5029051000645578
E01016425,1768,880,888,0.497737556561086,0.502262443438914
E01016426,1410,687,723,0.48723404255319147,0.5127659574468085
E01016430,1418,693,725,0.48871650211565587,0.5112834978843441
E01016364,1414,702,712,0.49646393210749645,0.5035360678925035
E01016409,1714,796,918,0.4644107351225204,0.5355892648774796
E01016427,1618,734,884,0.453646477132262,0.546353522867738
E01016428,1866,903,963,0.48392282958199356,0.5160771704180064
E01016429,1621,765,856,0.4719309068476249,0.528069093152375
E01016362,1514,758,756,0.5006605019815059,0.49933949801849403
E01016363,1860,885,975,0.47580645161290325,0.5241935483870968
E01016365,1585,822,763,0.5186119873817034,0.48138801261829656
E01016366,1582,795,787,0.5025284450063211,0.4974715549936789
E01016367,1578,778,800,0.49302915082382764,0.5069708491761724
E01016380,1643,811,832,0.4936092513694461,0.5063907486305539
E01016383,1484,694,790,0.46765498652291104,0.532345013477089
E01016384,1637,813,824,0.49664019547953575,0.5033598045204642
E01016431,1597,772,825,0.4834063869755792,0.5165936130244208
E01016432,1469,693,776,0.4717494894486045,0.5282505105513955
E01016381,1458,720,738,0.49382716049382713,0.5061728395061729
E01016382,1746,856,890,0.49026345933562426,0.5097365406643757
E01016385,1666,810,856,0.48619447779111646,0.5138055222088835
E01016396,1275,630,645,0.49411764705882355,0.5058823529411764
E01016397,1391,658,733,0.47304097771387493,0.5269590222861251
E01016355,1836,974,862,0.5305010893246187,0.46949891067538124
E01016358,1724,923,801,0.5353828306264501,0.4646171693735499
E01016359,2093,1028,1065,0.49116101290014336,0.5088389870998566
E01016360,2057,1098,959,0.5337870685464269,0.4662129314535732
E01016361,1743,871,872,0.49971313826735514,0.5002868617326449
E01016356,1557,793,764,0.5093127809890816,0.49068721901091844
E01016357,1668,902,766,0.5407673860911271,0.4592326139088729
E01016395,1388,664,724,0.4783861671469741,0.521613832853026
E01016398,1700,868,832,0.5105882352941177,0.4894117647058824
E01016399,1416,735,681,0.5190677966101694,0.4809322033898305
E01016400,1481,750,731,0.5064145847400405,0.49358541525995947
E01016394,1355,625,730,0.4612546125461255,0.5387453874538746
E01016433,1379,678,701,0.4916606236403191,0.508339376359681
E01016434,1770,841,929,0.4751412429378531,0.5248587570621469
E01016435,1410,670,740,0.475177304964539,0.524822695035461
E01016436,1530,752,778,0.4915032679738562,0.5084967320261438
E01016402,1911,965,946,0.5049712192569336,0.49502878074306644
E01016404,2050,1050,1000,0.5121951219512195,0.4878048780487805
E01016405,2079,1125,954,0.5411255411255411,0.4588744588744589
E01016406,1602,855,747,0.5337078651685393,0.46629213483146065
E01033417,1095,601,494,0.5488584474885845,0.4511415525114155
E01033421,1780,935,845,0.5252808988764045,0.4747191011235955
E01016353,1797,966,831,0.5375626043405676,0.46243739565943237
E01016378,2083,1113,970,0.5343254920787326,0.4656745079212674
E01016391,1835,918,917,0.5002724795640326,0.4997275204359673
E01033415,1535,924,611,0.6019543973941368,0.3980456026058632
E01033418,1171,654,517,0.5584970111016225,0.44150298889837747
E01033420,1130,636,494,0.5628318584070796,0.43716814159292033
E01033422,1117,602,515,0.5389435989256938,0.4610564010743062
E01033423,1168,623,545,0.5333904109589042,0.4666095890410959
E01016401,1509,763,746,0.5056328694499669,0.4943671305500331
E01016403,1951,1000,951,0.5125576627370579,0.48744233726294206
E01016416,1637,876,761,0.535125229077581,0.4648747709224191
E01016417,1726,879,847,0.5092699884125145,0.4907300115874855
E01016418,1640,812,828,0.4951219512195122,0.5048780487804878
E01016388,1435,695,740,0.4843205574912892,0.5156794425087108
E01016389,1736,813,923,0.4683179723502304,0.5316820276497696
E01016390,1540,799,741,0.5188311688311689,0.4811688311688312
E01016392,2041,1052,989,0.5154336109750123,0.4845663890249878
E01016393,1554,768,786,0.4942084942084942,0.5057915057915058
E01016374,1626,843,783,0.518450184501845,0.48154981549815495
E01016375,1258,634,624,0.5039745627980922,0.4960254372019078
E01016376,1535,783,752,0.5100977198697069,0.48990228013029313
E01016379,1750,964,786,0.5508571428571428,0.4491428571428571
E01016413,1764,862,902,0.4886621315192744,0.5113378684807256
E01016414,1610,836,774,0.5192546583850932,0.48074534161490684
E01016419,1675,831,844,0.4961194029850746,0.5038805970149254
E01016420,1395,669,726,0.47956989247311826,0.5204301075268817
E01016421,1316,612,704,0.46504559270516715,0.5349544072948328
E01016422,1359,637,722,0.4687270051508462,0.5312729948491538
E01016423,1480,674,806,0.4554054054054054,0.5445945945945946
E01016424,1323,655,668,0.4950869236583522,0.5049130763416477
E01016370,3093,1492,1601,0.4823795667636599,0.5176204332363401
E01016371,1669,817,852,0.4895146794487717,0.5104853205512283
E01016373,1515,734,781,0.4844884488448845,0.5155115511551155
E01016415,1611,841,770,0.5220360024829298,0.47796399751707014
E01016368,1412,691,721,0.48937677053824363,0.5106232294617564
E01016372,1274,620,654,0.48665620094191525,0.5133437990580848
E01016377,1641,843,798,0.5137111517367459,0.48628884826325414
E01016438,1294,626,668,0.48377125193199383,0.5162287480680062
E01016442,2805,1434,1371,0.5112299465240642,0.48877005347593583
E01016443,1505,712,793,0.47308970099667774,0.5269102990033223
E01016369,1603,779,824,0.4859638178415471,0.5140361821584529
E01016437,1415,707,708,0.49964664310954066,0.5003533568904593
E01016439,1534,747,787,0.4869621903520209,0.5130378096479792
E01016440,1458,732,726,0.5020576131687243,0.49794238683127573
E01016441,1449,668,781,0.4610075914423741,0.538992408557626
E01016450,1609,774,835,0.4810441267868241,0.5189558732131759
E01016451,1620,789,831,0.48703703703703705,0.512962962962963
E01016452,1660,821,839,0.49457831325301205,0.505421686746988
E01016453,1559,776,783,0.49775497113534317,0.5022450288646568
E01016454,1531,758,773,0.4951012410189419,0.5048987589810582
E01016455,1397,642,755,0.4595561918396564,0.5404438081603435
E01016483,1798,926,872,0.5150166852057843,0.4849833147942158
E01016484,1578,808,770,0.5120405576679341,0.4879594423320659
E01016485,1725,900,825,0.5217391304347826,0.4782608695652174
E01016486,1650,799,851,0.48424242424242425,0.5157575757575757
E01016487,1777,888,889,0.49971862689926844,0.5002813731007316
E01016488,1806,903,903,0.5,0.5
E01016493,1237,596,641,0.48181083265966046,0.5181891673403395
E01016494,1929,971,958,0.5033696215655781,0.496630378434422
E01016495,1467,716,751,0.48807089297886846,0.5119291070211316
E01016496,1298,606,692,0.46687211093990755,0.5331278890600925
E01016497,1442,702,740,0.4868238557558946,0.5131761442441054
E01016498,1642,796,846,0.48477466504263095,0.5152253349573691
E01016499,1342,666,676,0.496274217585693,0.503725782414307
E01016444,1715,842,873,0.4909620991253644,0.5090379008746355
E01016445,1824,860,964,0.47149122807017546,0.5285087719298246
E01016446,1613,801,812,0.49659020458772474,0.5034097954122753
E01016447,1818,934,884,0.5137513751375138,0.48624862486248627
E01016448,2349,1211,1138,0.5155385270327799,0.4844614729672201
E01016449,2131,1054,1077,0.4946034725480995,0.5053965274519006
E01016516,1723,866,857,0.5026117237376668,0.4973882762623331
E01016517,1522,767,755,0.5039421813403416,0.49605781865965837
E01016518,1735,902,833,0.5198847262247839,0.4801152737752161
E01016519,2556,1145,1411,0.44796557120500785,0.5520344287949922
E01016520,1681,833,848,0.4955383700178465,0.5044616299821535
E01016521,1800,893,907,0.4961111111111111,0.5038888888888889
E01016467,1457,742,715,0.5092656142759094,0.4907343857240906
E01016468,1712,843,869,0.49240654205607476,0.5075934579439252
E01016469,1643,828,815,0.5039561777236762,0.4960438222763238
E01016470,1615,825,790,0.5108359133126935,0.4891640866873065
E01016471,1354,637,717,0.4704579025110783,0.5295420974889217
E01016472,1666,817,849,0.49039615846338536,0.5096038415366146
E01016456,2112,1121,991,0.5307765151515151,0.46922348484848486
E01016457,1892,939,953,0.4963002114164905,0.5036997885835095
E01016458,1746,823,923,0.4713631156930126,0.5286368843069874
E01016459,2210,1126,1084,0.5095022624434389,0.49049773755656106
E01016460,1869,931,938,0.49812734082397003,0.50187265917603
E01016461,2535,1321,1214,0.5211045364891519,0.4788954635108481
E01016473,2136,1062,1074,0.49719101123595505,0.5028089887640449
E01016474,1957,965,992,0.49310168625447115,0.5068983137455289
E01016475,2083,1038,1045,0.49831973115698514,0.5016802688430149
E01016476,1760,881,879,0.5005681818181819,0.4994318181818182
E01016477,2343,1171,1172,0.49978659837814765,0.5002134016218523
E01016478,1837,935,902,0.5089820359281437,0.49101796407185627
E01016462,2395,1277,1118,0.5331941544885177,0.46680584551148224
E01016463,1950,1056,894,0.5415384615384615,0.4584615384615385
E01016464,1892,1020,872,0.5391120507399577,0.4608879492600423
E01016465,2732,1390,1342,0.5087847730600292,0.4912152269399707
E01032729,1636,850,786,0.519559902200489,0.480440097799511
E01032730,1512,773,739,0.5112433862433863,0.4887566137566138
E01016506,1765,926,839,0.5246458923512748,0.4753541076487252
E01016507,1580,765,815,0.48417721518987344,0.5158227848101266
E01016508,1741,853,888,0.48994830557151064,0.5100516944284894
E01016509,1521,766,755,0.5036160420775806,0.49638395792241946
E01016510,1472,732,740,0.49728260869565216,0.5027173913043478
E01016511,1835,943,892,0.5138964577656676,0.48610354223433244
E01016512,1843,962,881,0.5219750406945198,0.47802495930548017
E01016513,1927,950,977,0.4929942916450441,0.5070057083549558
E01016514,1741,886,855,0.5089029293509477,0.4910970706490523
E01016515,2040,981,1059,0.4808823529411765,0.5191176470588236
E01016500,1796,852,944,0.47438752783964366,0.5256124721603563
E01016501,1597,765,832,0.47902316844082654,0.5209768315591734
E01016502,1458,706,752,0.4842249657064472,0.5157750342935528
E01016503,1546,776,770,0.5019404915912031,0.49805950840879687
E01016504,1419,705,714,0.49682875264270615,0.5031712473572939
E01016505,1688,835,853,0.4946682464454976,0.5053317535545023
E01016490,1956,952,1004,0.4867075664621677,0.5132924335378323
E01016491,1707,881,826,0.5161101347393088,0.4838898652606913
E01016492,1673,823,850,0.4919306634787806,0.5080693365212193
E01032731,1547,773,774,0.49967679379444085,0.5003232062055591
E01032732,1618,803,815,0.496291718170581,0.5037082818294191
E01016479,1592,829,763,0.5207286432160804,0.4792713567839196
E01016480,1377,670,707,0.4865649963689179,0.5134350036310821
E01016481,1457,756,701,0.5188743994509266,0.48112560054907344
E01016482,1731,914,817,0.5280184864240324,0.4719815135759676
E01017144,1218,623,595,0.5114942528735632,0.4885057471264368
E01017145,1427,721,706,0.5052557813594954,0.49474421864050455
E01017146,2223,1143,1080,0.5141700404858299,0.48582995951417
E01017148,2185,1089,1096,0.4983981693363844,0.5016018306636155
E01017149,1400,751,649,0.5364285714285715,0.4635714285714286
E01017180,1491,725,766,0.4862508383635144,0.5137491616364855
E01017181,1405,690,715,0.49110320284697506,0.5088967971530249
E01017183,1628,803,825,0.49324324324324326,0.5067567567567568
E01017185,1767,860,907,0.48670062252405205,0.5132993774759479
E01017187,1587,777,810,0.4896030245746692,0.5103969754253308
E01017264,2582,1322,1260,0.512006196746708,0.487993803253292
E01017265,1632,786,846,0.48161764705882354,0.5183823529411765
E01017270,1355,711,644,0.5247232472324723,0.4752767527675277
E01017271,1086,552,534,0.5082872928176796,0.49171270718232046
E01017182,1401,656,745,0.46823697359029265,0.5317630264097074
E01017184,1407,676,731,0.48045486851457003,0.51954513148543
E01017186,1652,826,826,0.5,0.5
E01017188,1708,830,878,0.4859484777517564,0.5140515222482436
E01017266,1442,767,675,0.5319001386962552,0.4680998613037448
E01017267,1238,665,573,0.537156704361874,0.462843295638126
E01017272,1413,674,739,0.4769992922859165,0.5230007077140835
E01032756,2916,1620,1296,0.5555555555555556,0.4444444444444444
E01017147,1432,715,717,0.4993016759776536,0.5006983240223464
E01017150,1511,762,749,0.5043017868960953,0.4956982131039047
E01017151,1573,753,820,0.47870311506675145,0.5212968849332485
E01017152,1563,782,781,0.5003198976327575,0.4996801023672425
E01017238,1402,702,700,0.5007132667617689,0.4992867332382311
E01017241,1425,651,774,0.4568421052631579,0.5431578947368421
E01017242,1432,719,713,0.5020949720670391,0.4979050279329609
E01017243,1727,887,840,0.5136074116965836,0.4863925883034163
E01017244,1339,635,704,0.47423450336071693,0.5257654966392831
E01017174,1318,637,681,0.48330804248861914,0.5166919575113809
E01017175,1545,773,772,0.5003236245954693,0.49967637540453075
E01017176,1617,823,794,0.5089672232529375,0.49103277674706247
E01017179,1461,723,738,0.4948665297741273,0.5051334702258727
E01017226,1484,751,733,0.5060646900269542,0.4939353099730458
E01017231,1709,897,812,0.5248683440608543,0.4751316559391457
E01017232,1260,641,619,0.5087301587301587,0.49126984126984125
E01032753,2444,1271,1173,0.5200490998363339,0.4799509001636661
E01017246,1923,949,974,0.49349973998959956,0.5065002600104004
E01017250,1415,650,765,0.45936395759717313,0.5406360424028268
E01017251,1563,770,793,0.4926423544465771,0.5073576455534229
E01017253,1711,847,864,0.4950321449444769,0.5049678550555231
E01017247,1637,789,848,0.48197923029932804,0.518020769700672
E01017248,1558,763,795,0.48973042362002567,0.5102695763799743
E01017249,1398,686,712,0.4907010014306152,0.5092989985693849
E01017252,1564,751,813,0.48017902813299235,0.5198209718670077
E01017254,1656,808,848,0.48792270531400966,0.5120772946859904
E01017236,1395,664,731,0.4759856630824373,0.5240143369175627
E01017237,1504,753,751,0.5006648936170213,0.49933510638297873
E01017239,1536,775,761,0.5045572916666666,0.4954427083333333
E01017240,1230,605,625,0.491869918699187,0.508130081300813
E01017245,1500,689,811,0.4593333333333333,0.5406666666666666
E01017227,1319,691,628,0.5238817285822593,0.4761182714177407
E01017228,1552,796,756,0.5128865979381443,0.48711340206185566
E01017233,1613,787,826,0.4879107253564786,0.5120892746435214
E01017234,1864,989,875,0.5305793991416309,0.4694206008583691
E01017235,1586,849,737,0.5353089533417402,0.4646910466582598
E01017171,1840,960,880,0.5217391304347826,0.4782608695652174
E01017172,1776,925,851,0.5208333333333334,0.4791666666666667
E01017173,1436,715,721,0.4979108635097493,0.5020891364902507
E01017177,1510,773,737,0.5119205298013245,0.4880794701986755
E01017178,1523,760,763,0.4990151017728168,0.5009848982271832
E01017207,1628,752,876,0.4619164619164619,0.538083538083538
E01017209,1440,727,713,0.5048611111111111,0.4951388888888889
E01017211,1760,820,940,0.4659090909090909,0.5340909090909091
E01017212,1374,675,699,0.4912663755458515,0.5087336244541485
E01017213,1515,780,735,0.5148514851485149,0.48514851485148514
E01017200,1772,862,910,0.48645598194130923,0.5135440180586908
E01017201,1368,650,718,0.47514619883040937,0.5248538011695907
E01017202,1675,772,903,0.4608955223880597,0.5391044776119402
E01017203,1634,786,848,0.4810281517747858,0.5189718482252142
E01017204,1551,760,791,0.49000644745325594,0.5099935525467441
E01017157,1576,863,713,0.5475888324873096,0.45241116751269034
E01017158,1891,1033,858,0.5462718138551031,0.4537281861448969
E01017159,1674,862,812,0.5149342891278376,0.4850657108721625
E01017160,1481,750,731,0.5064145847400405,0.49358541525995947
E01017198,1434,675,759,0.4707112970711297,0.5292887029288703
E01017199,1624,754,870,0.4642857142857143,0.5357142857142857
E01017205,1365,663,702,0.4857142857142857,0.5142857142857142
E01017206,1612,806,806,0.5,0.5
E01017208,1424,694,730,0.48735955056179775,0.5126404494382022
E01017210,1532,686,846,0.44778067885117495,0.5522193211488251
E01017214,1468,729,739,0.49659400544959126,0.5034059945504087
E01017215,1777,866,911,0.48733821046707937,0.5126617895329206
E01017216,1464,747,717,0.5102459016393442,0.48975409836065575
E01017189,1522,844,678,0.5545335085413929,0.4454664914586071
E01017190,1720,926,794,0.5383720930232558,0.46162790697674416
E01017191,1732,962,770,0.5554272517321016,0.4445727482678984
E01017196,2015,1097,918,0.5444168734491315,0.45558312655086847
E01017197,1520,757,763,0.4980263157894737,0.5019736842105263
E01017192,2023,1036,987,0.5121107266435986,0.48788927335640137
E01017193,1657,845,812,0.5099577549788775,0.49004224502112254
E01017194,1798,953,845,0.5300333704115684,0.4699666295884316
E01017195,1950,1033,917,0.5297435897435897,0.47025641025641024
E01017153,1631,912,719,0.5591661557326794,0.44083384426732064
E01017154,2289,1181,1108,0.5159458278724334,0.48405417212756663
E01017155,1698,963,735,0.5671378091872792,0.43286219081272087
E01017156,1813,996,817,0.549365692222835,0.4506343077771649
E01032738,1296,738,558,0.5694444444444444,0.4305555555555556
E01032750,1495,859,636,0.5745819397993311,0.4254180602006689
E01017136,1623,866,757,0.5335797905113987,0.46642020948860136
E01017137,1719,935,784,0.5439208842350204,0.4560791157649796
E01017138,2325,1109,1216,0.47698924731182796,0.5230107526881721
E01017140,1497,815,682,0.5444221776887107,0.45557782231128924
E01017217,1544,762,782,0.49352331606217614,0.5064766839378239
E01017223,1678,848,830,0.5053635280095352,0.49463647199046484
E01017224,1353,691,662,0.5107169253510717,0.4892830746489283
E01017225,1552,741,811,0.47744845360824745,0.5225515463917526
E01017162,1435,690,745,0.4808362369337979,0.519163763066202
E01017163,1549,754,795,0.486765655261459,0.513234344738541
E01017164,1503,753,750,0.500998003992016,0.499001996007984
E01017165,1458,711,747,0.4876543209876543,0.5123456790123457
E01017166,1507,696,811,0.4618447246184472,0.5381552753815527
E01017256,2029,977,1052,0.4815179891572203,0.5184820108427797
E01017257,1560,789,771,0.5057692307692307,0.49423076923076925
E01017259,1451,732,719,0.5044796691936595,0.49552033080634045
E01017260,1382,668,714,0.4833574529667149,0.516642547033285
E01017262,1335,657,678,0.49213483146067416,0.5078651685393258
E01017167,1527,733,794,0.48002619515389655,0.5199738048461034
E01017168,1695,838,857,0.4943952802359882,0.5056047197640118
E01017169,1554,702,852,0.4517374517374517,0.5482625482625483
E01017170,1572,759,813,0.48282442748091603,0.517175572519084
E01017218,1353,677,676,0.500369549150037,0.49963045084996305
E01017219,1729,861,868,0.4979757085020243,0.5020242914979757
E01017220,1843,911,932,0.49430276722734673,0.5056972327726533
E01017221,1624,801,823,0.4932266009852217,0.5067733990147784
E01017222,1527,763,764,0.4996725605762934,0.5003274394237066
E01017139,2406,1260,1146,0.5236907730673317,0.4763092269326683
E01017142,2367,1351,1016,0.5707646810308408,0.4292353189691593
E01032745,2298,1221,1077,0.5313315926892951,0.46866840731070497
E01032746,1165,675,490,0.5793991416309013,0.4206008583690987
E01032748,1080,633,447,0.5861111111111111,0.41388888888888886
E01032751,1181,663,518,0.5613886536833192,0.4386113463166808
E01032755,1101,617,484,0.5603996366939146,0.4396003633060854
E01017255,1594,802,792,0.5031367628607277,0.4968632371392723
E01017258,1558,790,768,0.5070603337612324,0.49293966623876767
E01017261,1715,838,877,0.48862973760932943,0.5113702623906705
E01017263,1429,706,723,0.4940517844646606,0.5059482155353394
E01017273,1435,665,770,0.4634146341463415,0.5365853658536586
E01017275,1643,787,856,0.47900182592818014,0.5209981740718198
E01017276,1718,883,835,0.5139697322467986,0.4860302677532014
E01017278,1335,663,672,0.4966292134831461,0.503370786516854
E01017279,1691,800,891,0.47309284447072736,0.5269071555292726
E01017274,1490,702,788,0.47114093959731546,0.5288590604026846
E01017277,1502,715,787,0.4760319573901465,0.5239680426098535
E01017280,1394,661,733,0.47417503586800575,0.5258249641319943
E01017281,1644,835,809,0.5079075425790754,0.49209245742092456
E01016277,1576,834,742,0.5291878172588832,0.47081218274111675
E01016286,1571,816,755,0.5194143857415658,0.4805856142584341
E01016287,1464,714,750,0.48770491803278687,0.5122950819672131
E01016288,1651,806,845,0.4881889763779528,0.5118110236220472
E01016303,1472,719,753,0.48845108695652173,0.5115489130434783
E01016304,1544,770,774,0.49870466321243523,0.5012953367875648
E01016305,1245,606,639,0.4867469879518072,0.5132530120481927
E01016306,1314,679,635,0.5167427701674278,0.4832572298325723
E01016256,1747,903,844,0.5168860904407556,0.48311390955924444
E01016257,1356,649,707,0.4786135693215339,0.5213864306784661
E01016313,1611,759,852,0.47113594040968343,0.5288640595903166
E01016314,1367,696,671,0.5091441111923921,0.4908558888076079
E01016315,1581,784,797,0.4958886780518659,0.5041113219481341
E01016316,1998,975,1023,0.487987987987988,0.512012012012012
E01016317,1426,702,724,0.49228611500701264,0.5077138849929874
E01016318,1543,756,787,0.4899546338302009,0.5100453661697991
E01016258,1542,781,761,0.506485084306096,0.49351491569390404
E01016261,1647,803,844,0.48755312689738917,0.5124468731026108
E01016349,1230,625,605,0.508130081300813,0.491869918699187
E01016350,1526,755,771,0.4947575360419397,0.5052424639580603
E01016259,1550,768,782,0.49548387096774194,0.5045161290322581
E01016260,1710,857,853,0.5011695906432748,0.4988304093567251
E01016262,1340,651,689,0.48582089552238805,0.514179104477612
E01016272,1543,768,775,0.49773169151004537,0.5022683084899546
E01016273,1514,710,804,0.46895640686922063,0.5310435931307794
E01016263,2258,1126,1132,0.49867139061116034,0.5013286093888397
E01016278,1314,722,592,0.5494672754946728,0.4505327245053272
E01016283,2017,756,1261,0.3748140803173029,0.6251859196826971
E01016284,1441,702,739,0.4871616932685635,0.5128383067314365
E01016285,1593,814,779,0.5109855618330195,0.48901443816698054
E01016271,1401,685,716,0.4889364739471806,0.5110635260528195
E01016274,1386,701,685,0.5057720057720058,0.49422799422799424
E01016275,1470,711,759,0.48367346938775513,0.5163265306122449
E01016276,1471,728,743,0.49490142760027195,0.5050985723997281
E01016327,1196,602,594,0.5033444816053512,0.49665551839464883
E01016328,1757,844,913,0.4803642572566875,0.5196357427433125
E01016344,1488,715,773,0.48051075268817206,0.519489247311828
E01016345,1347,675,672,0.5011135857461024,0.49888641425389757
E01016296,1565,735,830,0.4696485623003195,0.5303514376996805
E01016297,1546,751,795,0.4857697283311772,0.5142302716688227
E01016298,1174,567,607,0.4829642248722317,0.5170357751277683
E01016299,1482,743,739,0.5013495276653172,0.49865047233468285
E01016254,1341,655,686,0.488441461595824,0.511558538404176
E01016255,1510,811,699,0.5370860927152318,0.4629139072847682
E01016264,1618,902,716,0.5574783683559951,0.44252163164400493
E01016265,1479,733,746,0.495605138607167,0.504394861392833
E01016266,1375,693,682,0.504,0.496
E01016339,2913,1506,1407,0.5169927909371782,0.48300720906282185
E01016310,1804,834,970,0.4623059866962306,0.5376940133037694
E01016311,1610,807,803,0.5012422360248447,0.49875776397515525
E01016323,1381,658,723,0.47646632874728456,0.5235336712527154
E01016324,1392,688,704,0.4942528735632184,0.5057471264367817
E01016325,1538,764,774,0.4967490247074122,0.5032509752925878
E01016279,2099,1056,1043,0.5030967127203431,0.496903287279657
E01016280,1831,910,921,0.496996176952485,0.503003823047515
E01016281,1422,731,691,0.5140646976090014,0.4859353023909986
E01016282,1475,738,737,0.5003389830508475,0.49966101694915255
E01016329,1461,730,731,0.4996577686516085,0.5003422313483915
E01016340,1573,789,784,0.501589319771138,0.49841068022886204
E01016341,1402,712,690,0.5078459343794579,0.4921540656205421
E01016342,1967,1014,953,0.5155058464667006,0.48449415353329944
E01016343,1448,725,723,0.5006906077348067,0.4993093922651934
E01016267,1424,709,715,0.4978932584269663,0.5021067415730337
E01016268,1594,790,804,0.49560853199498117,0.5043914680050188
E01016269,1407,709,698,0.503909026297086,0.496090973702914
E01016270,1530,745,785,0.4869281045751634,0.5130718954248366
E01016330,1420,693,727,0.4880281690140845,0.5119718309859155
E01016331,1601,776,825,0.48469706433479076,0.5153029356652092
E01016332,1551,753,798,0.48549323017408125,0.5145067698259188
E01016334,1735,871,864,0.5020172910662825,0.4979827089337176
E01016336,1278,629,649,0.4921752738654147,0.5078247261345853
E01016333,1297,637,660,0.49113338473400153,0.5088666152659984
E01016335,1560,799,761,0.5121794871794871,0.4878205128205128
E01016337,2179,1101,1078,0.505277650298302,0.49472234970169804
E01016338,1882,948,934,0.5037194473963869,0.4962805526036132
E01016300,1461,717,744,0.49075975359342916,0.5092402464065708
E01016301,1930,979,951,0.5072538860103627,0.4927461139896373
E01016302,1643,834,809,0.5076080340839927,0.4923919659160073
E01016326,1351,639,712,0.47298297557364916,0.5270170244263509
E01016293,2684,1312,1372,0.488822652757079,0.511177347242921
E01016346,1334,666,668,0.4992503748125937,0.5007496251874063
E01016347,1494,756,738,0.5060240963855421,0.4939759036144578
E01016348,2024,1022,1002,0.5049407114624506,0.4950592885375494
E01016294,1493,756,737,0.506363027461487,0.4936369725385131
E01016295,1505,733,772,0.4870431893687708,0.5129568106312292
E01016312,1940,965,975,0.49742268041237114,0.5025773195876289
E01016319,1647,756,891,0.45901639344262296,0.5409836065573771
E01016320,1380,696,684,0.5043478260869565,0.4956521739130435
E01016289,1427,688,739,0.4821303433777155,0.5178696566222845
E01016290,1549,769,780,0.4964493221433183,0.5035506778566817
E01016291,1783,879,904,0.4929893438025799,0.50701065619742
E01016292,1602,797,805,0.4975031210986267,0.5024968789013733
E01016321,1483,758,725,0.5111260957518543,0.48887390424814564
E01016322,1289,649,640,0.5034910783553141,0.4965089216446858
E01016307,1591,771,820,0.4846008799497172,0.5153991200502829
E01016308,1888,942,946,0.4989406779661017,0.5010593220338984
E01016309,2253,1158,1095,0.5139813581890812,0.48601864181091875
E01016570,1595,753,842,0.47210031347962383,0.5278996865203762
E01016572,1345,629,716,0.46765799256505575,0.5323420074349442
E01016582,1475,749,726,0.5077966101694915,0.4922033898305085
E01016600,1175,558,617,0.4748936170212766,0.5251063829787234
E01016530,1494,720,774,0.4819277108433735,0.5180722891566265
E01016531,1441,723,718,0.501734906315059,0.49826509368494104
E01016532,2015,992,1023,0.49230769230769234,0.5076923076923077
E01016533,1928,932,996,0.483402489626556,0.516597510373444
E01016578,1474,734,740,0.49796472184531887,0.5020352781546812
E01016579,1697,848,849,0.4997053624042428,0.5002946375957572
E01016581,1441,711,730,0.49340735600277585,0.5065926439972241
E01016571,1554,785,769,0.5051480051480052,0.4948519948519948
E01016573,1400,673,727,0.4807142857142857,0.5192857142857142
E01016574,1499,717,782,0.4783188792528352,0.5216811207471648
E01016599,1614,813,801,0.5037174721189591,0.4962825278810409
E01016583,1589,792,797,0.4984266834487099,0.5015733165512901
E01016585,1620,826,794,0.5098765432098765,0.4901234567901235
E01016586,1354,657,697,0.48522895125553916,0.5147710487444609
E01016591,1704,868,836,0.5093896713615024,0.49061032863849763
E01016592,1849,876,973,0.4737696051919957,0.5262303948080044
E01016525,1603,781,822,0.487211478477854,0.5127885215221459
E01016528,1621,807,814,0.49784083898827886,0.5021591610117212
E01016529,1638,806,832,0.49206349206349204,0.5079365079365079
E01016536,1855,931,924,0.5018867924528302,0.4981132075471698
E01016584,1675,822,853,0.49074626865671644,0.5092537313432836
E01032733,1026,495,531,0.4824561403508772,0.5175438596491229
E01032734,1435,743,692,0.5177700348432056,0.48222996515679445
E01016526,1852,896,956,0.4838012958963283,0.5161987041036717
E01016527,1601,775,826,0.4840724547158026,0.5159275452841974
E01016534,1530,741,789,0.4843137254901961,0.515686274509804
E01016598,1410,665,745,0.4716312056737589,0.5283687943262412
E01016601,1620,773,847,0.47716049382716047,0.5228395061728395
E01016602,1573,740,833,0.47043865225683407,0.5295613477431659
E01016535,1273,617,656,0.4846818538884525,0.5153181461115475
E01016537,1529,772,757,0.5049051667756703,0.4950948332243296
E01016538,1611,818,793,0.5077591558038486,0.49224084419615144
E01016593,1675,826,849,0.493134328358209,0.5068656716417911
E01016594,1452,714,738,0.49173553719008267,0.5082644628099173
E01016559,1477,749,728,0.5071090047393365,0.4928909952606635
E01016560,1518,753,765,0.49604743083003955,0.5039525691699605
E01016561,1784,877,907,0.4915919282511211,0.5084080717488789
E01016562,1384,673,711,0.48627167630057805,0.513728323699422
E01016563,1342,659,683,0.4910581222056632,0.5089418777943369
E01016580,1517,714,803,0.47066578773895845,0.5293342122610415
E01016539,1589,807,782,0.5078665827564506,0.4921334172435494
E01016540,1665,802,863,0.4816816816816817,0.5183183183183183
E01016541,1384,693,691,0.5007225433526011,0.49927745664739887
E01016542,1202,593,609,0.4933444259567388,0.5066555740432612
E01016543,1643,822,821,0.5003043213633597,0.4996956786366403
E01016544,1705,952,753,0.5583577712609971,0.44164222873900294
E01016567,2748,1848,900,0.6724890829694323,0.32751091703056767
E01016568,1240,597,643,0.4814516129032258,0.5185483870967742
E01016569,1020,498,522,0.48823529411764705,0.5117647058823529
E01016564,1628,804,824,0.49385749385749383,0.5061425061425061
E01016565,1563,766,797,0.49008317338451696,0.5099168266154831
E01016566,1722,857,865,0.49767711962833916,0.5023228803716608
E01016577,1683,815,868,0.48425430778371953,0.5157456922162804
E01016545,1938,900,1038,0.46439628482972134,0.5356037151702786
E01016547,1688,844,844,0.5,0.5
E01016550,1526,877,649,0.5747051114023591,0.4252948885976409
E01016552,1606,803,803,0.5,0.5
E01016551,1577,766,811,0.48573240329740014,0.5142675967025999
E01016553,1470,722,748,0.49115646258503404,0.508843537414966
E01016557,1871,903,968,0.4826296098343132,0.5173703901656868
E01016558,1696,825,871,0.486438679245283,0.5135613207547169
E01016548,1912,937,975,0.49006276150627615,0.5099372384937239
E01016549,2012,922,1090,0.45825049701789267,0.5417495029821073
E01016554,1620,779,841,0.4808641975308642,0.5191358024691358
E01016555,1455,732,723,0.5030927835051546,0.49690721649484537
E01016556,1774,874,900,0.4926719278466742,0.5073280721533259
E01016546,1621,788,833,0.486119679210364,0.5138803207896361
E01016595,1720,815,905,0.4738372093023256,0.5261627906976745
E01016596,1793,881,912,0.4913552704963748,0.5086447295036252
E01016597,1777,873,904,0.4912774338773213,0.5087225661226786
E01016575,1666,839,827,0.5036014405762305,0.4963985594237695
E01016576,1714,872,842,0.5087514585764294,0.4912485414235706
E01016587,1587,766,821,0.48267170762444866,0.5173282923755513
E01016588,1770,862,908,0.48700564971751414,0.5129943502824859
E01016589,1620,790,830,0.4876543209876543,0.5123456790123457
E01016522,1957,962,995,0.4915687276443536,0.5084312723556464
E01016523,1640,764,876,0.4658536585365854,0.5341463414634147
E01016524,2105,1056,1049,0.5016627078384798,0.4983372921615202
E01016609,1814,862,952,0.47519294377067256,0.5248070562293274
E01016603,1801,864,937,0.47973348139922267,0.5202665186007773
E01016604,2015,983,1032,0.4878411910669975,0.5121588089330025
E01016605,1531,743,788,0.4853037230568256,0.5146962769431744
E01016606,1639,805,834,0.49115314215985356,0.5088468578401464
E01016607,1765,687,1078,0.38923512747875355,0.6107648725212464
E01016608,1824,875,949,0.47971491228070173,0.5202850877192983
E01016675,1032,502,530,0.48643410852713176,0.5135658914728682
E01016676,1537,742,795,0.4827586206896552,0.5172413793103449
E01016677,1488,735,753,0.4939516129032258,0.5060483870967742
E01016678,1364,689,675,0.5051319648093842,0.49486803519061584
E01016619,1561,794,767,0.5086483023702755,0.4913516976297245
E01016620,1481,728,753,0.49155975692099935,0.5084402430790007
E01016692,1436,699,737,0.48676880222841223,0.5132311977715878
E01016693,1352,665,687,0.4918639053254438,0.5081360946745562
E01016694,1454,680,774,0.4676753782668501,0.53232462173315
E01016695,1549,768,781,0.49580374435119434,0.5041962556488057
E01016621,1478,731,747,0.4945872801082544,0.5054127198917456
E01016623,1489,710,779,0.4768300873069174,0.5231699126930826
E01016624,1438,705,733,0.4902642559109875,0.5097357440890126
E01016684,1598,812,786,0.5081351689612015,0.4918648310387985
E01016685,1631,797,834,0.48865726548129984,0.5113427345187002
E01016622,1249,617,632,0.49399519615692555,0.5060048038430744
E01016657,1483,721,762,0.4861766689143628,0.5138233310856373
E01016658,1338,687,651,0.5134529147982063,0.48654708520179374
E01016659,1410,661,749,0.46879432624113476,0.5312056737588653
E01016660,1627,813,814,0.49969268592501537,0.5003073140749846
E01016615,1519,750,769,0.4937458854509546,0.5062541145490455
E01016616,1489,749,740,0.5030221625251847,0.49697783747481533
E01016617,1242,606,636,0.48792270531400966,0.5120772946859904
E01016662,1724,858,866,0.4976798143851508,0.5023201856148491
E01016613,1534,757,777,0.4934810951760104,0.5065189048239895
E01016614,1385,711,674,0.5133574007220216,0.4866425992779783
E01016618,1283,628,655,0.48947778643803586,0.5105222135619641
E01016664,1274,609,665,0.47802197802197804,0.521978021978022
E01016668,1587,817,770,0.5148078134845621,0.48519218651543794
E01016669,1827,919,908,0.5030103995621237,0.4969896004378763
E01016661,1370,682,688,0.4978102189781022,0.5021897810218978
E01016663,1537,763,774,0.49642160052049444,0.5035783994795056
E01016686,1139,561,578,0.4925373134328358,0.5074626865671642
E01016687,1279,619,660,0.4839718530101642,0.5160281469898358
E01016688,1588,814,774,0.5125944584382871,0.48740554156171284
E01016689,1418,722,696,0.5091678420310296,0.4908321579689704
E01016652,1276,630,646,0.493730407523511,0.5062695924764891
E01016653,1494,772,722,0.5167336010709505,0.48326639892904955
E01016665,1592,789,803,0.4956030150753769,0.5043969849246231
E01016666,1383,698,685,0.5046999276934201,0.4953000723065799
E01032761,2743,1371,1372,0.4998177178271965,0.5001822821728035
E01016647,1921,958,963,0.4986985944820406,0.5013014055179594
E01016701,1746,839,907,0.4805269186712486,0.5194730813287515
E01016702,1828,898,930,0.4912472647702407,0.5087527352297593
E01016703,1926,950,976,0.4932502596053998,0.5067497403946002
E01016704,2017,970,1047,0.480912245909767,0.519087754090233
E01016627,1845,963,882,0.5219512195121951,0.47804878048780486
E01016628,1534,774,760,0.5045632333767927,0.4954367666232073
E01016656,1403,694,709,0.4946543121881682,0.5053456878118318
E01016700,1890,943,947,0.49894179894179896,0.5010582010582011
E01016644,1465,733,732,0.5003412969283276,0.49965870307167237
E01016645,1539,789,750,0.5126705653021443,0.4873294346978557
E01016646,1586,800,786,0.5044136191677175,0.49558638083228246
E01016648,1434,723,711,0.50418410041841,0.49581589958158995
E01016649,1440,725,715,0.5034722222222222,0.4965277777777778
E01016651,1406,680,726,0.48364153627311524,0.5163584637268848
E01016654,1397,672,725,0.48103078024337864,0.5189692197566214
E01016655,1302,646,656,0.49615975422427033,0.5038402457757296
E01016679,2195,1090,1105,0.49658314350797267,0.5034168564920274
E01016680,1295,647,648,0.4996138996138996,0.5003861003861004
E01032758,1593,778,815,0.4883866917765223,0.5116133082234777
E01032759,1450,716,734,0.49379310344827587,0.5062068965517241
E01016626,1629,786,843,0.48250460405156537,0.5174953959484346
E01016671,1700,757,943,0.44529411764705884,0.5547058823529412
E01016673,1724,816,908,0.4733178654292343,0.5266821345707656
E01016674,1410,685,725,0.4858156028368794,0.5141843971631206
E01016696,1476,714,762,0.483739837398374,0.516260162601626
E01016670,2058,1030,1028,0.500485908649174,0.49951409135082603
E01016672,1761,856,905,0.48608745031232253,0.5139125496876774
E01032763,2281,1143,1138,0.501096010521701,0.498903989478299
E01016612,2214,1064,1150,0.48057813911472447,0.5194218608852755
E01016629,1372,641,731,0.467201166180758,0.532798833819242
E01016630,1532,760,772,0.4960835509138381,0.5039164490861618
E01016635,1394,709,685,0.5086083213773315,0.4913916786226686
E01016625,1671,816,855,0.4883303411131059,0.5116696588868941
E01016631,1359,649,710,0.4775570272259014,0.5224429727740986
E01016632,1511,742,769,0.49106551952349436,0.5089344804765056
E01016634,1533,743,790,0.4846705805609915,0.5153294194390085
E01016699,1538,718,820,0.4668400520156047,0.5331599479843954
E01016682,1859,937,922,0.5040344271113502,0.4959655728886498
E01016683,1878,949,929,0.5053248136315229,0.4946751863684771
E01016690,1774,882,892,0.4971815107102593,0.5028184892897407
E01016691,1204,593,611,0.4925249169435216,0.5074750830564784
E01016610,2860,1426,1434,0.4986013986013986,0.5013986013986014
E01016611,1389,798,591,0.5745140388768899,0.42548596112311016
E01016641,1420,680,740,0.4788732394366197,0.5211267605633803
E01016642,1155,574,581,0.49696969696969695,0.503030303030303
E01016633,1362,652,710,0.4787077826725404,0.5212922173274597
E01016636,1464,741,723,0.5061475409836066,0.49385245901639346
E01016637,1084,543,541,0.5009225092250923,0.49907749077490776
E01016638,1320,653,667,0.4946969696969697,0.5053030303030303
E01016639,1595,782,813,0.490282131661442,0.509717868338558
E01016640,1552,775,777,0.4993556701030928,0.5006443298969072
E01016643,1387,693,694,0.4996395097332372,0.5003604902667628
E01016705,1567,899,668,0.5737077217613273,0.4262922782386726
E01016706,1667,811,856,0.486502699460108,0.5134973005398921
E01016707,1612,801,811,0.4968982630272953,0.5031017369727047
E01016708,1594,787,807,0.49372647427854455,0.5062735257214555
E01016709,1584,790,794,0.49873737373737376,0.5012626262626263
E01017648,1806,901,905,0.4988925802879291,0.5011074197120708
E01017649,2100,1024,1076,0.4876190476190476,0.5123809523809524
E01017650,1668,840,828,0.5035971223021583,0.49640287769784175
E01032960,3049,1583,1466,0.5191866185634634,0.48081338143653657
E01017644,1501,728,773,0.48500999333777484,0.5149900066622252
E01017645,1513,817,696,0.5399867812293456,0.4600132187706543
E01017646,1830,875,955,0.4781420765027322,0.5218579234972678
E01017647,1625,795,830,0.48923076923076925,0.5107692307692308
E01017671,1591,792,799,0.49780012570710247,0.5021998742928976
E01017672,1483,770,713,0.519217801753203,0.480782198246797
E01017695,1194,572,622,0.47906197654941374,0.5209380234505863
E01017696,1263,647,616,0.5122723673792557,0.48772763262074426
E01017693,1083,536,547,0.494921514312096,0.5050784856879039
E01017694,2329,1145,1184,0.49162730785744957,0.5083726921425504
E01017713,1436,728,708,0.5069637883008357,0.49303621169916434
E01017714,1333,670,663,0.5026256564141035,0.4973743435858965
E01017717,1698,852,846,0.5017667844522968,0.49823321554770317
E01017718,1577,763,814,0.4838300570703868,0.5161699429296132
E01017735,1318,630,688,0.4779969650986343,0.5220030349013657
E01017736,1526,756,770,0.4954128440366973,0.5045871559633027
E01017737,1351,645,706,0.4774241302738712,0.5225758697261288
E01017738,1530,731,799,0.4777777777777778,0.5222222222222223
E01017669,1494,722,772,0.48326639892904955,0.5167336010709505
E01017670,1548,758,790,0.4896640826873385,0.5103359173126615
E01017715,1171,584,587,0.4987190435525192,0.5012809564474808
E01017716,1840,914,926,0.4967391304347826,0.5032608695652174
E01017641,1705,815,890,0.4780058651026393,0.5219941348973607
E01017731,1323,655,668,0.4950869236583522,0.5049130763416477
E01017732,1422,692,730,0.4866385372714487,0.5133614627285513
E01017733,1197,569,628,0.4753550543024227,0.5246449456975772
E01017734,1394,718,676,0.5150645624103299,0.48493543758967
E01017703,1292,611,681,0.4729102167182663,0.5270897832817337
E01017704,1259,621,638,0.4932486100079428,0.5067513899920572
E01017719,1199,578,621,0.48206839032527105,0.517931609674729
E01017720,1314,657,657,0.5,0.5
E01032958,1522,748,774,0.4914586070959264,0.5085413929040736
E01032959,1748,853,895,0.4879862700228833,0.5120137299771167
E01017651,1557,757,800,0.4861913937058446,0.5138086062941555
E01017652,1466,738,728,0.5034106412005457,0.4965893587994543
E01017657,1421,701,720,0.4933145672061928,0.5066854327938072
E01017658,1426,712,714,0.4992987377279102,0.5007012622720898
E01017701,2207,1098,1109,0.49750792931581334,0.5024920706841867
E01017702,1467,730,737,0.49761417859577367,0.5023858214042263
E01017642,1269,592,677,0.4665090622537431,0.5334909377462569
E01017643,1309,662,647,0.5057295645530939,0.494270435446906
E01017673,1302,650,652,0.49923195084485406,0.500768049155146
E01017674,1870,1192,678,0.6374331550802139,0.3625668449197861
E01017659,1608,782,826,0.486318407960199,0.513681592039801
E01017660,1689,832,857,0.492599171107164,0.507400828892836
E01017661,1565,772,793,0.49329073482428115,0.5067092651757189
E01017664,1404,714,690,0.5085470085470085,0.49145299145299143
E01017705,1175,587,588,0.49957446808510636,0.5004255319148936
E01017706,1429,706,723,0.4940517844646606,0.5059482155353394
E01017707,1310,622,688,0.47480916030534354,0.5251908396946565
E01017708,1564,759,805,0.4852941176470588,0.5147058823529411
E01017665,1597,786,811,0.49217282404508456,0.5078271759549154
E01017666,1687,837,850,0.4961470065204505,0.5038529934795495
E01017667,1369,678,691,0.4952520087655223,0.5047479912344777
E01017668,1534,774,760,0.5045632333767927,0.4954367666232073
E01017697,1426,711,715,0.49859747545582045,0.5014025245441796
E01017698,1484,713,771,0.4804582210242588,0.5195417789757413
E01017699,1439,885,554,0.6150104239054899,0.38498957609451007
E01017700,1547,766,781,0.4951519069166128,0.5048480930833872
E01017634,1549,798,751,0.5151710781149128,0.48482892188508714
E01017662,1308,631,677,0.48241590214067276,0.5175840978593272
E01017663,1594,834,760,0.5232120451693852,0.4767879548306148
E01032955,1233,599,634,0.48580697485806973,0.5141930251419302
E01032961,1039,528,511,0.5081809432146295,0.4918190567853705
E01017653,1481,716,765,0.4834571235651587,0.5165428764348413
E01017654,1432,739,693,0.5160614525139665,0.48393854748603354
E01017655,1946,944,1002,0.4850976361767729,0.5149023638232272
E01032956,1629,795,834,0.4880294659300184,0.5119705340699816
E01032957,1356,690,666,0.5088495575221239,0.4911504424778761
E01032962,1554,791,763,0.509009009009009,0.49099099099099097
E01017635,1439,739,700,0.5135510771369006,0.4864489228630994
E01017636,1560,777,783,0.4980769230769231,0.5019230769230769
E01017637,1335,646,689,0.48389513108614235,0.5161048689138577
E01017638,1306,653,653,0.5,0.5
E01017639,1594,796,798,0.4993726474278545,0.5006273525721455
E01017640,1570,758,812,0.48280254777070064,0.5171974522292994
E01017709,1687,798,889,0.4730290456431535,0.5269709543568465
E01017710,1551,758,793,0.4887169568020632,0.5112830431979368
E01017711,1573,789,784,0.501589319771138,0.49841068022886204
E01017712,2101,1057,1044,0.5030937648738696,0.4969062351261304
E01017687,2030,1044,986,0.5142857142857142,0.4857142857142857
E01017688,1232,598,634,0.48538961038961037,0.5146103896103896
E01017689,1389,698,691,0.5025197984161267,0.4974802015838733
E01017690,1148,558,590,0.48606271777003485,0.5139372822299652
E01017691,1370,658,712,0.4802919708029197,0.5197080291970803
E01017692,1557,796,761,0.5112395632626846,0.48876043673731534
E01017721,1575,731,844,0.4641269841269841,0.5358730158730158
E01017722,1510,758,752,0.5019867549668874,0.49801324503311256
E01017723,1372,662,710,0.48250728862973763,0.5174927113702624
E01017724,1425,707,718,0.496140350877193,0.503859649122807
E01017627,1599,778,821,0.48655409631019386,0.5134459036898061
E01017628,1756,823,933,0.46867881548974943,0.5313211845102506
E01017629,1595,779,816,0.4884012539184953,0.5115987460815047
E01017630,1544,753,791,0.4876943005181347,0.5123056994818653
E01017631,1586,791,795,0.4987389659520807,0.5012610340479193
E01017632,1561,752,809,0.4817424727738629,0.518257527226137
E01017675,1431,706,725,0.493361285814116,0.506638714185884
E01017676,1428,669,759,0.4684873949579832,0.5315126050420168
E01017677,1342,637,705,0.47466467958271236,0.5253353204172876
E01017678,1297,619,678,0.4772552043176561,0.5227447956823439
E01017679,1615,784,831,0.4854489164086687,0.5145510835913313
E01017680,992,495,497,0.49899193548387094,0.501008064516129
E01017681,1232,605,627,0.49107142857142855,0.5089285714285714
E01017682,1219,602,617,0.4938474159146842,0.5061525840853158
E01017683,1700,844,856,0.4964705882352941,0.5035294117647059
E01017684,1108,508,600,0.4584837545126354,0.5415162454873647
E01017726,1140,531,609,0.46578947368421053,0.5342105263157895
E01017727,1700,808,892,0.4752941176470588,0.5247058823529411
E01017728,2237,1103,1134,0.4930710773357175,0.5069289226642825
E01017729,1696,823,873,0.4852594339622642,0.5147405660377359
E01017730,1561,734,827,0.47021140294682895,0.529788597053171
E01017750,2203,1109,1094,0.5034044484793464,0.49659555152065366
E01017752,2203,1108,1095,0.5029505220154336,0.4970494779845665
E01017766,2304,1145,1159,0.4969618055555556,0.5030381944444444
E01017778,1305,632,673,0.4842911877394636,0.5157088122605364
E01017747,1409,714,695,0.5067423704755145,0.49325762952448543
E01017748,1805,883,922,0.489196675900277,0.510803324099723
E01017749,1636,817,819,0.4993887530562347,0.5006112469437652
E01017789,1222,599,623,0.49018003273322425,0.5098199672667758
E01017790,1382,695,687,0.5028943560057887,0.4971056439942113
E01017795,2139,1067,1072,0.49883122954651704,0.501168770453483
E01017769,1584,803,781,0.5069444444444444,0.4930555555555556
E01017771,1460,708,752,0.4849315068493151,0.5150684931506849
E01017780,1262,620,642,0.49128367670364503,0.508716323296355
E01017781,1212,587,625,0.48432343234323433,0.5156765676567657
E01017770,1497,771,726,0.5150300601202404,0.4849699398797595
E01017791,1491,729,762,0.48893360160965793,0.5110663983903421
E01017792,1863,878,985,0.4712828770799785,0.5287171229200215
E01017793,1521,729,792,0.47928994082840237,0.5207100591715976
E01017768,2312,1088,1224,0.47058823529411764,0.5294117647058824
E01017779,1163,563,600,0.48409286328460877,0.5159071367153912
E01017785,1677,841,836,0.5014907573047108,0.49850924269528923
E01017786,1553,745,808,0.47971667739858337,0.5202833226014166
E01017787,1614,798,816,0.4944237918215613,0.5055762081784386
E01017788,1753,822,931,0.46891043924700515,0.5310895607529948
E01017741,1623,784,839,0.48305606900800985,0.5169439309919901
E01017742,1695,833,862,0.49144542772861355,0.5085545722713865
E01017743,1619,747,872,0.461395923409512,0.5386040765904879
E01017763,1718,794,924,0.46216530849825377,0.5378346915017462
E01017764,1753,855,898,0.4877353108956075,0.5122646891043925
E01017765,1764,912,852,0.5170068027210885,0.48299319727891155
E01017739,1254,626,628,0.49920255183413076,0.5007974481658692
E01017740,1327,635,692,0.47852298417483047,0.5214770158251696
E01017744,1447,704,743,0.4865238424326192,0.5134761575673807
E01017745,1768,876,892,0.49547511312217196,0.504524886877828
E01017746,1533,759,774,0.49510763209393344,0.5048923679060665
E01017762,1472,734,738,0.4986413043478261,0.501358695652174
E01017775,1564,727,837,0.4648337595907928,0.5351662404092071
E01017776,1619,769,850,0.4749845583693638,0.5250154416306362
E01017777,1637,789,848,0.48197923029932804,0.518020769700672
E01017759,1815,857,958,0.4721763085399449,0.5278236914600551
E01017760,1699,831,868,0.4891112419070041,0.5108887580929958
E01017761,2132,1027,1105,0.4817073170731707,0.5182926829268293
E01017794,2311,1120,1191,0.48463868455214193,0.515361315447858
E01017754,1571,756,815,0.4812221514958625,0.5187778485041374
E01017755,1514,725,789,0.47886393659180976,0.5211360634081902
E01017756,1492,725,767,0.4859249329758713,0.5140750670241286
E01017757,1225,573,652,0.46775510204081633,0.5322448979591837
E01017758,1266,635,631,0.5015797788309637,0.49842022116903634
E01017751,2203,1081,1122,0.49069450748978666,0.5093054925102134
E01017753,1259,587,672,0.46624305003971406,0.5337569499602859
E01017767,2236,1021,1215,0.45661896243291594,0.5433810375670841
E01017773,1533,739,794,0.482061317677756,0.5179386823222439
E01017774,1296,616,680,0.47530864197530864,0.5246913580246914
E01017782,1442,707,735,0.49029126213592233,0.5097087378640777
E01017783,1493,727,766,0.4869390488948426,0.5130609511051574
E01017784,1575,745,830,0.473015873015873,0.526984126984127
E01032609,1210,582,628,0.4809917355371901,0.5190082644628099
E01017796,1799,836,963,0.46470261256253476,0.5352973874374652
E01017797,1513,755,758,0.4990085922009253,0.5009914077990747
E01017798,1792,850,942,0.47433035714285715,0.5256696428571429
E01017799,2008,944,1064,0.4701195219123506,0.5298804780876494
E01017800,1781,912,869,0.5120718697361033,0.4879281302638967
E01017801,1624,782,842,0.4815270935960591,0.5184729064039408
E01017802,1564,774,790,0.4948849104859335,0.5051150895140665
E01017818,1957,966,991,0.4936126724578436,0.5063873275421563
E01017819,1594,808,786,0.506900878293601,0.493099121706399
E01017820,1601,694,907,0.4334790755777639,0.5665209244222361
E01017821,1598,774,824,0.48435544430538174,0.5156445556946183
E01017822,1943,939,1004,0.48327328872876996,0.51672671127123
E01017810,1729,793,936,0.45864661654135336,0.5413533834586466
E01017811,1210,586,624,0.484297520661157,0.515702479338843
E01017812,1667,852,815,0.5110977804439112,0.48890221955608876
E01017813,1857,915,942,0.4927302100161551,0.5072697899838449
E01017815,1829,866,963,0.4734827774740295,0.5265172225259704
E01017816,1668,792,876,0.4748201438848921,0.5251798561151079
E01017817,2002,994,1008,0.4965034965034965,0.5034965034965035
E01017823,1358,641,717,0.47201767304860087,0.5279823269513991
E01017830,1822,890,932,0.4884742041712404,0.5115257958287596
E01017831,1716,847,869,0.4935897435897436,0.5064102564102564
E01017832,1687,818,869,0.4848844101956135,0.5151155898043864
E01017834,1542,792,750,0.5136186770428015,0.48638132295719844
E01017835,1709,815,894,0.47688706846108836,0.5231129315389117
E01017803,1310,625,685,0.4770992366412214,0.5229007633587787
E01017806,1685,800,885,0.47477744807121663,0.5252225519287834
E01017814,1541,737,804,0.4782608695652174,0.5217391304347826
E01017833,1669,821,848,0.4919113241461953,0.5080886758538047
E01017804,1517,715,802,0.4713249835201055,0.5286750164798946
E01017805,1853,867,986,0.46788990825688076,0.5321100917431193
E01017807,1496,739,757,0.4939839572192513,0.5060160427807486
E01017808,1480,717,763,0.48445945945945945,0.5155405405405405
E01017809,1500,723,777,0.482,0.518
E01017824,1690,857,833,0.5071005917159763,0.4928994082840237
E01017825,1744,854,890,0.4896788990825688,0.5103211009174312
E01017826,1511,724,787,0.47915287888815355,0.5208471211118465
E01017827,1671,838,833,0.5014961101137043,0.4985038898862956
E01017828,1633,775,858,0.4745866503368034,0.5254133496631965
E01017829,1997,1012,985,0.5067601402103155,0.49323985978968454
E01017929,1668,722,946,0.43285371702637887,0.5671462829736211
E01017930,1740,854,886,0.4908045977011494,0.5091954022988506
E01017931,1396,681,715,0.4878223495702006,0.5121776504297995
E01017932,1573,762,811,0.4844246662428481,0.5155753337571519
E01017933,1724,828,896,0.4802784222737819,0.5197215777262181
E01017885,1707,860,847,0.5038078500292912,0.4961921499707089
E01017886,1486,732,754,0.49259757738896365,0.5074024226110363
E01017887,1147,569,578,0.4960767218831735,0.5039232781168265
E01017888,1712,821,891,0.47955607476635514,0.5204439252336449
E01017869,1334,667,667,0.5,0.5
E01017870,1242,644,598,0.5185185185185185,0.48148148148148145
E01017871,1573,728,845,0.4628099173553719,0.5371900826446281
E01017872,1643,808,835,0.4917833231892879,0.5082166768107121
E01017873,1421,716,705,0.5038705137227305,0.49612948627726955
E01017874,1149,572,577,0.4978241949521323,0.5021758050478677
E01017915,1361,679,682,0.49889786921381335,0.5011021307861866
E01017916,1194,594,600,0.49748743718592964,0.5025125628140703
E01017917,1469,747,722,0.5085091899251192,0.4914908100748809
E01017918,1530,743,787,0.48562091503267973,0.5143790849673202
E01017857,1408,717,691,0.5092329545454546,0.49076704545454547
E01017858,1617,808,809,0.4996907854050711,0.5003092145949288
E01017859,1416,746,670,0.5268361581920904,0.4731638418079096
E01017860,1450,734,716,0.5062068965517241,0.49379310344827587
E01017861,1663,778,885,0.4678292242934456,0.5321707757065545
E01017862,1880,931,949,0.4952127659574468,0.5047872340425532
E01017863,1735,855,880,0.49279538904899134,0.5072046109510087
E01017842,3005,1554,1451,0.5171381031613976,0.4828618968386023
E01017853,1345,681,664,0.5063197026022305,0.49368029739776953
E01017854,1288,633,655,0.49145962732919257,0.5085403726708074
E01017878,2648,1297,1351,0.4898036253776435,0.5101963746223565
E01017920,1256,637,619,0.5071656050955414,0.4928343949044586
E01017921,1793,926,867,0.5164528722810932,0.48354712771890684
E01017922,1644,797,847,0.48479318734793186,0.5152068126520681
E01017923,1498,800,698,0.5340453938584779,0.465954606141522
E01017924,1644,784,860,0.4768856447688564,0.5231143552311436
E01017937,1548,758,790,0.4896640826873385,0.5103359173126615
E01017938,1360,688,672,0.5058823529411764,0.49411764705882355
E01017940,1501,750,751,0.4996668887408394,0.5003331112591606
E01017942,1510,725,785,0.48013245033112584,0.5198675496688742
E01017850,1372,668,704,0.4868804664723032,0.5131195335276968
E01017851,1709,900,809,0.5266237565827969,0.473376243417203
E01017852,2493,1261,1232,0.5058162855996791,0.4941837144003209
E01017919,1346,718,628,0.5334323922734027,0.46656760772659733
E01017925,2107,1046,1061,0.49644043663977216,0.5035595633602278
E01017926,1500,719,781,0.47933333333333333,0.5206666666666667
E01017927,1558,760,798,0.4878048780487805,0.5121951219512195
E01017928,1397,683,714,0.4889047959914102,0.5110952040085899
E01017911,1723,862,861,0.5002901915264074,0.4997098084735926
E01017912,1401,715,686,0.510349750178444,0.489650249821556
E01017913,1726,896,830,0.5191193511008111,0.48088064889918886
E01017914,1364,696,668,0.5102639296187683,0.4897360703812317
E01017903,1654,850,804,0.5139056831922612,0.4860943168077388
E01017904,1746,929,817,0.5320733104238259,0.4679266895761741
E01017905,2181,1170,1011,0.5364511691884457,0.46354883081155435
E01017906,1980,984,996,0.49696969696969695,0.503030303030303
E01017907,1845,914,931,0.4953929539295393,0.5046070460704607
E01017899,1656,802,854,0.48429951690821255,0.5157004830917874
E01017900,1343,657,686,0.4892032762472077,0.5107967237527923
E01017901,1206,583,623,0.4834162520729685,0.5165837479270315
E01017902,1602,765,837,0.47752808988764045,0.5224719101123596
E01017836,1657,842,815,0.508147254073627,0.49185274592637296
E01017837,2196,1092,1104,0.4972677595628415,0.5027322404371585
E01017838,1559,839,720,0.5381654906991661,0.46183450930083386
E01017839,1721,622,1099,0.3614177803602557,0.6385822196397444
E01017840,1803,884,919,0.49029395452024405,0.509706045479756
E01017841,1429,708,721,0.49545136459062283,0.5045486354093772
E01017908,2505,1263,1242,0.5041916167664671,0.49580838323353293
E01017909,2182,1090,1092,0.4995417048579285,0.5004582951420715
E01017910,2401,1203,1198,0.5010412328196585,0.49895876718034154
E01017941,1398,691,707,0.49427753934191704,0.505722460658083
E01017843,1550,756,794,0.48774193548387096,0.512258064516129
E01017844,1747,819,928,0.4688036634230109,0.5311963365769892
E01017845,1677,844,833,0.5032796660703638,0.49672033392963627
E01017855,1435,690,745,0.4808362369337979,0.519163763066202
E01017856,1416,710,706,0.501412429378531,0.4985875706214689
E01017864,1339,653,686,0.4876773711725168,0.5123226288274833
E01017865,1543,757,786,0.49060272197018795,0.509397278029812
E01017867,1545,720,825,0.46601941747572817,0.5339805825242718
E01017868,1538,746,792,0.4850455136540962,0.5149544863459038
E01017934,1737,833,904,0.47956246401842256,0.5204375359815774
E01017935,1970,924,1046,0.46903553299492384,0.5309644670050762
E01017936,1554,750,804,0.4826254826254826,0.5173745173745173
E01017939,1366,687,679,0.5029282576866764,0.4970717423133236
E01017866,1438,716,722,0.49791376912378305,0.502086230876217
E01017875,1523,794,729,0.5213394615889692,0.47866053841103084
E01017876,2076,1032,1044,0.49710982658959535,0.5028901734104047
E01017877,1673,840,833,0.502092050209205,0.497907949790795
E01017846,1387,653,734,0.4708002883922134,0.5291997116077866
E01017847,1534,717,817,0.46740547588005216,0.5325945241199479
E01017848,1211,607,604,0.5012386457473162,0.49876135425268375
E01017849,1399,698,701,0.498927805575411,0.501072194424589
E01017889,1301,628,673,0.4827056110684089,0.5172943889315911
E01017890,1307,658,649,0.5034429992348891,0.49655700076511095
E01017891,1432,673,759,0.46997206703910616,0.5300279329608939
E01017892,1584,776,808,0.4898989898989899,0.51010101010101
E01017893,1580,753,827,0.47658227848101264,0.5234177215189874
E01017894,1595,750,845,0.4702194357366771,0.5297805642633229
E01017895,1317,634,683,0.48139711465451784,0.5186028853454822
E01017896,1409,664,745,0.47125621007806956,0.5287437899219305
E01017897,1576,764,812,0.4847715736040609,0.5152284263959391
E01017898,1224,582,642,0.47549019607843135,0.5245098039215687
E01017880,1423,694,729,0.4877020379479972,0.5122979620520028
E01017881,1877,914,963,0.48694725625998936,0.5130527437400106
E01017882,1619,789,830,0.4873378628783199,0.5126621371216801
E01017883,1639,806,833,0.4917632702867602,0.5082367297132397
E01017884,1442,661,781,0.45839112343966715,0.5416088765603329
E01032610,1623,787,836,0.4849044978434997,0.5150955021565004
E01020924,1418,711,707,0.501410437235543,0.498589562764457
E01020925,1523,704,819,0.46224556795797767,0.5377544320420223
E01020927,1503,697,806,0.4637391882900865,0.5362608117099135
E01020928,1568,711,857,0.4534438775510204,0.5465561224489796
E01020930,1480,739,741,0.49932432432432433,0.5006756756756757
E01020917,1501,739,762,0.49233844103930713,0.5076615589606929
E01020918,1619,775,844,0.47869054972205066,0.5213094502779494
E01020919,1546,741,805,0.4793014230271669,0.5206985769728332
E01020923,1452,695,757,0.4786501377410468,0.5213498622589532
E01020949,1577,738,839,0.4679771718452758,0.5320228281547241
E01020926,1613,780,833,0.48357098574085555,0.5164290142591444
E01020929,1601,757,844,0.4728294815740162,0.5271705184259837
E01020955,1498,736,762,0.49132176234979974,0.5086782376502003
E01020956,1575,741,834,0.4704761904761905,0.5295238095238095
E01020957,1492,690,802,0.4624664879356568,0.5375335120643432
E01020920,1471,693,778,0.4711080897348742,0.5288919102651257
E01020921,1506,699,807,0.4641434262948207,0.5358565737051793
E01020922,1496,688,808,0.45989304812834225,0.5401069518716578
E01020945,1842,870,972,0.4723127035830619,0.5276872964169381
E01020950,1623,765,858,0.4713493530499076,0.5286506469500925
E01020940,1509,756,753,0.5009940357852882,0.4990059642147117
E01020941,1693,789,904,0.46603662138216184,0.5339633786178382
E01020942,1564,703,861,0.44948849104859334,0.5505115089514067
E01020946,1721,793,928,0.4607786170830912,0.5392213829169088
E01020947,1497,713,784,0.47628590514362057,0.5237140948563794
E01020914,1934,915,1019,0.47311271975180974,0.5268872802481903
E01020915,1699,839,860,0.49381989405532667,0.5061801059446733
E01020952,1795,844,951,0.4701949860724234,0.5298050139275766
E01020953,1530,750,780,0.49019607843137253,0.5098039215686274
E01020954,1765,855,910,0.48441926345609065,0.5155807365439093
E01020948,1434,674,760,0.4700139470013947,0.5299860529986054
E01020963,1699,811,888,0.47733961153619775,0.5226603884638023
E01020965,1864,929,935,0.49839055793991416,0.5016094420600858
E01020966,1731,772,959,0.4459849797804737,0.5540150202195263
E01020938,1574,752,822,0.4777636594663278,0.5222363405336722
E01020939,1577,741,836,0.46987951807228917,0.5301204819277109
E01020943,1593,735,858,0.4613935969868173,0.5386064030131826
E01020964,1650,767,883,0.46484848484848484,0.5351515151515152
E01020967,1820,819,1001,0.45,0.55
E01020910,1709,815,894,0.47688706846108836,0.5231129315389117
E01020911,1990,1080,910,0.542713567839196,0.457286432160804
E01020912,2035,1096,939,0.5385749385749385,0.4614250614250614
E01020916,1686,801,885,0.4750889679715303,0.5249110320284698
E01020935,1843,980,863,0.5317417254476398,0.4682582745523603
E01020936,1721,781,940,0.4538059267867519,0.5461940732132481
E01020937,1634,818,816,0.5006119951040392,0.49938800489596086
E01020968,1700,799,901,0.47,0.53
E01020931,1849,831,1018,0.44943212547322875,0.5505678745267713
E01020932,1381,621,760,0.4496741491672701,0.5503258508327299
E01020933,1047,458,589,0.437440305635148,0.562559694364852
E01020934,1250,563,687,0.4504,0.5496
E01020944,1543,743,800,0.48152948801036943,0.5184705119896306
E01020913,2114,998,1116,0.4720908230842006,0.5279091769157994
E01020951,1513,748,765,0.4943820224719101,0.5056179775280899
E01020959,1457,708,749,0.48592999313658203,0.514070006863418
E01020961,1412,645,767,0.45679886685552407,0.5432011331444759
E01020962,2004,974,1030,0.48602794411177647,0.5139720558882236
E01020960,2455,1239,1216,0.504684317718941,0.49531568228105904
E01032831,1578,776,802,0.4917617237008872,0.5082382762991128
E01032832,1600,760,840,0.475,0.525
E01032833,1338,699,639,0.5224215246636771,0.47757847533632286
E01020969,1519,724,795,0.47662936142198814,0.5233706385780118
E01020970,2689,1330,1359,0.49460766084046115,0.5053923391595389
E01020971,2037,984,1053,0.48306332842415317,0.5169366715758469
E01020987,1797,873,924,0.48580968280467446,0.5141903171953256
E01020974,1537,748,789,0.4866623292127521,0.5133376707872479
E01020986,1473,697,776,0.47318397827562797,0.526816021724372
E01020988,1699,793,906,0.46674514420247204,0.533254855797528
E01021007,1442,703,739,0.48751733703190014,0.5124826629680999
E01021008,1587,730,857,0.4599873976055451,0.5400126023944549
E01021009,1944,943,1001,0.485082304526749,0.5149176954732511
E01020993,1343,646,697,0.4810126582278481,0.5189873417721519
E01020994,1533,741,792,0.48336594911937375,0.5166340508806262
E01020995,1431,683,748,0.4772886093640811,0.522711390635919
E01020996,1792,865,927,0.48270089285714285,0.5172991071428571
E01021019,1607,790,817,0.4915992532669571,0.5084007467330429
E01021004,1785,852,933,0.4773109243697479,0.5226890756302521
E01021005,1617,759,858,0.46938775510204084,0.5306122448979592
E01021006,1793,873,920,0.486893474623536,0.5131065253764641
E01021013,1827,908,919,0.4969896004378763,0.5030103995621237
E01020972,1549,721,828,0.4654615881213686,0.5345384118786314
E01020973,1752,832,920,0.4748858447488584,0.5251141552511416
E01020977,1588,774,814,0.48740554156171284,0.5125944584382871
E01021015,1606,736,870,0.45828144458281445,0.5417185554171855
E01021010,1582,757,825,0.47850821744627053,0.5214917825537294
E01021011,1560,739,821,0.4737179487179487,0.5262820512820513
E01021012,1664,799,865,0.4801682692307692,0.5198317307692307
E01021020,1850,869,981,0.4697297297297297,0.5302702702702703
E01021021,1892,881,1011,0.4656448202959831,0.5343551797040169
E01021000,1486,735,751,0.4946164199192463,0.5053835800807537
E01021001,1237,597,640,0.4826192400970089,0.5173807599029911
E01021002,1468,698,770,0.47547683923705725,0.5245231607629428
E01021003,1671,829,842,0.49611011370436864,0.5038898862956314
E01021014,1884,884,1000,0.4692144373673036,0.5307855626326964
E01020975,1810,878,932,0.4850828729281768,0.5149171270718232
E01020976,1913,942,971,0.4924202822791427,0.5075797177208573
E01020990,1653,847,806,0.5124016938898972,0.48759830611010285
E01020991,1334,657,677,0.49250374812593706,0.507496251874063
E01020992,1842,937,905,0.508686210640608,0.49131378935939196
E01020978,1947,993,954,0.5100154083204931,0.4899845916795069
E01020979,1834,982,852,0.5354416575790621,0.46455834242093785
E01020980,1583,780,803,0.49273531269741,0.50726468730259
E01020981,1623,822,801,0.5064695009242144,0.49353049907578556
E01020997,1638,737,901,0.44993894993894995,0.5500610500610501
E01020998,1850,912,938,0.492972972972973,0.5070270270270271
E01020999,1928,859,1069,0.44553941908713696,0.5544605809128631
E01021016,1645,770,875,0.46808510638297873,0.5319148936170213
E01021017,1604,780,824,0.486284289276808,0.513715710723192
E01021018,1915,938,977,0.48981723237597913,0.5101827676240209
E01020982,1742,927,815,0.5321469575200919,0.46785304247990817
E01020983,1657,859,798,0.5184067592033796,0.4815932407966204
E01020984,1951,1023,928,0.5243464889800102,0.47565351101998976
E01020985,1782,949,833,0.5325476992143658,0.4674523007856341
E01020989,1762,929,833,0.5272417707150965,0.4727582292849035
E01021022,2105,1009,1096,0.47933491686460805,0.520665083135392
E01021024,1210,575,635,0.47520661157024796,0.5247933884297521
E01021025,1878,983,895,0.5234291799787008,0.47657082002129925
E01021052,1267,595,672,0.4696132596685083,0.5303867403314917
E01021053,1190,601,589,0.5050420168067227,0.49495798319327733
E01021023,1980,981,999,0.4954545454545455,0.5045454545454545
E01021026,2424,1118,1306,0.4612211221122112,0.5387788778877888
E01021032,2106,1021,1085,0.48480531813865146,0.5151946818613485
E01021067,1123,546,577,0.48619768477292963,0.5138023152270703
E01021068,1153,565,588,0.4900260190806591,0.5099739809193409
E01021033,1751,862,889,0.4922901199314677,0.5077098800685322
E01021034,1317,634,683,0.48139711465451784,0.5186028853454822
E01021035,1710,838,872,0.49005847953216375,0.5099415204678363
E01021036,1469,710,759,0.4833219877467665,0.5166780122532335
E01021037,1595,794,801,0.49780564263322885,0.5021943573667712
E01021038,1753,820,933,0.4677695379349686,0.5322304620650313
E01021054,1447,735,712,0.5079474775397373,0.4920525224602626
E01021055,1747,829,918,0.4745277618775043,0.5254722381224957
E01021056,1703,796,907,0.4674104521432766,0.5325895478567234
E01021057,1525,752,773,0.49311475409836064,0.5068852459016393
E01021039,1452,693,759,0.4772727272727273,0.5227272727272727
E01021040,1727,947,780,0.548349739432542,0.451650260567458
E01021041,1570,755,815,0.48089171974522293,0.5191082802547771
E01021042,1346,640,706,0.475482912332838,0.524517087667162
E01021043,1607,755,852,0.4698195395146235,0.5301804604853765
E01021027,1557,782,775,0.5022479126525369,0.49775208734746307
E01021028,1614,781,833,0.4838909541511772,0.5161090458488228
E01021029,1548,744,804,0.4806201550387597,0.5193798449612403
E01021030,1256,566,690,0.45063694267515925,0.5493630573248408
E01021031,1502,757,745,0.503994673768309,0.4960053262316911
E01021061,1546,772,774,0.49935316946959896,0.500646830530401
E01021063,1703,845,858,0.4961832061068702,0.5038167938931297
E01021064,1608,772,836,0.48009950248756217,0.5199004975124378
E01021065,1189,578,611,0.4861227922624054,0.5138772077375946
E01021066,1544,753,791,0.4876943005181347,0.5123056994818653
E01021045,1794,890,904,0.496098104793757,0.5039018952062431
E01021046,1519,738,781,0.4858459512837393,0.5141540487162607
E01021047,1422,700,722,0.49226441631504925,0.5077355836849508
E01021048,1551,811,740,0.5228884590586719,0.4771115409413282
E01021044,1919,937,982,0.48827514330380406,0.5117248566961959
E01021049,1436,728,708,0.5069637883008357,0.49303621169916434
E01021050,1362,686,676,0.5036710719530103,0.49632892804698975
E01021051,1229,604,625,0.49145646867371845,0.5085435313262815
E01021058,1890,872,1018,0.4613756613756614,0.5386243386243387
E01021059,1523,718,805,0.4714379514116875,0.5285620485883126
E01021060,1598,791,807,0.49499374217772213,0.5050062578222778
E01021062,1466,718,748,0.4897680763983629,0.5102319236016372
E01021069,1594,774,820,0.48557089084065247,0.5144291091593476
E01021075,1793,856,937,0.4774121583937535,0.5225878416062465
E01021077,1482,701,781,0.47300944669365724,0.5269905533063428
E01021081,1603,765,838,0.47723019338739864,0.5227698066126014
E01021082,1632,787,845,0.48223039215686275,0.5177696078431373
E01021083,1376,689,687,0.5007267441860465,0.4992732558139535
E01021072,1542,715,827,0.46368352788586253,0.5363164721141375
E01021073,1482,714,768,0.4817813765182186,0.5182186234817814
E01021074,1656,790,866,0.47705314009661837,0.5229468599033816
E01021076,1894,913,981,0.4820485744456177,0.5179514255543822
E01021078,1279,593,686,0.46364347146207974,0.5363565285379203
E01021070,1565,744,821,0.47539936102236424,0.5246006389776358
E01021071,1710,847,863,0.4953216374269006,0.5046783625730994
E01021079,1547,706,841,0.4563671622495152,0.5436328377504848
E01021080,1416,672,744,0.4745762711864407,0.5254237288135594
E01021132,1491,728,763,0.48826291079812206,0.5117370892018779
E01021133,1630,796,834,0.4883435582822086,0.5116564417177915
E01021134,1481,762,719,0.5145172180958811,0.48548278190411887
E01021139,1320,635,685,0.4810606060606061,0.5189393939393939
E01021140,1817,901,916,0.49587231700605394,0.5041276829939461
E01021141,1542,772,770,0.5006485084306096,0.4993514915693904
E01021103,1483,703,780,0.47403910991233983,0.5259608900876601
E01021114,1528,734,794,0.4803664921465969,0.5196335078534031
E01021115,1592,779,813,0.48932160804020103,0.510678391959799
E01021116,1526,726,800,0.47575360419397117,0.5242463958060288
E01021098,1718,815,903,0.4743888242142026,0.5256111757857974
E01021099,1658,836,822,0.5042219541616405,0.4957780458383595
E01021100,1844,916,928,0.4967462039045553,0.5032537960954447
E01021104,1355,658,697,0.48560885608856086,0.5143911439114391
E01021105,1251,620,631,0.495603517186251,0.504396482813749
E01021101,1722,815,907,0.4732868757259001,0.5267131242740999
E01021102,1607,811,796,0.5046670815183572,0.4953329184816428
E01021117,1599,783,816,0.4896810506566604,0.5103189493433395
E01021118,1564,781,783,0.4993606138107417,0.5006393861892583
E01021119,1092,491,601,0.44963369963369965,0.5503663003663004
E01021087,1656,783,873,0.47282608695652173,0.5271739130434783
E01021088,1526,761,765,0.4986893840104849,0.5013106159895151
E01021089,1533,735,798,0.4794520547945205,0.5205479452054794
E01021109,1689,826,863,0.48904677323860274,0.5109532267613973
E01021110,2259,1085,1174,0.4803010181496237,0.5196989818503762
E01021084,1887,893,994,0.4732379438261791,0.5267620561738209
E01021085,1696,804,892,0.4740566037735849,0.5259433962264151
E01021086,1729,799,930,0.46211683053788316,0.5378831694621168
E01021096,1288,631,657,0.48990683229813664,0.5100931677018633
E01021097,1398,674,724,0.4821173104434907,0.5178826895565093
E01021111,1034,460,574,0.4448742746615087,0.5551257253384912
E01021113,1394,647,747,0.46413199426111906,0.5358680057388809
E01021131,1687,832,855,0.49318316538233553,0.5068168346176645
E01021135,1836,854,982,0.4651416122004357,0.5348583877995643
E01021136,1317,598,719,0.4540622627182992,0.5459377372817008
E01021137,1468,683,785,0.4652588555858311,0.534741144414169
E01021112,1505,704,801,0.4677740863787375,0.5322259136212625
E01021120,1322,535,787,0.40468986384266264,0.5953101361573374
E01021126,1542,745,797,0.48313878080415046,0.5168612191958496
E01021127,1563,724,839,0.46321177223288545,0.5367882277671145
E01021128,1825,897,928,0.4915068493150685,0.5084931506849315
E01021093,1539,730,809,0.4743339831059129,0.5256660168940871
E01021095,1291,580,711,0.4492641363284276,0.5507358636715725
E01021123,1548,721,827,0.4657622739018088,0.5342377260981912
E01021124,1674,768,906,0.45878136200716846,0.5412186379928315
E01021125,1294,586,708,0.4528593508500773,0.5471406491499228
E01021129,1789,843,946,0.47121296813862495,0.5287870318613751
E01021138,1097,508,589,0.463081130355515,0.536918869644485
E01021094,1530,681,849,0.44509803921568625,0.5549019607843138
E01021106,1658,717,941,0.4324487334137515,0.5675512665862484
E01021107,1569,748,821,0.4767367750159337,0.5232632249840663
E01021108,1480,692,788,0.46756756756756757,0.5324324324324324
E01021130,1435,684,751,0.47665505226480837,0.5233449477351917
E01021090,1666,793,873,0.4759903961584634,0.5240096038415366
E01021091,1923,924,999,0.48049921996879874,0.5195007800312013
E01021092,1997,909,1088,0.45518277416124187,0.5448172258387581
E01021121,1592,710,882,0.44597989949748745,0.5540201005025126
E01021122,1532,695,837,0.4536553524804178,0.5463446475195822
E01021167,2187,1041,1146,0.47599451303155005,0.52400548696845
E01021168,1677,800,877,0.4770423375074538,0.5229576624925462
E01021169,1414,679,735,0.4801980198019802,0.5198019801980198
E01021186,1205,599,606,0.4970954356846473,0.5029045643153527
E01021171,2050,981,1069,0.47853658536585364,0.5214634146341464
E01021172,1804,872,932,0.48337028824833705,0.516629711751663
E01021173,1420,712,708,0.5014084507042254,0.49859154929577465
E01021218,1147,551,596,0.4803836094158675,0.5196163905841326
E01021156,1786,874,912,0.48936170212765956,0.5106382978723404
E01021157,1829,880,949,0.4811372334609076,0.5188627665390924
E01021158,2186,1099,1087,0.5027447392497713,0.49725526075022874
E01021159,2324,1130,1194,0.48623063683304646,0.5137693631669535
E01021160,1649,773,876,0.4687689508793208,0.5312310491206792
E01021161,1577,806,771,0.5110970196575777,0.4889029803424223
E01021162,1618,777,841,0.48022249690976515,0.5197775030902348
E01021202,1123,487,636,0.43365983971504896,0.566340160284951
E01021203,1491,753,738,0.5050301810865191,0.4949698189134809
E01021229,1700,837,863,0.4923529411764706,0.5076470588235295
E01021230,1726,826,900,0.47856315179606024,0.5214368482039398
E01021231,1755,813,942,0.46324786324786327,0.5367521367521367
E01021151,1769,887,882,0.5014132278123233,0.49858677218767666
E01021152,1605,791,814,0.4928348909657321,0.5071651090342679
E01021153,1963,954,1009,0.4859908303616913,0.5140091696383087
E01021154,1482,753,729,0.5080971659919028,0.49190283400809715
E01021155,1163,574,589,0.4935511607910576,0.5064488392089423
E01021163,2241,1090,1151,0.48639000446229363,0.5136099955377064
E01021164,1913,937,976,0.48980658651332987,0.5101934134866701
E01021187,1434,722,712,0.5034867503486751,0.496513249651325
E01021144,1799,877,922,0.4874930516953863,0.5125069483046136
E01021145,1998,1004,994,0.5025025025025025,0.4974974974974975
E01021170,2741,1317,1424,0.48048157606712877,0.5195184239328712
E01021217,1286,629,657,0.4891135303265941,0.5108864696734059
E01021219,1350,657,693,0.4866666666666667,0.5133333333333333
E01021220,1640,772,868,0.47073170731707314,0.5292682926829269
E01021223,1121,534,587,0.47636039250669043,0.5236396074933095
E01021224,1472,712,760,0.483695652173913,0.5163043478260869
E01021225,1557,738,819,0.47398843930635837,0.5260115606936416
E01021226,1371,654,717,0.47702407002188185,0.5229759299781181
E01021150,1194,587,607,0.4916247906197655,0.5083752093802345
E01021191,1617,781,836,0.48299319727891155,0.5170068027210885
E01021192,1587,761,826,0.47952110901071204,0.520478890989288
E01021193,1722,840,882,0.4878048780487805,0.5121951219512195
E01021194,1652,782,870,0.47336561743341404,0.5266343825665859
E01021149,1278,632,646,0.4945226917057903,0.5054773082942097
E01021189,1387,693,694,0.4996395097332372,0.5003604902667628
E01021190,1524,763,761,0.5006561679790026,0.49934383202099736
E01021200,1106,512,594,0.4629294755877034,0.5370705244122965
E01021201,1536,740,796,0.4817708333333333,0.5182291666666666
E01021221,1270,632,638,0.49763779527559054,0.5023622047244094
E01021222,1506,709,797,0.4707835325365206,0.5292164674634794
E01021227,1693,827,866,0.4884819846426462,0.5115180153573539
E01021228,1513,726,787,0.47984137475214805,0.520158625247852
E01021146,1737,845,892,0.48647092688543464,0.5135290731145653
E01021147,1654,843,811,0.5096735187424426,0.49032648125755746
E01021148,1566,757,809,0.483397190293742,0.5166028097062579
E01021165,1192,599,593,0.50251677852349,0.4974832214765101
E01021188,1136,554,582,0.4876760563380282,0.5123239436619719
E01021198,1524,732,792,0.48031496062992124,0.5196850393700787
E01021199,1328,622,706,0.4683734939759036,0.5316265060240963
E01021204,1203,586,617,0.48711554447215294,0.512884455527847
E01021205,1250,624,626,0.4992,0.5008
E01021174,1627,783,844,0.4812538414259373,0.5187461585740627
E01021175,1489,716,773,0.48085963734049697,0.519140362659503
E01021176,1405,667,738,0.47473309608540926,0.5252669039145907
E01021177,1109,506,603,0.45626690712353474,0.5437330928764653
E01021180,1317,602,715,0.45709946848899013,0.5429005315110099
E01021181,1298,618,680,0.4761171032357473,0.5238828967642527
E01021182,1569,768,801,0.4894837476099426,0.5105162523900574
E01021183,1341,638,703,0.47576435495898584,0.5242356450410142
E01021178,1393,657,736,0.47164393395549176,0.5283560660445082
E01021179,1497,701,796,0.4682698730794923,0.5317301269205077
E01021184,1545,694,851,0.44919093851132685,0.5508090614886731
E01021185,1496,700,796,0.4679144385026738,0.5320855614973262
E01021142,1112,517,595,0.46492805755395683,0.5350719424460432
E01021143,1209,562,647,0.46484698097601324,0.5351530190239868
E01021166,2258,1080,1178,0.4782993799822852,0.5217006200177148
E01021195,1955,959,996,0.490537084398977,0.509462915601023
E01021196,1942,941,1001,0.48455200823892897,0.515447991761071
E01021197,2043,1029,1014,0.5036710719530103,0.49632892804698975
E01021212,1822,861,961,0.4725576289791438,0.5274423710208562
E01021213,1773,830,943,0.46813310772701633,0.5318668922729837
E01021214,1625,758,867,0.4664615384615385,0.5335384615384615
E01021215,1257,588,669,0.4677804295942721,0.5322195704057279
E01021216,1178,552,626,0.4685908319185059,0.5314091680814941
E01021206,1448,655,793,0.45234806629834257,0.5476519337016574
E01021207,1339,630,709,0.4705003734129948,0.5294996265870052
E01021208,1942,922,1020,0.4747682801235839,0.525231719876416
E01021209,1615,796,819,0.49287925696594426,0.5071207430340557
E01021210,1598,820,778,0.5131414267834794,0.48685857321652065
E01021211,1525,723,802,0.4740983606557377,0.5259016393442623
E01021232,1652,767,885,0.4642857142857143,0.5357142857142857
E01021233,1483,710,773,0.4787592717464599,0.5212407282535402
E01021234,1475,693,782,0.46983050847457625,0.5301694915254237
E01021235,1341,625,716,0.46607009694258017,0.5339299030574198
E01021236,1489,700,789,0.47011417058428473,0.5298858294157153
E01022553,1457,715,742,0.4907343857240906,0.5092656142759094
E01022554,1676,852,824,0.5083532219570406,0.4916467780429594
E01022555,1508,768,740,0.5092838196286472,0.4907161803713528
E01022556,1599,811,788,0.5071919949968731,0.49280800500312694
E01022560,1177,595,582,0.5055225148683092,0.49447748513169076
E01022493,1338,669,669,0.5,0.5
E01022536,1320,683,637,0.5174242424242425,0.4825757575757576
E01022537,1293,652,641,0.5042536736272235,0.4957463263727765
E01022557,1529,767,762,0.5016350555918901,0.49836494440810986
E01022558,1247,635,612,0.5092221331194867,0.4907778668805132
E01022559,1280,629,651,0.49140625,0.50859375
E01022488,1185,585,600,0.4936708860759494,0.5063291139240507
E01022489,1534,818,716,0.5332464146023468,0.4667535853976532
E01022499,1537,751,786,0.4886141834743006,0.5113858165256994
E01022500,1377,658,719,0.47785039941902685,0.5221496005809731
E01022513,1606,778,828,0.48443337484433374,0.5155666251556662
E01022472,1243,603,640,0.48511665325824616,0.5148833467417538
E01022473,1246,626,620,0.5024077046548957,0.49759229534510435
E01022520,1642,804,838,0.48964677222898906,0.510353227771011
E01022521,1708,838,870,0.49063231850117095,0.509367681498829
E01022522,1584,800,784,0.5050505050505051,0.494949494949495
E01022490,1773,881,892,0.49689791314156795,0.503102086858432
E01022491,1947,952,995,0.4889573703133025,0.5110426296866974
E01022492,1587,810,777,0.5103969754253308,0.4896030245746692
E01022546,1407,668,739,0.47476901208244493,0.5252309879175551
E01022547,1710,859,851,0.5023391812865498,0.4976608187134503
E01022495,1455,727,728,0.49965635738831615,0.5003436426116838
E01022496,2470,1228,1242,0.497165991902834,0.5028340080971659
E01022497,1362,662,700,0.48604992657856094,0.5139500734214391
E01022498,1519,759,760,0.49967083607636603,0.500329163923634
E01022539,1227,617,610,0.5028524857375714,0.4971475142624287
E01022540,1955,909,1046,0.4649616368286445,0.5350383631713554
E01022542,1263,647,616,0.5122723673792557,0.48772763262074426
E01022543,1585,801,784,0.5053627760252366,0.4946372239747634
E01032843,1612,792,820,0.4913151364764268,0.5086848635235732
E01032844,1528,745,783,0.487565445026178,0.512434554973822
E01032851,2079,1007,1072,0.4843674843674844,0.5156325156325157
E01022470,1881,948,933,0.5039872408293461,0.4960127591706539
E01022471,1543,767,776,0.4970836033700583,0.5029163966299417
E01022494,2433,1193,1240,0.490341142622277,0.509658857377723
E01022523,2041,1001,1040,0.49044585987261147,0.5095541401273885
E01022524,1974,933,1041,0.4726443768996961,0.5273556231003039
E01022525,1651,810,841,0.49061175045427013,0.5093882495457298
E01022526,1674,846,828,0.5053763440860215,0.4946236559139785
E01022527,1599,773,826,0.4834271419637273,0.5165728580362726
E01022566,1297,682,615,0.525828835774865,0.47417116422513494
E01022567,1277,629,648,0.4925606891151135,0.5074393108848865
E01022568,1421,686,735,0.4827586206896552,0.5172413793103449
E01022570,1566,739,827,0.4719029374201788,0.5280970625798213
E01032840,1925,955,970,0.4961038961038961,0.5038961038961038
E01032841,1655,843,812,0.5093655589123867,0.4906344410876133
E01022502,1541,798,743,0.517845554834523,0.48215444516547695
E01022506,1265,641,624,0.5067193675889328,0.4932806324110672
E01022507,1557,774,783,0.49710982658959535,0.5028901734104047
E01032842,1239,682,557,0.5504439063761097,0.4495560936238902
E01032847,1348,687,661,0.5096439169139466,0.4903560830860534
E01022481,1799,903,896,0.5019455252918288,0.4980544747081712
E01022482,1573,755,818,0.4799745708836618,0.5200254291163382
E01022503,1406,723,683,0.5142247510668563,0.48577524893314367
E01032845,1695,874,821,0.5156342182890855,0.48436578171091443
E01032846,1512,804,708,0.5317460317460317,0.46825396825396826
E01022484,1318,630,688,0.4779969650986343,0.5220030349013657
E01022485,1179,558,621,0.4732824427480916,0.5267175572519084
E01022486,2047,985,1062,0.4811919882755252,0.5188080117244749
E01022487,1299,644,655,0.49576597382602,0.5042340261739799
E01022569,1232,627,605,0.5089285714285714,0.49107142857142855
E01022548,1366,661,705,0.4838945827232797,0.5161054172767203
E01022549,1613,768,845,0.47613143211407316,0.5238685678859268
E01022550,1662,818,844,0.49217809867629364,0.5078219013237064
E01022551,1536,748,788,0.4869791666666667,0.5130208333333334
E01022552,1502,733,769,0.48801597869507324,0.5119840213049268
E01022528,1272,627,645,0.49292452830188677,0.5070754716981132
E01022529,1477,699,778,0.4732566012186865,0.5267433987813135
E01022530,1251,612,639,0.4892086330935252,0.5107913669064749
E01022531,1476,749,727,0.5074525745257452,0.49254742547425473
E01022475,1653,831,822,0.5027223230490018,0.49727767695099817
E01022476,1847,928,919,0.5024363833243097,0.4975636166756903
E01022480,1320,681,639,0.5159090909090909,0.48409090909090907
E01022504,1504,736,768,0.48936170212765956,0.5106382978723404
E01022505,1549,779,770,0.5029051000645578,0.4970948999354422
E01022467,1660,816,844,0.491566265060241,0.5084337349397591
E01022468,1792,852,940,0.47544642857142855,0.5245535714285714
E01022469,1570,759,811,0.4834394904458599,0.5165605095541401
E01022561,1467,742,725,0.5057941376959781,0.4942058623040218
E01022562,1329,665,664,0.5003762227238525,0.4996237772761475
E01022515,1291,628,663,0.48644461657629745,0.5135553834237025
E01022516,1484,714,770,0.4811320754716981,0.5188679245283019
E01022517,1241,610,631,0.49153908138597907,0.508460918614021
E01022518,2008,1012,996,0.5039840637450199,0.4960159362549801
E01022519,1261,644,617,0.5107057890563045,0.48929421094369546
E01022474,1552,725,827,0.46713917525773196,0.532860824742268
E01022477,1376,679,697,0.4934593023255814,0.5065406976744186
E01022478,1437,693,744,0.4822546972860125,0.5177453027139874
E01022479,1369,657,712,0.4799123447772096,0.5200876552227903
E01022509,1430,708,722,0.4951048951048951,0.5048951048951049
E01022514,1514,754,760,0.49801849405548215,0.5019815059445178
E01022563,1795,879,916,0.48969359331476325,0.5103064066852367
E01022564,1811,877,934,0.4842628382109332,0.5157371617890668
E01022565,1628,769,859,0.47235872235872234,0.5276412776412777
E01022510,1665,814,851,0.4888888888888889,0.5111111111111111
E01022511,1286,644,642,0.5007776049766719,0.49922239502332816
E01022512,1405,699,706,0.49750889679715304,0.502491103202847
E01032848,1585,786,799,0.49589905362776027,0.5041009463722398
E01032849,1549,756,793,0.4880568108457069,0.511943189154293
E01032850,1481,736,745,0.49696151249155973,0.5030384875084403
E01022532,1336,677,659,0.5067365269461078,0.49326347305389223
E01022533,1784,909,875,0.5095291479820628,0.4904708520179372
E01022534,1639,799,840,0.48749237339841367,0.5125076266015863
E01022535,1514,752,762,0.4966974900924703,0.5033025099075297
E01022581,1572,728,844,0.4631043256997455,0.5368956743002544
E01022582,1411,683,728,0.48405386250885896,0.515946137491141
E01022604,1255,611,644,0.48685258964143424,0.5131474103585657
E01022605,1618,787,831,0.48640296662546356,0.5135970333745364
E01022574,1400,670,730,0.4785714285714286,0.5214285714285715
E01022575,1522,736,786,0.4835742444152431,0.5164257555847569
E01022576,1524,722,802,0.473753280839895,0.526246719160105
E01022579,1119,565,554,0.5049151027703307,0.49508489722966936
E01022571,1203,583,620,0.484621778886118,0.515378221113882
E01022572,1244,598,646,0.4807073954983923,0.5192926045016077
E01022573,2448,1236,1212,0.5049019607843137,0.4950980392156863
E01022577,1483,707,776,0.47673634524612274,0.5232636547538773
E01022578,3001,1437,1564,0.47884038653782074,0.5211596134621793
E01022580,1254,611,643,0.48724082934609253,0.5127591706539075
E01022603,1430,707,723,0.4944055944055944,0.5055944055944056
E01022634,1079,510,569,0.4726598702502317,0.5273401297497683
E01022639,1886,1065,821,0.5646871686108166,0.4353128313891835
E01022640,1463,736,727,0.5030758714969241,0.4969241285030759
E01022615,2791,1378,1413,0.4937298459333572,0.5062701540666428
E01022633,1339,645,694,0.4817027632561613,0.5182972367438387
E01022635,1486,724,762,0.48721399730820997,0.5127860026917901
E01022636,1338,666,672,0.4977578475336323,0.5022421524663677
E01022641,1245,654,591,0.5253012048192771,0.4746987951807229
E01022591,2448,1221,1227,0.4987745098039216,0.5012254901960784
E01022593,1272,626,646,0.4921383647798742,0.5078616352201258
E01022594,1437,698,739,0.4857341684064022,0.5142658315935977
E01022595,1933,952,981,0.49249870667356443,0.5075012933264356
E01022596,1377,691,686,0.5018155410312273,0.49818445896877267
E01022627,2202,1080,1122,0.4904632152588556,0.5095367847411444
E01022630,2249,1118,1131,0.49710982658959535,0.5028901734104047
E01022642,1087,524,563,0.48206071757129715,0.5179392824287029
E01032663,2336,1160,1176,0.4965753424657534,0.5034246575342466
E01022583,1684,804,880,0.47743467933491684,0.5225653206650831
E01022584,1782,844,938,0.47362514029180697,0.5263748597081931
E01022585,1615,790,825,0.4891640866873065,0.5108359133126935
E01022586,1691,841,850,0.4973388527498522,0.5026611472501479
E01022587,1719,824,895,0.47934845840605,0.52065154159395
E01022616,1702,809,893,0.47532314923619273,0.5246768507638073
E01022617,1585,754,831,0.4757097791798107,0.5242902208201893
E01022618,1834,839,995,0.4574700109051254,0.5425299890948746
E01022631,1292,627,665,0.4852941176470588,0.5147058823529411
E01022632,1170,550,620,0.4700854700854701,0.5299145299145299
E01022592,2339,1177,1162,0.5032064985036341,0.496793501496366
E01022597,2847,1363,1484,0.47874956094134175,0.5212504390586582
E01022619,1337,679,658,0.5078534031413613,0.49214659685863876
E01022624,2272,1076,1196,0.4735915492957746,0.5264084507042254
E01022625,2744,1268,1476,0.4620991253644315,0.5379008746355685
E01022620,1137,567,570,0.49868073878627966,0.5013192612137203
E01022621,1426,651,775,0.45652173913043476,0.5434782608695652
E01022622,1323,628,695,0.47467876039304613,0.5253212396069539
E01022623,2294,1101,1193,0.479947689625109,0.520052310374891
E01032664,1082,502,580,0.46395563770794823,0.5360443622920518
E01032665,1359,652,707,0.4797645327446652,0.5202354672553348
E01022588,1611,799,812,0.49596523898199874,0.5040347610180013
E01022589,1747,860,887,0.4922724670864339,0.5077275329135661
E01022590,1496,750,746,0.5013368983957219,0.49866310160427807
E01022607,1192,567,625,0.47567114093959734,0.5243288590604027
E01022608,1342,657,685,0.48956780923994037,0.5104321907600596
E01022606,2394,1183,1211,0.49415204678362573,0.5058479532163743
E01022611,1531,722,809,0.4715871979098628,0.5284128020901372
E01022613,1373,672,701,0.48943918426802624,0.5105608157319738
E01022614,1089,517,572,0.47474747474747475,0.5252525252525253
E01022610,1341,634,707,0.4727815063385533,0.5272184936614467
E01022628,1157,566,591,0.4891961970613656,0.5108038029386344
E01022629,1373,651,722,0.4741442097596504,0.5258557902403496
E01032615,1111,535,576,0.4815481548154815,0.5184518451845185
E01032616,1569,769,800,0.49012109623964306,0.5098789037603569
E01022599,1291,623,668,0.482571649883811,0.517428350116189
E01022600,1473,706,767,0.4792939579090292,0.5207060420909708
E01022601,1439,695,744,0.4829742876997915,0.5170257123002084
E01022602,1271,626,645,0.4925255704169945,0.5074744295830055
E01032625,1122,530,592,0.47237076648841353,0.5276292335115864
E01022705,1606,741,865,0.4613947696139477,0.5386052303860523
E01022706,1667,816,851,0.489502099580084,0.510497900419916
E01022707,2015,1016,999,0.5042183622828784,0.4957816377171216
E01022708,1759,856,903,0.4866401364411598,0.5133598635588402
E01022709,1754,835,919,0.47605473204104903,0.523945267958951
E01022659,1599,779,820,0.48717948717948717,0.5128205128205128
E01022660,1501,722,779,0.4810126582278481,0.5189873417721519
E01022675,1403,709,694,0.5053456878118318,0.4946543121881682
E01022676,1512,764,748,0.5052910052910053,0.4947089947089947
E01022704,1830,875,955,0.4781420765027322,0.5218579234972678
E01022661,1689,833,856,0.4931912374185909,0.5068087625814092
E01022662,1344,640,704,0.47619047619047616,0.5238095238095238
E01022663,1625,813,812,0.5003076923076923,0.4996923076923077
E01022664,1550,739,811,0.47677419354838707,0.5232258064516129
E01022665,1497,735,762,0.4909819639278557,0.5090180360721442
E01022648,1289,638,651,0.49495733126454616,0.5050426687354539
E01022667,1500,769,731,0.5126666666666667,0.48733333333333334
E01022672,1581,799,782,0.5053763440860215,0.4946236559139785
E01022673,2090,1060,1030,0.507177033492823,0.49282296650717705
E01022674,1595,772,823,0.48401253918495296,0.515987460815047
E01022643,1617,807,810,0.49907235621521334,0.5009276437847866
E01022644,1320,646,674,0.4893939393939394,0.5106060606060606
E01022646,1569,786,783,0.5009560229445507,0.49904397705544934
E01022647,1534,756,778,0.49282920469361147,0.5071707953063885
E01022649,1627,797,830,0.48985863552550707,0.510141364474493
E01022650,1149,561,588,0.48825065274151436,0.5117493472584856
E01022668,2606,1280,1326,0.4911742133537989,0.508825786646201
E01022677,2007,968,1039,0.48231190832087695,0.5176880916791231
E01022678,1891,897,994,0.47435219460602857,0.5256478053939715
E01022680,1604,744,860,0.46384039900249374,0.5361596009975063
E01022681,1574,758,816,0.4815756035578145,0.5184243964421855
E01022666,2133,1102,1031,0.516643225503985,0.483356774496015
E01022669,1792,893,899,0.49832589285714285,0.5016741071428571
E01022670,1604,792,812,0.4937655860349127,0.5062344139650873
E01022671,1527,763,764,0.4996725605762934,0.5003274394237066
E01022679,1827,933,894,0.5106732348111659,0.48932676518883417
E01022645,1172,567,605,0.48378839590443684,0.5162116040955631
E01022682,1389,682,707,0.49100071994240463,0.5089992800575954
E01022683,1389,688,701,0.4953203743700504,0.5046796256299496
E01022684,1514,773,741,0.5105680317040951,0.4894319682959049
E01022685,1196,606,590,0.5066889632107023,0.49331103678929766
E01022686,1661,831,830,0.5003010234798314,0.4996989765201686
E01022687,1760,902,858,0.5125,0.4875
E01022713,1744,833,911,0.4776376146788991,0.5223623853211009
E01022714,1668,828,840,0.49640287769784175,0.5035971223021583
E01022715,1589,738,851,0.4644430459408433,0.5355569540591567
E01022716,1550,734,816,0.4735483870967742,0.5264516129032258
E01022717,1204,600,604,0.4983388704318937,0.5016611295681063
E01022718,1462,740,722,0.506155950752394,0.493844049247606
E01022719,1544,761,783,0.49287564766839376,0.5071243523316062
E01022653,1485,735,750,0.494949494949495,0.5050505050505051
E01022691,1583,771,812,0.48704990524320907,0.5129500947567909
E01022692,2845,1364,1481,0.47943760984182776,0.5205623901581722
E01022693,1531,761,770,0.4970607446113651,0.5029392553886349
E01022694,1789,891,898,0.4980435997764114,0.5019564002235886
E01022652,1764,838,926,0.47505668934240364,0.5249433106575964
E01022695,1332,623,709,0.4677177177177177,0.5322822822822822
E01022700,1572,744,828,0.4732824427480916,0.5267175572519084
E01022701,1086,518,568,0.47697974217311234,0.5230202578268877
E01022703,1467,714,753,0.4867075664621677,0.5132924335378323
E01022651,1834,872,962,0.47546346782988,0.52453653217012
E01022696,1556,755,801,0.4852185089974293,0.5147814910025706
E01022697,1592,752,840,0.4723618090452261,0.5276381909547738
E01022698,1621,802,819,0.4947563232572486,0.5052436767427514
E01022699,1530,765,765,0.5,0.5
E01022702,1286,645,641,0.5015552099533437,0.4984447900466563
E01022654,1351,662,689,0.4900074019245004,0.5099925980754997
E01022655,1542,713,829,0.46238651102464334,0.5376134889753567
E01022656,1476,714,762,0.483739837398374,0.516260162601626
E01022657,1626,814,812,0.5006150061500615,0.4993849938499385
E01022658,1669,811,858,0.4859197124026363,0.5140802875973637
E01022710,2010,1005,1005,0.5,0.5
E01022711,1713,805,908,0.4699357851722125,0.5300642148277875
E01022712,1609,768,841,0.47731510254816656,0.5226848974518334
E01022688,2221,1131,1090,0.5092300765420982,0.4907699234579018
E01022689,1517,743,774,0.4897824653922215,0.5102175346077785
E01022690,1963,991,972,0.5048395313295976,0.4951604686704024
E01022758,1628,776,852,0.47665847665847666,0.5233415233415234
E01022771,1645,825,820,0.5015197568389058,0.49848024316109424
E01022772,2211,1159,1052,0.5241971958389868,0.4758028041610131
E01022773,1577,774,803,0.49080532656943565,0.5091946734305643
E01022774,1952,985,967,0.5046106557377049,0.4953893442622951
E01022749,1359,667,692,0.49080206033848417,0.5091979396615158
E01022753,1248,596,652,0.4775641025641026,0.5224358974358975
E01022754,1795,874,921,0.486908077994429,0.5130919220055711
E01022780,1561,795,766,0.5092889173606663,0.4907110826393338
E01022787,1340,661,679,0.49328358208955225,0.5067164179104477
E01022788,1256,607,649,0.48328025477707004,0.51671974522293
E01022730,1476,701,775,0.4749322493224932,0.5250677506775068
E01022731,1341,669,672,0.4988814317673378,0.5011185682326622
E01022732,1534,725,809,0.4726205997392438,0.5273794002607562
E01022733,1685,815,870,0.4836795252225519,0.516320474777448
E01022734,1365,659,706,0.4827838827838828,0.5172161172161173
E01022720,1418,721,697,0.5084626234132581,0.4915373765867419
E01022725,1314,622,692,0.4733637747336377,0.5266362252663622
E01022726,1448,712,736,0.49171270718232046,0.5082872928176796
E01022727,1571,749,822,0.4767663908338638,0.5232336091661363
E01022729,1177,607,570,0.5157179269328802,0.4842820730671198
E01022743,1812,888,924,0.4900662251655629,0.5099337748344371
E01022750,1508,702,806,0.46551724137931033,0.5344827586206896
E01022751,1567,766,801,0.48883216336949586,0.5111678366305041
E01022752,1422,716,706,0.5035161744022504,0.4964838255977497
E01022757,1603,791,812,0.49344978165938863,0.5065502183406113
E01022790,1800,908,892,0.5044444444444445,0.4955555555555556
E01022755,1463,694,769,0.47436773752563227,0.5256322624743678
E01022756,1322,651,671,0.4924357034795764,0.5075642965204236
E01022791,2086,1122,964,0.5378715244487057,0.4621284755512943
E01022792,1542,756,786,0.490272373540856,0.5097276264591439
E01022793,1755,857,898,0.4883190883190883,0.5116809116809117
E01022781,1388,682,706,0.49135446685878964,0.5086455331412104
E01022782,1439,702,737,0.48783877692842254,0.5121612230715775
E01022785,1495,755,740,0.5050167224080268,0.49498327759197325
E01022786,1597,796,801,0.49843456480901693,0.5015654351909831
E01022789,1445,722,723,0.4996539792387543,0.5003460207612457
E01022721,1402,688,714,0.49072753209700426,0.5092724679029957
E01022722,1711,795,916,0.46464056107539453,0.5353594389246055
E01022723,1481,709,772,0.4787305874409183,0.5212694125590817
E01022724,1450,708,742,0.4882758620689655,0.5117241379310344
E01022737,1578,824,754,0.5221799746514575,0.47782002534854245
E01022766,1322,661,661,0.5,0.5
E01022769,1258,629,629,0.5,0.5
E01022740,1620,783,837,0.48333333333333334,0.5166666666666667
E01022741,1248,609,639,0.4879807692307692,0.5120192307692307
E01022742,1758,847,911,0.48179749715585896,0.518202502844141
E01022783,1507,742,765,0.49236894492368943,0.5076310550763106
E01022784,1385,696,689,0.5025270758122744,0.49747292418772565
E01022759,1530,765,765,0.5,0.5
E01022763,1535,740,795,0.4820846905537459,0.5179153094462541
E01022765,1692,806,886,0.47635933806146574,0.5236406619385343
E01022768,1357,677,680,0.498894620486367,0.501105379513633
E01022770,1733,867,866,0.5002885170225043,0.4997114829774957
E01022728,1777,874,903,0.4918401800787845,0.5081598199212155
E01022735,1449,724,725,0.4996549344375431,0.5003450655624568
E01022736,1537,779,758,0.5068314899154196,0.49316851008458035
E01022738,1043,524,519,0.5023969319271333,0.49760306807286675
E01022739,1624,731,893,0.4501231527093596,0.5498768472906403
E01022760,1528,746,782,0.4882198952879581,0.5117801047120419
E01022761,1502,723,779,0.481358189081225,0.5186418109187749
E01022762,1531,747,784,0.4879163945133899,0.51208360548661
E01022764,1564,760,804,0.4859335038363171,0.5140664961636828
E01022767,1237,611,626,0.4939369442198868,0.5060630557801131
E01022776,1563,787,776,0.5035188739603327,0.4964811260396673
E01022777,1642,753,889,0.4585870889159562,0.5414129110840439
E01022778,1529,738,791,0.48266841072596467,0.5173315892740353
E01032877,2173,1026,1147,0.47215830648872525,0.5278416935112747
E01022744,1353,666,687,0.49223946784922396,0.5077605321507761
E01022745,1504,725,779,0.4820478723404255,0.5179521276595744
E01022746,1645,771,874,0.46869300911854106,0.5313069908814589
E01022747,1245,546,699,0.43855421686746987,0.5614457831325301
E01022748,1423,650,773,0.4567814476458187,0.5432185523541813
E01022800,1649,828,821,0.5021224984839296,0.49787750151607035
E01022801,1525,735,790,0.4819672131147541,0.5180327868852459
E01022802,1492,737,755,0.49396782841823056,0.5060321715817694
E01022803,1651,808,843,0.48940036341611143,0.5105996365838885
E01022836,1438,696,742,0.48400556328233657,0.5159944367176634
E01022804,1582,796,786,0.5031605562579013,0.4968394437420986
E01022805,1501,721,780,0.480346435709527,0.519653564290473
E01022834,1335,654,681,0.4898876404494382,0.5101123595505618
E01022835,1468,706,762,0.48092643051771117,0.5190735694822888
E01022840,1608,794,814,0.4937810945273632,0.5062189054726368
E01022813,1409,718,691,0.5095812633073101,0.49041873669268987
E01022814,1682,812,870,0.4827586206896552,0.5172413793103449
E01022815,1553,768,785,0.49452672247263363,0.5054732775273664
E01022823,1547,767,780,0.4957983193277311,0.5042016806722689
E01022825,1440,734,706,0.5097222222222222,0.49027777777777776
E01022819,1586,778,808,0.4905422446406053,0.5094577553593947
E01022820,1825,892,933,0.48876712328767125,0.5112328767123288
E01022841,1509,718,791,0.4758117958913188,0.5241882041086813
E01022842,1681,841,840,0.5002974419988102,0.4997025580011898
E01032882,2066,998,1068,0.4830590513068732,0.5169409486931268
E01022807,1559,761,798,0.48813341885824246,0.5118665811417575
E01022816,1492,742,750,0.4973190348525469,0.5026809651474531
E01022817,1794,910,884,0.5072463768115942,0.4927536231884058
E01022818,1457,716,741,0.4914207275223061,0.5085792724776939
E01022824,2722,1406,1316,0.5165319617927994,0.4834680382072006
E01022826,1534,742,792,0.48370273794002605,0.516297262059974
E01022828,1300,583,717,0.44846153846153847,0.5515384615384615
E01022829,2093,1036,1057,0.49498327759197325,0.5050167224080268
E01022830,1408,669,739,0.47514204545454547,0.5248579545454546
E01032880,1415,685,730,0.4840989399293286,0.5159010600706714
E01032881,1744,875,869,0.5017201834862385,0.49827981651376146
E01032883,1366,663,703,0.48535871156661786,0.5146412884333821
E01022806,1490,750,740,0.5033557046979866,0.4966442953020134
E01022832,1651,819,832,0.49606299212598426,0.5039370078740157
E01022839,1355,695,660,0.5129151291512916,0.4870848708487085
E01032884,2095,1029,1066,0.4911694510739857,0.5088305489260143
E01022810,1583,832,751,0.525584333543904,0.474415666456096
E01022811,2270,1150,1120,0.5066079295154186,0.4933920704845815
E01022833,1854,935,919,0.5043149946062567,0.49568500539374327
E01022843,1570,737,833,0.4694267515923567,0.5305732484076433
E01032878,1109,572,537,0.5157799819657349,0.4842200180342651
E01032879,1208,634,574,0.5248344370860927,0.47516556291390727
E01022794,1472,709,763,0.48165760869565216,0.5183423913043478
E01022795,1503,751,752,0.49966733200266134,0.5003326679973387
E01022796,1259,598,661,0.4749801429706116,0.5250198570293884
E01022837,1603,776,827,0.4840923268870867,0.5159076731129133
E01022838,1312,617,695,0.47027439024390244,0.5297256097560976
E01022797,1121,558,563,0.4977698483496878,0.5022301516503123
E01022798,1205,629,576,0.5219917012448133,0.47800829875518674
E01022799,1376,661,715,0.4803779069767442,0.5196220930232558
E01022812,1249,613,636,0.49079263410728585,0.5092073658927142
E01022831,1446,718,728,0.49654218533886585,0.5034578146611342
E01022845,1460,664,796,0.4547945205479452,0.5452054794520548
E01022890,1470,700,770,0.47619047619047616,0.5238095238095238
E01022891,1743,843,900,0.4836488812392427,0.5163511187607573
E01022892,1862,920,942,0.4940923737916219,0.505907626208378
E01022893,1611,765,846,0.4748603351955307,0.5251396648044693
E01022894,1478,728,750,0.4925575101488498,0.5074424898511503
E01022859,1653,807,846,0.4882032667876588,0.5117967332123412
E01022895,1834,890,944,0.48527808069792805,0.514721919302072
E01022896,1618,794,824,0.4907292954264524,0.5092707045735476
E01022897,1697,852,845,0.5020624631703006,0.4979375368296995
E01022898,1516,751,765,0.4953825857519789,0.5046174142480211
E01022846,1182,637,545,0.538917089678511,0.461082910321489
E01022847,1738,874,864,0.5028768699654775,0.49712313003452246
E01022848,1553,762,791,0.49066323245331617,0.5093367675466839
E01022874,1360,678,682,0.4985294117647059,0.5014705882352941
E01022875,1466,737,729,0.5027285129604365,0.4972714870395634
E01022876,1360,673,687,0.4948529411764706,0.5051470588235294
E01022877,1456,738,718,0.5068681318681318,0.49313186813186816
E01022858,1055,544,511,0.5156398104265403,0.4843601895734597
E01022878,1731,825,906,0.47660311958405543,0.5233968804159446
E01022879,1775,849,926,0.4783098591549296,0.5216901408450704
E01022880,1493,741,752,0.49631614199598123,0.5036838580040187
E01022860,1957,907,1050,0.4634644864588656,0.5365355135411344
E01022862,1926,987,939,0.5124610591900312,0.48753894080996885
E01022867,1516,770,746,0.5079155672823219,0.4920844327176781
E01032852,1742,856,886,0.49138920780711826,0.5086107921928817
E01032853,1769,876,893,0.4951950254381006,0.5048049745618994
E01032854,1672,844,828,0.5047846889952153,0.49521531100478466
E01032857,1026,535,491,0.5214424951267057,0.47855750487329435
E01022881,2365,1180,1185,0.4989429175475687,0.5010570824524313
E01022882,1488,746,742,0.5013440860215054,0.4986559139784946
E01022883,1383,677,706,0.4895155459146782,0.5104844540853217
E01022884,1619,781,838,0.4823965410747375,0.5176034589252625
E01022885,1479,740,739,0.5003380662609872,0.49966193373901285
E01022861,1711,879,832,0.5137346580946814,0.4862653419053185
E01022863,1573,781,792,0.4965034965034965,0.5034965034965035
E01022865,1621,832,789,0.51326341764343,0.48673658235657
E01022868,1699,831,868,0.4891112419070041,0.5108887580929958
E01022870,1453,707,746,0.4865794907088782,0.5134205092911218
E01022864,1443,720,723,0.498960498960499,0.501039501039501
E01022871,1418,698,720,0.4922425952045134,0.5077574047954866
E01022872,1792,901,891,0.5027901785714286,0.49720982142857145
E01022873,1786,827,959,0.4630459126539754,0.5369540873460247
E01022887,1445,752,693,0.5204152249134948,0.4795847750865052
E01022849,1701,829,872,0.48736037624926515,0.5126396237507349
E01022850,1532,746,786,0.4869451697127937,0.5130548302872062
E01022851,1691,791,900,0.4677705499704317,0.5322294500295683
E01022853,1743,841,902,0.4825014343086632,0.5174985656913368
E01022869,1440,717,723,0.4979166666666667,0.5020833333333333
E01022852,1813,886,927,0.4886927744070601,0.5113072255929398
E01022854,1736,864,872,0.4976958525345622,0.5023041474654378
E01022855,1239,599,640,0.483454398708636,0.516545601291364
E01022856,1506,718,788,0.4767596281540505,0.5232403718459495
E01022857,1457,703,754,0.48249828414550444,0.5175017158544956
E01022888,1686,796,890,0.4721233689205219,0.527876631079478
E01022889,1479,700,779,0.47329276538201487,0.5267072346179851
E01032855,1293,664,629,0.5135344160866203,0.48646558391337974
E01032856,2183,1385,798,0.6344480073293632,0.36555199267063676
E01022930,1649,801,848,0.48574893875075803,0.5142510612492419
E01022931,1663,794,869,0.47745039085989177,0.5225496091401083
E01022935,1514,753,761,0.49735799207397624,0.5026420079260238
E01022975,1513,727,786,0.48050231328486454,0.5194976867151355
E01022976,1511,773,738,0.5115817339510258,0.4884182660489742
E01022922,1499,727,772,0.4849899933288859,0.5150100066711141
E01022971,1509,753,756,0.4990059642147117,0.5009940357852882
E01022972,1583,780,803,0.49273531269741,0.50726468730259
E01022974,1425,684,741,0.48,0.52
E01022959,1458,686,772,0.47050754458161864,0.5294924554183813
E01022962,1480,709,771,0.47905405405405405,0.5209459459459459
E01022965,1478,723,755,0.4891745602165088,0.5108254397834912
E01022973,2008,934,1074,0.4651394422310757,0.5348605577689243
E01022901,1711,806,905,0.4710695499707773,0.5289304500292227
E01022902,1572,786,786,0.5,0.5
E01022966,1373,638,735,0.4646758922068463,0.5353241077931536
E01022967,1240,602,638,0.4854838709677419,0.5145161290322581
E01022960,1421,686,735,0.4827586206896552,0.5172413793103449
E01022961,1382,686,696,0.4963820549927641,0.5036179450072359
E01022963,1412,704,708,0.4985835694050991,0.5014164305949008
E01022964,1376,672,704,0.4883720930232558,0.5116279069767442
E01022903,1814,890,924,0.4906284454244763,0.5093715545755237
E01022906,1479,717,762,0.4847870182555781,0.5152129817444219
E01022968,1447,696,751,0.4809951624049758,0.5190048375950241
E01022969,1667,785,882,0.4709058188362327,0.5290941811637673
E01022913,1307,640,667,0.48967100229533284,0.5103289977046672
E01022914,1302,651,651,0.5,0.5
E01022915,1468,751,717,0.5115803814713896,0.4884196185286104
E01022916,1590,747,843,0.469811320754717,0.530188679245283
E01022917,1243,603,640,0.48511665325824616,0.5148833467417538
E01022900,1854,904,950,0.48759439050701187,0.5124056094929881
E01022904,1990,984,1006,0.49447236180904525,0.5055276381909548
E01022905,1779,846,933,0.47554806070826305,0.524451939291737
E01022908,1453,692,761,0.47625602202339984,0.5237439779766001
E01022970,1892,900,992,0.47568710359408034,0.5243128964059197
E01022947,1650,828,822,0.5018181818181818,0.49818181818181817
E01022948,1639,780,859,0.4758999389871873,0.5241000610128127
E01022949,1525,726,799,0.4760655737704918,0.5239344262295081
E01022950,1501,750,751,0.4996668887408394,0.5003331112591606
E01022951,1393,701,692,0.5032304379038047,0.49676956209619527
E01022952,1463,719,744,0.4914559125085441,0.508544087491456
E01022924,1600,789,811,0.493125,0.506875
E01022925,1400,669,731,0.47785714285714287,0.5221428571428571
E01022926,1529,765,764,0.5003270111183781,0.499672988881622
E01022927,1647,760,887,0.461445051608986,0.5385549483910139
E01022928,1755,809,946,0.46096866096866096,0.539031339031339
E01022929,1561,730,831,0.4676489429852659,0.5323510570147342
E01022953,2029,986,1043,0.48595367175948745,0.5140463282405126
E01022954,1525,736,789,0.48262295081967216,0.5173770491803279
E01022955,1375,651,724,0.47345454545454546,0.5265454545454545
E01022956,1214,579,635,0.4769357495881384,0.5230642504118617
E01022957,1303,628,675,0.4819646968534152,0.5180353031465849
E01022958,1436,719,717,0.5006963788300836,0.49930362116991645
E01022937,1438,736,702,0.5118219749652295,0.48817802503477054
E01022943,1465,727,738,0.4962457337883959,0.5037542662116041
E01022944,1271,628,643,0.4940991345397325,0.5059008654602675
E01022946,1803,844,959,0.46810870770937324,0.5318912922906267
E01022940,1546,724,822,0.4683053040103493,0.5316946959896507
E01022942,1572,735,837,0.4675572519083969,0.5324427480916031
E01022945,2266,1062,1204,0.46866725507502205,0.531332744924978
E01022936,1491,751,740,0.5036887994634474,0.49631120053655264
E01022938,1449,673,776,0.4644582470669427,0.5355417529330573
E01022939,1565,765,800,0.48881789137380194,0.5111821086261981
E01022941,1513,745,768,0.49239920687376076,0.5076007931262393
E01022899,1381,677,704,0.49022447501810285,0.5097755249818972
E01022907,1512,724,788,0.47883597883597884,0.5211640211640212
E01022909,1577,781,796,0.49524413443246673,0.5047558655675333
E01022910,1429,726,703,0.5080475857242828,0.4919524142757173
E01022911,1502,763,739,0.5079893475366178,0.49201065246338216
E01032605,1362,642,720,0.4713656387665198,0.5286343612334802
E01022919,1630,804,826,0.49325153374233127,0.5067484662576687
E01022933,1672,830,842,0.4964114832535885,0.5035885167464115
E01022934,1923,949,974,0.49349973998959956,0.5065002600104004
E01032618,1486,738,748,0.49663526244952894,0.5033647375504711
E01022918,1498,717,781,0.4786381842456609,0.5213618157543392
E01022920,1570,751,819,0.478343949044586,0.521656050955414
E01022921,1563,784,779,0.5015994881637876,0.4984005118362124
E01032617,1593,776,817,0.48713119899560575,0.5128688010043942
E01023011,1462,732,730,0.5006839945280438,0.4993160054719562
E01023012,1372,680,692,0.4956268221574344,0.5043731778425656
E01023021,1592,791,801,0.49685929648241206,0.503140703517588
E01023022,1790,848,942,0.47374301675977654,0.5262569832402234
E01023023,1757,841,916,0.4786568013659647,0.5213431986340353
E01023024,1539,737,802,0.4788823911630929,0.521117608836907
E01023025,1364,664,700,0.4868035190615836,0.5131964809384164
E01023076,1419,704,715,0.49612403100775193,0.5038759689922481
E01023082,1466,739,727,0.5040927694406548,0.49590723055934516
E01023083,1515,737,778,0.4864686468646865,0.5135313531353135
E01023088,1623,767,856,0.47258163894023414,0.5274183610597659
E01023073,1397,690,707,0.49391553328561205,0.506084466714388
E01023080,1400,696,704,0.49714285714285716,0.5028571428571429
E01023081,2030,979,1051,0.48226600985221674,0.5177339901477832
E01023089,1545,780,765,0.5048543689320388,0.49514563106796117
E01023090,1886,947,939,0.5021208907741251,0.49787910922587486
E01023074,1451,710,741,0.48931771192281187,0.5106822880771882
E01023077,1518,742,776,0.4888010540184453,0.5111989459815547
E01023078,1405,691,714,0.4918149466192171,0.5081850533807829
E01023079,1733,886,847,0.5112521638776688,0.4887478361223312
E01023085,1543,740,803,0.4795852235904083,0.5204147764095917
E01023072,1302,661,641,0.5076804915514593,0.4923195084485407
E01023075,1191,570,621,0.47858942065491183,0.5214105793450882
E01023084,1540,739,801,0.4798701298701299,0.5201298701298701
E01023086,1526,729,797,0.47771952817824376,0.5222804718217562
E01023087,1480,713,767,0.4817567567567568,0.5182432432432432
E01022977,1486,737,749,0.4959623149394347,0.5040376850605652
E01022978,1528,727,801,0.4757853403141361,0.5242146596858639
E01022979,1203,578,625,0.48046550290939316,0.5195344970906068
E01022980,1547,768,779,0.4964447317388494,0.5035552682611506
E01022992,1153,578,575,0.5013009540329575,0.4986990459670425
E01022993,1362,667,695,0.4897209985315712,0.5102790014684288
E01023045,1580,768,812,0.4860759493670886,0.5139240506329114
E01023046,1449,693,756,0.4782608695652174,0.5217391304347826
E01023007,1139,539,600,0.47322212467076386,0.5267778753292361
E01023010,1537,720,817,0.468445022771633,0.531554977228367
E01023047,1328,663,665,0.4992469879518072,0.5007530120481928
E01023048,1358,663,695,0.4882179675994109,0.5117820324005891
E01023049,1662,850,812,0.5114320096269555,0.48856799037304455
E01023050,1793,900,893,0.501952035694367,0.49804796430563303
E01023008,1533,734,799,0.47879973907371165,0.5212002609262884
E01023009,1503,756,747,0.5029940119760479,0.49700598802395207
E01023038,1458,693,765,0.47530864197530864,0.5246913580246914
E01023039,1433,675,758,0.471039776692254,0.528960223307746
E01023040,1450,724,726,0.4993103448275862,0.5006896551724138
E01023026,1171,583,588,0.49786507258753204,0.502134927412468
E01023062,1495,740,755,0.49498327759197325,0.5050167224080268
E01023064,1380,663,717,0.48043478260869565,0.5195652173913043
E01023066,1659,800,859,0.4822182037371911,0.517781796262809
E01023067,1490,719,771,0.4825503355704698,0.5174496644295302
E01023003,1729,837,892,0.48409485251590517,0.5159051474840949
E01023004,1865,921,944,0.4938337801608579,0.5061662198391421
E01023005,1505,745,760,0.4950166112956811,0.5049833887043189
E01023006,1393,656,737,0.47092605886575734,0.5290739411342427
E01023028,2096,1035,1061,0.4937977099236641,0.5062022900763359
E01023037,1885,902,983,0.47851458885941645,0.5214854111405836
E01023065,1643,795,848,0.4838709677419355,0.5161290322580645
E01023068,1338,626,712,0.4678624813153961,0.5321375186846039
E01023069,1557,749,808,0.481053307642903,0.518946692357097
E01023070,1773,800,973,0.4512126339537507,0.5487873660462493
E01023071,1377,665,712,0.4829339143064633,0.5170660856935366
E01023029,1689,768,921,0.4547069271758437,0.5452930728241563
E01023030,1308,647,661,0.49464831804281345,0.5053516819571865
E01023032,1303,625,678,0.47966231772831924,0.5203376822716808
E01023033,1302,612,690,0.4700460829493088,0.5299539170506913
E01023013,1466,723,743,0.4931787175989086,0.5068212824010914
E01023014,1675,833,842,0.4973134328358209,0.5026865671641791
E01023015,1484,750,734,0.5053908355795148,0.4946091644204852
E01023016,1391,689,702,0.4953271028037383,0.5046728971962616
E01023027,1430,689,741,0.4818181818181818,0.5181818181818182
E01023031,1239,613,626,0.4947538337368846,0.5052461662631155
E01022989,1811,841,970,0.46438431805632246,0.5356156819436775
E01022991,2070,993,1077,0.4797101449275362,0.5202898550724637
E01022998,1751,839,912,0.47915476870359797,0.520845231296402
E01023000,1801,847,954,0.470294280955025,0.529705719044975
E01022994,1579,743,836,0.47055098163394554,0.5294490183660545
E01022995,1414,682,732,0.4823196605374823,0.5176803394625177
E01022996,1245,589,656,0.47309236947791167,0.5269076305220883
E01022997,1384,642,742,0.4638728323699422,0.5361271676300579
E01023063,1297,650,647,0.5011565150346955,0.49884348496530456
E01022990,1570,801,769,0.5101910828025478,0.48980891719745223
E01022999,2111,1074,1037,0.5087636191378494,0.49123638086215066
E01023041,1514,716,798,0.47291941875825627,0.5270805812417437
E01023042,1507,652,855,0.43264764432647645,0.5673523556735236
E01023043,1724,759,965,0.44025522041763343,0.5597447795823666
E01022984,1507,717,790,0.47577969475779697,0.5242203052422031
E01022985,1224,575,649,0.46977124183006536,0.5302287581699346
E01023020,1434,696,738,0.48535564853556484,0.5146443514644351
E01023034,1738,812,926,0.4672036823935558,0.5327963176064442
E01023035,1754,828,926,0.47206385404789053,0.5279361459521095
E01023036,1984,940,1044,0.4737903225806452,0.5262096774193549
E01023001,1782,868,914,0.48709315375982043,0.5129068462401796
E01023002,1719,788,931,0.4584060500290867,0.5415939499709134
E01023058,1490,704,786,0.47248322147651006,0.5275167785234899
E01023060,1397,680,717,0.4867573371510379,0.513242662848962
E01023061,1465,702,763,0.47918088737201364,0.5208191126279863
E01023017,1962,935,1027,0.4765545361875637,0.5234454638124363
E01023018,1432,669,763,0.46717877094972066,0.5328212290502793
E01023019,1451,672,779,0.4631288766368022,0.5368711233631978
E01023055,1290,632,658,0.48992248062015503,0.5100775193798449
E01022986,1424,693,731,0.4866573033707865,0.5133426966292135
E01022988,1501,730,771,0.48634243837441704,0.513657561625583
E01023054,1775,815,960,0.4591549295774648,0.5408450704225352
E01023056,1537,654,883,0.4255042290175667,0.5744957709824333
E01023057,1723,764,959,0.4434126523505514,0.5565873476494486
E01022981,1967,914,1053,0.4646670055922725,0.5353329944077275
E01022982,1834,831,1003,0.4531079607415485,0.5468920392584514
E01022983,1653,760,893,0.45977011494252873,0.5402298850574713
E01022987,2003,880,1123,0.43934098851722414,0.5606590114827759
E01023044,1099,515,584,0.46860782529572337,0.5313921747042766
E01023051,1541,736,805,0.47761194029850745,0.5223880597014925
E01023052,1641,754,887,0.45947592931139547,0.5405240706886045
E01023053,1656,775,881,0.46799516908212563,0.5320048309178744
E01023059,1710,786,924,0.45964912280701753,0.5403508771929825
E01023099,1689,770,919,0.45589105979869743,0.5441089402013025
E01023104,1670,823,847,0.492814371257485,0.5071856287425149
E01023106,1479,741,738,0.5010141987829615,0.49898580121703856
E01023121,2016,960,1056,0.47619047619047616,0.5238095238095238
E01023105,1559,746,813,0.47851186658114175,0.5214881334188582
E01023119,1308,628,680,0.4801223241590214,0.5198776758409785
E01023120,1797,865,932,0.4813578185865331,0.5186421814134669
E01023122,1514,711,803,0.46961690885072654,0.5303830911492734
E01023146,1374,661,713,0.4810771470160116,0.5189228529839883
E01023100,1257,636,621,0.5059665871121718,0.49403341288782815
E01023101,1278,638,640,0.49921752738654146,0.5007824726134585
E01023102,1374,705,669,0.5131004366812227,0.4868995633187773
E01023134,1811,910,901,0.5024848150193263,0.49751518498067365
E01023147,1493,729,764,0.4882786336235767,0.5117213663764233
E01023096,2133,1070,1063,0.5016408813877168,0.49835911861228316
E01023097,1418,699,719,0.4929478138222849,0.5070521861777151
E01023103,1621,811,810,0.500308451573103,0.499691548426897
E01023111,1818,868,950,0.47744774477447743,0.5225522552255225
E01023112,1270,614,656,0.48346456692913387,0.5165354330708661
E01023092,1465,731,734,0.49897610921501706,0.5010238907849829
E01023093,1376,683,693,0.49636627906976744,0.5036337209302325
E01023132,1560,770,790,0.4935897435897436,0.5064102564102564
E01023133,1353,652,701,0.4818920916481892,0.5181079083518108
E01023135,2419,1161,1258,0.4799503927242662,0.5200496072757338
E01023091,1722,847,875,0.491869918699187,0.508130081300813
E01023094,1330,657,673,0.493984962406015,0.5060150375939849
E01023095,1762,842,920,0.4778660612939841,0.5221339387060159
E01023098,1558,767,791,0.49229781771501924,0.5077021822849808
E01023148,1379,706,673,0.5119651921682379,0.4880348078317622
E01023149,1301,652,649,0.5011529592621061,0.49884704073789393
E01023113,1595,813,782,0.509717868338558,0.490282131661442
E01023114,1460,721,739,0.49383561643835616,0.5061643835616438
E01023136,1749,909,840,0.5197255574614065,0.48027444253859347
E01023137,1286,675,611,0.5248833592534993,0.4751166407465008
E01023138,1367,685,682,0.5010972933430871,0.49890270665691294
E01023139,1309,636,673,0.48586707410236823,0.5141329258976318
E01023140,1616,804,812,0.4975247524752475,0.5024752475247525
E01023141,3120,2033,1087,0.6516025641025641,0.3483974358974359
E01023142,1931,985,946,0.5100983946141895,0.48990160538581046
E01023143,2011,996,1015,0.49527598209845847,0.5047240179015415
E01023144,1754,904,850,0.5153933865450399,0.4846066134549601
E01023118,1749,899,850,0.5140080045740423,0.48599199542595767
E01023124,1267,629,638,0.4964483030781373,0.5035516969218626
E01023125,2388,1199,1189,0.5020938023450586,0.4979061976549414
E01032858,2135,1040,1095,0.48711943793911006,0.5128805620608899
E01023128,1386,663,723,0.47835497835497837,0.5216450216450217
E01023129,1275,637,638,0.4996078431372549,0.5003921568627451
E01023130,1376,689,687,0.5007267441860465,0.4992732558139535
E01023131,1414,663,751,0.46888260254596886,0.5311173974540311
E01023145,1998,983,1015,0.491991991991992,0.508008008008008
E01023109,1504,745,759,0.4953457446808511,0.504654255319149
E01023115,1368,666,702,0.4868421052631579,0.5131578947368421
E01023116,1802,890,912,0.4938956714761376,0.5061043285238623
E01023117,1800,902,898,0.5011111111111111,0.4988888888888889
E01023107,1440,694,746,0.48194444444444445,0.5180555555555556
E01023108,1366,626,740,0.4582723279648609,0.541727672035139
E01023110,1783,896,887,0.5025238362310712,0.4974761637689288
E01023123,1454,722,732,0.4965612104539202,0.5034387895460798
E01023165,2119,1027,1092,0.48466257668711654,0.5153374233128835
E01023169,1947,942,1005,0.48382126348228044,0.5161787365177196
E01023181,1408,702,706,0.49857954545454547,0.5014204545454546
E01023182,1569,778,791,0.4958572339069471,0.5041427660930529
E01023153,1668,846,822,0.5071942446043165,0.49280575539568344
E01023154,1695,807,888,0.4761061946902655,0.5238938053097345
E01023156,1486,726,760,0.48855989232839836,0.5114401076716016
E01023157,1426,683,743,0.4789621318373071,0.5210378681626928
E01023205,1348,657,691,0.4873887240356083,0.5126112759643917
E01023155,2768,1390,1378,0.5021676300578035,0.49783236994219654
E01023201,1649,803,846,0.48696179502728926,0.5130382049727107
E01023202,1743,839,904,0.48135398737808377,0.5186460126219162
E01023215,1568,736,832,0.46938775510204084,0.5306122448979592
E01023219,1411,672,739,0.47625797306874557,0.5237420269312544
E01023179,1819,908,911,0.49917537108301263,0.5008246289169873
E01023183,1474,724,750,0.49118046132971505,0.508819538670285
E01023190,1231,597,634,0.4849715678310317,0.5150284321689683
E01023203,1528,747,781,0.48887434554973824,0.5111256544502618
E01023204,1710,837,873,0.48947368421052634,0.5105263157894737
E01023180,1663,790,873,0.4750450992182802,0.5249549007817198
E01023186,1712,839,873,0.49007009345794394,0.509929906542056
E01023189,1638,818,820,0.4993894993894994,0.5006105006105006
E01023196,1709,845,864,0.4944411936805149,0.5055588063194851
E01032870,1911,943,968,0.4934589220303506,0.5065410779696494
E01032871,1531,741,790,0.4839973873285434,0.5160026126714565
E01023187,1634,766,868,0.46878824969400246,0.5312117503059975
E01023188,1332,636,696,0.4774774774774775,0.5225225225225225
E01023216,1828,904,924,0.49452954048140046,0.5054704595185996
E01023217,1582,766,816,0.48419721871049304,0.515802781289507
E01023218,1522,790,732,0.519053876478318,0.480946123521682
E01023159,2261,1135,1126,0.5019902697921274,0.49800973020787265
E01023195,2182,1154,1028,0.5288725939505041,0.4711274060494959
E01023197,1504,727,777,0.4833776595744681,0.5166223404255319
E01023198,1424,706,718,0.4957865168539326,0.5042134831460674
E01023160,1536,757,779,0.4928385416666667,0.5071614583333334
E01023168,1442,689,753,0.4778085991678225,0.5221914008321775
E01023178,2260,1126,1134,0.4982300884955752,0.5017699115044247
E01023166,1477,749,728,0.5071090047393365,0.4928909952606635
E01023167,1604,770,834,0.4800498753117207,0.5199501246882793
E01023177,2234,1099,1135,0.4919427036705461,0.5080572963294538
E01023184,1356,688,668,0.5073746312684366,0.49262536873156343
E01023185,1227,593,634,0.4832925835370823,0.5167074164629177
E01023174,1737,870,867,0.5008635578583766,0.4991364421416235
E01023175,1625,770,855,0.47384615384615386,0.5261538461538462
E01023176,1562,715,847,0.45774647887323944,0.5422535211267606
E01023207,1532,759,773,0.4954308093994778,0.5045691906005222
E01023208,1151,555,596,0.48218940052128584,0.5178105994787141
E01023209,1362,663,699,0.486784140969163,0.513215859030837
E01023150,1507,689,818,0.45719973457199736,0.5428002654280026
E01023151,1473,682,791,0.46300067888662594,0.5369993211133741
E01023152,1645,719,926,0.4370820668693009,0.562917933130699
E01023206,1174,552,622,0.47018739352640543,0.5298126064735945
E01023158,2267,1126,1141,0.49669166299073664,0.5033083370092634
E01023191,1874,906,968,0.4834578441835646,0.5165421558164355
E01023192,1817,845,972,0.46505228398459,0.53494771601541
E01023193,1590,795,795,0.5,0.5
E01023194,1542,763,779,0.49481193255512324,0.5051880674448768
E01023200,1541,727,814,0.4717715768981181,0.5282284231018819
E01023162,1807,865,942,0.478693967902601,0.521306032097399
E01023163,1654,826,828,0.49939540507859737,0.5006045949214026
E01023164,1613,776,837,0.4810911345319281,0.5189088654680719
E01023199,1735,908,827,0.523342939481268,0.47665706051873197
E01023210,1579,792,787,0.5015832805573147,0.49841671944268523
E01023211,1925,942,983,0.48935064935064937,0.5106493506493507
E01023212,1511,727,784,0.4811383189940437,0.5188616810059563
E01023213,1366,687,679,0.5029282576866764,0.4970717423133236
E01023214,1332,657,675,0.49324324324324326,0.5067567567567568
E01023170,1740,842,898,0.4839080459770115,0.5160919540229885
E01023171,1628,791,837,0.4858722358722359,0.5141277641277642
E01023172,1498,750,748,0.5006675567423231,0.4993324432576769
E01023173,1475,729,746,0.4942372881355932,0.5057627118644068
E01023286,1446,670,776,0.4633471645919779,0.5366528354080221
E01023287,2811,1398,1413,0.4973319103521878,0.5026680896478122
E01023288,1387,677,710,0.48810382119682766,0.5118961788031723
E01023236,1896,943,953,0.49736286919831224,0.5026371308016878
E01023237,1249,590,659,0.4723779023218575,0.5276220976781425
E01023238,1543,786,757,0.509397278029812,0.49060272197018795
E01023239,1643,798,845,0.48569689592209375,0.5143031040779062
E01023240,2217,1038,1179,0.46820027063599456,0.5317997293640054
E01023241,1360,661,699,0.4860294117647059,0.5139705882352941
E01023248,1710,836,874,0.4888888888888889,0.5111111111111111
E01023253,1631,736,895,0.4512568976088289,0.5487431023911711
E01023274,1866,984,882,0.5273311897106109,0.47266881028938906
E01023225,2281,1125,1156,0.49320473476545373,0.5067952652345462
E01023278,1621,755,866,0.46576187538556446,0.5342381246144355
E01023279,1464,734,730,0.5013661202185792,0.49863387978142076
E01023280,1532,758,774,0.49477806788511747,0.5052219321148825
E01023281,1732,791,941,0.45669745958429564,0.5433025404157044
E01023247,1536,733,803,0.4772135416666667,0.5227864583333334
E01023249,1220,590,630,0.48360655737704916,0.5163934426229508
E01023250,1739,799,940,0.4594594594594595,0.5405405405405406
E01023268,1334,645,689,0.4835082458770615,0.5164917541229386
E01023269,2359,1033,1326,0.4378974141585418,0.5621025858414582
E01023270,1537,918,619,0.5972674040338322,0.40273259596616784
E01023251,1161,525,636,0.45219638242894056,0.5478036175710594
E01023255,1803,775,1028,0.4298391569606212,0.5701608430393789
E01023256,1406,655,751,0.46586059743954483,0.5341394025604552
E01023257,1508,734,774,0.48673740053050396,0.513262599469496
E01023258,1568,653,915,0.4164540816326531,0.5835459183673469
E01023252,1787,867,920,0.485170677112479,0.514829322887521
E01023254,1828,911,917,0.49835886214442016,0.5016411378555798
E01023263,1387,709,678,0.5111751982696467,0.48882480173035325
E01023264,1978,1285,693,0.6496461071789686,0.35035389282103135
E01023265,1814,889,925,0.490077177508269,0.5099228224917309
E01023267,1292,646,646,0.5,0.5
E01023260,1640,704,936,0.4292682926829268,0.5707317073170731
E01023261,1584,718,866,0.4532828282828283,0.5467171717171717
E01023262,1551,701,850,0.451966473243069,0.5480335267569311
E01023266,1561,745,816,0.47725816784112746,0.5227418321588725
E01023229,2031,1016,1015,0.5002461841457411,0.499753815854259
E01023242,1209,595,614,0.4921422663358147,0.5078577336641853
E01023243,1292,619,673,0.4791021671826625,0.5208978328173375
E01023244,1547,727,820,0.46994182288299935,0.5300581771170007
E01023259,1515,751,764,0.4957095709570957,0.5042904290429043
E01023226,1589,745,844,0.46884833228445566,0.5311516677155443
E01023227,1839,918,921,0.499184339314845,0.5008156606851549
E01023228,2018,976,1042,0.4836471754212091,0.5163528245787908
E01023230,2126,1014,1112,0.47695202257761055,0.5230479774223895
E01023246,1481,740,741,0.49966239027683995,0.50033760972316
E01023235,2019,968,1051,0.4794452699356117,0.5205547300643883
E01023275,1455,692,763,0.4756013745704467,0.5243986254295533
E01023276,1562,766,796,0.49039692701664533,0.5096030729833547
E01023277,1234,611,623,0.49513776337115073,0.5048622366288493
E01023282,1881,920,961,0.4891015417331207,0.5108984582668793
E01023220,2016,974,1042,0.48313492063492064,0.5168650793650794
E01023221,1706,798,908,0.46776084407971863,0.5322391559202814
E01023222,1541,700,841,0.45425048669695,0.54574951330305
E01023223,1460,701,759,0.48013698630136986,0.5198630136986301
E01023272,1255,617,638,0.49163346613545816,0.5083665338645418
E01023273,1481,746,735,0.5037137069547603,0.4962862930452397
E01023245,2390,1179,1211,0.49330543933054394,0.5066945606694561
E01023271,1206,577,629,0.478441127694859,0.521558872305141
E01023284,2742,1393,1349,0.5080233406272794,0.4919766593727206
E01023285,1557,741,816,0.47591522157996147,0.5240847784200385
E01032859,1794,903,891,0.5033444816053512,0.49665551839464883
E01032860,1442,718,724,0.49791955617198336,0.5020804438280166
E01023224,1489,740,749,0.49697783747481533,0.5030221625251847
E01023231,1753,857,896,0.48887621220764405,0.511123787792356
E01023232,1907,945,962,0.49554273728369164,0.5044572627163083
E01023233,1493,711,782,0.47622237106496984,0.5237776289350301
E01023234,1583,756,827,0.4775742261528743,0.5224257738471257
E01023987,1041,506,535,0.4860710854947166,0.5139289145052833
E01023988,1401,670,731,0.4782298358315489,0.5217701641684511
E01024040,1167,562,605,0.48157669237360756,0.5184233076263924
E01024041,1115,540,575,0.484304932735426,0.515695067264574
E01032810,1488,709,779,0.47647849462365593,0.5235215053763441
E01032812,1744,861,883,0.49369266055045874,0.5063073394495413
E01023985,1111,538,573,0.48424842484248426,0.5157515751575158
E01023986,1245,578,667,0.4642570281124498,0.5357429718875502
E01023989,1182,578,604,0.4890016920473773,0.5109983079526227
E01023990,1221,587,634,0.48075348075348073,0.5192465192465192
E01024033,1713,842,871,0.4915353181552831,0.5084646818447168
E01024035,1073,512,561,0.4771668219944082,0.5228331780055918
E01023983,1381,645,736,0.4670528602461984,0.5329471397538016
E01023999,2203,1096,1107,0.49750340444847935,0.5024965955515207
E01032811,1646,815,831,0.4951397326852977,0.5048602673147023
E01032822,1450,689,761,0.47517241379310343,0.5248275862068965
E01023980,1150,528,622,0.4591304347826087,0.5408695652173913
E01023981,1225,593,632,0.4840816326530612,0.5159183673469387
E01023984,1210,588,622,0.4859504132231405,0.5140495867768595
E01023992,1501,726,775,0.4836775483011326,0.5163224516988674
E01023993,1464,710,754,0.4849726775956284,0.5150273224043715
E01024021,1298,631,667,0.4861325115562404,0.5138674884437596
E01024022,1415,678,737,0.4791519434628975,0.5208480565371024
E01032820,1559,765,794,0.490699166132136,0.5093008338678641
E01032821,1714,854,860,0.4982497082847141,0.5017502917152858
E01023973,1591,761,830,0.4783155248271527,0.5216844751728472
E01024002,1439,734,705,0.5100764419735928,0.48992355802640725
E01024023,2527,1213,1314,0.48001582904629997,0.5199841709537001
E01024027,1645,860,785,0.5227963525835866,0.47720364741641336
E01024029,2378,1188,1190,0.49957947855340623,0.5004205214465938
E01023972,1281,618,663,0.48243559718969553,0.5175644028103045
E01023995,1245,608,637,0.4883534136546185,0.5116465863453815
E01023996,1328,640,688,0.4819277108433735,0.5180722891566265
E01024003,1752,842,910,0.4805936073059361,0.519406392694064
E01024004,1720,819,901,0.4761627906976744,0.5238372093023256
E01024005,1564,766,798,0.489769820971867,0.510230179028133
E01023974,1306,639,667,0.4892802450229709,0.5107197549770292
E01023975,1650,790,860,0.47878787878787876,0.5212121212121212
E01023977,1160,568,592,0.4896551724137931,0.5103448275862069
E01024016,1363,668,695,0.4900953778429934,0.5099046221570066
E01024017,1761,852,909,0.4838160136286201,0.5161839863713799
E01024028,1718,827,891,0.48137369033760186,0.5186263096623981
E01023976,1646,801,845,0.4866342648845686,0.5133657351154314
E01024019,1472,705,767,0.4789402173913043,0.5210597826086957
E01024020,1979,923,1056,0.46639717028802424,0.5336028297119757
E01032816,1765,856,909,0.484985835694051,0.515014164305949
E01032823,1691,856,835,0.5062093435836783,0.4937906564163217
E01024001,1529,777,752,0.5081752779594506,0.4918247220405494
E01024006,1404,687,717,0.4893162393162393,0.5106837606837606
E01024008,2044,973,1071,0.476027397260274,0.523972602739726
E01032815,1044,488,556,0.4674329501915709,0.5325670498084292
E01032817,1205,587,618,0.4871369294605809,0.512863070539419
E01032818,1581,792,789,0.5009487666034156,0.4990512333965844
E01032819,1808,896,912,0.49557522123893805,0.504424778761062
E01032824,1483,757,726,0.5104517869184086,0.48954821308159135
E01024013,1706,830,876,0.48651817116060964,0.5134818288393904
E01024014,1708,818,890,0.47892271662763464,0.5210772833723654
E01024015,1602,783,819,0.4887640449438202,0.5112359550561798
E01024034,2416,1188,1228,0.4917218543046358,0.5082781456953642
E01023978,1271,644,627,0.5066876475216365,0.49331235247836347
E01023979,1303,626,677,0.4804297774366846,0.5195702225633154
E01024032,1584,788,796,0.49747474747474746,0.5025252525252525
E01024036,1301,643,658,0.49423520368946966,0.5057647963105304
E01024031,1481,720,761,0.4861580013504389,0.5138419986495611
E01024038,1903,946,957,0.49710982658959535,0.5028901734104047
E01024039,1491,705,786,0.47283702213279677,0.5271629778672032
E01032813,1812,867,945,0.478476821192053,0.5215231788079471
E01032814,1865,928,937,0.4975871313672922,0.5024128686327077
E01024009,1094,509,585,0.46526508226691043,0.5347349177330896
E01024010,1276,600,676,0.4702194357366771,0.5297805642633229
E01024011,1307,623,684,0.47666411629686306,0.523335883703137
E01024012,1074,520,554,0.48417132216014896,0.515828677839851
E01024024,2229,1024,1205,0.45939883355764916,0.5406011664423508
E01024025,1130,486,644,0.4300884955752212,0.5699115044247788
E01023997,1456,716,740,0.49175824175824173,0.5082417582417582
E01023998,1112,537,575,0.4829136690647482,0.5170863309352518
E01024026,1262,600,662,0.4754358161648177,0.5245641838351822
E01024037,1777,839,938,0.47214406302757456,0.5278559369724254
E01024078,1676,814,862,0.48568019093078757,0.5143198090692124
E01024080,1325,613,712,0.46264150943396226,0.5373584905660377
E01024081,1571,739,832,0.4704010184595799,0.5295989815404201
E01024082,1406,659,747,0.46870554765291605,0.531294452347084
E01024095,1492,717,775,0.48056300268096513,0.5194369973190348
E01024094,2441,1185,1256,0.48545678000819337,0.5145432199918066
E01024096,1780,826,954,0.4640449438202247,0.5359550561797752
E01024097,1542,713,829,0.46238651102464334,0.5376134889753567
E01024098,1590,735,855,0.46226415094339623,0.5377358490566038
E01024064,2432,1197,1235,0.4921875,0.5078125
E01024066,1595,773,822,0.4846394984326019,0.5153605015673981
E01024079,1493,702,791,0.47019423978566643,0.5298057602143336
E01024083,1370,647,723,0.47226277372262776,0.5277372262773723
E01024118,1792,842,950,0.46986607142857145,0.5301339285714286
E01024059,1529,705,824,0.46108567691301505,0.538914323086985
E01024065,2012,995,1017,0.4945328031809145,0.5054671968190855
E01024117,1416,684,732,0.4830508474576271,0.5169491525423728
E01024119,1625,773,852,0.4756923076923077,0.5243076923076923
E01024120,1565,749,816,0.47859424920127797,0.5214057507987221
E01024056,1946,930,1016,0.4779033915724563,0.5220966084275437
E01024057,1792,864,928,0.48214285714285715,0.5178571428571429
E01024058,1612,768,844,0.47642679900744417,0.5235732009925558
E01024114,1720,792,928,0.4604651162790698,0.5395348837209303
E01024115,1393,658,735,0.4723618090452261,0.5276381909547738
E01024073,1963,953,1010,0.4854814060112073,0.5145185939887926
E01024074,1504,749,755,0.49800531914893614,0.5019946808510638
E01024075,1627,778,849,0.478180700676091,0.521819299323909
E01024076,1875,923,952,0.4922666666666667,0.5077333333333334
E01024077,1471,741,730,0.5037389530931339,0.49626104690686607
E01024055,1519,703,816,0.4628044766293614,0.5371955233706386
E01024061,1496,687,809,0.4592245989304813,0.5407754010695187
E01024063,1551,753,798,0.48549323017408125,0.5145067698259188
E01024071,1682,809,873,0.48097502972651607,0.5190249702734839
E01024116,1500,692,808,0.4613333333333333,0.5386666666666666
E01024060,1521,710,811,0.46679815910585143,0.5332018408941486
E01024069,1380,663,717,0.48043478260869565,0.5195652173913043
E01024070,1405,668,737,0.47544483985765124,0.5245551601423487
E01024072,1324,632,692,0.4773413897280967,0.5226586102719033
E01024106,1578,713,865,0.45183776932826364,0.5481622306717364
E01024062,1556,772,784,0.4961439588688946,0.5038560411311054
E01024105,1530,743,787,0.48562091503267973,0.5143790849673202
E01024107,1466,709,757,0.48362892223738063,0.5163710777626194
E01024108,1146,546,600,0.47643979057591623,0.5235602094240838
E01024109,2247,1091,1156,0.48553627058299953,0.5144637294170005
E01024084,1141,529,612,0.4636283961437336,0.5363716038562665
E01024085,1577,738,839,0.4679771718452758,0.5320228281547241
E01024086,2054,1027,1027,0.5,0.5
E01024087,1248,596,652,0.4775641025641026,0.5224358974358975
E01024091,1431,735,696,0.5136268343815513,0.4863731656184486
E01024110,1271,630,641,0.4956726986624705,0.5043273013375295
E01024111,1533,737,796,0.48075668623613826,0.5192433137638617
E01024112,1570,750,820,0.47770700636942676,0.5222929936305732
E01024113,1324,624,700,0.47129909365558914,0.5287009063444109
E01024067,1132,552,580,0.4876325088339223,0.5123674911660777
E01024068,1524,746,778,0.489501312335958,0.510498687664042
E01024123,1646,784,862,0.47630619684082626,0.5236938031591738
E01032809,6176,2970,3206,0.4808937823834197,0.5191062176165803
E01024099,1500,724,776,0.4826666666666667,0.5173333333333333
E01024100,1581,737,844,0.4661606578115117,0.5338393421884883
E01024101,1844,966,878,0.5238611713665944,0.4761388286334056
E01024102,1762,871,891,0.49432463110102154,0.5056753688989785
E01024103,1630,763,867,0.46809815950920247,0.5319018404907976
E01024047,1583,762,821,0.4813644977890082,0.5186355022109918
E01024049,1817,1030,787,0.5668684645019263,0.43313153549807376
E01024090,2446,1143,1303,0.46729354047424365,0.5327064595257563
E01024092,1554,735,819,0.47297297297297297,0.527027027027027
E01024093,1571,718,853,0.4570337364735837,0.5429662635264163
E01024044,1976,944,1032,0.4777327935222672,0.5222672064777328
E01024045,1584,735,849,0.4640151515151515,0.5359848484848485
E01024046,1894,926,968,0.48891235480464623,0.5110876451953538
E01024048,1963,985,978,0.5017829852266938,0.49821701477330615
E01024131,1598,784,814,0.490613266583229,0.509386733416771
E01024052,2233,1094,1139,0.48992386923421405,0.510076130765786
E01024053,1847,916,931,0.4959393611261505,0.5040606388738494
E01024054,1798,874,924,0.4860956618464961,0.5139043381535039
E01024127,1552,750,802,0.4832474226804124,0.5167525773195877
E01024042,1364,669,695,0.4904692082111437,0.5095307917888563
E01024043,1393,655,738,0.47020818377602297,0.529791816223977
E01024088,1565,717,848,0.45814696485623,0.5418530351437699
E01024089,1193,574,619,0.48113998323554064,0.5188600167644594
E01024128,1660,819,841,0.49337349397590363,0.5066265060240964
E01024129,1747,845,902,0.48368631940469375,0.5163136805953062
E01024130,2534,1179,1355,0.4652722967640095,0.5347277032359905
E01024104,2005,977,1028,0.48728179551122197,0.512718204488778
E01024121,1506,727,779,0.48273572377158036,0.5172642762284196
E01024122,1407,636,771,0.4520255863539446,0.5479744136460555
E01024124,1572,782,790,0.49745547073791346,0.5025445292620865
E01024126,1503,685,818,0.45575515635395875,0.5442448436460412
E01032807,1463,680,783,0.46479835953520166,0.5352016404647983
E01032808,1417,703,714,0.49611856033874385,0.5038814396612562
E01024148,1674,810,864,0.4838709677419355,0.5161290322580645
E01024149,2972,1423,1549,0.4788021534320323,0.5211978465679677
E01024154,1266,605,661,0.47788309636650866,0.5221169036334913
E01024155,1492,698,794,0.467828418230563,0.532171581769437
E01024140,2692,1356,1336,0.5037147102526003,0.4962852897473997
E01024141,1597,787,810,0.49279899812147776,0.5072010018785222
E01024143,2246,1156,1090,0.5146927871772039,0.4853072128227961
E01024179,2817,1411,1406,0.5008874689385872,0.49911253106141285
E01024180,1436,752,684,0.5236768802228412,0.4763231197771588
E01024181,1355,680,675,0.5018450184501845,0.4981549815498155
E01024182,1571,829,742,0.527689369828135,0.47231063017186503
E01024183,1384,691,693,0.49927745664739887,0.5007225433526011
E01024184,1986,993,993,0.5,0.5
E01024185,2079,1004,1075,0.4829244829244829,0.517075517075517
E01024142,2724,1356,1368,0.4977973568281938,0.5022026431718062
E01024176,1670,820,850,0.49101796407185627,0.5089820359281437
E01024177,1436,702,734,0.48885793871866295,0.5111420612813371
E01024178,1638,829,809,0.5061050061050061,0.4938949938949939
E01024156,1658,852,806,0.5138721351025332,0.48612786489746684
E01024161,1976,1000,976,0.5060728744939271,0.4939271255060729
E01024162,1626,876,750,0.5387453874538746,0.4612546125461255
E01024163,1802,895,907,0.49667036625971145,0.5033296337402886
E01024164,1900,968,932,0.5094736842105263,0.4905263157894737
E01024169,1510,727,783,0.4814569536423841,0.5185430463576159
E01024170,1555,754,801,0.48488745980707393,0.5151125401929261
E01024171,1558,801,757,0.5141206675224647,0.4858793324775353
E01024172,1930,994,936,0.5150259067357513,0.48497409326424873
E01024144,1510,771,739,0.5105960264900662,0.48940397350993375
E01024145,1630,802,828,0.4920245398773006,0.5079754601226993
E01024146,1487,733,754,0.4929388029589778,0.5070611970410221
E01024147,1722,839,883,0.48722415795586527,0.5127758420441347
E01024186,1317,638,679,0.4844343204252088,0.5155656795747912
E01024133,1365,680,685,0.4981684981684982,0.5018315018315018
E01024136,1550,785,765,0.5064516129032258,0.4935483870967742
E01024137,1511,755,756,0.499669093315685,0.500330906684315
E01024138,1810,855,955,0.4723756906077348,0.5276243093922652
E01024139,1763,892,871,0.5059557572319909,0.49404424276800907
E01024165,1523,702,821,0.4609323703217334,0.5390676296782666
E01024166,1705,814,891,0.4774193548387097,0.5225806451612903
E01024167,1832,900,932,0.4912663755458515,0.5087336244541485
E01024168,1247,595,652,0.47714514835605454,0.5228548516439455
E01024150,1516,714,802,0.470976253298153,0.5290237467018469
E01024151,1431,705,726,0.49266247379454925,0.5073375262054507
E01024152,2655,1307,1348,0.49227871939736345,0.5077212806026365
E01024153,1410,699,711,0.4957446808510638,0.5042553191489362
E01024173,1793,895,898,0.4991634132738427,0.5008365867261573
E01024187,1113,530,583,0.47619047619047616,0.5238095238095238
E01024188,1311,622,689,0.4744469870327994,0.5255530129672006
E01024189,1576,752,824,0.47715736040609136,0.5228426395939086
E01024132,1286,634,652,0.49300155520995337,0.5069984447900466
E01024134,1643,800,843,0.48691418137553255,0.5130858186244674
E01024135,1426,692,734,0.485273492286115,0.514726507713885
E01024174,1148,563,585,0.490418118466899,0.509581881533101
E01024175,1289,617,672,0.4786656322730799,0.5213343677269201
E01024157,1674,799,875,0.477299880525687,0.522700119474313
E01024158,1560,717,843,0.4596153846153846,0.5403846153846154
E01024159,1577,759,818,0.48129359543436906,0.518706404565631
E01024160,1435,726,709,0.5059233449477352,0.49407665505226483
E01024206,1799,890,909,0.4947192884936076,0.5052807115063924
E01024207,1817,891,926,0.49036873968079253,0.5096312603192075
E01024208,1620,791,829,0.4882716049382716,0.5117283950617284
E01024209,1775,880,895,0.49577464788732395,0.504225352112676
E01024202,1914,914,1000,0.477533960292581,0.522466039707419
E01024242,1810,916,894,0.5060773480662983,0.49392265193370166
E01024243,1682,761,921,0.4524375743162901,0.5475624256837098
E01024244,1760,845,915,0.48011363636363635,0.5198863636363636
E01024245,1791,891,900,0.49748743718592964,0.5025125628140703
E01024219,1339,617,722,0.4607916355489171,0.5392083644510829
E01024220,1600,726,874,0.45375,0.54625
E01024221,1574,740,834,0.4701397712833545,0.5298602287166455
E01024227,1472,718,754,0.48777173913043476,0.5122282608695652
E01024229,1460,718,742,0.4917808219178082,0.5082191780821917
E01024228,1540,804,736,0.522077922077922,0.4779220779220779
E01024230,1376,661,715,0.4803779069767442,0.5196220930232558
E01024231,1538,783,755,0.5091027308192457,0.4908972691807542
E01024252,2393,1145,1248,0.47847889678228167,0.5215211032177184
E01024201,1534,766,768,0.49934810951760106,0.500651890482399
E01024217,1688,820,868,0.48578199052132703,0.514218009478673
E01024223,1599,726,873,0.4540337711069418,0.5459662288930581
E01024225,1692,839,853,0.4958628841607565,0.5041371158392435
E01024226,1475,694,781,0.4705084745762712,0.5294915254237288
E01024190,1455,710,745,0.4879725085910653,0.5120274914089347
E01024191,1752,843,909,0.4811643835616438,0.5188356164383562
E01024192,1698,816,882,0.48056537102473496,0.519434628975265
E01024204,1593,774,819,0.4858757062146893,0.5141242937853108
E01024218,1213,578,635,0.4765045342126958,0.5234954657873042
E01024222,1571,749,822,0.4767663908338638,0.5232336091661363
E01024224,1514,726,788,0.4795244385733157,0.5204755614266843
E01024250,1670,791,879,0.47365269461077847,0.5263473053892216
E01024251,1642,771,871,0.4695493300852619,0.5304506699147381
E01024200,1751,878,873,0.5014277555682467,0.4985722444317533
E01024203,1602,799,803,0.49875156054931336,0.5012484394506866
E01024205,1620,778,842,0.4802469135802469,0.519753086419753
E01024255,1558,742,816,0.4762516046213094,0.5237483953786907
E01024232,2030,975,1055,0.4802955665024631,0.5197044334975369
E01024236,1592,777,815,0.4880653266331658,0.5119346733668342
E01024237,1578,777,801,0.4923954372623574,0.5076045627376425
E01024253,1729,806,923,0.46616541353383456,0.5338345864661654
E01024233,1605,786,819,0.4897196261682243,0.5102803738317757
E01024235,1595,760,835,0.47648902821316613,0.5235109717868338
E01024254,2162,1073,1089,0.4962997224791859,0.503700277520814
E01024256,1422,693,729,0.4873417721518987,0.5126582278481012
E01033210,2342,1147,1195,0.4897523484201537,0.5102476515798463
E01024193,1615,763,852,0.4724458204334365,0.5275541795665635
E01024194,1506,779,727,0.5172642762284196,0.48273572377158036
E01024195,1404,693,711,0.4935897435897436,0.5064102564102564
E01024196,1486,720,766,0.4845222072678331,0.5154777927321669
E01024197,1569,772,797,0.49203314212874444,0.5079668578712556
E01024240,1688,803,885,0.47571090047393366,0.5242890995260664
E01024241,2148,1043,1105,0.4855679702048417,0.5144320297951583
E01024248,1900,984,916,0.5178947368421053,0.48210526315789476
E01024238,1999,1051,948,0.5257628814407204,0.47423711855927964
E01024239,1758,861,897,0.48976109215017066,0.5102389078498294
E01024247,1951,1010,941,0.5176832393644285,0.4823167606355715
E01033209,1047,564,483,0.5386819484240688,0.46131805157593125
E01033211,1129,565,564,0.5004428697962799,0.4995571302037201
E01024214,1688,857,831,0.5077014218009479,0.49229857819905215
E01024215,1614,856,758,0.530359355638166,0.46964064436183395
E01024216,1491,724,767,0.48558014755197854,0.5144198524480215
E01024246,2036,1075,961,0.5279960707269156,0.4720039292730845
E01024249,2072,1064,1008,0.5135135135135135,0.4864864864864865
E01024198,2347,1166,1181,0.4968044311887516,0.5031955688112484
E01024212,1531,793,738,0.5179621162638798,0.48203788373612017
E01024213,1389,678,711,0.48812095032397407,0.5118790496760259
E01024234,1364,659,705,0.4831378299120235,0.5168621700879765
E01024276,2542,1252,1290,0.4925255704169945,0.5074744295830055
E01024277,1888,926,962,0.4904661016949153,0.5095338983050848
E01024278,1863,926,937,0.49704777241009124,0.5029522275899088
E01024279,1510,745,765,0.49337748344370863,0.5066225165562914
E01024257,2042,1097,945,0.5372184133202742,0.46278158667972574
E01024290,1703,850,853,0.49911920140927774,0.5008807985907222
E01024291,1771,911,860,0.5143986448334275,0.48560135516657255
E01024295,1788,908,880,0.5078299776286354,0.49217002237136465
E01032799,1557,836,721,0.5369299935773925,0.4630700064226076
E01032800,1161,637,524,0.5486649440137812,0.45133505598621876
E01024258,1607,809,798,0.5034225264467953,0.49657747355320475
E01024261,2163,1084,1079,0.5011558021266759,0.49884419787332407
E01024293,1729,865,864,0.5002891844997108,0.4997108155002892
E01024294,2268,1087,1181,0.4792768959435626,0.5207231040564374
E01024296,2842,1490,1352,0.5242786769880365,0.4757213230119634
E01024262,1685,818,867,0.485459940652819,0.5145400593471811
E01024263,1524,716,808,0.46981627296587924,0.5301837270341208
E01024282,1630,799,831,0.4901840490797546,0.5098159509202455
E01024283,1320,657,663,0.49772727272727274,0.5022727272727273
E01024284,1558,772,786,0.49550706033376124,0.5044929396662388
E01024259,1531,759,772,0.495754408883083,0.504245591116917
E01024260,1858,949,909,0.5107642626480086,0.4892357373519914
E01024292,1638,849,789,0.5183150183150184,0.4816849816849817
E01024313,1597,749,848,0.46900438321853477,0.5309956167814652
E01024317,1705,846,859,0.4961876832844575,0.5038123167155425
E01024318,1579,766,813,0.4851171627612413,0.5148828372387587
E01024280,1673,789,884,0.47160789001793185,0.5283921099820681
E01024281,1457,722,735,0.4955387783115992,0.5044612216884008
E01024285,1391,659,732,0.47375988497483823,0.5262401150251618
E01024287,1464,702,762,0.47950819672131145,0.5204918032786885
E01024288,1379,652,727,0.47280638143582304,0.5271936185641769
E01024308,1420,667,753,0.4697183098591549,0.530281690140845
E01024310,1544,762,782,0.49352331606217614,0.5064766839378239
E01024311,1335,635,700,0.4756554307116105,0.5243445692883895
E01024314,1283,640,643,0.49883086515978176,0.5011691348402182
E01024315,1544,764,780,0.4948186528497409,0.5051813471502591
E01024297,1551,762,789,0.4912959381044487,0.5087040618955513
E01024298,1416,716,700,0.5056497175141242,0.4943502824858757
E01024299,1430,701,729,0.4902097902097902,0.5097902097902098
E01024309,1288,610,678,0.47360248447204967,0.5263975155279503
E01024312,1297,631,666,0.4865073245952197,0.5134926754047803
E01024264,1527,736,791,0.4819908316961362,0.5180091683038638
E01024286,1626,818,808,0.5030750307503075,0.4969249692496925
E01024316,1849,861,988,0.4656571119524067,0.5343428880475933
E01024319,1604,766,838,0.4775561097256858,0.5224438902743143
E01024265,1287,636,651,0.49417249417249415,0.5058275058275058
E01024266,1153,537,616,0.4657415437987858,0.5342584562012143
E01024267,1522,748,774,0.4914586070959264,0.5085413929040736
E01024300,1463,718,745,0.49077238550922764,0.5092276144907724
E01024301,1247,589,658,0.4723336006415397,0.5276663993584603
E01024303,1546,721,825,0.4663648124191462,0.5336351875808538
E01024304,1549,754,795,0.486765655261459,0.513234344738541
E01024305,1520,733,787,0.48223684210526313,0.5177631578947368
E01024306,1144,569,575,0.4973776223776224,0.5026223776223776
E01024307,1462,722,740,0.493844049247606,0.506155950752394
E01024268,1602,786,816,0.49063670411985016,0.5093632958801498
E01024269,1835,912,923,0.49700272479564034,0.5029972752043597
E01024270,1450,711,739,0.4903448275862069,0.5096551724137931
E01024271,1414,666,748,0.471004243281471,0.5289957567185289
E01024272,1493,706,787,0.47287340924313465,0.5271265907568654
E01024273,1529,779,750,0.5094833224329627,0.49051667756703726
E01024274,1495,721,774,0.4822742474916388,0.5177257525083612
E01024275,1406,700,706,0.49786628733997157,0.5021337126600285
E01024302,1466,735,731,0.5013642564802183,0.49863574351978174
E01024333,1376,682,694,0.4956395348837209,0.5043604651162791
E01024334,1023,496,527,0.48484848484848486,0.5151515151515151
E01024335,1554,771,783,0.49613899613899615,0.5038610038610039
E01024338,1387,704,683,0.5075702956020187,0.4924297043979812
E01024347,1702,837,865,0.4917743830787309,0.5082256169212691
E01024353,1812,882,930,0.4867549668874172,0.5132450331125827
E01024354,1462,708,754,0.4842681258549932,0.5157318741450069
E01024355,1963,995,968,0.5068772287315334,0.49312277126846665
E01024385,1602,792,810,0.4943820224719101,0.5056179775280899
E01024386,1730,837,893,0.4838150289017341,0.5161849710982659
E01024320,1191,563,628,0.4727120067170445,0.5272879932829555
E01024321,1718,811,907,0.4720605355064028,0.5279394644935972
E01024322,1172,581,591,0.49573378839590443,0.5042662116040956
E01024323,1345,664,681,0.49368029739776953,0.5063197026022305
E01024324,1452,697,755,0.4800275482093664,0.5199724517906336
E01024341,1715,829,886,0.4833819241982507,0.5166180758017492
E01024352,1795,857,938,0.4774373259052925,0.5225626740947075
E01024382,2052,1368,684,0.6666666666666666,0.3333333333333333
E01024383,2314,1308,1006,0.5652549697493517,0.4347450302506482
E01024384,1783,859,924,0.4817722938867078,0.5182277061132922
E01033090,1235,625,610,0.5060728744939271,0.4939271255060729
E01033092,1224,672,552,0.5490196078431373,0.45098039215686275
E01024330,1586,767,819,0.48360655737704916,0.5163934426229508
E01024336,1667,820,847,0.49190161967606477,0.5080983803239352
E01024337,1503,749,754,0.49833666001330673,0.5016633399866933
E01024348,1360,692,668,0.5088235294117647,0.49117647058823527
E01024351,1507,717,790,0.47577969475779697,0.5242203052422031
E01024339,1900,910,990,0.4789473684210526,0.5210526315789473
E01024340,2240,1133,1107,0.5058035714285715,0.4941964285714286
E01024356,1622,814,808,0.5018495684340321,0.49815043156596794
E01024373,1823,920,903,0.5046626439934174,0.4953373560065826
E01033087,1336,694,642,0.5194610778443114,0.4805389221556886
E01033091,1682,824,858,0.48989298454221164,0.5101070154577884
E01024326,1882,901,981,0.47874601487778956,0.5212539851222104
E01024327,1633,782,851,0.4788732394366197,0.5211267605633803
E01024328,1588,738,850,0.464735516372796,0.535264483627204
E01024329,1520,743,777,0.4888157894736842,0.5111842105263158
E01024349,1356,686,670,0.5058997050147492,0.4941002949852507
E01024357,1686,831,855,0.4928825622775801,0.5071174377224199
E01024358,1722,803,919,0.46631823461091754,0.5336817653890824
E01024367,1474,728,746,0.49389416553595655,0.5061058344640434
E01024369,1534,777,757,0.5065189048239895,0.4934810951760104
E01033088,1446,713,733,0.4930843706777317,0.5069156293222683
E01033089,1599,760,839,0.47529706066291433,0.5247029393370857
E01024360,1522,718,804,0.47174770039421815,0.5282522996057819
E01024372,1966,992,974,0.5045778229908443,0.49542217700915564
E01024374,1810,865,945,0.47790055248618785,0.5220994475138122
E01024401,1514,725,789,0.47886393659180976,0.5211360634081902
E01024403,1767,856,911,0.4844368986983588,0.5155631013016412
E01024371,1632,834,798,0.5110294117647058,0.4889705882352941
E01024392,1598,787,811,0.4924906132665832,0.5075093867334167
E01024393,1552,754,798,0.48582474226804123,0.5141752577319587
E01024395,1475,708,767,0.48,0.52
E01024396,1574,771,803,0.4898348157560356,0.5101651842439644
E01024361,1686,826,860,0.48991696322657174,0.5100830367734283
E01024362,1684,833,851,0.49465558194774345,0.5053444180522565
E01024363,2113,1063,1050,0.5030761949834359,0.49692380501656414
E01024387,2445,1208,1237,0.49406952965235174,0.5059304703476483
E01024331,1411,685,726,0.48547129695251595,0.5145287030474841
E01024394,1409,703,706,0.49893541518807666,0.5010645848119234
E01024402,1464,695,769,0.47472677595628415,0.5252732240437158
E01024404,1582,780,802,0.49304677623261695,0.506953223767383
E01024405,2004,951,1053,0.4745508982035928,0.5254491017964071
E01024389,2273,1078,1195,0.47426308842938847,0.5257369115706115
E01024390,1401,657,744,0.4689507494646681,0.5310492505353319
E01024391,1435,690,745,0.4808362369337979,0.519163763066202
E01024397,1450,709,741,0.4889655172413793,0.5110344827586207
E01024398,1736,820,916,0.47235023041474655,0.5276497695852534
E01024399,1308,612,696,0.46788990825688076,0.5321100917431193
E01024400,1401,656,745,0.46823697359029265,0.5317630264097074
E01024325,2327,1133,1194,0.48689299527288354,0.5131070047271165
E01024346,1293,645,648,0.4988399071925754,0.5011600928074246
E01024377,1614,799,815,0.4950433705080545,0.5049566294919455
E01024378,1365,656,709,0.4805860805860806,0.5194139194139195
E01024332,1198,595,603,0.496661101836394,0.503338898163606
E01024350,1458,720,738,0.49382716049382713,0.5061728395061729
E01024375,2394,1206,1188,0.5037593984962406,0.49624060150375937
E01024388,2929,1432,1497,0.4889040628200751,0.5110959371799249
E01024410,1564,749,815,0.4789002557544757,0.5210997442455243
E01024342,1671,802,869,0.4799521244763615,0.5200478755236385
E01024343,1419,728,691,0.5130373502466525,0.4869626497533474
E01024344,1374,672,702,0.4890829694323144,0.5109170305676856
E01024376,2277,1114,1163,0.48924022837066317,0.5107597716293368
E01024364,1627,773,854,0.47510755992624465,0.5248924400737554
E01024365,1760,848,912,0.4818181818181818,0.5181818181818182
E01024366,1768,825,943,0.4666289592760181,0.5333710407239819
E01024411,1288,673,615,0.5225155279503105,0.47748447204968947
E01024345,1556,793,763,0.5096401028277635,0.4903598971722365
E01024379,1715,871,844,0.5078717201166181,0.4921282798833819
E01024380,1688,834,854,0.4940758293838863,0.5059241706161137
E01024381,1426,698,728,0.4894810659186536,0.5105189340813464
E01024406,1513,740,773,0.48909451421017847,0.5109054857898215
E01024407,1495,743,752,0.49698996655518396,0.5030100334448161
E01024408,1433,704,729,0.49127704117236565,0.5087229588276343
E01024409,1506,723,783,0.4800796812749004,0.5199203187250996
E01024445,1290,623,667,0.48294573643410854,0.5170542635658915
E01024446,1478,711,767,0.4810554803788904,0.5189445196211097
E01024447,1324,638,686,0.4818731117824773,0.5181268882175226
E01024472,1396,686,710,0.49140401146131807,0.5085959885386819
E01024479,1484,730,754,0.4919137466307278,0.5080862533692723
E01024476,1540,723,817,0.4694805194805195,0.5305194805194805
E01024477,1416,671,745,0.4738700564971751,0.5261299435028248
E01024478,1422,716,706,0.5035161744022504,0.4964838255977497
E01024480,1635,767,868,0.4691131498470948,0.5308868501529052
E01024481,1535,715,820,0.46579804560260585,0.5342019543973942
E01024482,1450,691,759,0.476551724137931,0.523448275862069
E01024421,1909,931,978,0.48768988999476165,0.5123101100052383
E01024473,1597,762,835,0.4771446462116468,0.5228553537883531
E01024474,1267,627,640,0.494869771112865,0.505130228887135
E01024475,1484,747,737,0.5033692722371967,0.49663072776280326
E01024441,1524,749,775,0.4914698162729659,0.5085301837270341
E01024442,1512,783,729,0.5178571428571429,0.48214285714285715
E01024443,1533,682,851,0.44487932159165033,0.5551206784083497
E01024444,1266,602,664,0.4755134281200632,0.5244865718799369
E01024431,1814,856,958,0.4718853362734289,0.5281146637265711
E01024432,1522,726,796,0.47700394218134035,0.5229960578186597
E01024433,1319,661,658,0.5011372251705838,0.4988627748294162
E01024434,1970,951,1019,0.482741116751269,0.5172588832487309
E01024435,1545,752,793,0.4867313915857605,0.5132686084142395
E01024436,1504,738,766,0.49069148936170215,0.5093085106382979
E01024437,1509,767,742,0.508283631544069,0.4917163684559311
E01024438,1504,735,769,0.4886968085106383,0.5113031914893617
E01024422,1858,906,952,0.4876210979547901,0.5123789020452099
E01024423,1721,840,881,0.48808832074375363,0.5119116792562464
E01024439,1563,764,799,0.4888035828534869,0.5111964171465131
E01024440,1922,953,969,0.495837669094693,0.5041623309053069
E01024452,1393,697,696,0.5003589375448672,0.4996410624551328
E01024448,1251,588,663,0.47002398081534774,0.5299760191846523
E01024449,1440,694,746,0.48194444444444445,0.5180555555555556
E01024450,1527,722,805,0.472822527832351,0.527177472167649
E01024453,1625,824,801,0.5070769230769231,0.4929230769230769
E01024454,1577,757,820,0.4800253646163602,0.5199746353836399
E01024457,1161,541,620,0.46597760551248923,0.5340223944875108
E01024460,1662,810,852,0.48736462093862815,0.5126353790613718
E01024461,2446,1197,1249,0.4893704006541292,0.5106295993458708
E01024465,1384,673,711,0.48627167630057805,0.513728323699422
E01024466,1363,667,696,0.48936170212765956,0.5106382978723404
E01024468,1492,718,774,0.4812332439678284,0.5187667560321716
E01024416,1705,837,868,0.4909090909090909,0.509090909090909
E01024418,1387,668,719,0.4816149963950973,0.5183850036049027
E01024424,1415,708,707,0.5003533568904593,0.49964664310954066
E01024463,1502,744,758,0.49533954727030627,0.5046604527296937
E01024464,1681,822,859,0.48899464604402143,0.5110053539559786
E01024467,1705,830,875,0.4868035190615836,0.5131964809384164
E01024458,1452,725,727,0.49931129476584024,0.5006887052341598
E01024459,1581,766,815,0.4845034788108792,0.5154965211891208
E01024462,1675,814,861,0.48597014925373133,0.5140298507462686
E01024469,1632,827,805,0.5067401960784313,0.49325980392156865
E01024470,1602,772,830,0.4818976279650437,0.5181023720349563
E01024471,1849,825,1024,0.4461871281773932,0.5538128718226069
E01024417,1558,768,790,0.49293966623876767,0.5070603337612324
E01024419,1748,841,907,0.48112128146453087,0.5188787185354691
E01024483,1574,781,793,0.49618805590851334,0.5038119440914867
E01024484,1219,593,626,0.4864643150123052,0.5135356849876949
E01024485,1682,819,863,0.4869203329369798,0.5130796670630202
E01024425,1586,761,825,0.4798234552332913,0.5201765447667087
E01024426,1755,847,908,0.4826210826210826,0.5173789173789174
E01024427,1271,599,672,0.47128245476003144,0.5287175452399685
E01024428,1299,625,674,0.481139337952271,0.5188606620477291
E01024429,1568,752,816,0.47959183673469385,0.5204081632653061
E01024430,1428,690,738,0.4831932773109244,0.5168067226890757
E01024420,2049,1014,1035,0.49487554904831627,0.5051244509516838
E01024451,2204,1063,1141,0.4823049001814882,0.5176950998185118
E01024455,1206,577,629,0.478441127694859,0.521558872305141
E01024456,1261,616,645,0.48850118953211735,0.5114988104678826
E01024413,1623,749,874,0.4614910659272951,0.5385089340727048
E01024414,1566,753,813,0.48084291187739464,0.5191570881226054
E01024415,1358,669,689,0.49263622974963184,0.5073637702503682
E01032619,1618,797,821,0.4925834363411619,0.507416563658838
E01024490,2087,1040,1047,0.49832295160517487,0.5016770483948251
E01024544,1399,684,715,0.4889206576125804,0.5110793423874196
E01024545,1447,697,750,0.48168624740843125,0.5183137525915688
E01024547,1342,632,710,0.47093889716840537,0.5290611028315947
E01024492,1522,741,781,0.4868593955321945,0.5131406044678055
E01024541,2439,1206,1233,0.4944649446494465,0.5055350553505535
E01024542,2039,983,1056,0.4820990681706719,0.5179009318293281
E01033213,1789,890,899,0.4974846282839575,0.5025153717160424
E01033214,1735,855,880,0.49279538904899134,0.5072046109510087
E01024496,1583,760,823,0.4801010739102969,0.5198989260897031
E01024497,1661,773,888,0.4653822998193859,0.534617700180614
E01024498,1662,788,874,0.4741275571600481,0.5258724428399518
E01024503,1721,839,882,0.4875072632190587,0.5124927367809413
E01024518,1721,843,878,0.4898314933178385,0.5101685066821615
E01024499,1676,825,851,0.4922434367541766,0.5077565632458234
E01024500,1207,582,625,0.48218724109362054,0.5178127589063795
E01024501,1576,732,844,0.46446700507614214,0.5355329949238579
E01024502,1404,746,658,0.5313390313390314,0.4686609686609687
E01024505,1882,946,936,0.5026567481402763,0.4973432518597237
E01024491,1528,748,780,0.4895287958115183,0.5104712041884817
E01024493,1471,697,774,0.4738273283480625,0.5261726716519375
E01024494,1651,796,855,0.4821320411871593,0.5178679588128408
E01024495,1787,892,895,0.4991606043648573,0.5008393956351427
E01024520,1404,673,731,0.4793447293447293,0.5206552706552706
E01024528,1252,592,660,0.4728434504792332,0.5271565495207667
E01024511,1400,655,745,0.46785714285714286,0.5321428571428571
E01024512,1743,839,904,0.48135398737808377,0.5186460126219162
E01024513,1676,809,867,0.48269689737470167,0.5173031026252983
E01024514,1378,674,704,0.48911465892597966,0.5108853410740203
E01024515,1434,690,744,0.4811715481171548,0.5188284518828452
E01024516,1397,676,721,0.4838940586972083,0.5161059413027917
E01024519,1554,949,605,0.6106821106821106,0.3893178893178893
E01024521,1681,796,885,0.47352766210588937,0.5264723378941106
E01024523,1548,732,816,0.4728682170542636,0.5271317829457365
E01024526,1526,712,814,0.46657929226736566,0.5334207077326344
E01024527,1466,672,794,0.4583901773533424,0.5416098226466576
E01024550,2022,953,1069,0.4713155291790307,0.5286844708209694
E01024489,1703,853,850,0.5008807985907222,0.49911920140927774
E01024530,1464,690,774,0.4713114754098361,0.5286885245901639
E01024536,2004,981,1023,0.48952095808383234,0.5104790419161677
E01024546,1601,769,832,0.4803247970018738,0.5196752029981262
E01024522,1344,630,714,0.46875,0.53125
E01024524,1479,668,811,0.45165652467883705,0.5483434753211629
E01024525,1563,733,830,0.4689699296225208,0.5310300703774792
E01024529,1435,676,759,0.4710801393728223,0.5289198606271777
E01024531,1439,695,744,0.4829742876997915,0.5170257123002084
E01024486,2022,960,1062,0.47477744807121663,0.5252225519287834
E01024487,1266,613,653,0.48420221169036337,0.5157977883096366
E01024488,1300,603,697,0.46384615384615385,0.5361538461538462
E01024548,1245,634,611,0.5092369477911647,0.4907630522088353
E01024549,1113,569,544,0.5112309074573226,0.4887690925426775
E01024537,1675,843,832,0.5032835820895523,0.49671641791044774
E01024538,1769,855,914,0.4833239118145845,0.5166760881854154
E01024539,2006,931,1075,0.4641076769690927,0.5358923230309073
E01024540,1546,755,791,0.4883570504527814,0.5116429495472187
E01024532,1459,767,692,0.5257025359835503,0.4742974640164496
E01024533,1219,604,615,0.49548810500410173,0.5045118949958983
E01024534,1532,746,786,0.4869451697127937,0.5130548302872062
E01024535,2357,1220,1137,0.5176071277047094,0.4823928722952906
E01024504,2035,1145,890,0.5626535626535627,0.43734643734643736
E01024507,1995,1096,899,0.5493734335839598,0.4506265664160401
E01033212,1461,820,641,0.5612594113620808,0.43874058863791926
E01033215,1207,669,538,0.5542667771333886,0.44573322286661143
E01024508,1955,986,969,0.5043478260869565,0.4956521739130435
E01024509,1639,832,807,0.5076266015863331,0.4923733984136669
E01024510,1633,807,826,0.4941824862216779,0.5058175137783221
E01024517,1693,868,825,0.5126993502658004,0.4873006497341996
E01024609,1172,600,572,0.5119453924914675,0.4880546075085324
E01024610,1569,764,805,0.48693435309114086,0.5130656469088591
E01024611,1572,782,790,0.49745547073791346,0.5025445292620865
E01024612,1529,742,787,0.48528449967298887,0.5147155003270111
E01024613,1428,721,707,0.5049019607843137,0.4950980392156863
E01024614,1520,729,791,0.47960526315789476,0.5203947368421052
E01024615,1495,732,763,0.48963210702341137,0.5103678929765886
E01024616,1653,788,865,0.4767090139140956,0.5232909860859044
E01024585,1428,677,751,0.4740896358543417,0.5259103641456583
E01024587,1441,689,752,0.47814018043025674,0.5218598195697433
E01024588,1469,727,742,0.4948944860449285,0.5051055139550715
E01024589,1551,766,785,0.4938749194068343,0.5061250805931657
E01024595,1492,724,768,0.48525469168900803,0.514745308310992
E01024598,1571,812,759,0.5168682367918523,0.48313176320814766
E01024619,1449,689,760,0.47550034506556244,0.5244996549344375
E01024621,1255,588,667,0.4685258964143426,0.5314741035856574
E01032653,1501,743,758,0.4950033311125916,0.5049966688874084
E01032654,1829,921,908,0.5035538545653363,0.49644614543466375
E01024594,1395,686,709,0.4917562724014337,0.5082437275985663
E01024596,1611,794,817,0.4928615766604593,0.5071384233395406
E01024597,1454,716,738,0.4924346629986245,0.5075653370013755
E01024620,1242,623,619,0.501610305958132,0.49838969404186795
E01024580,1678,846,832,0.5041716328963052,0.4958283671036949
E01024581,1341,669,672,0.4988814317673378,0.5011185682326622
E01024586,1624,776,848,0.47783251231527096,0.5221674876847291
E01024618,3022,2140,882,0.7081403044341495,0.29185969556585045
E01024576,1648,803,845,0.48725728155339804,0.5127427184466019
E01024577,1369,679,690,0.4959824689554419,0.504017531044558
E01024578,1634,782,852,0.4785801713586291,0.5214198286413708
E01024579,2970,1467,1503,0.49393939393939396,0.5060606060606061
E01024583,1676,789,887,0.47076372315035797,0.529236276849642
E01032655,1584,799,785,0.5044191919191919,0.49558080808080807
E01032656,1503,740,763,0.49234863606121093,0.5076513639387891
E01024570,1749,810,939,0.4631217838765009,0.5368782161234992
E01024571,1545,750,795,0.4854368932038835,0.5145631067961165
E01024572,1144,579,565,0.5061188811188811,0.4938811188811189
E01024573,1340,639,701,0.47686567164179106,0.5231343283582089
E01024575,1180,583,597,0.4940677966101695,0.5059322033898305
E01024554,2432,1195,1237,0.49136513157894735,0.5086348684210527
E01024561,1360,709,651,0.5213235294117647,0.4786764705882353
E01024567,2774,1353,1421,0.4877433309300649,0.5122566690699352
E01024568,2794,1373,1421,0.4914101646385111,0.5085898353614889
E01024582,1567,787,780,0.5022335673261008,0.4977664326738992
E01024559,1339,647,692,0.4831964152352502,0.5168035847647499
E01024584,1704,814,890,0.47769953051643194,0.5223004694835681
E01024590,1532,777,755,0.5071801566579635,0.49281984334203655
E01024599,1926,924,1002,0.4797507788161994,0.5202492211838006
E01024608,1738,866,872,0.4982738780207135,0.5017261219792866
E01024591,1810,894,916,0.49392265193370166,0.5060773480662983
E01024592,1264,644,620,0.509493670886076,0.49050632911392406
E01024593,1371,663,708,0.48358862144420134,0.5164113785557987
E01024600,1484,727,757,0.4898921832884097,0.5101078167115903
E01024601,1612,788,824,0.48883374689826303,0.511166253101737
E01024560,1273,611,662,0.4799685781618225,0.5200314218381775
E01024562,1479,734,745,0.49628127112914133,0.5037187288708587
E01024569,1766,861,905,0.48754246885617214,0.5124575311438279
E01024630,1645,783,862,0.47598784194528876,0.5240121580547112
E01024632,1560,759,801,0.48653846153846153,0.5134615384615384
E01024606,1394,690,704,0.4949784791965567,0.5050215208034433
E01024628,1497,746,751,0.4983299933199733,0.5016700066800267
E01024629,1141,566,575,0.49605609114811566,0.5039439088518843
E01024631,1676,804,872,0.4797136038186158,0.5202863961813843
E01032735,1568,760,808,0.4846938775510204,0.5153061224489796
E01032737,1443,732,711,0.5072765072765073,0.49272349272349275
E01024564,1012,494,518,0.4881422924901186,0.5118577075098815
E01024603,1246,631,615,0.5064205457463884,0.49357945425361155
E01024604,1194,572,622,0.47906197654941374,0.5209380234505863
E01024605,1339,647,692,0.4831964152352502,0.5168035847647499
E01024626,1575,759,816,0.4819047619047619,0.518095238095238
E01024627,1934,936,998,0.483971044467425,0.516028955532575
E01024551,2241,1050,1191,0.4685408299866131,0.5314591700133868
E01024552,1855,887,968,0.47816711590296496,0.521832884097035
E01024553,1988,919,1069,0.46227364185110664,0.5377263581488934
E01024563,1581,778,803,0.49209361163820364,0.5079063883617964
E01024602,1489,717,772,0.48153122901276024,0.5184687709872398
E01024625,1862,906,956,0.4865735767991407,0.5134264232008593
E01024565,1305,669,636,0.5126436781609195,0.48735632183908045
E01024566,1483,764,719,0.5151719487525287,0.48482805124747136
E01024622,1681,833,848,0.4955383700178465,0.5044616299821535
E01024623,1838,890,948,0.4842219804134929,0.515778019586507
E01024624,1804,903,901,0.5005543237250555,0.49944567627494457
E01024555,1340,641,699,0.4783582089552239,0.5216417910447761
E01024556,1182,582,600,0.49238578680203043,0.5076142131979695
E01024557,1493,717,776,0.48024112525117213,0.5197588747488279
E01024558,1611,786,825,0.48789571694599626,0.5121042830540037
E01024657,2276,1210,1066,0.531634446397188,0.46836555360281196
E01024658,2072,1033,1039,0.4985521235521235,0.5014478764478765
E01024659,1527,733,794,0.48002619515389655,0.5199738048461034
E01024660,1760,874,886,0.4965909090909091,0.5034090909090909
E01024678,1918,954,964,0.49739311783107404,0.502606882168926
E01024653,1601,765,836,0.4778263585259213,0.5221736414740787
E01024654,1519,713,806,0.46938775510204084,0.5306122448979592
E01024655,1475,700,775,0.4745762711864407,0.5254237288135594
E01024656,1673,801,872,0.47878063359234907,0.5212193664076509
E01024675,2147,1010,1137,0.4704238472286912,0.5295761527713088
E01024676,1667,899,768,0.5392921415716857,0.46070785842831435
E01024677,1798,861,937,0.4788654060066741,0.521134593993326
E01024695,1302,636,666,0.48847926267281105,0.511520737327189
E01024697,1276,594,682,0.46551724137931033,0.5344827586206896
E01024710,1131,614,517,0.5428824049513705,0.45711759504862953
E01024661,1510,765,745,0.5066225165562914,0.49337748344370863
E01024664,1482,719,763,0.4851551956815115,0.5148448043184886
E01024665,1516,704,812,0.46437994722955145,0.5356200527704486
E01024694,1779,862,917,0.48454187745924676,0.5154581225407532
E01024696,1411,662,749,0.46917080085046065,0.5308291991495393
E01024672,1451,670,781,0.461750516884907,0.538249483115093
E01024673,1792,872,920,0.48660714285714285,0.5133928571428571
E01024674,1606,800,806,0.49813200498132004,0.50186799501868
E01024711,1441,705,736,0.4892435808466343,0.5107564191533657
E01024712,1554,752,802,0.4839124839124839,0.5160875160875161
E01024633,1545,740,805,0.47896440129449835,0.5210355987055016
E01024634,1403,656,747,0.46756949394155384,0.5324305060584462
E01024662,1579,734,845,0.4648511716276124,0.5351488283723876
E01024663,1587,733,854,0.461877756773787,0.5381222432262129
E01024666,1655,781,874,0.4719033232628399,0.5280966767371601
E01024641,1457,673,784,0.46190803019903914,0.5380919698009609
E01024713,1663,771,892,0.4636199639206254,0.5363800360793747
E01024714,1512,679,833,0.44907407407407407,0.5509259259259259
E01024715,1803,867,936,0.480865224625624,0.519134775374376
E01024716,2018,949,1069,0.47026759167492566,0.5297324083250743
E01024636,2028,920,1108,0.4536489151873767,0.5463510848126233
E01024637,1672,784,888,0.4688995215311005,0.5311004784688995
E01024638,1587,725,862,0.45683679899180846,0.5431632010081916
E01024639,1624,755,869,0.4649014778325123,0.5350985221674877
E01024640,1593,755,838,0.47394852479598243,0.5260514752040176
E01024635,1676,810,866,0.48329355608591884,0.5167064439140812
E01024642,1503,689,814,0.458416500332668,0.541583499667332
E01024644,1331,629,702,0.47257700976709244,0.5274229902329076
E01024692,1642,728,914,0.44336175395858707,0.5566382460414129
E01024693,1372,643,729,0.4686588921282799,0.5313411078717201
E01024643,1233,617,616,0.5004055150040552,0.49959448499594483
E01024705,1271,630,641,0.4956726986624705,0.5043273013375295
E01024706,1523,733,790,0.4812869336835194,0.5187130663164806
E01024707,1361,645,716,0.4739162380602498,0.5260837619397501
E01024708,1532,732,800,0.47780678851174935,0.5221932114882507
E01024686,1633,784,849,0.4800979791794244,0.5199020208205756
E01024688,1566,750,816,0.4789272030651341,0.5210727969348659
E01024689,1253,589,664,0.47007182761372707,0.529928172386273
E01024690,1503,682,821,0.4537591483699268,0.5462408516300732
E01024691,1272,618,654,0.4858490566037736,0.5141509433962265
E01024669,1684,803,881,0.47684085510688834,0.5231591448931117
E01024698,1466,692,774,0.47203274215552526,0.5279672578444747
E01024699,1853,902,951,0.48677819751753915,0.5132218024824609
E01024700,1804,842,962,0.46674057649667405,0.5332594235033259
E01024709,1336,636,700,0.47604790419161674,0.5239520958083832
E01024682,1723,796,927,0.4619849100406268,0.5380150899593732
E01024683,1720,820,900,0.47674418604651164,0.5232558139534884
E01024684,1601,786,815,0.4909431605246721,0.5090568394753279
E01024685,1866,867,999,0.4646302250803859,0.5353697749196141
E01024687,1445,722,723,0.4996539792387543,0.5003460207612457
E01024701,1995,979,1016,0.4907268170426065,0.5092731829573934
E01024702,1339,649,690,0.48469006721433905,0.515309932785661
E01024703,1736,854,882,0.49193548387096775,0.5080645161290323
E01024704,1668,809,859,0.48501199040767384,0.5149880095923262
E01024645,1516,752,764,0.49604221635883905,0.503957783641161
E01024647,1579,796,783,0.5041165294490184,0.49588347055098164
E01024668,1392,686,706,0.492816091954023,0.507183908045977
E01024670,1575,746,829,0.47365079365079366,0.5263492063492063
E01024681,1727,834,893,0.4829183555298205,0.5170816444701795
E01024646,1900,939,961,0.4942105263157895,0.5057894736842106
E01024648,1519,764,755,0.5029624753127058,0.4970375246872943
E01024649,1726,861,865,0.49884125144843566,0.5011587485515643
E01024667,1725,890,835,0.5159420289855072,0.48405797101449277
E01024671,1646,772,874,0.4690157958687728,0.5309842041312273
E01024650,1442,696,746,0.4826629680998613,0.5173370319001387
E01024651,1439,696,743,0.4836692147324531,0.5163307852675469
E01024652,1822,879,943,0.482436882546652,0.5175631174533479
E01024679,1261,604,657,0.47898493259318004,0.52101506740682
E01024680,1600,774,826,0.48375,0.51625
E01024719,1983,1013,970,0.5108421583459405,0.4891578416540595
E01024720,1398,681,717,0.4871244635193133,0.5128755364806867
E01024721,1285,639,646,0.4972762645914397,0.5027237354085603
E01024722,1377,667,710,0.4843863471314452,0.5156136528685549
E01024727,2724,1313,1411,0.48201174743024966,0.5179882525697503
E01024728,1638,809,829,0.4938949938949939,0.5061050061050061
E01024771,1865,901,964,0.4831099195710456,0.5168900804289545
E01024772,1644,814,830,0.4951338199513382,0.5048661800486618
E01024773,1744,850,894,0.4873853211009174,0.5126146788990825
E01024774,2461,1181,1280,0.47988622511174317,0.5201137748882568
E01032830,2497,1195,1302,0.47857428914697636,0.5214257108530236
E01024741,1538,730,808,0.47464239271781533,0.5253576072821846
E01024761,2214,1092,1122,0.4932249322493225,0.5067750677506775
E01024762,2054,1031,1023,0.5019474196689386,0.49805258033106137
E01024763,1394,676,718,0.48493543758967,0.5150645624103299
E01024764,1263,630,633,0.498812351543943,0.501187648456057
E01024765,1365,685,680,0.5018315018315018,0.4981684981684982
E01024782,1286,627,659,0.48755832037325036,0.5124416796267496
E01024785,1480,713,767,0.4817567567567568,0.5182432432432432
E01024717,1611,733,878,0.4549968963376785,0.5450031036623215
E01024718,1336,664,672,0.49700598802395207,0.5029940119760479
E01024735,1570,769,801,0.48980891719745223,0.5101910828025478
E01024736,1703,817,886,0.47974163241338813,0.5202583675866118
E01024737,2331,1121,1210,0.48090948090948094,0.5190905190905191
E01024723,1587,801,786,0.504725897920605,0.4952741020793951
E01024724,1992,967,1025,0.4854417670682731,0.5145582329317269
E01024725,1640,801,839,0.48841463414634145,0.5115853658536585
E01024726,1719,830,889,0.4828388598022106,0.5171611401977894
E01024755,2084,1035,1049,0.4966410748560461,0.503358925143954
E01024786,1921,921,1000,0.47943779281624155,0.5205622071837585
E01024746,1083,528,555,0.48753462603878117,0.5124653739612188
E01024760,1581,785,796,0.4965211891208096,0.5034788108791903
E01024781,2104,1039,1065,0.4938212927756654,0.5061787072243346
E01032825,1576,774,802,0.49111675126903553,0.5088832487309645
E01032826,1613,834,779,0.5170489770613763,0.4829510229386237
E01032827,1762,878,884,0.4982973893303065,0.5017026106696936
E01032828,1238,618,620,0.4991922455573506,0.5008077544426495
E01024743,1829,897,932,0.4904319300164024,0.5095680699835976
E01024744,2042,1035,1007,0.5068560235063663,0.4931439764936337
E01024745,1872,912,960,0.48717948717948717,0.5128205128205128
E01024747,1546,746,800,0.48253557567917205,0.517464424320828
E01024730,1284,616,668,0.4797507788161994,0.5202492211838006
E01024731,1209,583,626,0.48221670802315963,0.5177832919768404
E01024775,1529,731,798,0.4780902550686723,0.5219097449313277
E01024776,1318,615,703,0.4666160849772382,0.5333839150227617
E01024777,1238,596,642,0.481421647819063,0.518578352180937
E01024734,1613,759,854,0.47055176689398637,0.5294482331060136
E01024752,1662,815,847,0.49037304452466907,0.5096269554753309
E01024753,1595,801,794,0.5021943573667712,0.49780564263322885
E01024754,1697,853,844,0.502651738361815,0.497348261638185
E01024729,1770,826,944,0.4666666666666667,0.5333333333333333
E01024748,1452,719,733,0.4951790633608815,0.5048209366391184
E01024749,1507,729,778,0.48374253483742535,0.5162574651625746
E01024750,1489,693,796,0.4654130288784419,0.5345869711215581
E01024751,1556,736,820,0.4730077120822622,0.5269922879177378
E01024732,1896,1161,735,0.6123417721518988,0.3876582278481013
E01024733,1773,867,906,0.4890016920473773,0.5109983079526227
E01024756,1653,805,848,0.4869933454325469,0.5130066545674531
E01024766,1974,1007,967,0.5101317122593718,0.4898682877406282
E01024767,1543,749,794,0.4854180168502916,0.5145819831497084
E01024768,1686,823,863,0.48813760379596677,0.5118623962040332
E01024757,1596,789,807,0.4943609022556391,0.5056390977443609
E01024758,1585,773,812,0.48769716088328074,0.5123028391167193
E01024778,1579,783,796,0.49588347055098164,0.5041165294490184
E01024779,1806,921,885,0.5099667774086378,0.4900332225913621
E01024780,1638,772,866,0.4713064713064713,0.5286935286935287
E01024740,1825,895,930,0.4904109589041096,0.5095890410958904
E01024742,1714,818,896,0.47724620770128356,0.5227537922987164
E01024783,1670,769,901,0.4604790419161677,0.5395209580838324
E01024784,1372,659,713,0.4803206997084548,0.5196793002915452
E01032620,2265,1116,1149,0.49271523178807947,0.5072847682119205
E01032829,1361,676,685,0.4966936076414401,0.5033063923585599
E01024798,2467,1233,1234,0.49979732468585325,0.5002026753141467
E01024811,1220,606,614,0.4967213114754098,0.5032786885245901
E01024812,1312,624,688,0.47560975609756095,0.524390243902439
E01024813,1666,823,843,0.4939975990396158,0.5060024009603842
E01024814,1338,662,676,0.4947683109118087,0.5052316890881914
E01024815,1346,649,697,0.4821693907875186,0.5178306092124815
E01024816,1371,686,685,0.50036469730124,0.49963530269876005
E01024837,1963,964,999,0.49108507386653083,0.5089149261334692
E01024844,1647,828,819,0.5027322404371585,0.4972677595628415
E01024846,1600,781,819,0.488125,0.511875
E01024849,1655,822,833,0.49667673716012084,0.5033232628398792
E01024850,1335,667,668,0.49962546816479403,0.500374531835206
E01024836,1760,882,878,0.5011363636363636,0.49886363636363634
E01024839,1750,875,875,0.5,0.5
E01024845,1354,644,710,0.4756277695716396,0.5243722304283605
E01024847,1623,776,847,0.47812692544670365,0.5218730745532963
E01024848,1358,622,736,0.4580265095729013,0.5419734904270986
E01024793,1682,843,839,0.5011890606420928,0.49881093935790727
E01024825,1544,716,828,0.4637305699481865,0.5362694300518135
E01024826,1467,738,729,0.5030674846625767,0.49693251533742333
E01024827,1576,772,804,0.48984771573604063,0.5101522842639594
E01024828,1541,760,781,0.49318624269954575,0.5068137573004543
E01024840,2019,980,1039,0.48538880633977216,0.5146111936602278
E01024841,1929,947,982,0.4909279419388284,0.5090720580611716
E01024842,1602,786,816,0.49063670411985016,0.5093632958801498
E01024843,1489,745,744,0.5003357958361316,0.49966420416386836
E01024829,1658,810,848,0.48854041013269,0.51145958986731
E01024851,1723,813,910,0.4718514219384794,0.5281485780615206
E01024852,1355,665,690,0.4907749077490775,0.5092250922509225
E01024853,1367,645,722,0.4718361375274323,0.5281638624725676
E01024854,1696,841,855,0.49587264150943394,0.504127358490566
E01024799,1991,950,1041,0.47714716223003517,0.5228528377699648
E01024800,1678,821,857,0.4892729439809297,0.5107270560190703
E01024835,2123,1054,1069,0.49646726330664154,0.5035327366933584
E01024838,1741,851,890,0.488799540493969,0.511200459506031
E01024801,2594,1406,1188,0.5420200462606014,0.4579799537393986
E01024802,2040,1132,908,0.5549019607843138,0.44509803921568625
E01024823,1819,911,908,0.5008246289169873,0.49917537108301263
E01024833,2409,1228,1181,0.5097550850975509,0.49024491490244915
E01024821,2054,959,1095,0.46689386562804286,0.5331061343719572
E01024822,1881,853,1028,0.4534821903242956,0.5465178096757044
E01024824,1609,764,845,0.4748290863890615,0.5251709136109385
E01024832,1664,803,861,0.48257211538461536,0.5174278846153846
E01024834,2245,1111,1134,0.49487750556792875,0.5051224944320712
E01024795,1455,720,735,0.4948453608247423,0.5051546391752577
E01024796,1408,703,705,0.4992897727272727,0.5007102272727273
E01024830,1869,933,936,0.49919743178170145,0.5008025682182986
E01024831,1449,700,749,0.4830917874396135,0.5169082125603864
E01024792,1895,946,949,0.49920844327176783,0.5007915567282322
E01024794,1721,836,885,0.48576409064497383,0.5142359093550262
E01024804,1501,756,745,0.5036642238507661,0.49633577614923385
E01024805,1706,872,834,0.511137162954279,0.488862837045721
E01024806,1826,979,847,0.536144578313253,0.463855421686747
E01024797,1623,819,804,0.5046210720887245,0.4953789279112754
E01024817,1829,897,932,0.4904319300164024,0.5095680699835976
E01024818,1727,817,910,0.4730746960046323,0.5269253039953677
E01024819,1705,863,842,0.506158357771261,0.493841642228739
E01024820,1706,821,885,0.48124267291910905,0.518757327080891
E01024787,1294,616,678,0.4760432766615147,0.5239567233384853
E01024788,1489,701,788,0.470785762256548,0.529214237743452
E01024790,1305,653,652,0.5003831417624521,0.49961685823754787
E01024791,1337,639,698,0.4779356768885565,0.5220643231114436
E01024803,2180,1056,1124,0.48440366972477067,0.5155963302752293
E01024789,2374,958,1416,0.4035383319292334,0.5964616680707666
E01024807,1594,776,818,0.4868255959849435,0.5131744040150564
E01024808,1616,786,830,0.4863861386138614,0.5136138613861386
E01024809,1478,728,750,0.4925575101488498,0.5074424898511503
E01024810,1701,871,830,0.5120517342739564,0.4879482657260435
E01028479,1249,624,625,0.49959967974379504,0.500400320256205
E01028480,1469,719,750,0.48944860449285227,0.5105513955071477
E01028508,1089,526,563,0.4830119375573921,0.5169880624426079
E01028509,1527,762,765,0.49901768172888017,0.5009823182711198
E01028441,2474,1211,1263,0.4894907033144705,0.5105092966855295
E01028443,1464,718,746,0.49043715846994534,0.5095628415300546
E01028444,1533,767,766,0.5003261578604045,0.49967384213959554
E01032943,1632,797,835,0.4883578431372549,0.5116421568627451
E01032944,1347,682,665,0.5063103192279139,0.49368968077208614
E01028445,1458,685,773,0.46982167352537724,0.5301783264746228
E01028446,1544,752,792,0.48704663212435234,0.5129533678756477
E01028447,1260,651,609,0.5166666666666667,0.48333333333333334
E01028448,1606,763,843,0.475093399750934,0.524906600249066
E01028435,1696,820,876,0.4834905660377358,0.5165094339622641
E01028437,1592,776,816,0.48743718592964824,0.5125628140703518
E01028438,1687,840,847,0.4979253112033195,0.5020746887966805
E01028439,1423,710,713,0.4989458889669712,0.5010541110330288
E01028440,1634,833,801,0.5097919216646267,0.49020807833537333
E01032941,1433,675,758,0.471039776692254,0.528960223307746
E01032942,1415,710,705,0.5017667844522968,0.49823321554770317
E01028449,1354,673,681,0.49704579025110784,0.5029542097488922
E01028450,1461,675,786,0.4620123203285421,0.5379876796714579
E01028451,1308,681,627,0.5206422018348624,0.4793577981651376
E01028452,1393,677,716,0.48600143575017946,0.5139985642498205
E01028453,1359,651,708,0.47902869757174393,0.5209713024282561
E01028454,1595,765,830,0.47962382445141066,0.5203761755485894
E01028430,1477,739,738,0.5003385240352065,0.4996614759647935
E01028431,1515,732,783,0.48316831683168315,0.5168316831683168
E01028432,1551,734,817,0.4732430689877498,0.5267569310122502
E01028433,1678,788,890,0.4696066746126341,0.5303933253873659
E01028434,1555,663,892,0.42636655948553054,0.5736334405144694
E01028426,1378,670,708,0.4862119013062409,0.5137880986937591
E01028427,1524,775,749,0.5085301837270341,0.4914698162729659
E01028428,1443,713,730,0.4941094941094941,0.5058905058905059
E01028429,1064,492,572,0.462406015037594,0.5375939849624061
E01028422,1548,765,783,0.4941860465116279,0.5058139534883721
E01028423,1463,677,786,0.46274777853725224,0.5372522214627478
E01028475,2126,1044,1082,0.49106302916274697,0.5089369708372531
E01028476,2405,1201,1204,0.4993762993762994,0.5006237006237007
E01028474,1582,793,789,0.5012642225031606,0.49873577749683945
E01028485,1313,612,701,0.4661081492764661,0.5338918507235338
E01028486,1283,628,655,0.48947778643803586,0.5105222135619641
E01028503,1151,549,602,0.4769765421372719,0.5230234578627281
E01028504,1523,780,743,0.5121470781352594,0.48785292186474066
E01028481,1471,700,771,0.47586675730795375,0.5241332426920462
E01028482,1224,593,631,0.48447712418300654,0.5155228758169934
E01028505,1758,870,888,0.4948805460750853,0.5051194539249146
E01028506,1753,845,908,0.482030804335425,0.517969195664575
E01028507,1428,708,720,0.4957983193277311,0.5042016806722689
E01028425,2248,1250,998,0.556049822064057,0.44395017793594305
E01028477,1536,733,803,0.4772135416666667,0.5227864583333334
E01028478,1481,725,756,0.48953409858203917,0.5104659014179609
E01028483,1270,636,634,0.5007874015748032,0.49921259842519683
E01028484,1093,541,552,0.494967978042086,0.505032021957914
E01028499,1521,743,778,0.48849441157133466,0.5115055884286653
E01028459,1476,733,743,0.49661246612466126,0.5033875338753387
E01028460,2159,1079,1080,0.4997684113015285,0.5002315886984715
E01028461,1748,824,924,0.47139588100686497,0.528604118993135
E01028462,1631,808,823,0.49540159411404044,0.5045984058859595
E01028455,1442,715,727,0.4958391123439667,0.5041608876560333
E01028456,1463,725,738,0.4955570745044429,0.504442925495557
E01028457,1396,716,680,0.5128939828080229,0.4871060171919771
E01028458,1545,766,779,0.49579288025889967,0.5042071197411003
E01028467,1581,737,844,0.4661606578115117,0.5338393421884883
E01028466,1730,840,890,0.48554913294797686,0.5144508670520231
E01028469,1527,739,788,0.4839554682383759,0.5160445317616241
E01028470,1698,855,843,0.5035335689045937,0.49646643109540634
E01028471,1366,654,712,0.4787701317715959,0.5212298682284041
E01028472,1295,660,635,0.5096525096525096,0.49034749034749037
E01028473,1539,737,802,0.4788823911630929,0.521117608836907
E01028463,2523,1253,1270,0.49663099484740386,0.5033690051525961
E01028464,1428,711,717,0.49789915966386555,0.5021008403361344
E01028465,1460,717,743,0.4910958904109589,0.5089041095890411
E01028468,1847,898,949,0.48619382782891174,0.5138061721710883
E01028424,1602,833,769,0.5199750312109863,0.48002496878901374
E01028497,1422,690,732,0.48523206751054854,0.5147679324894515
E01028498,1633,811,822,0.4966319657072872,0.5033680342927128
E01028500,2108,1483,625,0.7035104364326376,0.29648956356736245
E01028501,1281,629,652,0.49102263856362216,0.5089773614363778
E01028502,1230,608,622,0.4943089430894309,0.5056910569105691
E01028487,1274,613,661,0.4811616954474097,0.5188383045525903
E01028489,1397,682,715,0.4881889763779528,0.5118110236220472
E01028490,1208,591,617,0.48923841059602646,0.5107615894039735
E01028491,1499,731,768,0.4876584389593062,0.5123415610406938
E01028494,1166,570,596,0.4888507718696398,0.5111492281303602
E01028492,1474,738,736,0.5006784260515604,0.4993215739484396
E01028493,1410,680,730,0.48226950354609927,0.5177304964539007
E01028495,1313,640,673,0.48743335872048743,0.5125666412795126
E01028496,1401,662,739,0.4725196288365453,0.5274803711634547
E01028488,1581,905,676,0.5724225173940544,0.4275774826059456
E01028510,1599,803,796,0.5021888680425266,0.4978111319574734
E01028511,1609,787,822,0.4891236793039155,0.5108763206960846
E01028512,1443,661,782,0.45807345807345806,0.5419265419265419
E01028594,1543,732,811,0.474400518470512,0.525599481529488
E01028595,1435,679,756,0.47317073170731705,0.526829268292683
E01028596,1468,696,772,0.47411444141689374,0.5258855585831063
E01028597,1420,702,718,0.4943661971830986,0.5056338028169014
E01028591,1413,770,643,0.5449398443029017,0.45506015569709835
E01028592,1549,824,725,0.5319561007101355,0.46804389928986445
E01032554,2069,950,1119,0.45915901401643305,0.5408409859835669
E01032555,2178,1043,1135,0.4788797061524334,0.5211202938475665
E01028565,1253,609,644,0.4860335195530726,0.5139664804469274
E01028583,1416,652,764,0.4604519774011299,0.53954802259887
E01028584,2598,1268,1330,0.4880677444187837,0.5119322555812164
E01028585,1483,749,734,0.5050573162508429,0.4949426837491571
E01028560,1490,714,776,0.4791946308724832,0.5208053691275167
E01028561,1593,745,848,0.46767106089139987,0.5323289391086001
E01028562,1647,767,880,0.46569520340012144,0.5343047965998786
E01028563,1529,751,778,0.49117069980379335,0.5088293001962066
E01028513,2246,1046,1200,0.4657168299198575,0.5342831700801425
E01028514,1502,718,784,0.4780292942743009,0.521970705725699
E01028516,1772,854,918,0.481941309255079,0.518058690744921
E01028538,1493,721,772,0.48292029470864034,0.5170797052913597
E01028534,1139,534,605,0.4688323090430202,0.5311676909569798
E01028535,1601,759,842,0.4740787008119925,0.5259212991880075
E01028536,1381,604,777,0.4373642288196959,0.5626357711803042
E01028537,1643,745,898,0.4534388314059647,0.5465611685940353
E01028539,1885,979,906,0.5193633952254642,0.4806366047745358
E01028540,2846,1288,1558,0.45256500351370343,0.5474349964862966
E01028515,1682,812,870,0.4827586206896552,0.5172413793103449
E01028571,1584,754,830,0.476010101010101,0.523989898989899
E01028572,1633,800,833,0.4898958971218616,0.5101041028781383
E01028573,1746,835,911,0.4782359679266896,0.5217640320733105
E01028574,1345,648,697,0.4817843866171004,0.5182156133828997
E01028521,8300,4705,3595,0.5668674698795181,0.4331325301204819
E01028522,3486,2024,1462,0.5806081468732072,0.4193918531267929
E01033282,4556,2301,2255,0.5050482879719052,0.4949517120280948
E01028548,1708,878,830,0.5140515222482436,0.4859484777517564
E01028549,1644,864,780,0.5255474452554745,0.4744525547445255
E01028550,1402,705,697,0.5028530670470756,0.4971469329529244
E01028551,2066,1100,966,0.5324298160696999,0.4675701839303001
E01028523,1520,712,808,0.46842105263157896,0.531578947368421
E01028524,1527,748,779,0.48984937786509497,0.510150622134905
E01028525,1919,895,1024,0.46638874413757164,0.5336112558624283
E01028526,2337,1118,1219,0.47839109970047067,0.5216089002995293
E01028579,1649,766,883,0.4645239539114615,0.5354760460885385
E01028580,1483,776,707,0.5232636547538773,0.47673634524612274
E01028581,1482,730,752,0.4925775978407557,0.5074224021592443
E01028582,1338,655,683,0.48953662182361735,0.5104633781763827
E01028586,1719,857,862,0.4985456660849331,0.5014543339150669
E01028587,2011,1000,1011,0.4972650422675286,0.5027349577324715
E01028588,1600,834,766,0.52125,0.47875
E01028541,1472,691,781,0.469429347826087,0.5305706521739131
E01028542,1831,950,881,0.5188421627525942,0.4811578372474058
E01028543,1320,697,623,0.5280303030303031,0.471969696969697
E01028544,1321,654,667,0.49507948523845574,0.5049205147615443
E01028531,2169,1083,1086,0.49930843706777317,0.5006915629322268
E01028532,2597,1328,1269,0.5113592606854063,0.4886407393145938
E01028533,2211,1109,1102,0.5015829941203076,0.49841700587969245
E01028556,1784,873,911,0.48934977578475336,0.5106502242152466
E01028557,2172,1027,1145,0.47283609576427255,0.5271639042357275
E01028558,1718,889,829,0.5174621653084982,0.48253783469150174
E01028559,1698,881,817,0.5188457008244994,0.48115429917550057
E01028545,1653,794,859,0.48033877797943136,0.5196612220205686
E01028546,1907,958,949,0.5023597273203986,0.4976402726796015
E01028547,2153,1091,1062,0.5067347886669763,0.4932652113330237
E01028527,1740,859,881,0.49367816091954025,0.5063218390804598
E01028528,1545,800,745,0.517799352750809,0.48220064724919093
E01028529,1570,770,800,0.49044585987261147,0.5095541401273885
E01028530,1707,847,860,0.4961921499707089,0.5038078500292912
E01028575,1528,750,778,0.4908376963350785,0.5091623036649214
E01028578,1550,774,776,0.4993548387096774,0.5006451612903225
E01028552,1724,831,893,0.4820185614849188,0.5179814385150812
E01028553,1811,923,888,0.5096631695196024,0.49033683048039756
E01028554,1326,655,671,0.4939668174962293,0.5060331825037707
E01028555,1580,785,795,0.49683544303797467,0.5031645569620253
E01028576,1462,718,744,0.4911080711354309,0.5088919288645691
E01028577,1960,962,998,0.49081632653061225,0.5091836734693878
E01028517,1307,628,679,0.48048967100229534,0.5195103289977047
E01028518,1617,777,840,0.4805194805194805,0.5194805194805194
E01028519,1451,717,734,0.4941419710544452,0.5058580289455548
E01028567,1756,848,908,0.48291571753986334,0.5170842824601367
E01028520,1702,853,849,0.5011750881316098,0.4988249118683901
E01028568,1601,722,879,0.4509681449094316,0.5490318550905684
E01028569,1735,762,973,0.439193083573487,0.5608069164265129
E01028570,1899,913,986,0.4807793575566087,0.5192206424433913
E01028666,1536,743,793,0.4837239583333333,0.5162760416666666
E01028667,1384,681,703,0.4920520231213873,0.5079479768786127
E01028668,1402,686,716,0.4893009985734665,0.5106990014265336
E01028669,1353,655,698,0.48410938654841096,0.515890613451589
E01028638,1382,686,696,0.4963820549927641,0.5036179450072359
E01028639,1342,660,682,0.4918032786885246,0.5081967213114754
E01028640,1454,726,728,0.49931224209078406,0.5006877579092159
E01028683,1378,693,685,0.5029027576197388,0.49709724238026126
E01028670,1496,713,783,0.4766042780748663,0.5233957219251337
E01028671,1420,689,731,0.4852112676056338,0.5147887323943662
E01028672,1710,842,868,0.49239766081871345,0.5076023391812865
E01028673,1260,584,676,0.4634920634920635,0.5365079365079365
E01028646,1150,562,588,0.48869565217391303,0.5113043478260869
E01028647,1577,754,823,0.47812301838934684,0.5218769816106531
E01028681,1292,645,647,0.49922600619195046,0.5007739938080495
E01028682,1198,579,619,0.48330550918196996,0.5166944908180301
E01028684,1423,689,734,0.48418833450456783,0.5158116654954322
E01028598,2370,1178,1192,0.4970464135021097,0.5029535864978903
E01028613,1437,709,728,0.4933890048712596,0.5066109951287404
E01028614,1498,734,764,0.48998664886515353,0.5100133511348465
E01028615,1583,756,827,0.4775742261528743,0.5224257738471257
E01028616,1406,677,729,0.48150782361308675,0.5184921763869133
E01028604,1548,773,775,0.49935400516795864,0.5006459948320413
E01028605,1555,762,793,0.490032154340836,0.509967845659164
E01028607,1331,645,686,0.48459804658151767,0.5154019534184824
E01028641,1204,580,624,0.48172757475083056,0.5182724252491694
E01028657,1213,612,601,0.5045342126957956,0.49546578730420443
E01028658,1315,647,668,0.4920152091254753,0.5079847908745247
E01028600,1499,743,756,0.49566377585056703,0.5043362241494329
E01028603,1201,600,601,0.4995836802664446,0.5004163197335554
E01028606,1731,846,885,0.48873483535528595,0.511265164644714
E01028609,1337,675,662,0.5048616305160808,0.4951383694839192
E01028610,1493,745,748,0.49899531145344944,0.5010046885465506
E01028678,1549,756,793,0.4880568108457069,0.511943189154293
E01028679,2174,1041,1133,0.4788408463661454,0.5211591536338547
E01028680,1728,801,927,0.4635416666666667,0.5364583333333334
E01028625,1962,973,989,0.49592252803261977,0.5040774719673802
E01028626,1648,836,812,0.5072815533980582,0.49271844660194175
E01028627,1494,714,780,0.4779116465863454,0.5220883534136547
E01028628,1493,763,730,0.5110515740120563,0.48894842598794375
E01028629,1446,710,736,0.49100968188105115,0.5089903181189488
E01028621,1432,732,700,0.5111731843575419,0.4888268156424581
E01028622,1214,584,630,0.48105436573311366,0.5189456342668863
E01028623,1634,805,829,0.49265605875153,0.50734394124847
E01028624,1451,698,753,0.4810475534114404,0.5189524465885597
E01028599,1378,649,729,0.4709724238026125,0.5290275761973875
E01028601,1916,1181,735,0.6163883089770354,0.3836116910229645
E01028602,1543,767,776,0.4970836033700583,0.5029163966299417
E01028620,2833,1564,1269,0.5520649488175079,0.44793505118249205
E01028608,1223,598,625,0.48896156991005724,0.5110384300899428
E01028617,1885,872,1013,0.4625994694960212,0.5374005305039787
E01028674,1326,644,682,0.4856711915535445,0.5143288084464555
E01028675,1251,610,641,0.4876099120703437,0.5123900879296562
E01028676,2025,963,1062,0.47555555555555556,0.5244444444444445
E01028677,1431,680,751,0.4751921733053808,0.5248078266946191
E01028630,1549,836,713,0.5397030342156229,0.460296965784377
E01028631,1104,551,553,0.4990942028985507,0.5009057971014492
E01028632,1477,728,749,0.4928909952606635,0.5071090047393365
E01028633,1505,763,742,0.5069767441860465,0.4930232558139535
E01028634,1337,650,687,0.48616305160807777,0.5138369483919222
E01028635,1528,770,758,0.5039267015706806,0.49607329842931935
E01028636,1307,583,724,0.44605967865340473,0.5539403213465952
E01028637,1559,785,774,0.5035279025016036,0.4964720974983964
E01028618,1847,935,912,0.5062263129399025,0.49377368706009744
E01028619,1835,890,945,0.48501362397820164,0.5149863760217984
E01028644,1583,781,802,0.4933670246367656,0.5066329753632344
E01028648,1162,581,581,0.5,0.5
E01028649,1555,755,800,0.4855305466237942,0.5144694533762058
E01028650,2004,922,1082,0.4600798403193613,0.5399201596806387
E01028651,1556,724,832,0.4652956298200514,0.5347043701799485
E01028652,1990,885,1105,0.44472361809045224,0.5552763819095478
E01028653,1449,697,752,0.4810213940648723,0.5189786059351277
E01028654,1609,784,825,0.4872591671845867,0.5127408328154133
E01028655,1714,774,940,0.4515752625437573,0.5484247374562428
E01028656,1297,628,669,0.48419429452582885,0.5158057054741712
E01028611,1144,561,583,0.49038461538461536,0.5096153846153846
E01028642,1295,617,678,0.47644787644787645,0.5235521235521235
E01028643,1402,673,729,0.48002853067047074,0.5199714693295292
E01028645,1465,690,775,0.4709897610921502,0.5290102389078498
E01028685,1195,579,616,0.4845188284518828,0.5154811715481171
E01028686,1409,810,599,0.5748757984386089,0.4251242015613911
E01028612,1225,575,650,0.46938775510204084,0.5306122448979592
E01028660,1760,879,881,0.4994318181818182,0.5005681818181819
E01028661,1829,994,835,0.5434663750683434,0.45653362493165667
E01028662,1316,618,698,0.4696048632218845,0.5303951367781155
E01028659,1619,843,776,0.5206917850525016,0.4793082149474985
E01028663,1491,700,791,0.4694835680751174,0.5305164319248826
E01028664,1310,611,699,0.466412213740458,0.533587786259542
E01028665,1316,623,693,0.4734042553191489,0.526595744680851
E01028708,1781,833,948,0.46771476698484,0.5322852330151601
E01028709,1572,771,801,0.4904580152671756,0.5095419847328244
E01028710,1635,819,816,0.5009174311926605,0.4990825688073395
E01028711,1682,822,860,0.4887039239001189,0.5112960760998811
E01028733,1283,627,656,0.4886983632112237,0.5113016367887763
E01028734,1552,758,794,0.4884020618556701,0.5115979381443299
E01028735,1634,834,800,0.5104039167686658,0.48959608323133413
E01028740,1553,785,768,0.5054732775273664,0.49452672247263363
E01028741,1543,740,803,0.4795852235904083,0.5204147764095917
E01028742,1575,768,807,0.4876190476190476,0.5123809523809524
E01028738,2143,1331,812,0.621091927204853,0.378908072795147
E01028739,1905,1022,883,0.5364829396325459,0.46351706036745405
E01028743,1605,1124,481,0.7003115264797508,0.29968847352024924
E01028744,1230,597,633,0.4853658536585366,0.5146341463414634
E01028750,1466,716,750,0.48840381991814463,0.5115961800818554
E01028751,1472,711,761,0.4830163043478261,0.516983695652174
E01028752,1697,833,864,0.4908662345315262,0.5091337654684738
E01028693,1613,808,805,0.5009299442033478,0.4990700557966522
E01028694,1470,744,726,0.5061224489795918,0.49387755102040815
E01028701,1561,762,799,0.48814862267777065,0.5118513773222293
E01028705,1289,634,655,0.4918541505042669,0.5081458494957332
E01028706,1497,756,741,0.5050100200400801,0.49498997995991983
E01028707,1555,762,793,0.490032154340836,0.509967845659164
E01028688,1217,605,612,0.4971240755957272,0.5028759244042728
E01028689,1471,730,741,0.49626104690686607,0.5037389530931339
E01028695,1563,783,780,0.5009596928982726,0.4990403071017274
E01028699,1598,807,791,0.5050062578222778,0.49499374217772213
E01028696,1406,730,676,0.519203413940256,0.48079658605974396
E01028697,1525,721,804,0.4727868852459016,0.5272131147540984
E01028698,1493,714,779,0.478231748158071,0.521768251841929
E01028700,1676,804,872,0.4797136038186158,0.5202863961813843
E01028703,1764,817,947,0.4631519274376417,0.5368480725623582
E01033305,1288,613,675,0.47593167701863354,0.5240683229813664
E01033306,1588,755,833,0.47544080604534006,0.52455919395466
E01028726,2191,1098,1093,0.5011410314924692,0.4988589685075308
E01028736,2349,1143,1206,0.48659003831417624,0.5134099616858238
E01028737,2341,1157,1184,0.4942332336608287,0.5057667663391713
E01028690,1622,823,799,0.5073982737361282,0.4926017262638718
E01028691,1424,683,741,0.47963483146067415,0.5203651685393258
E01028692,1411,677,734,0.479801559177888,0.520198440822112
E01028702,1241,590,651,0.47542304593070106,0.5245769540692989
E01028704,1858,870,988,0.4682454251883746,0.5317545748116254
E01028716,1883,937,946,0.49761019649495486,0.5023898035050451
E01028717,1584,752,832,0.47474747474747475,0.5252525252525253
E01028718,1499,719,780,0.47965310206804534,0.5203468979319547
E01028719,1595,788,807,0.49404388714733544,0.5059561128526646
E01028749,2430,1221,1209,0.5024691358024691,0.49753086419753084
E01028714,2353,1152,1201,0.4895877603059923,0.5104122396940076
E01028731,1292,636,656,0.49226006191950467,0.5077399380804953
E01028732,1224,611,613,0.4991830065359477,0.5008169934640523
E01028753,1422,676,746,0.47538677918424754,0.5246132208157525
E01028754,1349,644,705,0.47739065974796147,0.5226093402520385
E01028721,1348,683,665,0.5066765578635015,0.49332344213649854
E01028722,1601,808,793,0.504684572142411,0.49531542785758903
E01028723,1418,730,688,0.5148095909732017,0.48519040902679833
E01028724,1299,657,642,0.5057736720554272,0.4942263279445728
E01028725,1512,764,748,0.5052910052910053,0.4947089947089947
E01028755,1666,815,851,0.4891956782713085,0.5108043217286915
E01028756,2417,1145,1272,0.47372776168804304,0.526272238311957
E01028758,1553,766,787,0.49323889246619446,0.5067611075338055
E01028759,1526,772,754,0.5058977719528178,0.4941022280471822
E01028760,1287,617,670,0.4794094794094794,0.5205905205905206
E01028761,1354,668,686,0.4933530280649926,0.5066469719350074
E01028712,2002,962,1040,0.4805194805194805,0.5194805194805194
E01028727,1626,784,842,0.4821648216482165,0.5178351783517835
E01028728,1166,540,626,0.4631217838765009,0.5368782161234992
E01028729,1073,533,540,0.4967381174277726,0.5032618825722274
E01028730,1623,805,818,0.4959950708564387,0.5040049291435613
E01028757,1524,697,827,0.4573490813648294,0.5426509186351706
E01028713,2372,1178,1194,0.4966273187183811,0.5033726812816189
E01028715,1398,680,718,0.4864091559370529,0.5135908440629471
E01028720,2261,1098,1163,0.48562582927908005,0.51437417072092
E01028745,1383,711,672,0.5140997830802603,0.48590021691973967
E01028746,1290,650,640,0.5038759689922481,0.49612403100775193
E01028747,1250,646,604,0.5168,0.4832
E01028748,1069,536,533,0.5014031805425632,0.49859681945743684
E01028780,2015,1007,1008,0.4997518610421836,0.5002481389578164
E01028781,1255,595,660,0.47410358565737054,0.5258964143426295
E01028782,1551,744,807,0.4796905222437137,0.5203094777562862
E01028783,1516,710,806,0.4683377308707124,0.5316622691292876
E01028795,1541,732,809,0.47501622323166776,0.5249837767683323
E01028796,1422,721,701,0.5070323488045007,0.4929676511954993
E01028797,1139,555,584,0.4872695346795435,0.5127304653204565
E01028806,1976,937,1039,0.4741902834008097,0.5258097165991903
E01028763,1957,919,1038,0.46959632089933573,0.5304036791006643
E01028776,1938,952,986,0.49122807017543857,0.5087719298245614
E01028798,2012,979,1033,0.4865805168986084,0.5134194831013916
E01028804,1313,654,659,0.49809596344249807,0.5019040365575019
E01028823,1293,585,708,0.45243619489559167,0.5475638051044084
E01028824,1540,718,822,0.4662337662337662,0.5337662337662338
E01028825,1165,559,606,0.4798283261802575,0.5201716738197425
E01032954,2716,1310,1406,0.48232695139911635,0.5176730486008837
E01028777,1101,515,586,0.4677565849227975,0.5322434150772025
E01028778,1468,713,755,0.48569482288828336,0.5143051771117166
E01028779,1058,549,509,0.5189035916824196,0.4810964083175803
E01028799,1928,936,992,0.4854771784232365,0.5145228215767634
E01028788,1626,773,853,0.47539975399754,0.52460024600246
E01028789,1448,686,762,0.47375690607734805,0.5262430939226519
E01028790,1182,597,585,0.5050761421319797,0.4949238578680203
E01028791,1560,759,801,0.48653846153846153,0.5134615384615384
E01028784,2110,1069,1041,0.5066350710900474,0.4933649289099526
E01028792,1076,518,558,0.48141263940520446,0.5185873605947955
E01028793,1574,776,798,0.49301143583227447,0.5069885641677255
E01028794,1409,684,725,0.4854506742370476,0.5145493257629524
E01028810,1358,676,682,0.49779086892488955,0.5022091310751104
E01028811,1379,657,722,0.47643219724437996,0.52356780275562
E01028813,1294,638,656,0.49304482225656876,0.5069551777434312
E01028814,1414,672,742,0.4752475247524752,0.5247524752475248
E01028815,1260,620,640,0.49206349206349204,0.5079365079365079
E01032947,1818,888,930,0.4884488448844885,0.5115511551155115
E01032948,1943,926,1017,0.47658260422027793,0.5234173957797221
E01032952,1363,630,733,0.46221570066030815,0.5377842993396919
E01028809,1363,661,702,0.48495964783565665,0.5150403521643434
E01028820,1338,671,667,0.5014947683109118,0.49850523168908817
E01028821,1495,751,744,0.5023411371237458,0.49765886287625416
E01028822,1417,686,731,0.48412138320395204,0.515878616796048
E01028807,2166,1026,1140,0.47368421052631576,0.5263157894736842
E01028808,1728,846,882,0.4895833333333333,0.5104166666666666
E01028816,1383,698,685,0.5046999276934201,0.4953000723065799
E01028817,1481,734,747,0.49561107359891965,0.5043889264010804
E01028818,1734,800,934,0.461361014994233,0.538638985005767
E01028819,1588,760,828,0.47858942065491183,0.5214105793450882
E01028785,1556,744,812,0.4781491002570694,0.5218508997429306
E01028786,1256,618,638,0.49203821656050956,0.5079617834394905
E01028787,1296,638,658,0.49228395061728397,0.5077160493827161
E01028800,1308,650,658,0.4969418960244648,0.5030581039755352
E01028762,1772,892,880,0.5033860045146726,0.4966139954853273
E01028766,1955,945,1010,0.4833759590792839,0.5166240409207161
E01028767,1847,909,938,0.4921494315105577,0.5078505684894423
E01028772,1679,832,847,0.49553305539011316,0.5044669446098868
E01032949,1443,719,724,0.4982674982674983,0.5017325017325017
E01032950,1800,855,945,0.475,0.525
E01032951,1966,982,984,0.49949135300101727,0.5005086469989827
E01032953,2212,1075,1137,0.4859855334538879,0.5140144665461122
E01028771,1451,710,741,0.48931771192281187,0.5106822880771882
E01028773,1323,671,652,0.5071806500377929,0.4928193499622071
E01028774,2614,1677,937,0.6415455241009946,0.35845447589900536
E01028775,1281,670,611,0.5230288836846214,0.4769711163153786
E01028764,1769,856,913,0.4838892029395139,0.5161107970604861
E01028765,1940,965,975,0.49742268041237114,0.5025773195876289
E01028801,1374,692,682,0.5036390101892285,0.4963609898107715
E01028802,1526,755,771,0.4947575360419397,0.5052424639580603
E01030330,1550,745,805,0.4806451612903226,0.5193548387096775
E01030331,1547,736,811,0.47575953458306397,0.524240465416936
E01030332,1473,689,784,0.4677528852681602,0.5322471147318398
E01030333,1438,690,748,0.47983310152990266,0.5201668984700973
E01030326,1613,801,812,0.49659020458772474,0.5034097954122753
E01030327,1576,781,795,0.49555837563451777,0.5044416243654822
E01030328,1685,833,852,0.4943620178041543,0.5056379821958457
E01030329,1463,688,775,0.47026657552973344,0.5297334244702666
E01030334,1437,696,741,0.48434237995824636,0.5156576200417536
E01030335,1836,864,972,0.47058823529411764,0.5294117647058824
E01030336,1878,921,957,0.4904153354632588,0.5095846645367412
E01030337,1592,760,832,0.47738693467336685,0.5226130653266332
E01030361,1983,971,1012,0.4896621280887544,0.5103378719112456
E01030362,1176,575,601,0.48894557823129253,0.5110544217687075
E01030363,1840,910,930,0.4945652173913043,0.5054347826086957
E01030364,1512,763,749,0.5046296296296297,0.49537037037037035
E01030350,1636,780,856,0.4767726161369193,0.5232273838630807
E01030351,1523,743,780,0.48785292186474066,0.5121470781352594
E01030352,1561,745,816,0.47725816784112746,0.5227418321588725
E01030353,1587,762,825,0.48015122873345933,0.5198487712665406
E01030322,1814,869,945,0.4790518191841235,0.5209481808158766
E01030323,1383,682,701,0.49313087490961677,0.5068691250903832
E01030324,1578,780,798,0.49429657794676807,0.5057034220532319
E01030325,1568,762,806,0.48596938775510207,0.514030612244898
E01030357,1566,773,793,0.49361430395913153,0.5063856960408685
E01030358,1443,667,776,0.4622314622314622,0.5377685377685377
E01030359,2210,1099,1111,0.4972850678733032,0.5027149321266968
E01030360,1571,757,814,0.4818586887332909,0.5181413112667091
E01030354,1483,691,792,0.4659474039109912,0.5340525960890088
E01030355,1461,732,729,0.5010266940451745,0.4989733059548255
E01030356,1347,634,713,0.4706755753526355,0.5293244246473645
E01030365,1545,733,812,0.47443365695792883,0.5255663430420712
E01030368,1594,761,833,0.47741530740276034,0.5225846925972396
E01030319,1729,851,878,0.49219201850780797,0.507807981492192
E01030320,1741,869,872,0.4991384261918438,0.5008615738081562
E01030321,1598,799,799,0.5,0.5
E01030369,2243,1095,1148,0.4881854658938921,0.5118145341061079
E01030370,1633,806,827,0.4935701163502756,0.5064298836497244
E01030313,1564,755,809,0.4827365728900256,0.5172634271099744
E01030314,1560,765,795,0.49038461538461536,0.5096153846153846
E01030366,1786,859,927,0.480963045912654,0.5190369540873461
E01030367,1620,777,843,0.47962962962962963,0.5203703703703704
E01030338,1670,825,845,0.4940119760479042,0.5059880239520959
E01030339,1401,666,735,0.4753747323340471,0.5246252676659529
E01030340,1470,712,758,0.48435374149659866,0.5156462585034014
E01030341,1811,883,928,0.4875759249033683,0.5124240750966317
E01030371,1481,724,757,0.4888588791357191,0.5111411208642809
E01030372,1320,623,697,0.471969696969697,0.5280303030303031
E01030373,1546,769,777,0.4974126778783959,0.5025873221216042
E01030374,1600,801,799,0.500625,0.499375
E01030375,1717,825,892,0.48048922539312755,0.5195107746068724
E01030376,1283,658,625,0.5128604832424006,0.48713951675759937
E01030307,1690,845,845,0.5,0.5
E01030308,1614,792,822,0.49070631970260226,0.5092936802973977
E01030309,1558,723,835,0.46405648267008986,0.5359435173299102
E01030310,1881,906,975,0.48165869218500795,0.518341307814992
E01030311,1544,734,810,0.47538860103626945,0.5246113989637305
E01030312,1324,672,652,0.5075528700906344,0.49244712990936557
E01030315,1618,778,840,0.48084054388133496,0.519159456118665
E01030316,1597,772,825,0.4834063869755792,0.5165936130244208
E01030317,1668,799,869,0.4790167865707434,0.5209832134292566
E01030318,1539,680,859,0.44184535412605586,0.5581546458739441
E01030296,1755,857,898,0.4883190883190883,0.5116809116809117
E01030297,2196,1064,1132,0.48451730418943534,0.5154826958105647
E01030298,1581,749,832,0.4737507906388362,0.5262492093611638
E01030299,1636,791,845,0.4834963325183374,0.5165036674816625
E01030346,1501,715,786,0.4763491005996003,0.5236508994003998
E01030347,1664,814,850,0.4891826923076923,0.5108173076923077
E01030348,1631,807,824,0.49478847332924586,0.5052115266707541
E01030349,1706,813,893,0.4765533411488863,0.5234466588511137
E01030300,1609,736,873,0.4574269732753263,0.5425730267246737
E01030301,1553,769,784,0.4951706374758532,0.5048293625241468
E01030302,1576,753,823,0.47779187817258884,0.5222081218274112
E01030304,1628,763,865,0.46867321867321865,0.5313267813267813
E01030305,1620,814,806,0.5024691358024691,0.49753086419753084
E01030306,1503,762,741,0.5069860279441117,0.4930139720558882
E01030303,1826,879,947,0.4813800657174151,0.5186199342825849
E01030342,1728,810,918,0.46875,0.53125
E01030343,1693,838,855,0.4949793266391022,0.5050206733608978
E01030344,1530,752,778,0.4915032679738562,0.5084967320261438
E01030345,1664,820,844,0.49278846153846156,0.5072115384615384
E01030386,1446,718,728,0.49654218533886585,0.5034578146611342
E01030387,1673,821,852,0.4907352062163778,0.5092647937836222
E01030388,1308,638,670,0.4877675840978593,0.5122324159021406
E01030389,1507,734,773,0.4870603848706038,0.5129396151293961
E01030393,1900,936,964,0.4926315789473684,0.5073684210526316
E01030394,1763,889,874,0.504254112308565,0.49574588769143507
E01030399,2053,970,1083,0.47247929858743304,0.527520701412567
E01030400,1656,753,903,0.45471014492753625,0.5452898550724637
E01030414,1325,646,679,0.48754716981132074,0.5124528301886793
E01030377,2381,1169,1212,0.4909701805963881,0.5090298194036119
E01030378,1551,767,784,0.4945196647324307,0.5054803352675693
E01030406,1600,799,801,0.499375,0.500625
E01030407,1390,678,712,0.48776978417266187,0.5122302158273381
E01030408,1819,875,944,0.4810335349092908,0.5189664650907092
E01030395,1754,851,903,0.48517673888255414,0.5148232611174458
E01030413,2070,989,1081,0.4777777777777778,0.5222222222222223
E01030415,1653,829,824,0.5015124016938899,0.4984875983061101
E01030416,1329,661,668,0.49736644093303234,0.5026335590669676
E01030383,2472,1250,1222,0.5056634304207119,0.494336569579288
E01030384,2701,1327,1374,0.49129951869677896,0.508700481303221
E01030401,2465,1230,1235,0.49898580121703856,0.5010141987829615
E01030402,1331,633,698,0.4755822689706987,0.5244177310293012
E01030385,1657,820,837,0.4948702474351237,0.5051297525648762
E01030391,1819,879,940,0.4832325453545904,0.5167674546454095
E01030403,1549,752,797,0.4854744996772111,0.5145255003227889
E01030404,1576,747,829,0.4739847715736041,0.5260152284263959
E01030409,1488,703,785,0.4724462365591398,0.5275537634408602
E01030410,1416,680,736,0.480225988700565,0.519774011299435
E01030381,1467,709,758,0.4832992501704158,0.5167007498295841
E01030411,2180,999,1181,0.45825688073394494,0.541743119266055
E01030412,1895,906,989,0.47810026385224275,0.5218997361477573
E01030419,1674,773,901,0.46176821983273597,0.538231780167264
E01030379,1603,820,783,0.511540860885839,0.48845913911416095
E01030380,1406,674,732,0.4793741109530583,0.5206258890469416
E01030405,1632,769,863,0.47120098039215685,0.5287990196078431
E01030417,1340,639,701,0.47686567164179106,0.5231343283582089
E01030418,1470,725,745,0.4931972789115646,0.5068027210884354
E01030420,1235,544,691,0.4404858299595142,0.5595141700404859
E01030382,1397,679,718,0.4860415175375805,0.5139584824624195
E01030390,1831,851,980,0.4647733478973239,0.5352266521026762
E01030392,1882,930,952,0.49415515409139216,0.5058448459086079
E01030396,1827,885,942,0.48440065681444994,0.5155993431855501
E01030398,1760,873,887,0.4960227272727273,0.5039772727272728
E01032624,1851,892,959,0.48190167477039436,0.5180983252296056
E01030440,1631,793,838,0.4862047823421214,0.5137952176578786
E01030458,1251,629,622,0.5027977617905676,0.49720223820943243
E01030459,1373,554,819,0.40349599417334303,0.596504005826657
E01030475,1317,643,674,0.4882308276385725,0.5117691723614275
E01030476,1257,607,650,0.48289578361177404,0.5171042163882259
E01030477,1671,841,830,0.5032914422501497,0.4967085577498504
E01030465,1435,698,737,0.486411149825784,0.5135888501742161
E01030466,1546,770,776,0.49805950840879687,0.5019404915912031
E01030473,1732,841,891,0.4855658198614319,0.5144341801385681
E01030474,1959,1199,760,0.6120469627360898,0.38795303726391017
E01030441,1276,599,677,0.46943573667711597,0.530564263322884
E01030442,1490,713,777,0.4785234899328859,0.521476510067114
E01030443,1346,674,672,0.5007429420505201,0.49925705794947994
E01030444,1552,760,792,0.4896907216494845,0.5103092783505154
E01030445,1454,676,778,0.4649243466299862,0.5350756533700137
E01030446,1369,637,732,0.46530314097881664,0.5346968590211834
E01030447,1342,645,697,0.48062593144560356,0.5193740685543964
E01030426,1496,737,759,0.49264705882352944,0.5073529411764706
E01030427,1502,742,760,0.4940079893475366,0.5059920106524634
E01030428,1197,605,592,0.5054302422723476,0.49456975772765244
E01030429,1491,728,763,0.48826291079812206,0.5117370892018779
E01030430,1494,742,752,0.4966532797858099,0.5033467202141901
E01030499,1549,757,792,0.48870238863783083,0.5112976113621691
E01030500,1530,768,762,0.5019607843137255,0.4980392156862745
E01030501,1638,820,818,0.5006105006105006,0.4993894993894994
E01030502,1244,619,625,0.49758842443729906,0.502411575562701
E01030503,1445,691,754,0.4782006920415225,0.5217993079584775
E01030504,1123,522,601,0.46482635796972394,0.5351736420302761
E01030485,1729,886,843,0.5124349334875651,0.4875650665124349
E01030487,1630,846,784,0.5190184049079755,0.48098159509202454
E01030488,2269,1162,1107,0.5121198765976201,0.4878801234023799
E01030489,2533,1236,1297,0.48795894196604817,0.5120410580339518
E01030481,1744,883,861,0.5063073394495413,0.49369266055045874
E01030482,1405,706,699,0.502491103202847,0.49750889679715304
E01030483,1377,711,666,0.5163398692810458,0.48366013071895425
E01030484,1661,855,806,0.5147501505117399,0.4852498494882601
E01030434,1650,806,844,0.48848484848484847,0.5115151515151515
E01030435,1800,868,932,0.4822222222222222,0.5177777777777778
E01030462,1654,777,877,0.469770253929867,0.530229746070133
E01030463,1487,731,756,0.49159381304640215,0.5084061869535978
E01030464,1676,824,852,0.4916467780429594,0.5083532219570406
E01030486,1644,850,794,0.5170316301703163,0.4829683698296837
E01030493,1295,625,670,0.4826254826254826,0.5173745173745173
E01030495,1749,942,807,0.5385934819897084,0.4614065180102916
E01030498,1399,703,696,0.5025017869907077,0.49749821300929237
E01030424,1518,744,774,0.4901185770750988,0.5098814229249012
E01030431,1469,737,732,0.5017018379850239,0.4982981620149762
E01030432,1514,750,764,0.4953764861294584,0.5046235138705416
E01030433,1643,820,823,0.4990870359099209,0.5009129640900791
E01030436,2246,1105,1141,0.4919857524487979,0.5080142475512022
E01030437,1792,847,945,0.47265625,0.52734375
E01030439,1719,836,883,0.48632926119837117,0.5136707388016288
E01030460,1570,771,799,0.4910828025477707,0.5089171974522293
E01030461,1649,788,861,0.47786537295330506,0.522134627046695
E01030470,2943,1440,1503,0.4892966360856269,0.5107033639143731
E01030494,1630,826,804,0.5067484662576687,0.49325153374233127
E01030496,1619,795,824,0.49104385423100677,0.5089561457689932
E01030497,1615,788,827,0.48792569659442725,0.5120743034055728
E01030438,1590,774,816,0.4867924528301887,0.5132075471698113
E01030450,2348,1269,1079,0.5404599659284497,0.45954003407155025
E01030451,1884,1033,851,0.5483014861995754,0.45169851380042464
E01030453,1479,765,714,0.5172413793103449,0.4827586206896552
E01030455,1565,834,731,0.5329073482428115,0.4670926517571885
E01030457,1601,847,754,0.5290443472829481,0.47095565271705186
E01030421,1467,713,754,0.48602590320381733,0.5139740967961827
E01030422,1449,687,762,0.474120082815735,0.525879917184265
E01030423,1652,796,856,0.48184019370460046,0.5181598062953995
E01030425,1588,779,809,0.4905541561712846,0.5094458438287154
E01030452,1976,1037,939,0.5247975708502024,0.47520242914979755
E01030467,1632,800,832,0.49019607843137253,0.5098039215686274
E01030468,3499,1710,1789,0.4887110603029437,0.5112889396970564
E01030469,1418,709,709,0.5,0.5
E01030448,1489,742,747,0.4983210208193418,0.5016789791806582
E01030449,1293,636,657,0.4918793503480278,0.5081206496519721
E01030454,1703,855,848,0.5020551967116853,0.49794480328831475
E01030456,1445,707,738,0.4892733564013841,0.510726643598616
E01030471,1242,616,626,0.49597423510466987,0.5040257648953301
E01030472,1371,706,665,0.5149525893508388,0.4850474106491612
E01030478,2041,884,1157,0.43312101910828027,0.5668789808917197
E01030479,1793,841,952,0.4690462911321807,0.5309537088678193
E01030480,1821,830,991,0.4557935200439319,0.5442064799560681
E01030490,1600,776,824,0.485,0.515
E01030491,1874,920,954,0.49092849519743864,0.5090715048025614
E01030492,2024,989,1035,0.48863636363636365,0.5113636363636364
E01030506,1353,670,683,0.49519586104951957,0.5048041389504804
E01030508,1342,666,676,0.496274217585693,0.503725782414307
E01030509,1072,503,569,0.46921641791044777,0.5307835820895522
E01030513,1409,675,734,0.47906316536550747,0.5209368346344926
E01030514,1478,688,790,0.4654939106901218,0.5345060893098782
E01030505,1536,768,768,0.5,0.5
E01030507,1240,595,645,0.4798387096774194,0.5201612903225806
E01030511,1533,738,795,0.48140900195694714,0.5185909980430529
E01030512,1578,742,836,0.47021546261089986,0.5297845373891001
E01030548,1876,939,937,0.5005330490405118,0.4994669509594883
E01030549,1830,937,893,0.5120218579234973,0.48797814207650275
E01030550,1731,903,828,0.5216637781629117,0.4783362218370884
E01030551,1598,786,812,0.4918648310387985,0.5081351689612015
E01030510,1628,759,869,0.46621621621621623,0.5337837837837838
E01030552,1443,720,723,0.498960498960499,0.501039501039501
E01030553,1705,830,875,0.4868035190615836,0.5131964809384164
E01030554,1133,549,584,0.48455428067078554,0.5154457193292145
E01030539,1780,901,879,0.5061797752808989,0.49382022471910114
E01030540,2056,1032,1024,0.5019455252918288,0.4980544747081712
E01030541,1343,659,684,0.49069247952345496,0.509307520476545
E01030542,1271,620,651,0.4878048780487805,0.5121951219512195
E01030543,1546,755,791,0.4883570504527814,0.5116429495472187
E01030516,1295,602,693,0.4648648648648649,0.5351351351351351
E01030517,1549,735,814,0.4744996772111039,0.525500322788896
E01030518,1346,640,706,0.475482912332838,0.524517087667162
E01030519,1589,762,827,0.47954688483322844,0.5204531151667715
E01030520,1461,665,796,0.45516769336071183,0.5448323066392882
E01030521,1647,791,856,0.4802671523982999,0.5197328476017
E01030522,1295,654,641,0.505019305019305,0.49498069498069497
E01030523,1193,566,627,0.4744341994970662,0.5255658005029338
E01030524,2007,1032,975,0.5142002989536621,0.4857997010463378
E01030525,1524,720,804,0.47244094488188976,0.5275590551181102
E01030526,1344,662,682,0.49255952380952384,0.5074404761904762
E01030527,1614,788,826,0.4882280049566295,0.5117719950433705
E01030532,1499,730,769,0.48699132755170116,0.5130086724482988
E01030533,1388,692,696,0.49855907780979825,0.5014409221902018
E01030534,1270,593,677,0.46692913385826773,0.5330708661417323
E01030556,1995,963,1032,0.48270676691729325,0.5172932330827068
E01030535,1864,879,985,0.4715665236051502,0.5284334763948498
E01030536,1806,849,957,0.4700996677740864,0.5299003322259136
E01030537,1730,848,882,0.49017341040462425,0.5098265895953757
E01030538,1601,808,793,0.504684572142411,0.49531542785758903
E01030544,1604,790,814,0.4925187032418953,0.5074812967581047
E01030545,1556,764,792,0.4910025706940874,0.5089974293059126
E01030546,1656,805,851,0.4861111111111111,0.5138888888888888
E01030547,1601,785,816,0.49031855090568394,0.509681449094316
E01030529,1680,838,842,0.4988095238095238,0.5011904761904762
E01030555,1745,879,866,0.5037249283667622,0.4962750716332378
E01030557,1885,938,947,0.49761273209549073,0.5023872679045093
E01030558,2251,1087,1164,0.4828964904486895,0.5171035095513106
E01030515,1881,946,935,0.5029239766081871,0.49707602339181284
E01030528,1413,696,717,0.49256900212314225,0.5074309978768577
E01030530,1279,635,644,0.49648162627052383,0.5035183737294762
E01030531,2326,1172,1154,0.5038693035253654,0.4961306964746346
E01030603,1504,731,773,0.48603723404255317,0.5139627659574468
E01030604,1530,760,770,0.49673202614379086,0.5032679738562091
E01030605,1464,710,754,0.4849726775956284,0.5150273224043715
E01030607,1744,857,887,0.4913990825688073,0.5086009174311926
E01030559,1292,579,713,0.4481424148606811,0.5518575851393189
E01030560,1614,704,910,0.436183395291202,0.563816604708798
E01030561,1440,620,820,0.4305555555555556,0.5694444444444444
E01030562,1286,597,689,0.4642301710730949,0.5357698289269052
E01030563,2067,1211,856,0.5858732462506048,0.4141267537493953
E01030564,1411,693,718,0.4911410347271439,0.5088589652728561
E01030606,1314,655,659,0.4984779299847793,0.5015220700152208
E01030641,1613,761,852,0.4717916924984501,0.5282083075015499
E01030642,1599,759,840,0.474671669793621,0.525328330206379
E01030644,1278,646,632,0.5054773082942097,0.4945226917057903
E01030565,1468,718,750,0.4891008174386921,0.510899182561308
E01030566,1521,737,784,0.48454963839579224,0.5154503616042078
E01030567,1575,778,797,0.49396825396825395,0.506031746031746
E01030568,1561,791,770,0.5067264573991032,0.49327354260089684
E01030569,2698,1330,1368,0.49295774647887325,0.5070422535211268
E01030608,1421,657,764,0.46235045742434905,0.5376495425756509
E01030609,1529,740,789,0.4839764551994768,0.5160235448005233
E01030640,1532,751,781,0.4902088772845953,0.5097911227154047
E01030643,1348,635,713,0.4710682492581602,0.5289317507418397
E01030635,1597,776,821,0.4859110832811522,0.5140889167188478
E01030636,1250,612,638,0.4896,0.5104
E01030637,1249,624,625,0.49959967974379504,0.500400320256205
E01030638,1542,767,775,0.4974059662775616,0.5025940337224384
E01030639,1485,692,793,0.465993265993266,0.534006734006734
E01030589,1725,847,878,0.4910144927536232,0.5089855072463768
E01030590,1870,915,955,0.4893048128342246,0.5106951871657754
E01030591,1412,680,732,0.48158640226628896,0.5184135977337111
E01030592,1884,907,977,0.48142250530785563,0.5185774946921444
E01030599,1552,783,769,0.5045103092783505,0.4954896907216495
E01030600,1556,743,813,0.47750642673521854,0.5224935732647815
E01030601,1623,794,829,0.48921749845964263,0.5107825015403573
E01030602,1797,855,942,0.4757929883138564,0.5242070116861436
E01030598,1595,798,797,0.5003134796238244,0.49968652037617556
E01030623,2143,1027,1116,0.47923471768548764,0.5207652823145124
E01030624,1355,645,710,0.47601476014760147,0.5239852398523985
E01030625,1671,814,857,0.48713345302214245,0.5128665469778576
E01030626,1038,494,544,0.47591522157996147,0.5240847784200385
E01030627,1631,795,836,0.4874310239117106,0.5125689760882894
E01030615,1563,766,797,0.49008317338451696,0.5099168266154831
E01030616,1597,782,815,0.48966812773951157,0.5103318722604884
E01030617,1640,779,861,0.475,0.525
E01030618,1882,937,945,0.49787460148777896,0.502125398512221
E01030619,1503,745,758,0.49567531603459747,0.5043246839654025
E01030622,1868,942,926,0.5042826552462527,0.49571734475374735
E01030610,1296,622,674,0.4799382716049383,0.5200617283950617
E01030611,2684,1335,1349,0.4973919523099851,0.5026080476900149
E01030612,2496,1274,1222,0.5104166666666666,0.4895833333333333
E01030613,1886,953,933,0.5053022269353128,0.49469777306468715
E01030614,1616,821,795,0.5080445544554455,0.49195544554455445
E01030593,1388,689,699,0.49639769452449567,0.5036023054755043
E01030596,1529,753,776,0.4924787442773054,0.5075212557226946
E01030597,1592,757,835,0.47550251256281406,0.5244974874371859
E01030620,1766,864,902,0.48924122310305773,0.5107587768969423
E01030621,1584,742,842,0.4684343434343434,0.5315656565656566
E01030594,1788,866,922,0.4843400447427293,0.5156599552572707
E01030595,1498,729,769,0.48664886515353806,0.513351134846462
E01030630,1641,797,844,0.48567946374162096,0.514320536258379
E01030631,1500,692,808,0.4613333333333333,0.5386666666666666
E01030570,1587,763,824,0.4807813484562067,0.5192186515437933
E01030571,1588,795,793,0.5006297229219143,0.4993702770780856
E01030572,2123,1009,1114,0.4752708431464908,0.5247291568535092
E01030573,1784,880,904,0.49327354260089684,0.5067264573991032
E01030574,1775,883,892,0.49746478873239436,0.5025352112676056
E01030628,1410,701,709,0.4971631205673759,0.5028368794326241
E01030629,1201,597,604,0.4970857618651124,0.5029142381348876
E01030632,1357,670,687,0.4937361827560796,0.5062638172439204
E01030633,1382,690,692,0.4992764109985528,0.5007235890014472
E01030634,1451,685,766,0.4720882150241213,0.5279117849758787
E01030584,1631,798,833,0.4892703862660944,0.5107296137339056
E01030585,1593,791,802,0.4965473948524796,0.5034526051475204
E01030586,1695,821,874,0.48436578171091443,0.5156342182890855
E01030587,1464,727,737,0.49658469945355194,0.5034153005464481
E01030588,1471,715,756,0.4860639021074099,0.5139360978925901
E01030580,1924,961,963,0.4994802494802495,0.5005197505197505
E01030581,1257,621,636,0.49403341288782815,0.5059665871121718
E01030582,1264,595,669,0.47072784810126583,0.5292721518987342
E01030583,1480,746,734,0.504054054054054,0.49594594594594593
E01030575,2092,1062,1030,0.5076481835564054,0.49235181644359466
E01030576,1681,853,828,0.5074360499702558,0.4925639500297442
E01030577,1636,818,818,0.5,0.5
E01030578,1455,732,723,0.5030927835051546,0.49690721649484537
E01030579,1433,676,757,0.47173761339846476,0.5282623866015352
E01030667,1427,692,735,0.4849334267694464,0.5150665732305536
E01030668,1820,827,993,0.4543956043956044,0.5456043956043956
E01030669,1634,816,818,0.49938800489596086,0.5006119951040392
E01030670,1503,674,829,0.44843646041250834,0.5515635395874917
E01030671,2938,1276,1662,0.4343090537780803,0.5656909462219196
E01030672,2489,1186,1303,0.4764965849738851,0.5235034150261149
E01030673,1061,538,523,0.5070688030160226,0.49293119698397736
E01030674,1408,680,728,0.48295454545454547,0.5170454545454546
E01030675,1347,641,706,0.4758723088344469,0.5241276911655531
E01030676,1364,637,727,0.4670087976539589,0.532991202346041
E01030663,1582,767,815,0.48482932996207334,0.5151706700379267
E01030664,1653,800,853,0.4839685420447671,0.5160314579552329
E01030665,1519,750,769,0.4937458854509546,0.5062541145490455
E01030666,1720,858,862,0.49883720930232556,0.5011627906976744
E01030687,1172,578,594,0.4931740614334471,0.5068259385665529
E01030688,1474,736,738,0.4993215739484396,0.5006784260515604
E01030656,1601,786,815,0.4909431605246721,0.5090568394753279
E01030658,1347,668,679,0.495916852264291,0.504083147735709
E01030685,1425,738,687,0.5178947368421053,0.48210526315789476
E01030686,1394,707,687,0.5071736011477762,0.4928263988522238
E01030689,1390,699,691,0.5028776978417266,0.49712230215827335
E01030690,1658,782,876,0.47165259348612787,0.5283474065138721
E01030691,1583,773,810,0.4883133291219204,0.5116866708780796
E01030692,1309,634,675,0.48433919022154315,0.5156608097784569
E01030652,1659,831,828,0.5009041591320073,0.49909584086799275
E01030653,1398,686,712,0.4907010014306152,0.5092989985693849
E01030654,1424,705,719,0.49508426966292135,0.5049157303370787
E01030657,1488,750,738,0.5040322580645161,0.4959677419354839
E01030659,1604,801,803,0.4993765586034913,0.5006234413965087
E01030647,1620,797,823,0.4919753086419753,0.5080246913580246
E01030648,1624,753,871,0.46366995073891626,0.5363300492610837
E01030649,1663,807,856,0.48526758869512926,0.5147324113048707
E01030650,1284,645,639,0.5023364485981309,0.4976635514018692
E01030651,1334,661,673,0.4955022488755622,0.5044977511244377
E01030655,1557,754,803,0.4842646114322415,0.5157353885677585
E01030662,1570,767,803,0.48853503184713376,0.5114649681528662
E01030677,1576,764,812,0.4847715736040609,0.5152284263959391
E01030678,1319,629,690,0.47687642153146326,0.5231235784685367
E01030679,1243,617,626,0.49637972646822204,0.503620273531778
E01030680,1534,744,790,0.485006518904824,0.5149934810951761
E01030645,1926,933,993,0.48442367601246106,0.5155763239875389
E01030646,2050,1007,1043,0.49121951219512194,0.5087804878048781
E01030660,2088,996,1092,0.47701149425287354,0.5229885057471264
E01030661,1670,802,868,0.4802395209580838,0.5197604790419161
E01030684,1474,720,754,0.48846675712347354,0.5115332428765265
E01030681,1587,782,805,0.4927536231884058,0.5072463768115942
E01030682,1354,695,659,0.5132939438700148,0.48670605612998524
E01030683,1342,668,674,0.4977645305514158,0.5022354694485842
E01030693,1201,571,630,0.47543713572023316,0.5245628642797668
E01030694,1362,673,689,0.49412628487518356,0.5058737151248165
E01030695,1266,619,647,0.48894154818325436,0.5110584518167457
E01030696,1475,728,747,0.4935593220338983,0.5064406779661017
E01030743,1499,747,752,0.4983322214809873,0.5016677785190127
E01030744,1578,847,731,0.5367553865652726,0.4632446134347275
E01030745,1587,746,841,0.4700693131695022,0.5299306868304978
E01030747,1371,696,675,0.5076586433260394,0.4923413566739606
E01030709,1540,768,772,0.4987012987012987,0.5012987012987012
E01030710,1668,831,837,0.4982014388489209,0.5017985611510791
E01030711,1775,874,901,0.4923943661971831,0.5076056338028169
E01030746,1632,798,834,0.4889705882352941,0.5110294117647058
E01030707,1625,854,771,0.5255384615384615,0.47446153846153843
E01030708,1649,826,823,0.5009096422073984,0.4990903577926016
E01030712,1333,649,684,0.48687171792948236,0.5131282820705176
E01030713,1229,631,598,0.5134255492270138,0.48657445077298617
E01030714,1490,602,888,0.4040268456375839,0.5959731543624162
E01030715,1512,777,735,0.5138888888888888,0.4861111111111111
E01030716,1525,762,763,0.499672131147541,0.5003278688524591
E01030734,1517,735,782,0.48450889914304546,0.5154911008569545
E01030735,1597,796,801,0.49843456480901693,0.5015654351909831
E01030736,1797,948,849,0.5275459098497496,0.4724540901502504
E01030737,1446,751,695,0.5193637621023514,0.4806362378976487
E01030738,1504,721,783,0.47938829787234044,0.5206117021276596
E01030701,1577,758,819,0.4806594800253646,0.5193405199746354
E01030702,1143,555,588,0.48556430446194226,0.5144356955380578
E01030703,1579,772,807,0.4889170360987967,0.5110829639012033
E01030704,1475,736,739,0.49898305084745764,0.5010169491525424
E01030705,1628,797,831,0.48955773955773957,0.5104422604422605
E01030706,1394,684,710,0.49067431850789095,0.509325681492109
E01030697,1562,781,781,0.5,0.5
E01030698,1676,806,870,0.4809069212410501,0.5190930787589498
E01030699,1509,758,751,0.5023194168323393,0.49768058316766073
E01030700,1721,842,879,0.48925043579314353,0.5107495642068565
E01030725,1755,880,875,0.5014245014245015,0.4985754985754986
E01030729,1537,749,788,0.48731294729993496,0.5126870527000651
E01030739,1662,788,874,0.4741275571600481,0.5258724428399518
E01030740,1770,863,907,0.48757062146892655,0.5124293785310734
E01030741,1765,862,903,0.488385269121813,0.511614730878187
E01030748,1753,889,864,0.5071306332002282,0.49286936679977184
E01030749,1556,737,819,0.4736503856041131,0.5263496143958869
E01030750,1590,776,814,0.4880503144654088,0.5119496855345912
E01030751,1537,783,754,0.5094339622641509,0.49056603773584906
E01030752,1640,815,825,0.4969512195121951,0.5030487804878049
E01030726,1701,831,870,0.48853615520282184,0.5114638447971781
E01030727,1818,871,947,0.4790979097909791,0.5209020902090209
E01030728,1662,827,835,0.49759326113116725,0.5024067388688327
E01030742,1926,956,970,0.4963655244029076,0.5036344755970924
E01030753,1681,834,847,0.496133254015467,0.5038667459845331
E01030754,1520,759,761,0.4993421052631579,0.5006578947368421
E01030755,1935,915,1020,0.4728682170542636,0.5271317829457365
E01030756,1662,823,839,0.49518652226233456,0.5048134777376655
E01030717,1599,778,821,0.48655409631019386,0.5134459036898061
E01030718,1353,655,698,0.48410938654841096,0.515890613451589
E01030719,1574,770,804,0.4891994917407878,0.5108005082592122
E01030720,1580,749,831,0.4740506329113924,0.5259493670886076
E01030721,1544,735,809,0.47603626943005184,0.5239637305699482
E01030722,1587,783,804,0.4933837429111531,0.5066162570888468
E01030723,1566,796,770,0.508301404853129,0.49169859514687103
E01030724,1510,725,785,0.48013245033112584,0.5198675496688742
E01030730,1756,867,889,0.49373576309794986,0.5062642369020501
E01030731,1871,925,946,0.49438802779262425,0.5056119722073757
E01030732,1472,685,787,0.46535326086956524,0.5346467391304348
E01030733,1578,779,799,0.49366286438529783,0.5063371356147022
E01030763,1175,576,599,0.4902127659574468,0.5097872340425532
E01030764,1229,612,617,0.4979658258746949,0.5020341741253052
E01030765,1395,684,711,0.49032258064516127,0.5096774193548387
E01030809,1433,710,723,0.4954640614096302,0.5045359385903698
E01030810,1469,756,713,0.5146358066712049,0.4853641933287951
E01030811,1490,719,771,0.4825503355704698,0.5174496644295302
E01030757,1591,812,779,0.5103708359522313,0.4896291640477687
E01030758,1181,563,618,0.47671464860287893,0.5232853513971211
E01030759,1588,793,795,0.4993702770780856,0.5006297229219143
E01030760,1232,623,609,0.5056818181818182,0.4943181818181818
E01030778,1820,901,919,0.4950549450549451,0.5049450549450549
E01030779,1765,832,933,0.47138810198300285,0.5286118980169972
E01030780,1628,797,831,0.48955773955773957,0.5104422604422605
E01030781,1578,777,801,0.4923954372623574,0.5076045627376425
E01030786,1791,841,950,0.46957007258514794,0.5304299274148521
E01030787,1444,709,735,0.4909972299168975,0.5090027700831025
E01030788,1401,664,737,0.4739471805852962,0.5260528194147038
E01030801,1613,796,817,0.4934903905765654,0.5065096094234346
E01030802,1678,851,827,0.5071513706793802,0.4928486293206198
E01030796,1398,673,725,0.4814020028612303,0.5185979971387696
E01030797,1486,730,756,0.49125168236877526,0.5087483176312247
E01030798,1518,768,750,0.5059288537549407,0.49407114624505927
E01030799,1388,687,701,0.49495677233429397,0.5050432276657061
E01030800,1621,775,846,0.4780999383096854,0.5219000616903147
E01030761,2072,1302,770,0.6283783783783784,0.3716216216216216
E01030762,1893,952,941,0.502905441098785,0.497094558901215
E01030806,1574,785,789,0.49872935196950446,0.5012706480304956
E01030807,1544,759,785,0.49158031088082904,0.508419689119171
E01030808,1575,780,795,0.49523809523809526,0.5047619047619047
E01030774,1382,677,705,0.48986975397973953,0.5101302460202605
E01030775,1450,723,727,0.4986206896551724,0.5013793103448276
E01030776,1613,780,833,0.48357098574085555,0.5164290142591444
E01030777,1604,784,820,0.48877805486284287,0.5112219451371571
E01030793,1527,792,735,0.518664047151277,0.481335952848723
E01030794,1598,815,783,0.5100125156445557,0.4899874843554443
E01030795,2072,989,1083,0.47731660231660233,0.5226833976833977
E01030803,1705,862,843,0.5055718475073314,0.49442815249266864
E01030804,1822,886,936,0.4862788144895719,0.5137211855104281
E01030805,1625,821,804,0.5052307692307693,0.4947692307692308
E01030789,1479,746,733,0.504394861392833,0.495605138607167
E01030790,1705,853,852,0.5002932551319648,0.4997067448680352
E01030791,1660,815,845,0.49096385542168675,0.5090361445783133
E01030792,1336,650,686,0.4865269461077844,0.5134730538922155
E01030766,1641,808,833,0.49238269347958563,0.5076173065204144
E01030767,1622,792,830,0.4882860665844636,0.5117139334155364
E01030768,1384,678,706,0.48988439306358383,0.5101156069364162
E01030769,1531,752,779,0.49118223383409537,0.5088177661659047
E01030770,1495,734,761,0.4909698996655518,0.5090301003344482
E01030771,1270,609,661,0.4795275590551181,0.5204724409448819
E01030772,1515,768,747,0.5069306930693069,0.49306930693069306
E01030773,1437,709,728,0.4933890048712596,0.5066109951287404
E01030782,1575,790,785,0.5015873015873016,0.4984126984126984
E01030783,1614,777,837,0.48141263940520446,0.5185873605947955
E01030784,2477,1296,1181,0.5232135647961244,0.47678643520387565
E01030785,1435,735,700,0.5121951219512195,0.4878048780487805
E01030855,1831,922,909,0.5035499726925178,0.4964500273074823
E01030856,1486,706,780,0.47510094212651416,0.5248990578734859
E01030859,1881,961,920,0.5108984582668793,0.4891015417331207
E01030860,2019,998,1021,0.4943041109460129,0.5056958890539871
E01030844,1816,894,922,0.4922907488986784,0.5077092511013216
E01030845,1272,606,666,0.47641509433962265,0.5235849056603774
E01030846,1536,745,791,0.4850260416666667,0.5149739583333334
E01030857,2199,1035,1164,0.47066848567530695,0.529331514324693
E01030858,2153,1047,1106,0.4862981885740827,0.5137018114259173
E01030828,1372,727,645,0.5298833819241983,0.47011661807580174
E01030829,1447,707,740,0.48859709744298546,0.5114029025570145
E01030830,1327,661,666,0.4981160512434062,0.5018839487565938
E01030850,2149,1010,1139,0.4699860400186133,0.5300139599813867
E01030851,2053,998,1055,0.48611787627861663,0.5138821237213833
E01030861,2141,901,1240,0.42083138720224195,0.5791686127977581
E01030820,1735,845,890,0.48703170028818443,0.5129682997118156
E01030847,1628,753,875,0.46253071253071254,0.5374692874692875
E01030848,2138,1060,1078,0.49579045837231056,0.5042095416276894
E01030831,2246,1100,1146,0.4897595725734639,0.5102404274265361
E01030832,1323,636,687,0.48072562358276644,0.5192743764172335
E01030836,1594,755,839,0.4736511919698871,0.526348808030113
E01030837,1542,697,845,0.45201037613488976,0.5479896238651103
E01030838,1267,625,642,0.49329123914759276,0.5067087608524072
E01030839,1445,702,743,0.48581314878892734,0.5141868512110727
E01030840,1499,726,773,0.48432288192128087,0.5156771180787192
E01030841,1264,616,648,0.4873417721518987,0.5126582278481012
E01030842,1821,876,945,0.48105436573311366,0.5189456342668863
E01030843,1545,763,782,0.49385113268608416,0.5061488673139158
E01030812,1529,717,812,0.46893394375408765,0.5310660562459124
E01030813,1532,763,769,0.4980417754569191,0.5019582245430809
E01030814,1304,630,674,0.4831288343558282,0.5168711656441718
E01030815,1444,697,747,0.4826869806094183,0.5173130193905817
E01030824,1503,692,811,0.46041250831669994,0.5395874916833001
E01030825,1396,660,736,0.47277936962750716,0.5272206303724928
E01030826,1461,702,759,0.4804928131416838,0.5195071868583162
E01030827,1589,780,809,0.4908747640025173,0.5091252359974827
E01030821,2230,1104,1126,0.49506726457399103,0.5049327354260089
E01030822,1836,913,923,0.49727668845315903,0.5027233115468409
E01030833,1327,588,739,0.4431047475508666,0.5568952524491334
E01030834,1393,683,710,0.49030868628858576,0.5096913137114142
E01030835,1481,707,774,0.4773801485482782,0.5226198514517219
E01030816,1561,779,782,0.49903907751441384,0.5009609224855862
E01030817,1405,701,704,0.498932384341637,0.501067615658363
E01030818,1250,616,634,0.4928,0.5072
E01030819,1485,760,725,0.5117845117845118,0.4882154882154882
E01030823,2096,1017,1079,0.48520992366412213,0.5147900763358778
E01030852,1974,934,1040,0.47315096251266464,0.5268490374873354
E01030853,1690,801,889,0.47396449704142013,0.5260355029585799
E01030854,1920,910,1010,0.4739583333333333,0.5260416666666666
E01032571,1863,932,931,0.5002683843263553,0.49973161567364466
E01030890,1556,731,825,0.4697943444730077,0.5302056555269923
E01030902,1319,656,663,0.4973464746019712,0.5026535253980288
E01030903,1582,794,788,0.5018963337547409,0.49810366624525915
E01030904,1394,692,702,0.4964131994261119,0.503586800573888
E01030891,1575,778,797,0.49396825396825395,0.506031746031746
E01030892,1307,649,658,0.49655700076511095,0.5034429992348891
E01030899,1606,810,796,0.5043586550435866,0.49564134495641343
E01030900,1222,603,619,0.49345335515548283,0.5065466448445172
E01030901,1416,697,719,0.4922316384180791,0.507768361581921
E01030884,1473,708,765,0.48065173116089616,0.5193482688391039
E01030885,1479,620,859,0.4192021636240703,0.5807978363759296
E01030886,1253,615,638,0.49082202713487627,0.5091779728651237
E01030893,1883,895,988,0.4753053637812002,0.5246946362187997
E01030895,1529,728,801,0.4761281883584042,0.5238718116415958
E01030881,1430,716,714,0.5006993006993007,0.4993006993006993
E01030883,1377,666,711,0.48366013071895425,0.5163398692810458
E01030888,1516,742,774,0.4894459102902375,0.5105540897097626
E01030894,1604,789,815,0.4918952618453865,0.5081047381546134
E01030911,1539,746,793,0.48473034437946716,0.5152696556205328
E01030912,1305,604,701,0.46283524904214557,0.5371647509578544
E01030913,1243,613,630,0.49316170555108607,0.5068382944489139
E01030920,1506,738,768,0.4900398406374502,0.5099601593625498
E01030921,1678,776,902,0.46245530393325385,0.5375446960667462
E01030882,1360,686,674,0.5044117647058823,0.49558823529411766
E01030887,1373,665,708,0.48434085943190097,0.515659140568099
E01030889,1495,713,782,0.47692307692307695,0.5230769230769231
E01030896,1169,582,587,0.49786142001710865,0.5021385799828914
E01030897,1340,666,674,0.49701492537313435,0.5029850746268657
E01030916,1712,870,842,0.508177570093458,0.49182242990654207
E01030917,1090,599,491,0.5495412844036697,0.4504587155963303
E01030918,1116,521,595,0.4668458781362007,0.5331541218637993
E01030919,1899,1186,713,0.6245392311743022,0.37546076882569773
E01030922,1416,694,722,0.4901129943502825,0.5098870056497176
E01030863,1914,897,1017,0.46865203761755486,0.5313479623824452
E01030865,1538,675,863,0.4388816644993498,0.5611183355006502
E01030866,1558,729,829,0.46790757381258025,0.5320924261874198
E01030940,1761,854,907,0.4849517319704713,0.5150482680295286
E01030898,1614,828,786,0.5130111524163569,0.48698884758364314
E01030905,1536,752,784,0.4895833333333333,0.5104166666666666
E01030906,1707,846,861,0.4956063268892794,0.5043936731107206
E01030907,1373,709,664,0.5163874726875455,0.48361252731245447
E01030914,1354,661,693,0.4881831610044313,0.5118168389955687
E01030915,1626,806,820,0.4956949569495695,0.5043050430504306
E01030923,1460,736,724,0.5041095890410959,0.4958904109589041
E01030924,1246,622,624,0.49919743178170145,0.5008025682182986
E01030925,1614,746,868,0.46220570012391576,0.5377942998760843
E01030877,1173,570,603,0.4859335038363171,0.5140664961636828
E01030878,1569,777,792,0.49521988527724664,0.5047801147227533
E01030937,1645,804,841,0.4887537993920973,0.5112462006079027
E01030938,1324,596,728,0.4501510574018127,0.5498489425981873
E01030939,1187,581,606,0.489469250210615,0.510530749789385
E01030864,1549,777,772,0.5016139444803098,0.4983860555196901
E01030879,1124,551,573,0.4902135231316726,0.5097864768683275
E01030941,1577,756,821,0.47939124920735576,0.5206087507926442
E01030942,1419,702,717,0.49471458773784355,0.5052854122621564
E01030943,1310,638,672,0.4870229007633588,0.5129770992366413
E01030870,1613,782,831,0.4848109113453193,0.5151890886546807
E01030871,1641,822,819,0.5009140767824497,0.4990859232175503
E01030872,1783,871,912,0.48850252383623105,0.511497476163769
E01030873,1431,701,730,0.48986722571628233,0.5101327742837177
E01030874,1688,889,799,0.5266587677725119,0.47334123222748814
E01030875,1301,638,663,0.49039200614911604,0.509607993850884
E01030876,1235,608,627,0.49230769230769234,0.5076923076923077
E01030862,1848,859,989,0.4648268398268398,0.5351731601731602
E01030867,1384,661,723,0.47760115606936415,0.5223988439306358
E01030868,1324,667,657,0.5037764350453172,0.4962235649546828
E01030869,1241,617,624,0.49717969379532634,0.5028203062046737
E01030880,2228,997,1231,0.44748653500897667,0.5525134649910234
E01030930,1622,776,846,0.4784217016029593,0.5215782983970407
E01030931,1685,785,900,0.4658753709198813,0.5341246290801187
E01030932,1493,718,775,0.48091091761553917,0.5190890823844608
E01030933,1753,841,912,0.479749001711352,0.5202509982886481
E01030926,1535,713,822,0.46449511400651466,0.5355048859934853
E01030927,1297,638,659,0.4919043947571318,0.5080956052428681
E01030928,1735,818,917,0.47146974063400576,0.5285302593659942
E01030929,1414,649,765,0.458981612446959,0.541018387553041
E01030908,1685,853,832,0.5062314540059347,0.4937685459940653
E01030909,1202,583,619,0.48502495840266224,0.5149750415973378
E01030910,1202,578,624,0.480865224625624,0.519134775374376
E01030934,1543,750,793,0.4860661049902787,0.5139338950097213
E01030935,1324,658,666,0.49697885196374625,0.5030211480362538
E01032626,1425,693,732,0.4863157894736842,0.5136842105263157
E01030946,1337,651,686,0.4869109947643979,0.5130890052356021
E01030947,1480,734,746,0.49594594594594593,0.504054054054054
E01030948,1577,749,828,0.4749524413443247,0.5250475586556753
E01030949,1732,850,882,0.4907621247113164,0.5092378752886836
E01030950,1598,753,845,0.4712140175219024,0.5287859824780976
E01030996,1600,769,831,0.480625,0.519375
E01030998,1898,923,975,0.4863013698630137,0.5136986301369864
E01031002,1755,839,916,0.47806267806267805,0.5219373219373219
E01031003,1791,886,905,0.4946957007258515,0.5053042992741485
E01031004,2080,982,1098,0.4721153846153846,0.5278846153846154
E01030963,1550,730,820,0.47096774193548385,0.5290322580645161
E01030964,1772,902,870,0.5090293453724605,0.4909706546275395
E01030965,1467,725,742,0.4942058623040218,0.5057941376959781
E01030966,1481,740,741,0.49966239027683995,0.50033760972316
E01030967,1641,783,858,0.47714808043875684,0.5228519195612431
E01030968,1293,626,667,0.48414539829853054,0.5158546017014695
E01030980,1706,903,803,0.5293083235638921,0.4706916764361079
E01030981,1647,851,796,0.5166970248937462,0.4833029751062538
E01030982,1836,1000,836,0.5446623093681917,0.4553376906318083
E01030983,1782,944,838,0.5297418630751964,0.4702581369248036
E01030984,2038,991,1047,0.486261040235525,0.5137389597644749
E01030985,1565,782,783,0.4996805111821086,0.5003194888178913
E01030951,1320,640,680,0.48484848484848486,0.5151515151515151
E01030952,1561,782,779,0.5009609224855862,0.49903907751441384
E01030953,1472,705,767,0.4789402173913043,0.5210597826086957
E01030956,1331,677,654,0.5086401202103682,0.49135987978963186
E01030957,1319,638,681,0.4836997725549659,0.5163002274450341
E01030958,1459,693,766,0.47498286497601094,0.5250171350239891
E01030959,1026,465,561,0.45321637426900585,0.5467836257309941
E01030988,2004,1035,969,0.5164670658682635,0.48353293413173654
E01030989,1721,840,881,0.48808832074375363,0.5119116792562464
E01030990,1486,732,754,0.49259757738896365,0.5074024226110363
E01030997,1524,737,787,0.4835958005249344,0.5164041994750657
E01030974,1556,792,764,0.5089974293059126,0.4910025706940874
E01030975,1415,695,720,0.4911660777385159,0.508833922261484
E01030976,1538,743,795,0.4830949284785436,0.5169050715214565
E01030977,1780,908,872,0.5101123595505618,0.4898876404494382
E01030979,2163,1058,1105,0.4891354600092464,0.5108645399907535
E01030954,2223,1157,1066,0.52046783625731,0.47953216374269003
E01030969,1457,746,711,0.5120109814687714,0.48798901853122856
E01030970,1476,732,744,0.4959349593495935,0.5040650406504065
E01030991,1927,953,974,0.4945511157239232,0.5054488842760768
E01030993,2451,1277,1174,0.5210118319053447,0.4789881680946552
E01030960,1721,847,874,0.49215572341661823,0.5078442765833817
E01030961,1927,969,958,0.502854177477945,0.497145822522055
E01030962,1682,807,875,0.4797859690844233,0.5202140309155767
E01031000,1536,761,775,0.4954427083333333,0.5045572916666666
E01030955,1394,675,719,0.48421807747489237,0.5157819225251076
E01030992,1674,813,861,0.48566308243727596,0.514336917562724
E01030999,1433,680,753,0.47452896022330776,0.5254710397766923
E01031001,1687,820,867,0.4860699466508595,0.5139300533491404
E01030971,1930,949,981,0.4917098445595855,0.5082901554404146
E01030972,1876,925,951,0.49307036247334757,0.5069296375266524
E01030973,1770,920,850,0.519774011299435,0.480225988700565
E01030994,1806,901,905,0.4988925802879291,0.5011074197120708
E01030995,1386,714,672,0.5151515151515151,0.48484848484848486
E01030944,1397,711,686,0.5089477451682176,0.4910522548317824
E01030945,1168,566,602,0.4845890410958904,0.5154109589041096
E01030978,1506,747,759,0.4960159362549801,0.5039840637450199
E01030986,1074,531,543,0.49441340782122906,0.505586592178771
E01030987,1396,690,706,0.49426934097421205,0.505730659025788
E01031349,1340,649,691,0.4843283582089552,0.5156716417910447
E01031350,1209,582,627,0.4813895781637717,0.5186104218362283
E01031351,1557,759,798,0.48747591522157996,0.51252408477842
E01031352,1455,705,750,0.4845360824742268,0.5154639175257731
E01031370,1451,699,752,0.48173673328738803,0.518263266712612
E01031374,1512,746,766,0.4933862433862434,0.5066137566137566
E01031338,1165,565,600,0.48497854077253216,0.5150214592274678
E01031339,1175,574,601,0.48851063829787233,0.5114893617021277
E01031340,1473,731,742,0.49626612355736593,0.5037338764426341
E01031365,1539,715,824,0.4645873944119558,0.5354126055880442
E01031367,1282,633,649,0.49375975039001563,0.5062402496099844
E01031345,1472,723,749,0.49116847826086957,0.5088315217391305
E01031353,1367,718,649,0.5252377468910022,0.4747622531089978
E01031354,1231,610,621,0.49553208773354995,0.50446791226645
E01031355,1649,801,848,0.48574893875075803,0.5142510612492419
E01031359,1381,687,694,0.49746560463432293,0.502534395365677
E01031347,1624,782,842,0.4815270935960591,0.5184729064039408
E01031348,1643,799,844,0.48630553864881315,0.5136944613511869
E01031366,1406,671,735,0.4772403982930299,0.5227596017069701
E01031371,1260,581,679,0.46111111111111114,0.5388888888888889
E01031372,1270,610,660,0.48031496062992124,0.5196850393700787
E01031373,1468,690,778,0.47002724795640327,0.5299727520435967
E01031375,1456,676,780,0.4642857142857143,0.5357142857142857
E01031356,2283,1144,1139,0.5010950503723172,0.4989049496276829
E01031357,2241,1132,1109,0.5051316376617582,0.49486836233824183
E01031364,1455,700,755,0.48109965635738833,0.5189003436426117
E01031368,1245,595,650,0.4779116465863454,0.5220883534136547
E01031369,1302,565,737,0.4339477726574501,0.5660522273425499
E01031344,1345,692,653,0.5144981412639406,0.4855018587360595
E01031346,1381,668,713,0.4837074583635047,0.5162925416364953
E01031361,1515,738,777,0.4871287128712871,0.5128712871287129
E01031362,1277,631,646,0.4941268598277212,0.5058731401722788
E01031363,1571,730,841,0.46467218332272436,0.5353278166772756
E01031358,1522,705,817,0.4632063074901445,0.5367936925098554
E01031360,1534,738,796,0.4810951760104302,0.5189048239895697
E01031376,1248,609,639,0.4879807692307692,0.5120192307692307
E01031378,1361,676,685,0.4966936076414401,0.5033063923585599
E01031341,1351,623,728,0.46113989637305697,0.538860103626943
E01031342,1665,771,894,0.46306306306306305,0.5369369369369369
E01031343,1395,649,746,0.4652329749103943,0.5347670250896057
E01031377,1533,723,810,0.47162426614481406,0.5283757338551859
E01031379,1573,718,855,0.4564526382708201,0.54354736172918
E01031390,1350,662,688,0.49037037037037035,0.5096296296296297
E01031391,1475,693,782,0.46983050847457625,0.5301694915254237
E01031392,1473,709,764,0.4813306177868296,0.5186693822131704
E01031465,1443,708,735,0.49064449064449067,0.5093555093555093
E01031386,1468,710,758,0.48365122615803813,0.5163487738419619
E01031387,1521,709,812,0.46614069690992765,0.5338593030900723
E01031425,1363,629,734,0.4614820249449743,0.5385179750550256
E01031426,1194,585,609,0.4899497487437186,0.5100502512562815
E01031393,1759,821,938,0.46674246731097213,0.5332575326890279
E01031394,1656,824,832,0.4975845410628019,0.5024154589371981
E01031395,1534,751,783,0.4895697522816167,0.5104302477183833
E01031396,1919,910,1009,0.47420531526836895,0.525794684731631
E01031397,1759,858,901,0.4877771461057419,0.5122228538942581
E01031466,1446,705,741,0.487551867219917,0.5124481327800829
E01031427,1363,639,724,0.46881878209831257,0.5311812179016875
E01031429,1451,690,761,0.4755341144038594,0.5244658855961406
E01031430,1431,698,733,0.48777078965758214,0.5122292103424179
E01031467,1717,841,876,0.4898078043098428,0.5101921956901573
E01031468,2297,1124,1173,0.4893339138006095,0.5106660861993905
E01031388,2645,1275,1370,0.4820415879017013,0.5179584120982986
E01031389,2154,1019,1135,0.47307335190343547,0.5269266480965645
E01031414,1508,733,775,0.4860742705570292,0.5139257294429708
E01031415,1535,710,825,0.46254071661237783,0.5374592833876222
E01031459,1789,807,982,0.4510899944102851,0.5489100055897149
E01031470,1883,1080,803,0.5735528412108338,0.4264471587891662
E01031471,1285,646,639,0.5027237354085603,0.4972762645914397
E01031472,1527,718,809,0.4702030124426981,0.5297969875573019
E01031473,1231,589,642,0.4784727863525589,0.5215272136474411
E01031407,1572,743,829,0.47264631043257,0.52735368956743
E01031408,1935,915,1020,0.4728682170542636,0.5271317829457365
E01031410,1266,587,679,0.4636650868878357,0.5363349131121643
E01031462,1470,674,796,0.45850340136054424,0.5414965986394558
E01031463,1624,736,888,0.45320197044334976,0.5467980295566502
E01031464,1585,691,894,0.4359621451104101,0.5640378548895899
E01031412,1390,662,728,0.4762589928057554,0.5237410071942447
E01031422,1502,677,825,0.4507323568575233,0.5492676431424767
E01031423,1624,758,866,0.4667487684729064,0.5332512315270936
E01031424,1354,606,748,0.44756277695716395,0.552437223042836
E01031398,1490,725,765,0.4865771812080537,0.5134228187919463
E01031399,1668,785,883,0.4706235011990408,0.5293764988009593
E01031409,1398,691,707,0.49427753934191704,0.505722460658083
E01031455,1421,653,768,0.4595355383532723,0.5404644616467277
E01031461,1760,817,943,0.4642045454545455,0.5357954545454545
E01031469,1677,810,867,0.48300536672629696,0.516994633273703
E01031411,1380,623,757,0.4514492753623188,0.5485507246376812
E01031413,1336,588,748,0.44011976047904194,0.5598802395209581
E01031457,1585,723,862,0.45615141955835964,0.5438485804416404
E01031458,1785,812,973,0.4549019607843137,0.5450980392156862
E01031460,1699,778,921,0.4579164214243673,0.5420835785756327
E01031400,1623,806,817,0.49661121380160195,0.503388786198398
E01031428,1550,791,759,0.5103225806451613,0.4896774193548387
E01031454,2155,1095,1060,0.5081206496519721,0.4918793503480278
E01031456,1781,893,888,0.5014037057832679,0.4985962942167322
E01031401,1558,725,833,0.4653401797175867,0.5346598202824133
E01031402,1617,787,830,0.4867037724180581,0.5132962275819418
E01031403,1413,674,739,0.4769992922859165,0.5230007077140835
E01031405,1377,663,714,0.48148148148148145,0.5185185185185185
E01031406,1333,661,672,0.495873968492123,0.5041260315078769
E01031417,1603,771,832,0.4809731752963194,0.5190268247036806
E01031438,1620,767,853,0.4734567901234568,0.5265432098765432
E01031439,1914,874,1040,0.4566353187042842,0.5433646812957158
E01031440,1543,729,814,0.47245625405055086,0.5275437459494491
E01031404,1198,572,626,0.4774624373956594,0.5225375626043406
E01031433,1440,685,755,0.4756944444444444,0.5243055555555556
E01031434,1609,766,843,0.47607209446861404,0.5239279055313859
E01031441,1640,777,863,0.473780487804878,0.526219512195122
E01031442,1589,784,805,0.4933920704845815,0.5066079295154186
E01031416,1582,763,819,0.4823008849557522,0.5176991150442478
E01031418,1683,797,886,0.47355912061794414,0.5264408793820559
E01031419,1631,727,904,0.4457388105456775,0.5542611894543225
E01031420,1628,760,868,0.4668304668304668,0.5331695331695332
E01031421,1725,814,911,0.4718840579710145,0.5281159420289855
E01031443,1348,645,703,0.478486646884273,0.521513353115727
E01031444,1590,785,805,0.4937106918238994,0.5062893081761006
E01031450,1252,604,648,0.48242811501597443,0.5175718849840255
E01031451,1467,727,740,0.49556918882072254,0.5044308111792775
E01031452,1491,698,793,0.4681421864520456,0.5318578135479544
E01031431,1615,763,852,0.4724458204334365,0.5275541795665635
E01031432,1892,929,963,0.49101479915433405,0.508985200845666
E01031435,1687,803,884,0.4759928867812685,0.5240071132187315
E01031436,1803,889,914,0.4930671103716029,0.5069328896283971
E01031437,1980,981,999,0.4954545454545455,0.5045454545454545
E01031453,1661,806,855,0.4852498494882601,0.5147501505117399
E01031380,1554,733,821,0.4716859716859717,0.5283140283140283
E01031381,1601,759,842,0.4740787008119925,0.5259212991880075
E01031382,1688,788,900,0.466824644549763,0.533175355450237
E01031383,1571,725,846,0.4614894971355824,0.5385105028644176
E01031384,1710,791,919,0.4625730994152047,0.5374269005847954
E01031385,1561,701,860,0.44907110826393337,0.5509288917360666
E01031445,1549,750,799,0.4841833440929632,0.5158166559070368
E01031446,1330,629,701,0.47293233082706765,0.5270676691729324
E01031447,1528,714,814,0.46727748691099474,0.5327225130890052
E01031448,1534,732,802,0.4771838331160365,0.5228161668839635
E01031449,1597,773,824,0.48403256105197245,0.5159674389480275
E01031502,1576,795,781,0.5044416243654822,0.49555837563451777
E01031503,1674,845,829,0.504778972520908,0.49522102747909197
E01031504,2084,984,1100,0.472168905950096,0.527831094049904
E01031519,1406,709,697,0.5042674253200569,0.4957325746799431
E01031517,1827,900,927,0.49261083743842365,0.5073891625615764
E01031518,1551,764,787,0.49258542875564154,0.5074145712443585
E01031544,1279,622,657,0.48631743549648165,0.5136825645035183
E01031545,1198,581,617,0.48497495826377296,0.5150250417362271
E01031508,2026,994,1032,0.4906219151036525,0.5093780848963475
E01031520,1322,636,686,0.481089258698941,0.518910741301059
E01031521,1125,569,556,0.5057777777777778,0.49422222222222223
E01031536,1148,564,584,0.4912891986062718,0.5087108013937283
E01031497,1358,673,685,0.4955817378497791,0.5044182621502209
E01031511,1460,644,816,0.4410958904109589,0.5589041095890411
E01031512,1874,887,987,0.47331910352187834,0.5266808964781217
E01032717,2546,1169,1377,0.4591516103692066,0.5408483896307934
E01031478,1134,547,587,0.48236331569664903,0.517636684303351
E01031479,1067,497,570,0.46579194001874413,0.5342080599812559
E01031498,1134,539,595,0.47530864197530864,0.5246913580246914
E01031514,1696,783,913,0.46167452830188677,0.5383254716981132
E01031515,1593,755,838,0.47394852479598243,0.5260514752040176
E01031516,1453,697,756,0.4796971782518926,0.5203028217481074
E01031477,2235,1051,1184,0.4702460850111857,0.5297539149888143
E01031485,1511,731,780,0.48378557246856385,0.5162144275314361
E01031487,1528,721,807,0.4718586387434555,0.5281413612565445
E01031509,2365,1102,1263,0.46596194503171245,0.5340380549682875
E01031506,1268,616,652,0.48580441640378547,0.5141955835962145
E01031507,1403,696,707,0.49607982893799,0.5039201710620099
E01031531,1316,639,677,0.48556231003039513,0.5144376899696048
E01031533,1150,516,634,0.44869565217391305,0.551304347826087
E01031543,2309,1112,1197,0.4815937635339974,0.5184062364660026
E01031482,1497,713,784,0.47628590514362057,0.5237140948563794
E01031483,2354,1119,1235,0.47536108751062023,0.5246389124893798
E01031486,1792,773,1019,0.43136160714285715,0.5686383928571429
E01031488,1894,906,988,0.4783526927138332,0.5216473072861668
E01031494,1591,748,843,0.470144563167819,0.5298554368321811
E01031495,1577,730,847,0.4629042485732403,0.5370957514267597
E01031475,1356,666,690,0.4911504424778761,0.5088495575221239
E01031476,1480,709,771,0.47905405405405405,0.5209459459459459
E01031532,1642,969,673,0.5901339829476249,0.40986601705237513
E01031534,1718,800,918,0.46565774155995343,0.5343422584400466
E01031535,1622,775,847,0.47780517879161527,0.5221948212083847
E01031480,1337,640,697,0.4786836200448766,0.5213163799551234
E01031481,1511,730,781,0.4831237590999338,0.5168762409000662
E01031484,1781,857,924,0.4811903425042111,0.5188096574957889
E01031490,1909,852,1057,0.4463069669984285,0.5536930330015715
E01031491,1836,884,952,0.48148148148148145,0.5185185185185185
E01031474,1420,689,731,0.4852112676056338,0.5147887323943662
E01031493,1679,784,895,0.4669446098868374,0.5330553901131626
E01031496,2228,1051,1177,0.47172351885098746,0.5282764811490126
E01031505,2325,1115,1210,0.47956989247311826,0.5204301075268817
E01031489,1534,726,808,0.47327249022164275,0.5267275097783573
E01031492,1464,697,767,0.4760928961748634,0.5239071038251366
E01031513,2252,1107,1145,0.49156305506216696,0.5084369449378331
E01031530,1257,616,641,0.4900556881463803,0.5099443118536198
E01031538,1553,715,838,0.4603992273019961,0.5396007726980039
E01031539,1072,504,568,0.4701492537313433,0.5298507462686567
E01031499,1831,877,954,0.4789732386673949,0.5210267613326052
E01031500,1887,890,997,0.47164811870694223,0.5283518812930578
E01031501,1399,667,732,0.4767691208005718,0.5232308791994281
E01031529,1171,602,569,0.5140905209222887,0.48590947907771137
E01031540,1364,626,738,0.45894428152492667,0.5410557184750733
E01031541,1336,607,729,0.45434131736526945,0.5456586826347305
E01031542,1772,869,903,0.4904063205417607,0.5095936794582393
E01031522,1970,910,1060,0.4619289340101523,0.5380710659898477
E01031523,1565,737,828,0.470926517571885,0.529073482428115
E01031524,1485,704,781,0.4740740740740741,0.5259259259259259
E01031525,1345,612,733,0.4550185873605948,0.5449814126394052
E01031526,1381,639,742,0.46270818247646633,0.5372918175235337
E01031527,1539,734,805,0.47693307342430147,0.5230669265756985
E01031528,1452,714,738,0.49173553719008267,0.5082644628099173
E01031573,1623,804,819,0.4953789279112754,0.5046210720887245
E01031574,1868,938,930,0.5021413276231264,0.49785867237687365
E01031575,1776,966,810,0.543918918918919,0.4560810810810811
E01031576,1629,812,817,0.49846531614487416,0.5015346838551259
E01031577,1359,715,644,0.5261221486387049,0.47387785136129507
E01031586,1787,882,905,0.493564633463906,0.506435366536094
E01031587,1681,865,816,0.5145746579417013,0.4854253420582986
E01031588,1498,764,734,0.5100133511348465,0.48998664886515353
E01031590,1593,779,814,0.48901443816698054,0.5109855618330195
E01031593,1399,691,708,0.49392423159399573,0.5060757684060043
E01031570,1394,679,715,0.48708751793400284,0.5129124820659972
E01031571,1645,793,852,0.48206686930091186,0.5179331306990882
E01031572,1511,717,794,0.4745201853077432,0.5254798146922568
E01031609,1571,754,817,0.47994907702100575,0.5200509229789942
E01031610,1801,884,917,0.49083842309827874,0.5091615769017213
E01031583,1978,1027,951,0.519211324570273,0.480788675429727
E01031584,1663,834,829,0.5015033072760072,0.4984966927239928
E01031585,1657,857,800,0.5171997585998793,0.4828002414001207
E01031601,1244,627,617,0.5040192926045016,0.4959807073954984
E01032835,1473,773,700,0.5247793618465716,0.47522063815342835
E01032836,1658,832,826,0.5018094089264173,0.49819059107358266
E01031589,1767,920,847,0.5206564799094511,0.479343520090549
E01031591,1814,906,908,0.4994487320837927,0.5005512679162073
E01031594,1418,678,740,0.4781382228490832,0.5218617771509168
E01031600,1394,671,723,0.4813486370157819,0.5186513629842181
E01031603,1484,751,733,0.5060646900269542,0.4939353099730458
E01031564,1478,728,750,0.4925575101488498,0.5074424898511503
E01031565,2168,1035,1133,0.47739852398523985,0.5226014760147601
E01031566,1606,807,799,0.5024906600249066,0.4975093399750934
E01031567,1364,657,707,0.48167155425219943,0.5183284457478006
E01031568,1391,670,721,0.48166786484543495,0.5183321351545651
E01031596,1875,914,961,0.48746666666666666,0.5125333333333333
E01031597,1498,730,768,0.48731642189586116,0.5126835781041389
E01031598,1717,808,909,0.47058823529411764,0.5294117647058824
E01031599,1751,881,870,0.5031410622501428,0.49685893774985723
E01031608,1748,874,874,0.5,0.5
E01031578,1790,891,899,0.4977653631284916,0.5022346368715084
E01031580,2348,1139,1209,0.48509369676320274,0.5149063032367973
E01031581,1785,911,874,0.5103641456582633,0.4896358543417367
E01031592,2020,1019,1001,0.5044554455445545,0.49554455445544554
E01031560,1476,750,726,0.508130081300813,0.491869918699187
E01031561,1432,737,695,0.5146648044692738,0.48533519553072624
E01031562,1287,621,666,0.4825174825174825,0.5174825174825175
E01031563,1304,606,698,0.4647239263803681,0.5352760736196319
E01031579,1628,816,812,0.5012285012285013,0.4987714987714988
E01031582,1818,897,921,0.4933993399339934,0.5066006600660066
E01031547,1332,637,695,0.47822822822822825,0.5217717717717718
E01031548,1596,800,796,0.5012531328320802,0.49874686716791977
E01031549,1482,749,733,0.5053981106612686,0.49460188933873145
E01031550,1455,713,742,0.49003436426116836,0.5099656357388316
E01031569,1577,771,806,0.4889029803424223,0.5110970196575777
E01031595,1692,792,900,0.46808510638297873,0.5319148936170213
E01031604,1563,740,823,0.473448496481126,0.5265515035188739
E01031605,1574,747,827,0.47458703939008895,0.525412960609911
E01031606,1523,755,768,0.49573210768220616,0.5042678923177938
E01031607,1418,695,723,0.4901269393511989,0.5098730606488011
E01031546,1455,740,715,0.5085910652920962,0.49140893470790376
E01031551,1545,766,779,0.49579288025889967,0.5042071197411003
E01031553,1559,760,799,0.48749198203976907,0.5125080179602309
E01031554,1714,827,887,0.4824970828471412,0.5175029171528588
E01031555,1563,773,790,0.4945617402431222,0.5054382597568778
E01031552,1898,924,974,0.4868282402528978,0.5131717597471022
E01031556,1655,782,873,0.4725075528700906,0.5274924471299094
E01031557,1726,844,882,0.48899188876013905,0.5110081112398609
E01031558,1572,719,853,0.4573791348600509,0.5426208651399491
E01031559,1529,754,775,0.49313276651406146,0.5068672334859385
E01031670,1564,768,796,0.49104859335038364,0.5089514066496164
E01031671,1628,822,806,0.504914004914005,0.4950859950859951
E01031673,1567,777,790,0.4958519463943842,0.5041480536056159
E01031676,2722,1351,1371,0.49632623071271126,0.5036737692872888
E01031644,1441,715,726,0.4961832061068702,0.5038167938931297
E01031645,1439,689,750,0.4788047255038221,0.5211952744961779
E01031646,1529,714,815,0.4669718770438195,0.5330281229561805
E01031647,1197,568,629,0.47451963241436923,0.5254803675856308
E01031649,1147,567,580,0.4943330427201395,0.5056669572798606
E01031650,1320,637,683,0.4825757575757576,0.5174242424242425
E01031666,1602,762,840,0.4756554307116105,0.5243445692883895
E01031668,1531,770,761,0.5029392553886349,0.4970607446113651
E01031620,1601,776,825,0.48469706433479076,0.5153029356652092
E01031648,1670,820,850,0.49101796407185627,0.5089820359281437
E01031651,1693,798,895,0.4713526284701713,0.5286473715298287
E01031658,2068,985,1083,0.4763056092843327,0.5236943907156673
E01031689,1566,779,787,0.49744572158365263,0.5025542784163474
E01031654,1597,789,808,0.4940513462742642,0.5059486537257357
E01031655,1524,760,764,0.49868766404199477,0.5013123359580053
E01031667,1565,751,814,0.47987220447284346,0.5201277955271566
E01031669,1570,756,814,0.48152866242038217,0.5184713375796178
E01031672,1730,830,900,0.4797687861271676,0.5202312138728323
E01031657,2055,990,1065,0.48175182481751827,0.5182481751824818
E01031659,1565,785,780,0.5015974440894568,0.4984025559105431
E01031674,1337,642,695,0.4801795063575168,0.5198204936424832
E01031675,1385,676,709,0.488086642599278,0.511913357400722
E01031636,2199,1035,1164,0.47066848567530695,0.529331514324693
E01031652,1767,865,902,0.48953027730616866,0.5104697226938314
E01031653,1731,847,884,0.48931253610629694,0.510687463893703
E01031656,1740,836,904,0.4804597701149425,0.5195402298850574
E01031688,1371,656,715,0.4784828592268417,0.5215171407731582
E01031691,1652,800,852,0.48426150121065376,0.5157384987893463
E01031619,1511,761,750,0.5036399735274653,0.49636002647253474
E01031637,1883,911,972,0.4838024429102496,0.5161975570897503
E01031638,1791,883,908,0.49302065884980456,0.5069793411501954
E01031690,1516,739,777,0.487467018469657,0.512532981530343
E01031639,1874,880,994,0.4695837780149413,0.5304162219850587
E01031640,1808,867,941,0.4795353982300885,0.5204646017699115
E01031660,1242,598,644,0.48148148148148145,0.5185185185185185
E01031661,1557,755,802,0.4849068721901092,0.5150931278098908
E01031679,2038,1002,1036,0.4916584887144259,0.5083415112855741
E01031677,1490,739,751,0.4959731543624161,0.5040268456375839
E01031678,1631,828,803,0.5076640098099325,0.49233599019006746
E01031680,1394,714,680,0.5121951219512195,0.4878048780487805
E01031681,1512,747,765,0.49404761904761907,0.5059523809523809
E01031682,1188,593,595,0.49915824915824913,0.5008417508417509
E01031683,1477,748,729,0.5064319566689235,0.4935680433310765
E01031611,1612,798,814,0.49503722084367247,0.5049627791563276
E01031612,2109,1047,1062,0.49644381223328593,0.5035561877667141
E01031613,2063,1044,1019,0.5060591371788657,0.49394086282113425
E01031614,2054,1006,1048,0.48977604673807207,0.5102239532619279
E01031615,1541,723,818,0.4691758598312784,0.5308241401687216
E01031632,1475,758,717,0.5138983050847458,0.48610169491525423
E01031633,1293,656,637,0.5073472544470224,0.49265274555297756
E01031634,1306,629,677,0.48162327718223585,0.5183767228177641
E01031635,1426,694,732,0.48667601683029454,0.5133239831697055
E01031621,1664,806,858,0.484375,0.515625
E01031623,1713,843,870,0.4921190893169877,0.5078809106830122
E01031627,1992,953,1039,0.4784136546184739,0.5215863453815262
E01031664,1615,807,808,0.4996904024767802,0.5003095975232198
E01031626,1490,709,781,0.47583892617449663,0.5241610738255034
E01031630,1697,791,906,0.4661166764879199,0.5338833235120801
E01031631,1559,730,829,0.46824887748556765,0.5317511225144324
E01031662,1554,726,828,0.4671814671814672,0.5328185328185329
E01031663,1773,841,932,0.47433728144388043,0.5256627185561196
E01031665,1205,601,604,0.4987551867219917,0.5012448132780083
E01031618,1339,650,689,0.4854368932038835,0.5145631067961165
E01031641,1638,720,918,0.43956043956043955,0.5604395604395604
E01031642,1849,886,963,0.4791779340183883,0.5208220659816117
E01031643,1639,774,865,0.4722391702257474,0.5277608297742525
E01031687,1668,776,892,0.46522781774580335,0.5347721822541966
E01031622,1609,808,801,0.5021752641392169,0.4978247358607831
E01031624,1517,753,764,0.4963744232036915,0.5036255767963085
E01031625,1435,735,700,0.5121951219512195,0.4878048780487805
E01031628,1470,732,738,0.49795918367346936,0.5020408163265306
E01031629,1435,668,767,0.46550522648083625,0.5344947735191637
E01031616,1600,780,820,0.4875,0.5125
E01031617,2375,1160,1215,0.4884210526315789,0.511578947368421
E01031684,1457,682,775,0.46808510638297873,0.5319148936170213
E01031685,1723,765,958,0.4439930354033662,0.5560069645966338
E01031686,1421,674,747,0.47431386347642507,0.525686136523575
E01031731,2010,963,1047,0.4791044776119403,0.5208955223880597
E01031732,1881,900,981,0.4784688995215311,0.5215311004784688
E01031733,1764,836,928,0.47392290249433106,0.5260770975056689
E01031734,1664,830,834,0.4987980769230769,0.5012019230769231
E01031741,1646,811,835,0.49270959902794653,0.5072904009720535
E01031742,1871,879,992,0.46980224478888294,0.530197755211117
E01031743,1644,833,811,0.5066909975669099,0.49330900243309
E01031718,1846,913,933,0.4945828819068256,0.5054171180931745
E01031719,1792,858,934,0.47879464285714285,0.5212053571428571
E01031720,1454,742,712,0.5103163686382394,0.4896836313617607
E01031722,1435,833,602,0.5804878048780487,0.4195121951219512
E01031695,1565,767,798,0.49009584664536743,0.5099041533546326
E01031696,1319,646,673,0.489764973464746,0.510235026535254
E01031729,1792,890,902,0.4966517857142857,0.5033482142857143
E01031730,1821,942,879,0.5172981878088962,0.4827018121911038
E01031735,1691,830,861,0.49083382613837967,0.5091661738616203
E01031736,1676,837,839,0.49940334128878283,0.5005966587112172
E01031737,1539,762,777,0.4951267056530214,0.5048732943469786
E01031738,1246,616,630,0.4943820224719101,0.5056179775280899
E01031739,1762,867,895,0.49205448354143017,0.5079455164585698
E01031740,1325,648,677,0.4890566037735849,0.510943396226415
E01031721,1502,720,782,0.4793608521970706,0.5206391478029294
E01031723,1408,723,685,0.5134943181818182,0.4865056818181818
E01031724,1386,680,706,0.4906204906204906,0.5093795093795094
E01031725,1474,715,759,0.48507462686567165,0.5149253731343284
E01031694,1936,991,945,0.5118801652892562,0.4881198347107438
E01031764,1457,722,735,0.4955387783115992,0.5044612216884008
E01031765,1604,807,797,0.5031172069825436,0.49688279301745636
E01031766,2181,1101,1080,0.5048143053645117,0.4951856946354883
E01031692,2178,1097,1081,0.5036730945821855,0.4963269054178145
E01031693,1917,951,966,0.49608763693270735,0.5039123630672926
E01031697,1239,606,633,0.4891041162227603,0.5108958837772397
E01031727,1753,856,897,0.4883057615516258,0.5116942384483743
E01031758,1392,707,685,0.5079022988505747,0.4920977011494253
E01031760,1767,843,924,0.4770797962648557,0.5229202037351444
E01031772,1663,767,896,0.4612146722790138,0.5387853277209862
E01031773,1973,943,1030,0.4779523568170299,0.5220476431829701
E01031774,1637,829,808,0.5064141722663409,0.4935858277336591
E01031775,1721,788,933,0.4578733294596165,0.5421266705403835
E01031751,2613,1322,1291,0.5059318790662074,0.4940681209337926
E01031759,1647,827,820,0.5021250758955677,0.4978749241044323
E01031761,2035,1007,1028,0.49484029484029485,0.5051597051597052
E01032837,1406,628,778,0.4466571834992888,0.5533428165007113
E01032838,1319,651,668,0.4935557240333586,0.5064442759666414
E01032839,1133,581,552,0.5127978817299206,0.4872021182700794
E01031752,1432,658,774,0.4594972067039106,0.5405027932960894
E01031753,1363,650,713,0.4768892149669846,0.5231107850330154
E01031754,1580,770,810,0.4873417721518987,0.5126582278481012
E01031755,1323,625,698,0.47241118669690096,0.527588813303099
E01031757,1520,738,782,0.4855263157894737,0.5144736842105263
E01031726,1474,693,781,0.4701492537313433,0.5298507462686567
E01031728,2029,979,1050,0.48250369640216856,0.5174963035978315
E01031749,1475,714,761,0.48406779661016947,0.5159322033898305
E01031750,1478,751,727,0.5081190798376184,0.4918809201623816
E01031756,1829,901,928,0.4926189174412247,0.5073810825587752
E01031763,1745,855,890,0.4899713467048711,0.5100286532951289
E01031699,1677,804,873,0.47942754919499103,0.5205724508050089
E01031700,1711,852,859,0.4979544126241964,0.5020455873758036
E01031701,1847,901,946,0.48781808337845156,0.5121819166215484
E01031714,1538,737,801,0.47919375812743825,0.5208062418725617
E01031704,1745,856,889,0.49054441260744985,0.5094555873925501
E01031706,1694,836,858,0.4935064935064935,0.5064935064935064
E01031711,1748,860,888,0.4919908466819222,0.5080091533180778
E01031712,1486,690,796,0.46433378196500674,0.5356662180349933
E01031713,1393,704,689,0.5053840631730079,0.4946159368269921
E01031705,1568,744,824,0.4744897959183674,0.5255102040816326
E01031707,1578,765,813,0.4847908745247148,0.5152091254752852
E01031708,1659,829,830,0.49969861362266427,0.5003013863773358
E01031709,1606,791,815,0.4925280199252802,0.5074719800747198
E01031716,1266,599,667,0.4731437598736177,0.5268562401263823
E01031717,1406,708,698,0.5035561877667141,0.49644381223328593
E01031702,1487,743,744,0.4996637525218561,0.5003362474781439
E01031703,1702,790,912,0.46415981198589895,0.535840188014101
E01031710,1431,692,739,0.4835779175401817,0.5164220824598184
E01031715,1567,785,782,0.5009572431397575,0.4990427568602425
E01031698,1668,844,824,0.5059952038369304,0.4940047961630695
E01031767,1533,735,798,0.4794520547945205,0.5205479452054794
E01031769,1783,866,917,0.485698261357263,0.514301738642737
E01031770,1666,805,861,0.4831932773109244,0.5168067226890757
E01031771,1576,790,786,0.501269035532995,0.4987309644670051
E01031744,1469,711,758,0.48400272294077606,0.5159972770592239
E01031745,1796,816,980,0.45434298440979953,0.5456570155902004
E01031746,1640,807,833,0.4920731707317073,0.5079268292682927
E01031747,1433,639,794,0.4459176552686671,0.5540823447313329
E01031748,1329,652,677,0.49059443190368696,0.509405568096313
E01031768,1526,712,814,0.46657929226736566,0.5334207077326344
E01031793,1338,645,693,0.4820627802690583,0.5179372197309418
E01031820,1701,813,888,0.47795414462081126,0.5220458553791887
E01031821,1663,800,863,0.4810583283223091,0.5189416716776909
E01031828,1317,641,676,0.486712224753227,0.5132877752467729
E01031829,1562,749,813,0.4795134443021767,0.5204865556978233
E01031822,1576,757,819,0.4803299492385787,0.5196700507614214
E01031825,1609,782,827,0.4860161591050342,0.5139838408949658
E01031826,1359,676,683,0.4974245768947756,0.5025754231052244
E01031827,1429,709,720,0.49615115465360393,0.5038488453463961
E01031839,1738,843,895,0.48504027617951667,0.5149597238204833
E01031792,1356,633,723,0.4668141592920354,0.5331858407079646
E01031794,1327,630,697,0.4747550866616428,0.5252449133383572
E01031795,1507,719,788,0.47710683477106836,0.5228931652289317
E01031818,2080,1006,1074,0.48365384615384616,0.5163461538461539
E01031830,1617,760,857,0.47000618429189855,0.5299938157081014
E01031778,1514,754,760,0.49801849405548215,0.5019815059445178
E01031797,1293,630,663,0.4872389791183295,0.5127610208816705
E01031800,1566,755,811,0.4821200510855683,0.5178799489144317
E01031823,1430,714,716,0.4993006993006993,0.5006993006993007
E01031824,1349,653,696,0.4840622683469237,0.5159377316530763
E01031776,1575,732,843,0.46476190476190476,0.5352380952380953
E01031777,1682,819,863,0.4869203329369798,0.5130796670630202
E01031780,1556,758,798,0.487146529562982,0.512853470437018
E01031781,1668,806,862,0.4832134292565947,0.5167865707434053
E01031798,1534,780,754,0.5084745762711864,0.4915254237288136
E01031783,1533,737,796,0.48075668623613826,0.5192433137638617
E01031785,1473,707,766,0.47997284453496264,0.5200271554650373
E01031786,1510,722,788,0.4781456953642384,0.5218543046357615
E01031817,1593,774,819,0.4858757062146893,0.5141242937853108
E01031819,1300,631,669,0.48538461538461536,0.5146153846153846
E01031782,1676,804,872,0.4797136038186158,0.5202863961813843
E01031784,1828,857,971,0.4688183807439825,0.5311816192560175
E01031836,1680,832,848,0.49523809523809526,0.5047619047619047
E01031838,1620,785,835,0.4845679012345679,0.5154320987654321
E01031840,1691,829,862,0.49024246008279126,0.5097575399172087
E01031791,2111,995,1116,0.47134059687351965,0.5286594031264803
E01031796,1587,760,827,0.4788909892879647,0.5211090107120353
E01031799,1585,747,838,0.47129337539432176,0.5287066246056782
E01031801,1808,894,914,0.4944690265486726,0.5055309734513275
E01031837,1917,940,977,0.4903495044340115,0.5096504955659885
E01031779,1378,665,713,0.4825834542815675,0.5174165457184325
E01031831,1680,808,872,0.48095238095238096,0.5190476190476191
E01031832,1628,774,854,0.47542997542997545,0.5245700245700246
E01031833,1645,787,858,0.478419452887538,0.521580547112462
E01031834,1599,772,827,0.482801751094434,0.517198248905566
E01031790,1822,822,1000,0.45115257958287597,0.5488474204171241
E01031807,1723,797,926,0.4625652930934417,0.5374347069065584
E01031809,1531,765,766,0.4996734160679295,0.5003265839320705
E01031810,1586,775,811,0.48865069356872637,0.5113493064312736
E01031811,1485,701,784,0.47205387205387206,0.5279461279461279
E01031787,1893,957,936,0.5055467511885895,0.49445324881141045
E01031788,2109,1034,1075,0.4902797534376482,0.5097202465623518
E01031789,1955,974,981,0.49820971867007674,0.5017902813299233
E01031808,1534,773,761,0.5039113428943938,0.49608865710560623
E01031835,1825,906,919,0.4964383561643836,0.5035616438356164
E01031812,1559,720,839,0.46183450930083386,0.5381654906991661
E01031813,1795,845,950,0.47075208913649025,0.5292479108635098
E01031814,1501,736,765,0.49033977348434377,0.5096602265156562
E01031815,1534,716,818,0.4667535853976532,0.5332464146023468
E01031816,1610,766,844,0.47577639751552797,0.5242236024844721
E01031802,1556,711,845,0.4569408740359897,0.5430591259640103
E01031803,1507,716,791,0.4751161247511613,0.5248838752488387
E01031804,1653,793,860,0.47973381730187536,0.5202661826981246
E01031805,1610,722,888,0.4484472049689441,0.5515527950310559
E01031806,1664,771,893,0.46334134615384615,0.5366586538461539
E01014399,1624,789,835,0.4858374384236453,0.5141625615763546
E01014400,1944,933,1011,0.4799382716049383,0.5200617283950617
E01014401,1645,784,861,0.4765957446808511,0.5234042553191489
E01014402,1684,804,880,0.47743467933491684,0.5225653206650831
E01014403,1671,749,922,0.44823459006582883,0.5517654099341711
E01014404,1669,769,900,0.46075494307968845,0.5392450569203115
E01014395,1235,612,623,0.49554655870445347,0.5044534412955466
E01014396,1434,669,765,0.4665271966527197,0.5334728033472803
E01014397,1312,656,656,0.5,0.5
E01014398,1423,708,715,0.49754040758959944,0.5024595924104006
E01014409,1590,738,852,0.4641509433962264,0.5358490566037736
E01014410,1770,865,905,0.4887005649717514,0.5112994350282486
E01014411,2109,1025,1084,0.48601232811759126,0.5139876718824087
E01014477,1454,691,763,0.4752407152682256,0.5247592847317745
E01014478,1189,561,628,0.471825063078217,0.528174936921783
E01014479,1420,664,756,0.4676056338028169,0.532394366197183
E01014480,1261,625,636,0.4956383822363204,0.5043616177636796
E01014465,1517,722,795,0.4759393539881345,0.5240606460118655
E01014466,1263,653,610,0.5170229612034838,0.4829770387965162
E01014467,1620,851,769,0.5253086419753087,0.47469135802469137
E01014468,1520,797,723,0.5243421052631579,0.4756578947368421
E01014370,1800,924,876,0.5133333333333333,0.4866666666666667
E01014371,1866,942,924,0.5048231511254019,0.49517684887459806
E01014372,2004,1037,967,0.5174650698602794,0.48253493013972054
E01014412,1462,709,753,0.4849521203830369,0.5150478796169631
E01014413,1598,729,869,0.45619524405506884,0.5438047559449312
E01014414,1529,770,759,0.5035971223021583,0.49640287769784175
E01014427,1351,661,690,0.48926720947446334,0.5107327905255367
E01014428,1432,690,742,0.4818435754189944,0.5181564245810056
E01014429,1614,771,843,0.47769516728624534,0.5223048327137546
E01014430,1541,674,867,0.4373783257624919,0.5626216742375081
E01014405,2076,997,1079,0.4802504816955684,0.5197495183044316
E01014407,1235,626,609,0.5068825910931174,0.4931174089068826
E01033080,2205,1149,1056,0.5210884353741496,0.47891156462585033
E01014373,1545,751,794,0.486084142394822,0.513915857605178
E01014374,1441,682,759,0.4732824427480916,0.5267175572519084
E01014375,1254,610,644,0.4864433811802233,0.5135566188197768
E01014376,1499,724,775,0.4829886591060707,0.5170113408939293
E01014377,1408,685,723,0.4865056818181818,0.5134943181818182
E01033078,1888,943,945,0.4994703389830508,0.5005296610169492
E01033079,1164,561,603,0.48195876288659795,0.5180412371134021
E01014461,1174,578,596,0.49233390119250425,0.5076660988074957
E01014462,1476,702,774,0.47560975609756095,0.524390243902439
E01014463,1384,681,703,0.4920520231213873,0.5079479768786127
E01014464,1281,613,668,0.4785323965651834,0.5214676034348166
E01014380,3383,1714,1669,0.5066509015666568,0.4933490984333432
E01014381,1480,698,782,0.47162162162162163,0.5283783783783784
E01014481,1445,722,723,0.4996539792387543,0.5003460207612457
E01014482,1278,666,612,0.5211267605633803,0.4788732394366197
E01014483,1477,724,753,0.4901828029790115,0.5098171970209885
E01014484,1570,754,816,0.4802547770700637,0.5197452229299363
E01014473,1672,831,841,0.49700956937799046,0.5029904306220095
E01014474,1183,577,606,0.48774302620456467,0.5122569737954353
E01014475,2175,1011,1164,0.46482758620689657,0.5351724137931034
E01014476,1439,712,727,0.4947880472550382,0.5052119527449618
E01014435,1593,809,784,0.5078468298807282,0.4921531701192718
E01014436,1584,770,814,0.4861111111111111,0.5138888888888888
E01014437,1425,687,738,0.48210526315789476,0.5178947368421053
E01014438,1280,658,622,0.5140625,0.4859375
E01014455,1317,675,642,0.5125284738041003,0.4874715261958998
E01014456,1503,717,786,0.47704590818363274,0.5229540918163673
E01014457,1320,648,672,0.4909090909090909,0.509090909090909
E01014458,1389,659,730,0.4744420446364291,0.5255579553635709
E01014391,1432,722,710,0.5041899441340782,0.4958100558659218
E01014392,1073,521,552,0.48555452003727867,0.5144454799627214
E01014452,1471,721,750,0.49014276002719237,0.5098572399728076
E01014453,1262,611,651,0.48415213946117275,0.5158478605388273
E01014454,1340,663,677,0.49477611940298505,0.505223880597015
E01014459,1456,737,719,0.5061813186813187,0.49381868131868134
E01014460,1168,549,619,0.4700342465753425,0.5299657534246576
E01014415,2001,999,1002,0.4992503748125937,0.5007496251874063
E01014416,1714,795,919,0.46382730455075843,0.5361726954492415
E01014417,1790,909,881,0.5078212290502794,0.4921787709497207
E01014387,1232,597,635,0.48457792207792205,0.515422077922078
E01014388,1305,620,685,0.47509578544061304,0.524904214559387
E01014389,1361,665,696,0.4886113152094049,0.5113886847905952
E01014390,1521,700,821,0.46022353714661407,0.539776462853386
E01014431,1225,612,613,0.4995918367346939,0.5004081632653061
E01014432,1277,638,639,0.49960845732184805,0.5003915426781519
E01014433,1358,635,723,0.46759941089838,0.53240058910162
E01014434,1821,888,933,0.4876441515650741,0.5123558484349259
E01014385,1380,667,713,0.48333333333333334,0.5166666666666667
E01014386,1157,587,570,0.5073465859982714,0.49265341400172863
E01014419,1292,644,648,0.4984520123839009,0.5015479876160991
E01014446,1119,553,566,0.4941912421805183,0.5058087578194816
E01014447,1354,633,721,0.4675036927621861,0.5324963072378139
E01014382,2386,1182,1204,0.4953897736797988,0.5046102263202011
E01014383,1016,484,532,0.4763779527559055,0.5236220472440944
E01014384,1361,659,702,0.4842027920646583,0.5157972079353417
E01014418,1391,681,710,0.4895758447160316,0.5104241552839683
E01014379,2435,1161,1274,0.4767967145790554,0.5232032854209445
E01014442,1727,844,883,0.48870874348581356,0.5112912565141865
E01014443,1575,784,791,0.49777777777777776,0.5022222222222222
E01014444,1523,760,763,0.4990151017728168,0.5009848982271832
E01014445,1621,802,819,0.4947563232572486,0.5052436767427514
E01014393,1350,642,708,0.47555555555555556,0.5244444444444445
E01014394,1655,836,819,0.5051359516616314,0.49486404833836856
E01014439,1789,839,950,0.4689770821688094,0.5310229178311906
E01014440,1897,974,923,0.5134422772799156,0.48655772272008435
E01014441,1616,782,834,0.4839108910891089,0.5160891089108911
E01014448,1577,788,789,0.49968294229549776,0.5003170577045022
E01014449,1468,705,763,0.48024523160762944,0.5197547683923706
E01014450,1316,642,674,0.4878419452887538,0.5121580547112462
E01014451,1259,625,634,0.4964257347100874,0.5035742652899127
E01014420,1571,770,801,0.49013367281986,0.50986632718014
E01014421,1423,697,726,0.4898102600140548,0.5101897399859452
E01014422,1509,746,763,0.4943671305500331,0.5056328694499669
E01014423,1372,673,699,0.4905247813411079,0.5094752186588921
E01014469,1266,641,625,0.5063191153238547,0.49368088467614535
E01014470,1620,781,839,0.4820987654320988,0.5179012345679013
E01014471,1550,776,774,0.5006451612903225,0.4993548387096774
E01014472,1418,697,721,0.4915373765867419,0.5084626234132581
E01014424,1691,843,848,0.498521584861029,0.5014784151389711
E01014425,1991,973,1018,0.4886991461577097,0.5113008538422903
E01014426,1440,713,727,0.4951388888888889,0.5048611111111111
E01015301,1483,727,756,0.49022252191503707,0.5097774780849629
E01015303,1520,783,737,0.5151315789473684,0.48486842105263156
E01015305,1554,747,807,0.4806949806949807,0.5193050193050193
E01015306,1670,819,851,0.49041916167664673,0.5095808383233533
E01015302,1850,880,970,0.4756756756756757,0.5243243243243243
E01015304,1711,817,894,0.4774985388661601,0.5225014611338399
E01015308,1707,817,890,0.4786174575278266,0.5213825424721734
E01015311,1340,655,685,0.48880597014925375,0.5111940298507462
E01015332,1524,733,791,0.4809711286089239,0.5190288713910761
E01015333,1581,758,823,0.4794433902593295,0.5205566097406704
E01015334,1611,738,873,0.4581005586592179,0.5418994413407822
E01015335,1683,826,857,0.49079025549613786,0.5092097445038621
E01015337,1697,837,860,0.493223335297584,0.506776664702416
E01015343,1551,740,811,0.4771115409413282,0.5228884590586719
E01015349,1514,699,815,0.4616908850726552,0.5383091149273448
E01015351,1509,736,773,0.487740225314778,0.512259774685222
E01015352,1529,728,801,0.4761281883584042,0.5238718116415958
E01015353,1150,544,606,0.47304347826086957,0.5269565217391304
E01015354,1729,831,898,0.48062463851937537,0.5193753614806247
E01015307,1393,664,729,0.4766690595836324,0.5233309404163675
E01015309,1450,676,774,0.46620689655172415,0.5337931034482759
E01015312,1241,573,668,0.46172441579371476,0.5382755842062853
E01015313,1369,670,699,0.48940832724616506,0.5105916727538349
E01015359,1566,780,786,0.49808429118773945,0.5019157088122606
E01015320,1686,827,859,0.4905100830367734,0.5094899169632265
E01015323,1585,787,798,0.4965299684542587,0.5034700315457413
E01015324,1549,767,782,0.49515816655907036,0.5048418334409296
E01015325,1706,813,893,0.4765533411488863,0.5234466588511137
E01015350,1451,718,733,0.4948311509303928,0.5051688490696071
E01015310,1536,750,786,0.48828125,0.51171875
E01015336,1601,797,804,0.4978138663335415,0.5021861336664585
E01015355,1689,847,842,0.5014801657785672,0.4985198342214328
E01015357,1561,754,807,0.48302370275464446,0.5169762972453555
E01015358,1955,946,1009,0.48388746803069055,0.5161125319693095
E01015338,1815,847,968,0.4666666666666667,0.5333333333333333
E01015339,1587,787,800,0.4959042218021424,0.5040957781978576
E01015340,1577,759,818,0.48129359543436906,0.518706404565631
E01015341,1490,705,785,0.47315436241610737,0.5268456375838926
E01015321,1861,944,917,0.5072541644277271,0.49274583557227297
E01015356,1766,854,912,0.48357870894677235,0.5164212910532276
E01015374,2310,1137,1173,0.4922077922077922,0.5077922077922078
E01015375,1907,916,991,0.48033560566334554,0.5196643943366545
E01015377,1637,786,851,0.48014660965180206,0.5198533903481979
E01015322,1660,829,831,0.49939759036144576,0.5006024096385542
E01015330,1820,862,958,0.4736263736263736,0.5263736263736264
E01015342,1577,751,826,0.47622067216233355,0.5237793278376665
E01015373,1704,864,840,0.5070422535211268,0.49295774647887325
E01015378,1735,865,870,0.49855907780979825,0.5014409221902018
E01015314,1527,753,774,0.4931237721021611,0.5068762278978389
E01015315,1932,961,971,0.4974120082815735,0.5025879917184265
E01015318,1664,805,859,0.48377403846153844,0.5162259615384616
E01015319,1438,661,777,0.45966620305980527,0.5403337969401947
E01015344,1787,846,941,0.47341913822048126,0.5265808617795188
E01015346,1665,857,808,0.5147147147147147,0.4852852852852853
E01015348,1830,886,944,0.48415300546448087,0.5158469945355191
E01015360,1787,838,949,0.4689423614997202,0.5310576385002798
E01015326,1924,993,931,0.5161122661122661,0.4838877338877339
E01015331,2315,1213,1102,0.5239740820734341,0.4760259179265659
E01015345,1899,1020,879,0.5371248025276462,0.4628751974723539
E01015376,1773,893,880,0.5036661026508742,0.49633389734912575
E01015316,1591,772,819,0.4852294154619736,0.5147705845380264
E01015317,1574,764,810,0.48538754764930114,0.5146124523506989
E01015361,1415,697,718,0.4925795053003534,0.5074204946996467
E01015362,1249,600,649,0.4803843074459568,0.5196156925540433
E01015363,1695,831,864,0.4902654867256637,0.5097345132743363
E01015292,1696,881,815,0.5194575471698113,0.4805424528301887
E01015293,1530,762,768,0.4980392156862745,0.5019607843137255
E01015294,1949,1022,927,0.5243714725500257,0.47562852744997436
E01015327,1964,989,975,0.5035641547861507,0.4964358452138493
E01015329,1660,904,756,0.5445783132530121,0.45542168674698796
E01015272,1722,825,897,0.47909407665505227,0.5209059233449478
E01015273,1964,1003,961,0.5106924643584522,0.4893075356415479
E01015275,1780,939,841,0.5275280898876404,0.47247191011235956
E01015276,1700,826,874,0.4858823529411765,0.5141176470588236
E01015277,1944,993,951,0.5108024691358025,0.48919753086419754
E01015283,1871,1013,858,0.5414216996258685,0.4585783003741315
E01015286,1910,955,955,0.5,0.5
E01015287,2229,1131,1098,0.5074024226110363,0.49259757738896365
E01015328,1850,955,895,0.5162162162162162,0.4837837837837838
E01033242,1010,561,449,0.5554455445544555,0.44455445544554456
E01033285,1080,617,463,0.5712962962962963,0.4287037037037037
E01015274,1766,869,897,0.4920724801812005,0.5079275198187996
E01015297,1491,656,835,0.4399731723675386,0.5600268276324615
E01015364,1600,786,814,0.49125,0.50875
E01015365,1708,879,829,0.5146370023419203,0.4853629976580796
E01015366,1807,851,956,0.47094631986718316,0.5290536801328168
E01015279,1841,960,881,0.5214557305812059,0.47854426941879413
E01015280,1983,1068,915,0.5385779122541604,0.46142208774583965
E01015281,1723,917,806,0.5322112594312246,0.4677887405687754
E01015282,1973,1195,778,0.6056766345666498,0.3943233654333502
E01033241,1112,600,512,0.539568345323741,0.460431654676259
E01033283,1211,608,603,0.5020644095788604,0.49793559042113955
E01015295,1444,685,759,0.4743767313019391,0.525623268698061
E01015296,1726,827,899,0.47914252607184243,0.5208574739281576
E01015298,1555,715,840,0.45980707395498394,0.5401929260450161
E01015299,1700,803,897,0.4723529411764706,0.5276470588235294
E01015300,1570,733,837,0.46687898089171975,0.5331210191082802
E01015285,2671,1439,1232,0.5387495320104829,0.461250467989517
E01015288,1877,999,878,0.5322322855620671,0.46776771443793286
E01015289,1871,1013,858,0.5414216996258685,0.4585783003741315
E01015290,1826,1030,796,0.5640744797371303,0.4359255202628697
E01015291,1939,996,943,0.5136668385765859,0.48633316142341415
E01015371,1534,815,719,0.5312907431551499,0.46870925684485004
E01015372,1824,831,993,0.4555921052631579,0.5444078947368421
E01033286,1066,544,522,0.5103189493433395,0.4896810506566604
E01033288,1045,527,518,0.5043062200956938,0.49569377990430624
E01015367,2021,1129,892,0.5586343394359228,0.44136566056407717
E01015368,1680,807,873,0.48035714285714287,0.5196428571428572
E01015369,1668,824,844,0.4940047961630695,0.5059952038369304
E01015370,1638,824,814,0.503052503052503,0.49694749694749696
E01014601,1662,780,882,0.4693140794223827,0.5306859205776173
E01014602,1841,883,958,0.4796306355241716,0.5203693644758284
E01014603,2134,994,1140,0.46579194001874413,0.5342080599812559
E01014605,1615,765,850,0.47368421052631576,0.5263157894736842
E01032516,1881,877,1004,0.46624136097820307,0.5337586390217969
E01032517,1566,736,830,0.46998722860791825,0.5300127713920817
E01014688,1716,796,920,0.46386946386946387,0.5361305361305362
E01014689,1604,791,813,0.493142144638404,0.506857855361596
E01014690,2025,999,1026,0.49333333333333335,0.5066666666666667
E01014691,1939,871,1068,0.4492006188757091,0.5507993811242908
E01014692,1664,819,845,0.4921875,0.5078125
E01014693,1372,670,702,0.48833819241982507,0.5116618075801749
E01014694,1636,831,805,0.5079462102689487,0.49205378973105135
E01014497,1563,783,780,0.5009596928982726,0.4990403071017274
E01014498,1583,755,828,0.47694251421351863,0.5230574857864814
E01014638,1624,755,869,0.4649014778325123,0.5350985221674877
E01014639,1494,682,812,0.4564926372155288,0.5435073627844712
E01014640,1491,749,742,0.5023474178403756,0.49765258215962443
E01014631,1187,586,601,0.493681550126369,0.506318449873631
E01014632,1543,774,769,0.5016202203499676,0.4983797796500324
E01014633,1575,775,800,0.49206349206349204,0.5079365079365079
E01014636,1496,688,808,0.45989304812834225,0.5401069518716578
E01014630,2091,1028,1063,0.4916307986609278,0.5083692013390723
E01014634,1699,930,769,0.5473808122424956,0.4526191877575044
E01014659,2075,1021,1054,0.49204819277108436,0.5079518072289156
E01014661,1664,817,847,0.4909855769230769,0.5090144230769231
E01014616,1521,730,791,0.4799474030243261,0.5200525969756739
E01014719,1366,674,692,0.493411420204978,0.5065885797950219
E01014720,1598,749,849,0.46871088861076343,0.5312891113892365
E01014721,1557,701,856,0.45022479126525367,0.5497752087347463
E01014641,1403,676,727,0.48182466143977193,0.5181753385602281
E01014642,1449,708,741,0.4886128364389234,0.5113871635610766
E01014643,1364,646,718,0.4736070381231672,0.5263929618768328
E01014644,1512,739,773,0.4887566137566138,0.5112433862433863
E01014492,1478,691,787,0.4675236806495264,0.5324763193504736
E01014493,1488,718,770,0.4825268817204301,0.5174731182795699
E01014494,1473,742,731,0.5037338764426341,0.49626612355736593
E01014495,1661,795,866,0.4786273329319687,0.5213726670680313
E01014496,1628,844,784,0.5184275184275184,0.48157248157248156
E01014499,1611,760,851,0.4717566728739913,0.5282433271260087
E01014715,1611,801,810,0.4972067039106145,0.5027932960893855
E01014716,1527,729,798,0.4774066797642436,0.5225933202357563
E01014717,1700,660,1040,0.38823529411764707,0.611764705882353
E01014718,1395,680,715,0.4874551971326165,0.5125448028673835
E01014510,1960,1013,947,0.5168367346938776,0.48316326530612247
E01014635,1865,988,877,0.5297587131367292,0.47024128686327077
E01014637,1371,711,660,0.5185995623632386,0.4814004376367615
E01014662,1575,806,769,0.5117460317460317,0.4882539682539683
E01014615,1525,749,776,0.4911475409836066,0.5088524590163934
E01014617,1339,646,693,0.48244958924570575,0.5175504107542942
E01014618,1547,719,828,0.464770523594053,0.535229476405947
E01014620,1456,693,763,0.47596153846153844,0.5240384615384616
E01014571,1589,761,828,0.4789175582127124,0.5210824417872876
E01014577,1525,772,753,0.5062295081967213,0.4937704918032787
E01014586,1486,688,798,0.4629878869448183,0.5370121130551817
E01014587,1371,688,683,0.5018234865061999,0.49817651349380015
E01014588,2137,1040,1097,0.4866635470285447,0.5133364529714554
E01014589,1419,659,760,0.46441155743481327,0.5355884425651868
E01014590,1813,899,914,0.4958632101489244,0.5041367898510756
E01014591,1780,841,939,0.47247191011235956,0.5275280898876404
E01014592,1610,784,826,0.48695652173913045,0.5130434782608696
E01014660,1572,766,806,0.4872773536895674,0.5127226463104325
E01014663,1438,727,711,0.5055632823365785,0.4944367176634214
E01014664,1654,853,801,0.5157194679564692,0.48428053204353083
E01014665,2102,1062,1040,0.50523311132255,0.49476688867745006
E01014709,1161,564,597,0.48578811369509045,0.5142118863049095
E01014710,1368,704,664,0.5146198830409356,0.4853801169590643
E01014711,1217,567,650,0.4658997534921939,0.5341002465078061
E01014712,1273,590,683,0.4634721131186174,0.5365278868813825
E01014713,1270,613,657,0.4826771653543307,0.5173228346456693
E01014714,2980,1483,1497,0.4976510067114094,0.5023489932885906
E01014507,1664,805,859,0.48377403846153844,0.5162259615384616
E01014508,1722,1027,695,0.5963995354239257,0.40360046457607435
E01014509,2061,1052,1009,0.5104318292091218,0.4895681707908782
E01014511,1468,709,759,0.4829700272479564,0.5170299727520435
E01014512,1505,740,765,0.49169435215946844,0.5083056478405316
E01014513,1591,759,832,0.47705845380263984,0.5229415461973601
E01014514,1900,940,960,0.49473684210526314,0.5052631578947369
E01014619,1545,787,758,0.5093851132686085,0.4906148867313916
E01014621,1469,719,750,0.48944860449285227,0.5105513955071477
E01014666,1824,912,912,0.5,0.5
E01014667,1637,826,811,0.5045815516188149,0.4954184483811851
E01014672,2049,1064,985,0.5192776964372865,0.4807223035627135
E01014624,1738,828,910,0.476409666283084,0.523590333716916
E01014629,1477,706,771,0.4779959377115775,0.5220040622884224
E01032518,1848,878,970,0.4751082251082251,0.5248917748917749
E01032519,1159,569,590,0.4909404659188956,0.5090595340811044
E01014572,1857,952,905,0.5126548196015078,0.4873451803984922
E01014573,1837,922,915,0.5019052803483941,0.4980947196516059
E01014575,1562,805,757,0.5153649167733675,0.4846350832266325
E01014576,1920,945,975,0.4921875,0.5078125
E01014487,2000,1070,930,0.535,0.465
E01014491,1962,997,965,0.5081549439347605,0.49184505606523954
E01014668,1638,821,817,0.5012210012210012,0.4987789987789988
E01014669,1505,764,741,0.507641196013289,0.49235880398671095
E01014670,1513,788,725,0.5208195637805684,0.47918043621943157
E01014671,1635,857,778,0.5241590214067279,0.4758409785932722
E01014622,1530,758,772,0.4954248366013072,0.5045751633986928
E01014623,1631,822,809,0.5039852851011649,0.4960147148988351
E01014626,1976,946,1030,0.47874493927125505,0.521255060728745
E01014627,2145,1066,1079,0.49696969696969695,0.503030303030303
E01014557,1635,812,823,0.4966360856269113,0.5033639143730887
E01014558,1875,1005,870,0.536,0.464
E01014559,1982,1075,907,0.5423814328960646,0.4576185671039354
E01014560,1669,841,828,0.5038945476333133,0.49610545236668663
E01014562,1838,930,908,0.5059847660500544,0.4940152339499456
E01014485,1817,874,943,0.4810126582278481,0.5189873417721519
E01014486,2317,1188,1129,0.5127319810099267,0.4872680189900734
E01014488,1993,1022,971,0.5127947817360763,0.4872052182639237
E01014489,2403,1279,1124,0.5322513524760716,0.4677486475239284
E01033347,1122,644,478,0.5739750445632799,0.42602495543672014
E01033348,1104,587,517,0.5317028985507246,0.4682971014492754
E01033366,1507,749,758,0.49701393497013935,0.5029860650298607
E01014539,1834,944,890,0.514721919302072,0.48527808069792805
E01014561,1741,887,854,0.5094773118897186,0.49052268811028144
E01014563,1814,912,902,0.5027563395810364,0.4972436604189636
E01033342,1881,1052,829,0.5592769803296119,0.44072301967038807
E01033367,1287,741,546,0.5757575757575758,0.42424242424242425
E01014551,1781,860,921,0.48287478944413254,0.5171252105558675
E01014552,1826,1003,823,0.5492880613362541,0.45071193866374587
E01014553,1718,894,824,0.5203725261932479,0.479627473806752
E01014554,1697,883,814,0.5203299941072481,0.47967000589275194
E01014556,1712,883,829,0.5157710280373832,0.4842289719626168
E01014673,1743,862,881,0.4945496270797476,0.5054503729202524
E01014674,1572,774,798,0.49236641221374045,0.5076335877862596
E01014675,1509,750,759,0.4970178926441352,0.5029821073558648
E01014676,1535,746,789,0.4859934853420195,0.5140065146579804
E01014682,1576,753,823,0.47779187817258884,0.5222081218274112
E01014683,1677,868,809,0.5175909361955874,0.4824090638044126
E01014685,1582,766,816,0.48419721871049304,0.515802781289507
E01014686,1630,746,884,0.45766871165644174,0.5423312883435583
E01014687,1580,770,810,0.4873417721518987,0.5126582278481012
E01014565,1697,849,848,0.5002946375957572,0.4997053624042428
E01014566,1669,848,821,0.5080886758538047,0.4919113241461953
E01014567,1909,1010,899,0.5290728129910948,0.4709271870089052
E01014681,2142,1048,1094,0.4892623716153128,0.5107376283846872
E01014684,1708,880,828,0.5152224824355972,0.4847775175644028
E01014544,1524,806,718,0.5288713910761155,0.47112860892388453
E01014545,1575,829,746,0.5263492063492063,0.47365079365079366
E01014546,1449,763,686,0.5265700483091788,0.47342995169082125
E01014547,1646,850,796,0.5164034021871203,0.4835965978128797
E01014538,1940,1006,934,0.5185567010309279,0.4814432989690722
E01014540,2676,1480,1196,0.5530642750373692,0.4469357249626308
E01014542,2316,1243,1073,0.5367012089810017,0.4632987910189983
E01033344,1627,818,809,0.5027658266748617,0.4972341733251383
E01033345,1344,690,654,0.5133928571428571,0.48660714285714285
E01033350,1035,598,437,0.5777777777777777,0.4222222222222222
E01014677,1413,739,674,0.5230007077140835,0.4769992922859165
E01014678,1558,766,792,0.49165596919127086,0.5083440308087291
E01014679,1540,730,810,0.474025974025974,0.525974025974026
E01014680,1287,636,651,0.49417249417249415,0.5058275058275058
E01014548,1690,899,791,0.5319526627218935,0.4680473372781065
E01014549,1191,646,545,0.5424013434089001,0.45759865659109994
E01014550,2162,1109,1053,0.5129509713228492,0.4870490286771508
E01014555,1847,981,866,0.5311315646995127,0.4688684353004873
E01014528,1497,747,750,0.49899799599198397,0.501002004008016
E01014529,1431,659,772,0.4605171208944794,0.5394828791055206
E01014530,1384,696,688,0.5028901734104047,0.49710982658959535
E01014531,1661,846,815,0.5093317278747742,0.4906682721252258
E01014532,1468,706,762,0.48092643051771117,0.5190735694822888
E01014537,1773,870,903,0.4906937394247039,0.5093062605752962
E01014695,1711,848,863,0.49561659848042083,0.5043834015195792
E01014696,1696,843,853,0.4970518867924528,0.5029481132075472
E01014698,1839,963,876,0.5236541598694943,0.4763458401305057
E01014699,1542,761,781,0.49351491569390404,0.506485084306096
E01014700,1559,766,793,0.4913406029506094,0.5086593970493907
E01014701,1690,899,791,0.5319526627218935,0.4680473372781065
E01014730,1613,837,776,0.5189088654680719,0.4810911345319281
E01014731,1526,753,773,0.49344692005242463,0.5065530799475754
E01014732,1697,878,819,0.5173836181496759,0.4826163818503241
E01014735,1680,867,813,0.5160714285714286,0.48392857142857143
E01014523,1351,690,661,0.5107327905255367,0.48926720947446334
E01014524,1474,733,741,0.4972862957937585,0.5027137042062415
E01014525,1586,761,825,0.4798234552332913,0.5201765447667087
E01014526,1517,763,754,0.5029663810151616,0.4970336189848385
E01014527,1344,692,652,0.5148809523809523,0.4851190476190476
E01014500,1559,754,805,0.4836433611289288,0.5163566388710712
E01014502,1716,860,856,0.5011655011655012,0.4988344988344988
E01033359,1242,695,547,0.5595813204508857,0.44041867954911434
E01033361,1264,684,580,0.5411392405063291,0.4588607594936709
E01033362,1114,560,554,0.5026929982046678,0.49730700179533216
E01033364,1557,791,766,0.5080282594733462,0.4919717405266538
E01014729,1435,683,752,0.4759581881533101,0.5240418118466899
E01014733,1728,889,839,0.5144675925925926,0.4855324074074074
E01014734,1578,781,797,0.49493029150823825,0.5050697084917617
E01014736,1923,926,997,0.48153926157046284,0.5184607384295372
E01014501,1684,808,876,0.47980997624703087,0.5201900237529691
E01014504,1499,732,767,0.4883255503669113,0.5116744496330887
E01014505,1740,838,902,0.48160919540229885,0.5183908045977011
E01014506,1579,744,835,0.47118429385687144,0.5288157061431286
E01014645,1565,755,810,0.48242811501597443,0.5175718849840255
E01014646,1573,774,799,0.49205340114431023,0.5079465988556897
E01014648,1648,850,798,0.5157766990291263,0.4842233009708738
E01014649,1649,801,848,0.48574893875075803,0.5142510612492419
E01014651,1631,838,793,0.5137952176578786,0.4862047823421214
E01014533,1469,778,691,0.5296119809394145,0.4703880190605854
E01014534,1619,827,792,0.5108091414453366,0.4891908585546634
E01014535,1928,933,995,0.48392116182572614,0.5160788381742739
E01014536,1437,710,727,0.4940848990953375,0.5059151009046625
E01014578,1679,778,901,0.46337105419892793,0.5366289458010721
E01014583,1440,667,773,0.46319444444444446,0.5368055555555555
E01014585,1932,888,1044,0.45962732919254656,0.5403726708074534
E01014647,1685,827,858,0.4908011869436202,0.5091988130563798
E01014650,1564,763,801,0.48785166240409206,0.5121483375959079
E01014579,1404,673,731,0.4793447293447293,0.5206552706552706
E01014580,1490,676,814,0.45369127516778524,0.5463087248322148
E01014581,1529,737,792,0.48201438848920863,0.5179856115107914
E01014582,1400,694,706,0.4957142857142857,0.5042857142857143
E01014584,1393,649,744,0.46590093323761667,0.5340990667623834
E01014518,1651,829,822,0.5021199273167777,0.49788007268322226
E01014519,1312,621,691,0.4733231707317073,0.5266768292682927
E01014520,1527,763,764,0.4996725605762934,0.5003274394237066
E01014521,1332,637,695,0.47822822822822825,0.5217717717717718
E01014607,1361,645,716,0.4739162380602498,0.5260837619397501
E01014608,1692,810,882,0.4787234042553192,0.5212765957446809
E01014609,1777,852,925,0.47945976364659537,0.5205402363534046
E01014610,1423,665,758,0.46732255797610683,0.5326774420238932
E01014613,1483,732,751,0.4935940660822657,0.5064059339177344
E01014614,1251,615,636,0.49160671462829736,0.5083932853717026
E01014594,1506,670,836,0.4448871181938911,0.5551128818061088
E01014598,1465,731,734,0.49897610921501706,0.5010238907849829
E01014599,1280,637,643,0.49765625,0.50234375
E01014600,1387,658,729,0.47440519105984136,0.5255948089401586
E01014702,1433,701,732,0.4891835310537334,0.5108164689462665
E01014703,1420,671,749,0.4725352112676056,0.5274647887323943
E01014704,1889,898,991,0.4753838009528851,0.5246161990471149
E01014705,1401,663,738,0.4732334047109208,0.5267665952890792
E01014706,1248,584,664,0.46794871794871795,0.532051282051282
E01014707,1591,783,808,0.49214330609679446,0.5078566939032055
E01014708,1820,894,926,0.4912087912087912,0.5087912087912088
E01014515,1488,682,806,0.4583333333333333,0.5416666666666666
E01014516,1407,648,759,0.4605543710021322,0.5394456289978679
E01014517,1209,574,635,0.4747725392886683,0.5252274607113316
E01014522,1650,743,907,0.4503030303030303,0.5496969696969697
E01014593,1515,703,812,0.464026402640264,0.5359735973597359
E01014595,1417,695,722,0.49047282992237123,0.5095271700776288
E01014596,1584,747,837,0.4715909090909091,0.5284090909090909
E01014597,1320,663,657,0.5022727272727273,0.49772727272727274
E01014611,1285,658,627,0.5120622568093385,0.48793774319066147
E01014612,1451,705,746,0.48587181254307377,0.5141281874569262
E01014722,1492,756,736,0.5067024128686327,0.4932975871313673
E01014723,1344,663,681,0.49330357142857145,0.5066964285714286
E01014725,1468,738,730,0.502724795640327,0.49727520435967304
E01014726,1650,805,845,0.48787878787878786,0.5121212121212121
E01014727,1539,704,835,0.45743989603638724,0.5425601039636128
E01032514,1970,894,1076,0.45380710659898477,0.5461928934010152
E01032515,1376,665,711,0.48328488372093026,0.5167151162790697
E01033352,1253,744,509,0.5937749401436552,0.4062250598563448
E01033353,1129,626,503,0.5544729849424269,0.4455270150575731
E01033355,1075,633,442,0.5888372093023255,0.4111627906976744
E01033358,2052,1059,993,0.5160818713450293,0.48391812865497075
E01033370,1125,634,491,0.5635555555555556,0.43644444444444447
E01014564,1863,913,950,0.4900697799248524,0.5099302200751477
E01014653,2596,1396,1200,0.5377503852080123,0.4622496147919877
E01014655,2365,1230,1135,0.5200845665961945,0.4799154334038055
E01014654,2323,1199,1124,0.5161429186396901,0.48385708136030997
E01014658,2177,1085,1092,0.4983922829581994,0.5016077170418006
E01033356,1419,729,690,0.5137420718816068,0.48625792811839325
E01033369,1428,725,703,0.507703081232493,0.49229691876750703
E01014568,2431,1217,1214,0.5006170300287948,0.4993829699712053
E01014569,2148,1046,1102,0.48696461824953446,0.5130353817504656
E01014570,1824,913,911,0.5005482456140351,0.4994517543859649
E01014574,2165,1137,1028,0.5251732101616629,0.4748267898383372
E01018753,1608,768,840,0.47761194029850745,0.5223880597014925
E01018754,1543,748,795,0.4847699287103046,0.5152300712896954
E01018755,1490,735,755,0.49328859060402686,0.5067114093959731
E01018756,1612,772,840,0.47890818858560796,0.5210918114143921
E01018777,2015,1032,983,0.5121588089330025,0.4878411910669975
E01018782,1476,702,774,0.47560975609756095,0.524390243902439
E01018783,1536,776,760,0.5052083333333334,0.4947916666666667
E01018784,1454,703,751,0.48349381017881704,0.5165061898211829
E01018750,2265,1126,1139,0.4971302428256071,0.502869757174393
E01018751,1505,761,744,0.5056478405315614,0.4943521594684385
E01018752,2016,979,1037,0.48561507936507936,0.5143849206349206
E01018779,2231,1088,1143,0.48767368892873153,0.5123263110712685
E01018758,2425,1137,1288,0.4688659793814433,0.5311340206185567
E01018768,1973,943,1030,0.4779523568170299,0.5220476431829701
E01018769,1851,875,976,0.47271745002701243,0.5272825499729876
E01018778,1716,833,883,0.48543123543123545,0.5145687645687645
E01018767,1490,682,808,0.4577181208053691,0.5422818791946309
E01018770,1246,603,643,0.4839486356340289,0.5160513643659711
E01018771,1300,670,630,0.5153846153846153,0.4846153846153846
E01018772,1557,761,796,0.48876043673731534,0.5112395632626846
E01018764,1436,713,723,0.49651810584958217,0.5034818941504178
E01018787,1560,779,781,0.49935897435897436,0.5006410256410256
E01018795,1210,589,621,0.48677685950413224,0.5132231404958678
E01018796,1206,584,622,0.4842454394693201,0.5157545605306799
E01018757,2066,988,1078,0.4782187802516941,0.5217812197483059
E01018763,1115,566,549,0.5076233183856502,0.4923766816143498
E01018765,1479,743,736,0.5023664638269101,0.4976335361730899
E01018785,1946,956,990,0.49126413155190135,0.5087358684480987
E01018786,1305,652,653,0.49961685823754787,0.5003831417624521
E01018788,1413,634,779,0.448690728945506,0.551309271054494
E01018790,1180,565,615,0.4788135593220339,0.5211864406779662
E01018794,1382,653,729,0.4725036179450072,0.5274963820549927
E01018789,1456,692,764,0.47527472527472525,0.5247252747252747
E01018791,1222,612,610,0.5008183306055647,0.49918166939443537
E01018792,2782,1356,1426,0.4874191229331416,0.5125808770668584
E01018793,1703,841,862,0.4938344098649442,0.5061655901350558
E01018759,1494,721,773,0.4825970548862115,0.5174029451137885
E01018760,1242,625,617,0.5032206119162641,0.4967793880837359
E01018761,1489,711,778,0.47750167897918067,0.5224983210208194
E01018766,1825,885,940,0.4849315068493151,0.5150684931506849
E01018774,1403,672,731,0.4789736279401283,0.5210263720598717
E01018797,1127,536,591,0.4755989352262644,0.5244010647737356
E01018798,1484,732,752,0.49326145552560646,0.5067385444743935
E01018799,1182,551,631,0.46615905245346867,0.5338409475465313
E01018800,1618,763,855,0.4715698393077874,0.5284301606922126
E01018780,2278,1099,1179,0.48244073748902544,0.5175592625109745
E01018781,1839,896,943,0.48722131593257206,0.512778684067428
E01033294,2306,1133,1173,0.49132697311361667,0.5086730268863834
E01018762,1203,592,611,0.4921030756442228,0.5078969243557773
E01018773,1517,737,780,0.4858272907053395,0.5141727092946605
E01018775,1436,697,739,0.4853760445682451,0.5146239554317549
E01018776,1169,582,587,0.49786142001710865,0.5021385799828914
E01018815,2026,1015,1011,0.5009871668311945,0.4990128331688055
E01018831,1307,638,669,0.4881407804131599,0.5118592195868401
E01018832,1327,650,677,0.4898266767143934,0.5101733232856066
E01018847,1513,726,787,0.47984137475214805,0.520158625247852
E01018833,1486,739,747,0.49730820995962316,0.5026917900403769
E01018842,1402,680,722,0.48502139800285304,0.514978601997147
E01018843,1292,630,662,0.48761609907120745,0.5123839009287926
E01018844,1226,598,628,0.48776508972267535,0.5122349102773246
E01018825,1554,747,807,0.4806949806949807,0.5193050193050193
E01018826,2127,974,1153,0.45792195580629996,0.5420780441937001
E01018851,1383,646,737,0.4671005061460593,0.5328994938539408
E01018852,2501,1188,1313,0.4750099960015994,0.5249900039984007
E01018823,1464,677,787,0.462431693989071,0.537568306010929
E01018824,2553,1212,1341,0.47473560517038776,0.5252643948296122
E01018853,2499,1196,1303,0.4785914365746298,0.5214085634253701
E01018854,1344,631,713,0.4694940476190476,0.5305059523809523
E01018819,1475,699,776,0.4738983050847458,0.5261016949152543
E01018822,1234,595,639,0.4821717990275527,0.5178282009724473
E01018855,2382,1148,1234,0.4819479429051218,0.5180520570948782
E01018856,1391,684,707,0.49173256649892166,0.5082674335010784
E01018857,1173,544,629,0.463768115942029,0.5362318840579711
E01018858,1458,679,779,0.4657064471879287,0.5342935528120714
E01018807,1303,615,688,0.47198772064466615,0.5280122793553338
E01018808,1451,692,759,0.47691247415575466,0.5230875258442453
E01018809,1960,913,1047,0.4658163265306122,0.5341836734693878
E01018810,1354,651,703,0.4807976366322009,0.5192023633677991
E01018816,1683,803,880,0.477124183006536,0.5228758169934641
E01018817,2049,995,1054,0.48560273304050755,0.5143972669594924
E01018818,1616,754,862,0.4665841584158416,0.5334158415841584
E01018820,1806,869,937,0.48117386489479513,0.5188261351052049
E01018821,1227,622,605,0.5069274653626732,0.4930725346373268
E01018845,1578,724,854,0.458808618504436,0.541191381495564
E01018846,1321,637,684,0.4822104466313399,0.5177895533686601
E01018848,1614,779,835,0.4826517967781908,0.5173482032218092
E01018849,1863,876,987,0.47020933977455714,0.5297906602254429
E01018850,1334,652,682,0.48875562218890556,0.5112443778110944
E01018827,1503,710,793,0.47238855622089154,0.5276114437791084
E01018828,1489,696,793,0.4674278038952317,0.5325721961047682
E01018829,1353,683,670,0.5048041389504804,0.49519586104951957
E01018830,1459,705,754,0.4832076764907471,0.5167923235092529
E01018834,1798,870,928,0.4838709677419355,0.5161290322580645
E01018835,1758,882,876,0.5017064846416383,0.49829351535836175
E01018836,1580,759,821,0.48037974683544304,0.519620253164557
E01018837,1957,971,986,0.4961676034747062,0.5038323965252938
E01018838,1557,734,823,0.4714193962748876,0.5285806037251124
E01018839,1178,562,616,0.4770797962648557,0.5229202037351444
E01018840,1636,772,864,0.4718826405867971,0.5281173594132029
E01018841,1435,682,753,0.4752613240418119,0.5247386759581881
E01018860,1919,884,1035,0.460656591974987,0.539343408025013
E01018803,1748,845,903,0.4834096109839817,0.5165903890160183
E01018804,1878,881,997,0.4691160809371672,0.5308839190628328
E01018805,1458,688,770,0.4718792866941015,0.5281207133058985
E01018806,1532,744,788,0.4856396866840731,0.5143603133159269
E01018811,1490,715,775,0.4798657718120805,0.5201342281879194
E01018812,1374,661,713,0.4810771470160116,0.5189228529839883
E01018813,1424,705,719,0.49508426966292135,0.5049157303370787
E01018814,1437,694,743,0.48295059151009045,0.5170494084899095
E01018859,1731,839,892,0.4846909300982091,0.5153090699017908
E01018889,1334,642,692,0.48125937031484256,0.5187406296851574
E01018890,1420,699,721,0.4922535211267606,0.5077464788732394
E01018891,1297,618,679,0.4764841942945258,0.5235158057054742
E01018892,1336,657,679,0.49176646706586824,0.5082335329341318
E01018893,1353,661,692,0.4885439763488544,0.5114560236511456
E01018908,1668,838,830,0.5023980815347722,0.49760191846522783
E01018909,1591,765,826,0.4808296668761785,0.5191703331238215
E01018910,1861,878,983,0.47178936055883935,0.5282106394411606
E01018911,1684,837,847,0.4970308788598575,0.5029691211401425
E01018912,1467,709,758,0.4832992501704158,0.5167007498295841
E01018913,1837,930,907,0.5062602068590093,0.49373979314099076
E01018914,1873,916,957,0.4890549919914576,0.5109450080085425
E01018915,2037,976,1061,0.4791359842906235,0.5208640157093766
E01018916,1328,624,704,0.46987951807228917,0.5301204819277109
E01018917,1373,637,736,0.46394756008739985,0.5360524399126001
E01018918,1772,850,922,0.4796839729119639,0.5203160270880361
E01018919,1348,645,703,0.478486646884273,0.521513353115727
E01018894,1810,899,911,0.4966850828729282,0.5033149171270718
E01018895,1674,822,852,0.4910394265232975,0.5089605734767025
E01018896,1528,777,751,0.5085078534031413,0.49149214659685864
E01018897,1416,711,705,0.5021186440677966,0.4978813559322034
E01018898,1293,617,676,0.477184841453983,0.522815158546017
E01018865,1900,971,929,0.5110526315789473,0.48894736842105263
E01018866,1601,769,832,0.4803247970018738,0.5196752029981262
E01018867,1935,937,998,0.4842377260981912,0.5157622739018087
E01018868,1768,854,914,0.4830316742081448,0.5169683257918553
E01018874,1304,611,693,0.46855828220858897,0.531441717791411
E01018875,1348,598,750,0.443620178041543,0.5563798219584569
E01018876,1389,677,712,0.48740100791936647,0.5125989920806335
E01018877,1420,671,749,0.4725352112676056,0.5274647887323943
E01018878,1405,685,720,0.4875444839857651,0.5124555160142349
E01018869,1570,776,794,0.4942675159235669,0.5057324840764331
E01018870,1293,611,682,0.4725444702242846,0.5274555297757154
E01018871,1657,832,825,0.5021122510561256,0.4978877489438745
E01018872,1250,606,644,0.4848,0.5152
E01018873,1297,626,671,0.4826522744795682,0.5173477255204317
E01018863,1652,813,839,0.49213075060532685,0.5078692493946732
E01018864,1639,807,832,0.4923733984136669,0.5076266015863331
E01018921,2101,1052,1049,0.5007139457401237,0.49928605425987627
E01018922,2372,1177,1195,0.49620573355817876,0.5037942664418212
E01018879,1753,828,925,0.47233314318311465,0.5276668568168853
E01018880,2137,1065,1072,0.4983621899859616,0.5016378100140384
E01018899,2601,1257,1344,0.48327566320645904,0.5167243367935409
E01018900,1486,731,755,0.4919246298788694,0.5080753701211306
E01018901,1668,808,860,0.4844124700239808,0.5155875299760192
E01018882,1521,734,787,0.482577251808021,0.517422748191979
E01018883,1570,778,792,0.49554140127388535,0.5044585987261146
E01018884,1655,788,867,0.4761329305135952,0.5238670694864048
E01018885,1486,735,751,0.4946164199192463,0.5053835800807537
E01018886,1951,958,993,0.4910302409021015,0.5089697590978985
E01018887,1587,764,823,0.481411468178954,0.518588531821046
E01018888,1912,878,1034,0.4592050209205021,0.5407949790794979
E01018861,1434,701,733,0.4888423988842399,0.5111576011157601
E01018862,1384,665,719,0.4804913294797688,0.5195086705202312
E01018905,1316,653,663,0.49620060790273557,0.5037993920972644
E01018906,1225,588,637,0.48,0.52
E01018907,1226,584,642,0.4763458401305057,0.5236541598694943
E01018881,1842,934,908,0.507057546145494,0.49294245385450597
E01018902,1200,597,603,0.4975,0.5025
E01018903,1776,1151,625,0.6480855855855856,0.3519144144144144
E01018904,2091,1013,1078,0.4844571975131516,0.5155428024868484
E01018920,2008,1007,1001,0.5014940239043825,0.49850597609561753
E01018936,1518,755,763,0.497364953886693,0.502635046113307
E01018937,1898,904,994,0.47629083245521603,0.523709167544784
E01018938,1675,809,866,0.4829850746268657,0.5170149253731343
E01018959,1445,669,776,0.4629757785467128,0.5370242214532872
E01018960,1920,930,990,0.484375,0.515625
E01018961,1478,730,748,0.4939106901217862,0.5060893098782138
E01018943,2121,1087,1034,0.5124941065535125,0.4875058934464875
E01018951,2254,1089,1165,0.4831410825199645,0.5168589174800355
E01018974,2570,1262,1308,0.4910505836575875,0.5089494163424124
E01018940,1558,747,811,0.47946084724005134,0.5205391527599487
E01018941,1554,760,794,0.48906048906048905,0.510939510939511
E01018942,1519,733,786,0.4825543120473996,0.5174456879526004
E01018969,2250,1084,1166,0.4817777777777778,0.5182222222222223
E01018953,1209,613,596,0.5070306038047974,0.49296939619520264
E01018968,2515,1231,1284,0.48946322067594433,0.5105367793240556
E01033291,1596,780,816,0.48872180451127817,0.5112781954887218
E01033292,1349,636,713,0.4714603409933284,0.5285396590066717
E01018946,1491,700,791,0.4694835680751174,0.5305164319248826
E01018947,2988,1438,1550,0.48125836680053546,0.5187416331994645
E01018948,1677,818,859,0.4877757901013715,0.5122242098986285
E01018949,1421,693,728,0.4876847290640394,0.5123152709359606
E01018950,1639,803,836,0.4899328859060403,0.5100671140939598
E01018925,2153,1032,1121,0.4793311658151417,0.5206688341848583
E01018952,1167,580,587,0.49700085689802914,0.5029991431019709
E01018965,2478,1185,1293,0.4782082324455206,0.5217917675544794
E01018966,1092,552,540,0.5054945054945055,0.4945054945054945
E01018967,1367,706,661,0.5164594001463058,0.48354059985369424
E01018924,1140,563,577,0.493859649122807,0.506140350877193
E01018962,2174,1058,1116,0.48666053357865685,0.5133394664213431
E01033289,2239,1071,1168,0.47833854399285397,0.5216614560071461
E01018954,1236,606,630,0.49029126213592233,0.5097087378640777
E01018955,1606,777,829,0.4838107098381071,0.5161892901618929
E01018956,1085,539,546,0.4967741935483871,0.5032258064516129
E01018957,1282,609,673,0.4750390015600624,0.5249609984399376
E01018958,1352,636,716,0.47041420118343197,0.5295857988165681
E01018970,1521,725,796,0.47666009204470744,0.5233399079552926
E01018971,2015,894,1121,0.4436724565756824,0.5563275434243177
E01018972,1789,827,962,0.4622694242593628,0.5377305757406372
E01018973,1396,633,763,0.45343839541547276,0.5465616045845272
E01018923,1250,623,627,0.4984,0.5016
E01018926,2354,1139,1215,0.483857264231096,0.516142735768904
E01018944,1194,593,601,0.4966499162479062,0.5033500837520938
E01018945,1291,621,670,0.4810224632068164,0.5189775367931836
E01018932,1680,814,866,0.4845238095238095,0.5154761904761904
E01018933,1418,716,702,0.5049365303244006,0.49506346967559944
E01018934,1990,995,995,0.5,0.5
E01018935,2259,1081,1178,0.4785303231518371,0.5214696768481629
E01018927,1574,746,828,0.47395171537484115,0.5260482846251588
E01018928,1754,830,924,0.4732041049030787,0.5267958950969214
E01018929,1274,628,646,0.49293563579277866,0.5070643642072213
E01018930,1603,754,849,0.4703680598877105,0.5296319401122894
E01018931,1184,578,606,0.48817567567567566,0.5118243243243243
E01019008,1428,643,785,0.45028011204481794,0.5497198879551821
E01019009,1520,744,776,0.48947368421052634,0.5105263157894737
E01019010,1372,642,730,0.4679300291545189,0.532069970845481
E01019011,1445,673,772,0.4657439446366782,0.5342560553633218
E01019012,1778,853,925,0.4797525309336333,0.5202474690663667
E01018978,1481,696,785,0.4699527346387576,0.5300472653612424
E01018981,2046,965,1081,0.47165200391006845,0.5283479960899315
E01018982,2149,1028,1121,0.4783620288506282,0.5216379711493718
E01018983,1609,768,841,0.47731510254816656,0.5226848974518334
E01018984,2118,1041,1077,0.4915014164305949,0.5084985835694051
E01018985,2324,1111,1213,0.4780550774526678,0.5219449225473322
E01018986,1568,722,846,0.4604591836734694,0.5395408163265306
E01018987,2081,1032,1049,0.49591542527630944,0.5040845747236905
E01018975,1994,909,1085,0.45586760280842525,0.5441323971915747
E01018979,1390,715,675,0.5143884892086331,0.4856115107913669
E01018980,1407,685,722,0.48685145700071075,0.5131485429992892
E01018990,1810,844,966,0.4662983425414365,0.5337016574585636
E01019007,2202,1081,1121,0.4909173478655767,0.5090826521344233
E01018988,1537,734,803,0.47755367599219256,0.5224463240078074
E01018989,1776,852,924,0.4797297297297297,0.5202702702702703
E01018991,1518,746,772,0.4914361001317523,0.5085638998682477
E01019006,1616,782,834,0.4839108910891089,0.5160891089108911
E01018976,2144,996,1148,0.46455223880597013,0.5354477611940298
E01018977,1428,665,763,0.46568627450980393,0.5343137254901961
E01018994,1632,764,868,0.4681372549019608,0.5318627450980392
E01018996,1590,754,836,0.4742138364779874,0.5257861635220126
E01018997,1471,683,788,0.46430999320190347,0.5356900067980965
E01018995,2069,994,1075,0.4804253262445626,0.5195746737554374
E01018998,1467,716,751,0.48807089297886846,0.5119291070211316
E01018999,1447,698,749,0.4823773324118867,0.5176226675881134
E01019001,1685,768,917,0.45578635014836794,0.544213649851632
E01018992,1624,799,825,0.4919950738916256,0.5080049261083743
E01018993,1670,809,861,0.4844311377245509,0.5155688622754491
E01019005,2081,1032,1049,0.49591542527630944,0.5040845747236905
E01019000,1403,652,751,0.4647184604419102,0.5352815395580898
E01019002,1390,695,695,0.5,0.5
E01019003,1716,828,888,0.4825174825174825,0.5174825174825175
E01019004,1603,768,835,0.479101684341859,0.5208983156581409
E01019048,1828,893,935,0.4885120350109409,0.5114879649890591
E01019049,1817,906,911,0.49862410566868465,0.5013758943313154
E01019050,1428,705,723,0.49369747899159666,0.5063025210084033
E01019051,1598,769,829,0.4812265331664581,0.518773466833542
E01019060,1659,805,854,0.48523206751054854,0.5147679324894515
E01019061,1728,850,878,0.49189814814814814,0.5081018518518519
E01019062,1944,943,1001,0.485082304526749,0.5149176954732511
E01019063,1963,937,1026,0.4773306164034641,0.5226693835965359
E01019064,1931,952,979,0.49300880372863803,0.506991196271362
E01019065,1326,674,652,0.5082956259426847,0.4917043740573152
E01019028,2098,1016,1082,0.48427073403241183,0.5157292659675882
E01019029,1453,699,754,0.48107364074328973,0.5189263592567103
E01019030,1782,880,902,0.49382716049382713,0.5061728395061729
E01019031,1558,766,792,0.49165596919127086,0.5083440308087291
E01019018,1611,792,819,0.49162011173184356,0.5083798882681564
E01019019,1417,693,724,0.4890613973182781,0.510938602681722
E01019020,1441,734,707,0.5093684941013186,0.4906315058986815
E01019021,1486,738,748,0.49663526244952894,0.5033647375504711
E01019022,1726,812,914,0.4704519119351101,0.52954808806489
E01019023,1596,788,808,0.49373433583959897,0.506265664160401
E01019052,1808,890,918,0.4922566371681416,0.5077433628318584
E01019053,1942,968,974,0.4984552008238929,0.5015447991761071
E01019054,1816,901,915,0.4961453744493392,0.5038546255506607
E01019055,1484,715,769,0.48180592991913745,0.5181940700808625
E01019035,1519,715,804,0.4707044107965767,0.5292955892034233
E01019036,1687,852,835,0.5050385299347955,0.4949614700652045
E01019037,1508,717,791,0.47546419098143233,0.5245358090185677
E01019074,1785,907,878,0.5081232492997199,0.4918767507002801
E01019075,1731,854,877,0.49335644136337375,0.5066435586366262
E01019076,1870,953,917,0.5096256684491979,0.4903743315508021
E01019069,1308,646,662,0.4938837920489297,0.5061162079510704
E01019070,1999,970,1029,0.4852426213106553,0.5147573786893447
E01019071,1580,774,806,0.489873417721519,0.5101265822784811
E01019072,1514,730,784,0.4821664464993395,0.5178335535006605
E01019073,1426,700,726,0.4908835904628331,0.5091164095371669
E01019056,1628,805,823,0.49447174447174447,0.5055282555282555
E01019057,1918,921,997,0.4801876955161627,0.5198123044838373
E01019058,1773,857,916,0.48336153412295546,0.5166384658770445
E01019059,1554,744,810,0.47876447876447875,0.5212355212355212
E01019024,1446,702,744,0.4854771784232365,0.5145228215767634
E01019025,1441,657,784,0.45593337959750174,0.5440666204024983
E01019026,1458,687,771,0.4711934156378601,0.5288065843621399
E01019027,1513,712,801,0.47058823529411764,0.5294117647058824
E01019013,2214,1084,1130,0.4896115627822945,0.5103884372177055
E01019014,1395,650,745,0.4659498207885305,0.5340501792114696
E01019015,1467,726,741,0.4948875255623722,0.5051124744376279
E01019016,1881,903,978,0.4800637958532695,0.5199362041467305
E01019017,2342,1133,1209,0.48377455166524336,0.5162254483347566
E01019032,1482,744,738,0.5020242914979757,0.4979757085020243
E01019034,1523,746,777,0.489822718319107,0.5101772816808929
E01019045,2145,1032,1113,0.4811188811188811,0.5188811188811189
E01019047,1194,553,641,0.4631490787269682,0.5368509212730318
E01019033,1403,671,732,0.4782608695652174,0.5217391304347826
E01019041,1763,804,959,0.4560408394781622,0.5439591605218378
E01019042,1709,827,882,0.483908718548859,0.516091281451141
E01019043,1558,759,799,0.4871630295250321,0.5128369704749679
E01019044,1487,698,789,0.4694014794889038,0.5305985205110961
E01019046,1367,660,707,0.48280907095830283,0.5171909290416972
E01019038,1106,516,590,0.4665461121157324,0.5334538878842676
E01019039,1411,680,731,0.4819277108433735,0.5180722891566265
E01019040,1220,580,640,0.47540983606557374,0.5245901639344263
E01019066,1212,590,622,0.4867986798679868,0.5132013201320133
E01019067,1143,545,598,0.4768153980752406,0.5231846019247594
E01019068,1620,799,821,0.49320987654320986,0.5067901234567901
E01019077,2203,1102,1101,0.5002269632319565,0.4997730367680436
E01014790,1489,735,754,0.49361987911349897,0.506380120886501
E01014795,1366,685,681,0.5014641288433382,0.4985358711566618
E01014797,1727,869,858,0.5031847133757962,0.4968152866242038
E01032675,1355,700,655,0.5166051660516605,0.4833948339483395
E01032676,1334,674,660,0.5052473763118441,0.4947526236881559
E01032681,1232,570,662,0.46266233766233766,0.5373376623376623
E01014789,1327,668,659,0.5033911077618689,0.49660889223813115
E01014793,1512,720,792,0.47619047619047616,0.5238095238095238
E01014794,1643,781,862,0.4753499695678637,0.5246500304321363
E01014798,1532,769,763,0.5019582245430809,0.4980417754569191
E01014792,1818,849,969,0.466996699669967,0.533003300330033
E01014796,1695,812,883,0.4790560471976401,0.5209439528023598
E01032677,1365,652,713,0.4776556776556777,0.5223443223443224
E01032678,1589,807,782,0.5078665827564506,0.4921334172435494
E01032682,1059,501,558,0.4730878186968839,0.5269121813031161
E01014766,1352,675,677,0.4992603550295858,0.5007396449704142
E01014767,1303,657,646,0.5042210283960092,0.4957789716039908
E01014786,1596,811,785,0.5081453634085213,0.4918546365914787
E01014787,1929,942,987,0.48833592534992226,0.5116640746500778
E01014752,1515,752,763,0.49636963696369635,0.5036303630363036
E01014754,1145,546,599,0.47685589519650656,0.5231441048034935
E01014758,1353,608,745,0.4493717664449372,0.5506282335550629
E01014759,1396,692,704,0.49570200573065903,0.504297994269341
E01014849,1550,780,770,0.5032258064516129,0.4967741935483871
E01014850,2073,1014,1059,0.48914616497829233,0.5108538350217077
E01014851,2559,1247,1312,0.48729972645564673,0.5127002735443532
E01014852,1611,790,821,0.4903786468032278,0.5096213531967722
E01032674,2483,1265,1218,0.5094643576318969,0.4905356423681031
E01032680,1832,912,920,0.4978165938864629,0.5021834061135371
E01014750,1621,768,853,0.47378161628624305,0.526218383713757
E01014751,1627,780,847,0.4794099569760295,0.5205900430239705
E01014753,1810,890,920,0.49171270718232046,0.5082872928176796
E01014755,1386,613,773,0.4422799422799423,0.5577200577200577
E01014760,1457,704,753,0.48318462594371997,0.51681537405628
E01014780,1545,737,808,0.47702265372168284,0.5229773462783172
E01014781,1605,753,852,0.4691588785046729,0.5308411214953271
E01014782,1391,686,705,0.4931703810208483,0.5068296189791517
E01014783,1549,766,783,0.4945125887669464,0.5054874112330536
E01014784,1569,741,828,0.4722753346080306,0.5277246653919694
E01014785,1386,663,723,0.47835497835497837,0.5216450216450217
E01014775,1231,613,618,0.4979691307879773,0.5020308692120228
E01014776,1317,646,671,0.4905087319665907,0.5094912680334093
E01014777,1547,739,808,0.4776987718164189,0.5223012281835812
E01014778,1298,649,649,0.5,0.5
E01014779,1192,566,626,0.4748322147651007,0.5251677852348994
E01014756,1623,779,844,0.47997535428219346,0.5200246457178065
E01014757,1473,727,746,0.49355057705363203,0.506449422946368
E01014761,1614,768,846,0.4758364312267658,0.5241635687732342
E01014762,1437,696,741,0.48434237995824636,0.5156576200417536
E01014763,1824,896,928,0.49122807017543857,0.5087719298245614
E01014737,1507,736,771,0.48838752488387527,0.5116124751161247
E01014738,1465,710,755,0.48464163822525597,0.515358361774744
E01014739,1488,726,762,0.4879032258064516,0.5120967741935484
E01014740,1328,644,684,0.48493975903614456,0.5150602409638554
E01014855,1437,700,737,0.4871259568545581,0.5128740431454419
E01014856,1540,772,768,0.5012987012987012,0.4987012987012987
E01014857,1521,743,778,0.48849441157133466,0.5115055884286653
E01014858,1721,847,874,0.49215572341661823,0.5078442765833817
E01014859,1571,767,804,0.48822406110757477,0.5117759388924252
E01014860,1483,739,744,0.4983142279163857,0.5016857720836143
E01014847,1713,847,866,0.4944541739638062,0.5055458260361938
E01014848,1269,638,631,0.5027580772261623,0.49724192277383766
E01014853,1645,778,867,0.4729483282674772,0.5270516717325228
E01014854,1348,638,710,0.4732937685459941,0.526706231454006
E01014764,1606,738,868,0.45952677459526775,0.5404732254047323
E01014765,1891,864,1027,0.45690111052353255,0.5430988894764675
E01014773,1690,846,844,0.5005917159763313,0.49940828402366866
E01014774,1690,815,875,0.4822485207100592,0.5177514792899408
E01014821,1218,566,652,0.46469622331691296,0.535303776683087
E01014822,1474,718,756,0.4871099050203528,0.5128900949796472
E01014823,1292,651,641,0.5038699690402477,0.49613003095975233
E01014824,1457,698,759,0.4790665751544269,0.5209334248455731
E01014825,1226,609,617,0.4967373572593801,0.5032626427406199
E01014826,1573,749,824,0.4761602034329307,0.5238397965670692
E01014827,1359,692,667,0.5091979396615158,0.49080206033848417
E01014817,1520,735,785,0.48355263157894735,0.5164473684210527
E01014820,1401,656,745,0.46823697359029265,0.5317630264097074
E01014835,1414,655,759,0.46322489391796323,0.5367751060820368
E01014836,1468,689,779,0.46934604904632155,0.5306539509536785
E01014838,1396,659,737,0.47206303724928367,0.5279369627507163
E01014840,1390,652,738,0.46906474820143884,0.5309352517985612
E01014812,1406,676,730,0.48079658605974396,0.519203413940256
E01014813,1734,863,871,0.49769319492502884,0.5023068050749712
E01014815,1340,677,663,0.505223880597015,0.49477611940298505
E01014816,1457,706,751,0.48455730954015097,0.515442690459849
E01014818,1698,827,871,0.4870435806831567,0.5129564193168433
E01014819,1531,734,797,0.47942521227955587,0.5205747877204442
E01014841,1670,884,786,0.5293413173652695,0.47065868263473054
E01014842,1486,746,740,0.5020188425302826,0.4979811574697174
E01014843,1465,674,791,0.46006825938566553,0.5399317406143345
E01014844,1233,599,634,0.48580697485806973,0.5141930251419302
E01014845,1221,581,640,0.47583947583947583,0.5241605241605242
E01014846,1508,720,788,0.47745358090185674,0.5225464190981433
E01014799,1564,802,762,0.5127877237851662,0.48721227621483376
E01014800,1535,815,720,0.5309446254071661,0.46905537459283386
E01014801,1549,772,777,0.4983860555196901,0.5016139444803098
E01014802,1549,741,808,0.47837314396384767,0.5216268560361523
E01014809,1715,859,856,0.5008746355685131,0.49912536443148686
E01014811,1594,757,837,0.4749058971141782,0.5250941028858218
E01014829,1826,859,967,0.4704271631982475,0.5295728368017525
E01014830,1571,779,792,0.4958625079567155,0.5041374920432845
E01014831,1253,609,644,0.4860335195530726,0.5139664804469274
E01014832,1418,688,730,0.48519040902679833,0.5148095909732017
E01014833,1466,695,771,0.4740791268758527,0.5259208731241474
E01014804,1347,630,717,0.46770601336302897,0.532293986636971
E01014806,1643,751,892,0.4570906877662812,0.5429093122337189
E01014807,1637,825,812,0.5039706780696396,0.4960293219303604
E01014808,1426,687,739,0.48176718092566617,0.5182328190743338
E01014744,1342,644,698,0.4798807749627422,0.5201192250372578
E01014746,1410,681,729,0.4829787234042553,0.5170212765957447
E01014769,2349,1153,1196,0.49084716900808856,0.5091528309919114
E01014770,1354,657,697,0.48522895125553916,0.5147710487444609
E01014771,1386,667,719,0.48124098124098125,0.5187590187590188
E01014772,1328,632,696,0.4759036144578313,0.5240963855421686
E01014741,1438,655,783,0.45549374130737136,0.5445062586926287
E01014742,1565,790,775,0.5047923322683706,0.4952076677316294
E01014745,1543,726,817,0.47051198963058977,0.5294880103694103
E01014747,1353,656,697,0.48484848484848486,0.5151515151515151
E01014748,1106,540,566,0.488245931283906,0.5117540687160941
E01014749,1356,667,689,0.4918879056047198,0.5081120943952803
E01014803,1507,738,769,0.48971466489714666,0.5102853351028533
E01014805,1437,704,733,0.4899095337508699,0.5100904662491301
E01014828,1440,691,749,0.4798611111111111,0.5201388888888889
E01014834,1393,613,780,0.44005743000717873,0.5599425699928212
E01014839,1600,777,823,0.485625,0.514375
E01032666,1153,573,580,0.49696444058976585,0.5030355594102341
E01032667,1089,553,536,0.5078053259871441,0.4921946740128558
E01032668,1496,738,758,0.49331550802139035,0.5066844919786097
E01032672,1330,642,688,0.48270676691729325,0.5172932330827068
E01032673,1302,614,688,0.4715821812596006,0.5284178187403994
E01014810,1312,631,681,0.4809451219512195,0.5190548780487805
E01032669,1469,716,753,0.4874063989108237,0.5125936010891763
E01032670,1645,799,846,0.4857142857142857,0.5142857142857142
E01032671,1397,680,717,0.4867573371510379,0.513242662848962
E01032679,1281,630,651,0.4918032786885246,0.5081967213114754
E01015025,1576,738,838,0.4682741116751269,0.5317258883248731
E01015097,1669,810,859,0.4853205512282804,0.5146794487717196
E01015160,1485,703,782,0.4734006734006734,0.5265993265993266
E01015164,1999,962,1037,0.4812406203101551,0.5187593796898449
E01015027,1623,791,832,0.48736906962415283,0.5126309303758472
E01015159,1609,735,874,0.45680546923555004,0.54319453076445
E01015161,1483,705,778,0.4753877275792313,0.5246122724207687
E01015162,1447,692,755,0.4782308223911541,0.5217691776088459
E01015166,1871,924,947,0.4938535542490647,0.5061464457509354
E01015023,1644,802,842,0.4878345498783455,0.5121654501216545
E01015026,1582,775,807,0.48988621997471554,0.5101137800252844
E01015028,1446,701,745,0.4847856154910097,0.5152143845089903
E01015163,1451,702,749,0.48380427291523087,0.5161957270847691
E01015165,1684,814,870,0.4833729216152019,0.5166270783847982
E01015024,1431,719,712,0.5024458420684835,0.4975541579315164
E01015082,1625,793,832,0.488,0.512
E01015083,1472,723,749,0.49116847826086957,0.5088315217391305
E01015084,1467,702,765,0.4785276073619632,0.5214723926380368
E01015090,1370,684,686,0.4992700729927007,0.5007299270072992
E01015091,1539,757,782,0.4918778427550357,0.5081221572449642
E01015092,1570,726,844,0.4624203821656051,0.5375796178343949
E01015093,1378,672,706,0.4876632801161103,0.5123367198838897
E01015094,1405,642,763,0.45693950177935944,0.5430604982206406
E01015085,1611,754,857,0.468032278088144,0.531967721911856
E01015087,1594,800,794,0.5018820577164367,0.4981179422835634
E01015088,1601,736,865,0.45971267957526546,0.5402873204247346
E01015147,1249,599,650,0.4795836669335468,0.5204163330664532
E01015148,1515,743,772,0.4904290429042904,0.5095709570957095
E01015030,1566,756,810,0.4827586206896552,0.5172413793103449
E01015070,2519,1238,1281,0.49146486701071856,0.5085351329892814
E01015081,1555,734,821,0.4720257234726688,0.5279742765273312
E01015086,1342,604,738,0.45007451564828616,0.5499254843517138
E01015089,1672,800,872,0.4784688995215311,0.5215311004784688
E01015029,1910,905,1005,0.4738219895287958,0.5261780104712042
E01015064,1623,765,858,0.4713493530499076,0.5286506469500925
E01015065,1464,693,771,0.4733606557377049,0.5266393442622951
E01015071,1524,732,792,0.48031496062992124,0.5196850393700787
E01015076,1438,704,734,0.48956884561891517,0.5104311543810849
E01015142,1312,647,665,0.49314024390243905,0.506859756097561
E01015143,1344,665,679,0.4947916666666667,0.5052083333333334
E01015144,1529,754,775,0.49313276651406146,0.5068672334859385
E01015146,1772,840,932,0.47404063205417607,0.5259593679458239
E01015149,1451,712,739,0.4906960716747071,0.5093039283252929
E01015150,1378,701,677,0.5087082728592163,0.49129172714078373
E01015063,1440,674,766,0.46805555555555556,0.5319444444444444
E01015068,1628,801,827,0.492014742014742,0.507985257985258
E01015069,1594,744,850,0.46675031367628605,0.533249686323714
E01015095,1394,682,712,0.48923959827833574,0.5107604017216643
E01015096,1443,671,772,0.465003465003465,0.534996534996535
E01015074,1519,712,807,0.4687294272547729,0.5312705727452272
E01015077,1714,826,888,0.48191365227537925,0.5180863477246208
E01015079,1481,728,753,0.49155975692099935,0.5084402430790007
E01015102,1687,838,849,0.4967397747480735,0.5032602252519265
E01015104,1534,744,790,0.485006518904824,0.5149934810951761
E01015035,1537,745,792,0.4847104749512036,0.5152895250487963
E01015037,1340,635,705,0.47388059701492535,0.5261194029850746
E01015058,1471,690,781,0.469068660774983,0.530931339225017
E01015066,1485,719,766,0.4841750841750842,0.5158249158249159
E01015067,1514,764,750,0.5046235138705416,0.4953764861294584
E01015072,1597,783,814,0.49029430181590483,0.5097056981840952
E01015073,1450,708,742,0.4882758620689655,0.5117241379310344
E01015078,1245,597,648,0.4795180722891566,0.5204819277108433
E01015080,1406,702,704,0.4992887624466572,0.5007112375533428
E01015106,1232,605,627,0.49107142857142855,0.5089285714285714
E01015039,1292,689,603,0.5332817337461301,0.46671826625387
E01015040,1505,757,748,0.5029900332225914,0.49700996677740866
E01015041,1419,713,706,0.5024665257223396,0.4975334742776603
E01015075,1444,660,784,0.45706371191135736,0.5429362880886427
E01015145,1819,856,963,0.47058823529411764,0.5294117647058824
E01015120,1566,757,809,0.483397190293742,0.5166028097062579
E01015121,1508,696,812,0.46153846153846156,0.5384615384615384
E01015123,1695,759,936,0.44778761061946903,0.552212389380531
E01015124,1598,768,830,0.4806007509386733,0.5193992490613266
E01015125,1538,738,800,0.4798439531859558,0.5201560468140443
E01015033,1570,788,782,0.5019108280254777,0.4980891719745223
E01015034,1401,671,730,0.47894361170592437,0.5210563882940756
E01015036,1481,705,776,0.47602970965563807,0.5239702903443619
E01015038,1718,860,858,0.5005820721769499,0.49941792782305006
E01015101,1624,764,860,0.47044334975369456,0.5295566502463054
E01015098,1565,774,791,0.49456869009584664,0.5054313099041533
E01015099,1476,684,792,0.4634146341463415,0.5365853658536586
E01015100,1477,744,733,0.5037237643872715,0.4962762356127285
E01015103,1476,719,757,0.48712737127371275,0.5128726287262872
E01015105,1482,710,772,0.47908232118758437,0.5209176788124157
E01015107,1552,760,792,0.4896907216494845,0.5103092783505154
E01015110,1588,831,757,0.5232997481108312,0.47670025188916876
E01015111,1641,776,865,0.4728823887873248,0.5271176112126752
E01015119,1725,857,868,0.49681159420289855,0.5031884057971014
E01015112,1497,713,784,0.47628590514362057,0.5237140948563794
E01015113,1495,731,764,0.4889632107023411,0.5110367892976588
E01015114,1479,714,765,0.4827586206896552,0.5172413793103449
E01015118,1634,783,851,0.4791921664626683,0.5208078335373317
E01015122,1592,763,829,0.4792713567839196,0.5207286432160804
E01015042,1473,732,741,0.4969450101832994,0.5030549898167006
E01015044,1454,768,686,0.5281980742778541,0.4718019257221458
E01015167,1547,801,746,0.5177763413057531,0.48222365869424694
E01015168,1810,922,888,0.5093922651933702,0.49060773480662984
E01015171,1730,883,847,0.5104046242774567,0.48959537572254336
E01015055,1433,696,737,0.4856943475226797,0.5143056524773203
E01015056,1566,752,814,0.48020434227330777,0.5197956577266922
E01015057,1493,689,804,0.4614869390488948,0.5385130609511052
E01015059,1555,788,767,0.5067524115755627,0.4932475884244373
E01015060,1573,761,812,0.4837889383343929,0.5162110616656072
E01015176,1464,717,747,0.48975409836065575,0.5102459016393442
E01015108,1952,951,1001,0.48719262295081966,0.5128073770491803
E01015109,1457,714,743,0.4900480439258751,0.5099519560741249
E01015115,1435,625,810,0.4355400696864111,0.5644599303135889
E01015116,1497,739,758,0.49365397461589844,0.5063460253841016
E01015117,1450,716,734,0.49379310344827587,0.5062068965517241
E01015031,1608,825,783,0.5130597014925373,0.4869402985074627
E01015032,2022,1176,846,0.5816023738872403,0.41839762611275966
E01015049,1621,897,724,0.5533621221468229,0.44663787785317705
E01015050,1855,1032,823,0.5563342318059299,0.44366576819407005
E01015051,1935,1019,916,0.5266149870801033,0.47338501291989665
E01015169,1990,1068,922,0.5366834170854271,0.46331658291457284
E01015170,1614,792,822,0.49070631970260226,0.5092936802973977
E01015173,1733,867,866,0.5002885170225043,0.4997114829774957
E01015174,1639,796,843,0.4856619890176937,0.5143380109823062
E01015061,1457,708,749,0.48592999313658203,0.514070006863418
E01015062,2104,1096,1008,0.5209125475285171,0.4790874524714829
E01015175,1663,854,809,0.5135297654840649,0.4864702345159351
E01015177,1744,897,847,0.5143348623853211,0.4856651376146789
E01015178,2050,1089,961,0.531219512195122,0.468780487804878
E01015043,1491,770,721,0.5164319248826291,0.4835680751173709
E01015045,1469,741,728,0.504424778761062,0.49557522123893805
E01015046,2005,1044,961,0.5206982543640898,0.4793017456359102
E01015047,1504,720,784,0.4787234042553192,0.5212765957446809
E01015048,1176,642,534,0.5459183673469388,0.45408163265306123
E01015053,1496,824,672,0.5508021390374331,0.44919786096256686
E01015054,2275,1186,1089,0.5213186813186813,0.4786813186813187
E01015152,1837,989,848,0.5383777898747959,0.46162221012520416
E01015156,1492,851,641,0.5703753351206434,0.4296246648793566
E01032657,1525,760,765,0.49836065573770494,0.5016393442622951
E01032658,1261,634,627,0.5027755749405234,0.4972244250594766
E01015052,1967,1001,966,0.5088967971530249,0.49110320284697506
E01015179,1710,891,819,0.5210526315789473,0.4789473684210526
E01015180,1760,930,830,0.5284090909090909,0.4715909090909091
E01015181,2056,1094,962,0.5321011673151751,0.4678988326848249
E01015182,1847,934,913,0.5056848944233893,0.49431510557661074
E01015151,1917,1034,883,0.5393844548774126,0.4606155451225874
E01015153,1762,917,845,0.5204313280363224,0.47956867196367764
E01015155,1749,952,797,0.5443110348770727,0.4556889651229274
E01015157,2079,1161,918,0.5584415584415584,0.44155844155844154
E01015158,2163,1158,1005,0.5353675450762829,0.4646324549237171
E01015172,1798,922,876,0.5127919911012235,0.4872080088987764
E01015126,1429,643,786,0.44996501049685095,0.5500349895031491
E01015127,1502,721,781,0.4800266311584554,0.5199733688415447
E01015131,1476,706,770,0.47831978319783197,0.521680216802168
E01015132,1507,714,793,0.47378898473788983,0.5262110152621101
E01015133,1535,727,808,0.4736156351791531,0.5263843648208469
E01015135,1545,761,784,0.4925566343042071,0.5074433656957928
E01015136,1517,709,808,0.4673698088332235,0.5326301911667766
E01015137,1572,759,813,0.48282442748091603,0.517175572519084
E01015138,1518,781,737,0.5144927536231884,0.4855072463768116
E01015139,1454,697,757,0.4793672627235213,0.5206327372764786
E01015141,1820,879,941,0.48296703296703297,0.5170329670329671
E01015128,1634,762,872,0.4663402692778458,0.5336597307221542
E01015129,1481,712,769,0.48075624577987847,0.5192437542201216
E01015130,1714,873,841,0.5093348891481914,0.49066511085180864
E01015134,1538,722,816,0.4694408322496749,0.5305591677503251
E01015140,1516,731,785,0.4821899736147757,0.5178100263852242
E01015431,1487,740,747,0.4976462676529926,0.5023537323470074
E01015432,1643,775,868,0.4716981132075472,0.5283018867924528
E01015433,1480,735,745,0.4966216216216216,0.5033783783783784
E01015434,1631,773,858,0.4739423666462293,0.5260576333537706
E01015379,1461,689,772,0.47159479808350446,0.5284052019164955
E01015435,1523,760,763,0.4990151017728168,0.5009848982271832
E01015436,1348,675,673,0.5007418397626113,0.4992581602373887
E01015437,1280,636,644,0.496875,0.503125
E01015395,1327,623,704,0.4694800301431801,0.5305199698568199
E01015396,1540,722,818,0.4688311688311688,0.5311688311688312
E01015397,1496,726,770,0.4852941176470588,0.5147058823529411
E01015398,1390,686,704,0.4935251798561151,0.5064748201438849
E01015399,1509,701,808,0.464546056991385,0.5354539430086149
E01015400,1518,736,782,0.48484848484848486,0.5151515151515151
E01015401,1523,725,798,0.47603414313854236,0.5239658568614577
E01015412,1307,664,643,0.5080336648814078,0.49196633511859217
E01015413,1457,702,755,0.48181194234728897,0.518188057652711
E01015414,1454,692,762,0.4759284731774415,0.5240715268225584
E01015415,1262,626,636,0.4960380348652932,0.5039619651347068
E01015416,1335,640,695,0.4794007490636704,0.5205992509363296
E01015407,1478,706,772,0.4776725304465494,0.5223274695534507
E01015408,1405,678,727,0.4825622775800712,0.5174377224199288
E01015409,1507,741,766,0.49170537491705374,0.5082946250829462
E01015410,1515,753,762,0.497029702970297,0.502970297029703
E01015411,1359,649,710,0.4775570272259014,0.5224429727740986
E01015417,1460,721,739,0.49383561643835616,0.5061643835616438
E01015418,1522,755,767,0.49605781865965837,0.5039421813403416
E01015419,1756,839,917,0.4777904328018223,0.5222095671981777
E01015420,1560,739,821,0.4737179487179487,0.5262820512820513
E01015421,1435,673,762,0.4689895470383275,0.5310104529616725
E01015422,1447,706,741,0.4879060124395301,0.51209398756047
E01015380,1716,835,881,0.4865967365967366,0.5134032634032634
E01015381,1629,811,818,0.4978514426028238,0.5021485573971762
E01015382,1859,905,954,0.4868208714362561,0.5131791285637439
E01015383,1419,692,727,0.48766737138830163,0.5123326286116984
E01015384,1608,804,804,0.5,0.5
E01015385,1731,836,895,0.4829578278451762,0.5170421721548238
E01015438,1529,744,785,0.486592544146501,0.513407455853499
E01015439,1723,879,844,0.51015670342426,0.48984329657574
E01015441,1872,926,946,0.4946581196581197,0.5053418803418803
E01015442,1923,919,1004,0.4778991159646386,0.5221008840353614
E01015443,1791,885,906,0.49413735343383586,0.5058626465661642
E01015444,1735,899,836,0.5181556195965418,0.48184438040345823
E01015386,1666,853,813,0.5120048019207684,0.4879951980792317
E01015387,1469,700,769,0.4765146358066712,0.5234853641933288
E01015388,1597,786,811,0.49217282404508456,0.5078271759549154
E01015389,1474,750,724,0.508819538670285,0.49118046132971505
E01015390,1688,846,842,0.5011848341232228,0.49881516587677727
E01015391,1455,726,729,0.49896907216494846,0.5010309278350515
E01015392,1421,682,739,0.47994370161857847,0.5200562983814215
E01015393,1260,639,621,0.5071428571428571,0.4928571428571429
E01015394,1591,779,812,0.4896291640477687,0.5103708359522313
E01015440,1942,941,1001,0.48455200823892897,0.515447991761071
E01015447,1626,769,857,0.47293972939729395,0.527060270602706
E01015449,1690,780,910,0.46153846153846156,0.5384615384615384
E01015456,1784,837,947,0.46917040358744394,0.530829596412556
E01015457,1648,808,840,0.49029126213592233,0.5097087378640777
E01015445,1927,921,1006,0.4779449922158796,0.5220550077841204
E01015446,1583,789,794,0.4984207201516109,0.5015792798483891
E01015448,1525,748,777,0.4904918032786885,0.5095081967213114
E01015450,1738,878,860,0.5051783659378596,0.4948216340621404
E01015451,1465,706,759,0.48191126279863483,0.5180887372013652
E01015458,1495,715,780,0.4782608695652174,0.5217391304347826
E01015460,1746,858,888,0.49140893470790376,0.5085910652920962
E01015461,1592,801,791,0.503140703517588,0.49685929648241206
E01015462,1592,827,765,0.5194723618090452,0.4805276381909548
E01015463,1557,793,764,0.5093127809890816,0.49068721901091844
E01015464,1614,783,831,0.4851301115241636,0.5148698884758365
E01015427,1686,874,812,0.5183867141162515,0.4816132858837485
E01015428,2164,1079,1085,0.4986136783733826,0.5013863216266173
E01015429,1702,817,885,0.4800235017626322,0.5199764982373678
E01015430,1547,763,784,0.49321266968325794,0.5067873303167421
E01015465,1750,858,892,0.49028571428571427,0.5097142857142857
E01015466,1714,816,898,0.47607934655775963,0.5239206534422404
E01015468,1959,840,1119,0.42879019908116384,0.5712098009188361
E01032659,1169,611,558,0.5226689478186484,0.4773310521813516
E01032660,1669,815,854,0.48831635710005994,0.5116836428999401
E01032661,1305,656,649,0.5026819923371647,0.49731800766283524
E01032662,1117,527,590,0.4717994628469114,0.5282005371530887
E01015423,2010,1039,971,0.5169154228855721,0.48308457711442787
E01015424,1369,673,696,0.49159970781592405,0.508400292184076
E01015425,1292,618,674,0.47832817337461303,0.521671826625387
E01015426,1371,657,714,0.47921225382932164,0.5207877461706784
E01015452,1800,860,940,0.4777777777777778,0.5222222222222223
E01015453,1840,903,937,0.4907608695652174,0.5092391304347826
E01015454,1829,916,913,0.5008201202843083,0.4991798797156916
E01015455,1878,911,967,0.4850905218317359,0.5149094781682642
E01015459,1759,860,899,0.48891415577032404,0.511085844229676
E01015402,1656,792,864,0.4782608695652174,0.5217391304347826
E01015403,1752,787,965,0.4492009132420091,0.5507990867579908
E01015404,1660,816,844,0.491566265060241,0.5084337349397591
E01015405,1811,889,922,0.49088901159580345,0.5091109884041966
E01015406,1741,908,833,0.5215393452039058,0.4784606547960942
E01014985,1383,687,696,0.4967462039045553,0.5032537960954447
E01014986,1591,740,851,0.46511627906976744,0.5348837209302325
E01014987,1264,616,648,0.4873417721518987,0.5126582278481012
E01014988,1403,687,716,0.4896650035637919,0.5103349964362082
E01014989,1277,542,735,0.4244322631166797,0.5755677368833203
E01014990,1484,730,754,0.4919137466307278,0.5080862533692723
E01014991,2164,1055,1109,0.48752310536044363,0.5124768946395564
E01014992,1483,765,718,0.5158462575859744,0.48415374241402565
E01014993,1442,738,704,0.5117891816920943,0.4882108183079057
E01014884,2048,1290,758,0.6298828125,0.3701171875
E01014885,1868,935,933,0.5005353319057816,0.4994646680942184
E01014929,2021,1015,1006,0.5022266204849085,0.49777337951509154
E01014930,1978,940,1038,0.4752275025278059,0.5247724974721941
E01014863,1496,737,759,0.49264705882352944,0.5073529411764706
E01014864,1457,732,725,0.5024021962937543,0.49759780370624573
E01014962,1748,849,899,0.4856979405034325,0.5143020594965675
E01014963,1880,923,957,0.4909574468085106,0.5090425531914894
E01014861,1864,926,938,0.4967811158798283,0.5032188841201717
E01014862,2841,1388,1453,0.4885603660682858,0.5114396339317142
E01014953,2108,1051,1057,0.4985768500948767,0.5014231499051234
E01014954,1539,794,745,0.5159194282001299,0.48408057179987
E01015014,1466,754,712,0.514324693042292,0.48567530695770805
E01015015,1469,734,735,0.4996596324029952,0.5003403675970047
E01015016,1217,602,615,0.49465899753492193,0.5053410024650781
E01015017,1447,690,757,0.4768486523842433,0.5231513476157568
E01015018,1524,728,796,0.4776902887139108,0.5223097112860893
E01015019,1776,827,949,0.46565315315315314,0.5343468468468469
E01015020,1556,763,793,0.4903598971722365,0.5096401028277635
E01015021,1571,807,764,0.5136855506047103,0.4863144493952896
E01015022,1550,775,775,0.5,0.5
E01014886,1803,862,941,0.47809206877426513,0.5219079312257349
E01014887,1397,677,720,0.4846098783106657,0.5153901216893343
E01014888,1453,708,745,0.48726772195457674,0.5127322780454233
E01014889,1567,768,799,0.4901084875558392,0.5098915124441609
E01014872,1593,808,785,0.5072190834902699,0.49278091650973005
E01014874,1498,759,739,0.5066755674232309,0.493324432576769
E01014876,1716,865,851,0.504079254079254,0.4959207459207459
E01014877,1563,787,776,0.5035188739603327,0.4964811260396673
E01014879,1712,882,830,0.5151869158878505,0.4848130841121495
E01014881,1956,960,996,0.49079754601226994,0.50920245398773
E01015009,1384,672,712,0.48554913294797686,0.5144508670520231
E01015010,1322,663,659,0.5015128593040847,0.49848714069591527
E01015011,1556,769,787,0.49421593830334193,0.5057840616966581
E01015012,1214,575,639,0.47364085667215816,0.5263591433278418
E01015013,1349,689,660,0.5107487027427724,0.4892512972572276
E01014946,1574,789,785,0.5012706480304956,0.49872935196950446
E01014947,1422,701,721,0.4929676511954993,0.5070323488045007
E01014948,1693,821,872,0.4849379799173066,0.5150620200826934
E01014949,1420,722,698,0.5084507042253521,0.4915492957746479
E01014950,1428,727,701,0.5091036414565826,0.49089635854341734
E01014951,1322,635,687,0.4803328290468986,0.5196671709531013
E01014952,1652,844,808,0.5108958837772397,0.4891041162227603
E01014873,1507,750,757,0.49767750497677504,0.5023224950232249
E01014875,1792,928,864,0.5178571428571429,0.48214285714285715
E01014878,2113,1081,1032,0.5115948887837198,0.48840511121628016
E01014880,1833,919,914,0.5013638843426077,0.49863611565739224
E01014882,2084,1023,1061,0.4908829174664108,0.5091170825335892
E01014883,1232,618,614,0.5016233766233766,0.49837662337662336
E01014911,1386,676,710,0.48773448773448774,0.5122655122655123
E01014912,1835,923,912,0.5029972752043597,0.49700272479564034
E01014913,1622,818,804,0.5043156596794082,0.4956843403205919
E01014914,1677,841,836,0.5014907573047108,0.49850924269528923
E01014892,1660,792,868,0.4771084337349398,0.5228915662650603
E01014893,1494,753,741,0.5040160642570282,0.4959839357429719
E01014894,1308,670,638,0.5122324159021406,0.4877675840978593
E01014895,1422,706,716,0.4964838255977497,0.5035161744022504
E01014896,1332,663,669,0.49774774774774777,0.5022522522522522
E01014979,1515,766,749,0.5056105610561056,0.49438943894389437
E01014980,1621,802,819,0.4947563232572486,0.5052436767427514
E01014982,1519,756,763,0.4976958525345622,0.5023041474654378
E01014983,1518,717,801,0.4723320158102767,0.5276679841897233
E01014984,1481,740,741,0.49966239027683995,0.50033760972316
E01014998,1553,717,836,0.4616870573084353,0.5383129426915647
E01014999,1594,778,816,0.4880803011292346,0.5119196988707654
E01015000,1542,760,782,0.49286640726329445,0.5071335927367056
E01015001,1609,779,830,0.4841516469857054,0.5158483530142945
E01014978,1530,773,757,0.5052287581699346,0.4947712418300654
E01014981,2874,1481,1393,0.5153096729297146,0.4846903270702853
E01014996,1629,794,835,0.48741559238796806,0.512584407612032
E01033331,2230,1205,1025,0.5403587443946188,0.45964125560538116
E01033333,2244,1197,1047,0.5334224598930482,0.46657754010695185
E01014904,1487,765,722,0.5144586415601883,0.4855413584398117
E01014905,1639,858,781,0.5234899328859061,0.47651006711409394
E01014906,1672,804,868,0.48086124401913877,0.5191387559808612
E01014907,1530,798,732,0.5215686274509804,0.47843137254901963
E01014908,1320,672,648,0.509090909090909,0.4909090909090909
E01014909,1488,793,695,0.5329301075268817,0.46706989247311825
E01014910,1471,755,716,0.513256288239293,0.486743711760707
E01014867,1352,707,645,0.5229289940828402,0.4770710059171598
E01014868,1552,783,769,0.5045103092783505,0.4954896907216495
E01014994,1733,873,860,0.5037507212925563,0.49624927870744373
E01014995,1666,832,834,0.49939975990396157,0.5006002400960384
E01033338,1575,804,771,0.5104761904761905,0.4895238095238095
E01033339,1429,686,743,0.4800559832050385,0.5199440167949615
E01014901,1685,821,864,0.4872403560830861,0.512759643916914
E01014902,1319,660,659,0.5003790750568613,0.49962092494313876
E01014903,1487,729,758,0.4902488231338265,0.5097511768661735
E01014965,1494,719,775,0.48125836680053546,0.5187416331994645
E01014964,1711,846,865,0.494447691408533,0.5055523085914669
E01014966,1576,767,809,0.4866751269035533,0.5133248730964467
E01014967,2117,1061,1056,0.5011809163911195,0.4988190836088805
E01014969,1599,795,804,0.4971857410881801,0.5028142589118199
E01033334,1609,842,767,0.5233064014916097,0.4766935985083903
E01033336,1757,860,897,0.48947068867387594,0.5105293113261241
E01014897,1498,738,760,0.49265687583444595,0.507343124165554
E01014898,1668,792,876,0.4748201438848921,0.5251798561151079
E01014899,1635,784,851,0.4795107033639144,0.5204892966360857
E01014900,1493,746,747,0.4996651038178165,0.5003348961821835
E01014959,1387,692,695,0.4989185291997116,0.5010814708002884
E01014960,1631,815,816,0.4996934396076027,0.5003065603923973
E01014961,1651,817,834,0.49485160508782555,0.5051483949121744
E01014968,1712,826,886,0.4824766355140187,0.5175233644859814
E01014865,1888,934,954,0.4947033898305085,0.5052966101694916
E01014869,1716,864,852,0.5034965034965035,0.4965034965034965
E01014870,1606,781,825,0.4863013698630137,0.5136986301369864
E01014871,1220,597,623,0.489344262295082,0.510655737704918
E01014890,2072,1021,1051,0.49276061776061775,0.5072393822393823
E01014891,1665,838,827,0.5033033033033033,0.4966966966966967
E01014955,1304,638,666,0.4892638036809816,0.5107361963190185
E01014956,1579,788,791,0.4990500316656111,0.5009499683343889
E01014957,1255,622,633,0.4956175298804781,0.5043824701195219
E01014974,1575,772,803,0.4901587301587302,0.5098412698412699
E01014977,1275,603,672,0.47294117647058825,0.5270588235294118
E01014922,1383,701,682,0.5068691250903832,0.49313087490961677
E01014923,1523,728,795,0.4780039395929087,0.5219960604070912
E01014924,1765,858,907,0.4861189801699717,0.5138810198300283
E01014973,1464,703,761,0.4801912568306011,0.519808743169399
E01014975,1574,788,786,0.5006353240152478,0.4993646759847522
E01014976,1450,721,729,0.49724137931034484,0.5027586206896552
E01014925,1494,716,778,0.47925033467202144,0.5207496653279786
E01014926,1685,800,885,0.47477744807121663,0.5252225519287834
E01014927,1677,802,875,0.4782349433512224,0.5217650566487776
E01014928,1526,751,775,0.4921363040629096,0.5078636959370905
E01014958,1175,546,629,0.4646808510638298,0.5353191489361702
E01014915,1569,767,802,0.4888463989802422,0.5111536010197578
E01015003,1621,795,826,0.4904380012338063,0.5095619987661937
E01015005,2000,1001,999,0.5005,0.4995
E01015007,1693,844,849,0.4985233313644418,0.5014766686355582
E01015008,1699,822,877,0.48381400824014126,0.5161859917598587
E01014943,1722,823,899,0.47793263646922185,0.5220673635307782
E01014944,1860,954,906,0.5129032258064516,0.4870967741935484
E01014972,1752,839,913,0.4788812785388128,0.5211187214611872
E01015002,1576,764,812,0.4847715736040609,0.5152284263959391
E01015004,1718,871,847,0.5069848661233993,0.4930151338766007
E01015006,1571,795,776,0.5060471037555697,0.4939528962444303
E01014936,1474,723,751,0.49050203527815467,0.5094979647218453
E01014938,1548,753,795,0.48643410852713176,0.5135658914728682
E01014939,1191,597,594,0.5012594458438288,0.4987405541561713
E01014940,1331,664,667,0.4988730277986476,0.5011269722013524
E01014941,1616,783,833,0.484529702970297,0.5154702970297029
E01014942,1485,733,752,0.4936026936026936,0.5063973063973064
E01014945,1699,837,862,0.492642731018246,0.5073572689817539
E01014916,1508,726,782,0.48143236074270557,0.5185676392572944
E01014917,1456,700,756,0.4807692307692308,0.5192307692307693
E01014918,1433,681,752,0.47522679692951847,0.5247732030704815
E01014919,1271,621,650,0.4885916601101495,0.5114083398898505
E01014920,1338,684,654,0.5112107623318386,0.48878923766816146
E01014921,1387,685,702,0.4938716654650324,0.5061283345349675
E01014866,1621,789,832,0.48673658235657,0.51326341764343
E01014931,1423,695,728,0.4884047786366831,0.5115952213633169
E01014932,1641,802,839,0.4887263863497867,0.5112736136502133
E01014933,1460,737,723,0.5047945205479452,0.4952054794520548
E01014934,1237,622,615,0.5028294260307195,0.4971705739692805
E01014935,1506,750,756,0.49800796812749004,0.50199203187251
E01014937,1282,626,656,0.48829953198127923,0.5117004680187207
E01015519,1471,691,780,0.4697484704282801,0.53025152957172
E01015520,1206,582,624,0.48258706467661694,0.5174129353233831
E01015521,1432,720,712,0.5027932960893855,0.4972067039106145
E01015522,1441,671,770,0.46564885496183206,0.5343511450381679
E01015523,1510,734,776,0.4860927152317881,0.5139072847682119
E01015524,1199,607,592,0.5062552126772311,0.493744787322769
E01015543,1362,662,700,0.48604992657856094,0.5139500734214391
E01015544,1666,799,867,0.47959183673469385,0.5204081632653061
E01015545,1598,774,824,0.48435544430538174,0.5156445556946183
E01015546,1702,798,904,0.4688601645123384,0.5311398354876615
E01015513,1555,769,786,0.4945337620578778,0.5054662379421222
E01015514,1266,615,651,0.48578199052132703,0.514218009478673
E01015515,1431,731,700,0.5108315863032844,0.4891684136967156
E01015516,1303,619,684,0.4750575594781274,0.5249424405218726
E01015517,1438,698,740,0.4853963838664812,0.5146036161335188
E01015555,1466,708,758,0.4829467939972715,0.5170532060027285
E01015556,1600,775,825,0.484375,0.515625
E01015557,1395,708,687,0.5075268817204301,0.4924731182795699
E01015558,1543,735,808,0.4763447828904731,0.5236552171095269
E01015559,1472,736,736,0.5,0.5
E01015560,1619,794,825,0.490426189005559,0.509573810994441
E01015526,1480,759,721,0.5128378378378379,0.4871621621621622
E01015528,1817,897,920,0.4936708860759494,0.5063291139240507
E01015529,1541,757,784,0.49123945489941595,0.508760545100584
E01015530,1677,816,861,0.4865831842576029,0.5134168157423972
E01015506,1551,785,766,0.5061250805931657,0.4938749194068343
E01015507,1613,761,852,0.4717916924984501,0.5282083075015499
E01015527,1751,841,910,0.4802969731581953,0.5197030268418047
E01015580,1660,800,860,0.4819277108433735,0.5180722891566265
E01015473,1716,830,886,0.4836829836829837,0.5163170163170163
E01015474,1644,825,819,0.5018248175182481,0.4981751824817518
E01015547,1749,895,854,0.5117209834190967,0.4882790165809034
E01015548,1577,774,803,0.49080532656943565,0.5091946734305643
E01015549,1765,867,898,0.4912181303116147,0.5087818696883852
E01015550,1802,895,907,0.49667036625971145,0.5033296337402886
E01015551,1534,725,809,0.4726205997392438,0.5273794002607562
E01015552,2106,1040,1066,0.49382716049382713,0.5061728395061729
E01015553,1631,814,817,0.49908031882280807,0.5009196811771919
E01015554,1436,696,740,0.48467966573816157,0.5153203342618384
E01015508,1400,696,704,0.49714285714285716,0.5028571428571429
E01015509,1620,838,782,0.5172839506172839,0.48271604938271606
E01015510,1874,948,926,0.5058697972251868,0.49413020277481323
E01015511,1556,807,749,0.5186375321336761,0.4813624678663239
E01015562,1537,749,788,0.48731294729993496,0.5126870527000651
E01015563,1569,811,758,0.5168897386870618,0.48311026131293816
E01015565,1607,759,848,0.4723086496577474,0.5276913503422527
E01015566,1593,808,785,0.5072190834902699,0.49278091650973005
E01015578,1606,822,784,0.5118306351183064,0.48816936488169366
E01015579,1585,804,781,0.5072555205047319,0.4927444794952681
E01015581,1516,769,747,0.5072559366754618,0.49274406332453824
E01015582,1874,940,934,0.5016008537886874,0.4983991462113127
E01032708,1642,885,757,0.5389768574908648,0.4610231425091352
E01032716,1449,774,675,0.5341614906832298,0.4658385093167702
E01015481,1744,844,900,0.48394495412844035,0.5160550458715596
E01015482,1278,656,622,0.513302034428795,0.486697965571205
E01015483,1438,692,746,0.4812239221140473,0.5187760778859527
E01015484,1403,685,718,0.48823948681397006,0.5117605131860299
E01015485,1440,722,718,0.5013888888888889,0.4986111111111111
E01015486,1439,729,710,0.5066018068102849,0.49339819318971506
E01015561,1466,761,705,0.5190995907230559,0.48090040927694405
E01015564,1566,773,793,0.49361430395913153,0.5063856960408685
E01015567,1492,761,731,0.510053619302949,0.48994638069705093
E01015568,1432,712,720,0.4972067039106145,0.5027932960893855
E01015475,2182,1197,985,0.5485792850595783,0.45142071494042163
E01015476,2251,1275,976,0.5664149266992448,0.43358507330075524
E01015477,1548,828,720,0.5348837209302325,0.46511627906976744
E01015480,2371,1322,1049,0.5575706452973429,0.4424293547026571
E01015538,1767,849,918,0.48047538200339557,0.5195246179966044
E01015572,1250,615,635,0.492,0.508
E01015573,2138,1076,1062,0.5032740879326474,0.49672591206735267
E01015575,1184,587,597,0.49577702702702703,0.504222972972973
E01015479,1618,825,793,0.5098887515451175,0.4901112484548826
E01015493,1773,927,846,0.5228426395939086,0.47715736040609136
E01015574,1640,804,836,0.4902439024390244,0.5097560975609756
E01015576,1559,741,818,0.47530468248877483,0.5246953175112251
E01015499,1270,659,611,0.5188976377952756,0.4811023622047244
E01015500,1523,731,792,0.4799737360472751,0.5200262639527249
E01015504,1372,662,710,0.48250728862973763,0.5174927113702624
E01015505,1496,740,756,0.4946524064171123,0.5053475935828877
E01015494,1783,985,798,0.5524397083567022,0.4475602916432978
E01015496,1614,867,747,0.5371747211895911,0.4628252788104089
E01015497,1592,837,755,0.5257537688442211,0.4742462311557789
E01032714,1286,734,552,0.5707620528771384,0.42923794712286156
E01032715,998,543,455,0.5440881763527055,0.4559118236472946
E01015537,1773,827,946,0.4664410603496898,0.5335589396503102
E01015539,1620,803,817,0.495679012345679,0.504320987654321
E01015540,1859,913,946,0.4911242603550296,0.5088757396449705
E01015541,1791,869,922,0.4852037967615857,0.5147962032384142
E01015542,1471,707,764,0.4806254248810333,0.5193745751189667
E01015478,1483,765,718,0.5158462575859744,0.48415374241402565
E01015498,1732,903,829,0.5213625866050808,0.47863741339491916
E01015532,1556,820,736,0.5269922879177378,0.4730077120822622
E01032706,1498,800,698,0.5340453938584779,0.465954606141522
E01032707,1876,951,925,0.5069296375266524,0.49307036247334757
E01015501,1369,694,675,0.5069393718042366,0.49306062819576335
E01015502,1545,761,784,0.4925566343042071,0.5074433656957928
E01015503,1314,633,681,0.4817351598173516,0.5182648401826484
E01015569,1510,743,767,0.49205298013245036,0.5079470198675496
E01015570,1531,800,731,0.5225342913128674,0.4774657086871326
E01015571,1590,808,782,0.5081761006289308,0.4918238993710692
E01015487,1615,814,801,0.5040247678018576,0.49597523219814244
E01015488,1439,700,739,0.4864489228630994,0.5135510771369006
E01015489,1438,720,718,0.5006954102920723,0.4993045897079277
E01015490,1285,626,659,0.48715953307392995,0.51284046692607
E01015491,1473,723,750,0.4908350305498982,0.5091649694501018
E01015492,1434,696,738,0.48535564853556484,0.5146443514644351
E01015533,1504,719,785,0.47805851063829785,0.5219414893617021
E01015534,1904,959,945,0.5036764705882353,0.4963235294117647
E01015535,1494,734,760,0.49129852744310576,0.5087014725568942
E01015536,2400,1167,1233,0.48625,0.51375
E01015583,2282,1124,1158,0.4925503943908852,0.5074496056091148
E01015584,1417,686,731,0.48412138320395204,0.515878616796048
E01015585,1642,804,838,0.48964677222898906,0.510353227771011
E01015586,1437,677,760,0.4711203897007655,0.5288796102992345
E01015587,1897,907,990,0.47812335266209804,0.521876647337902
E01015588,1837,898,939,0.48884050081654873,0.5111594991834513
E01015525,1578,797,781,0.5050697084917617,0.49493029150823825
E01032700,1612,832,780,0.5161290322580645,0.4838709677419355
E01032703,1468,718,750,0.4891008174386921,0.510899182561308
E01032705,1479,728,751,0.49222447599729546,0.5077755240027045
E01032709,1358,684,674,0.5036818851251841,0.4963181148748159
E01032713,1762,900,862,0.5107832009080591,0.489216799091941
E01032701,1219,621,598,0.5094339622641509,0.49056603773584906
E01032702,1413,713,700,0.5046001415428167,0.4953998584571833
E01032704,1419,723,696,0.5095137420718816,0.4904862579281184
E01032711,1330,675,655,0.5075187969924813,0.4924812030075188
E01032712,1408,699,709,0.49644886363636365,0.5035511363636364
E01015471,1655,836,819,0.5051359516616314,0.49486404833836856
E01015472,2754,1377,1377,0.5,0.5
E01015512,1715,853,862,0.49737609329446064,0.5026239067055394
E01015518,1561,784,777,0.5022421524663677,0.4977578475336323
E01032710,1343,675,668,0.5026061057334326,0.4973938942665674
E01015262,1352,630,722,0.46597633136094674,0.5340236686390533
E01015263,1538,731,807,0.4752925877763329,0.5247074122236671
E01015264,1323,616,707,0.4656084656084656,0.5343915343915344
E01015265,1471,737,734,0.5010197144799456,0.4989802855200544
E01015266,1494,699,795,0.4678714859437751,0.5321285140562249
E01015236,1484,744,740,0.5013477088948787,0.49865229110512127
E01015237,1358,673,685,0.4955817378497791,0.5044182621502209
E01015238,1451,679,772,0.46795313576843556,0.5320468642315644
E01015239,1529,686,843,0.4486592544146501,0.55134074558535
E01015249,1478,691,787,0.4675236806495264,0.5324763193504736
E01015250,1438,682,756,0.47426981919332406,0.5257301808066759
E01015251,1200,593,607,0.49416666666666664,0.5058333333333334
E01015252,2383,1161,1222,0.4872010071338649,0.5127989928661352
E01015253,1627,779,848,0.47879532882606024,0.5212046711739398
E01015254,1399,675,724,0.48248749106504646,0.5175125089349535
E01015257,1354,654,700,0.48301329394387,0.51698670605613
E01015258,1929,963,966,0.49922239502332816,0.5007776049766719
E01015259,1396,683,713,0.4892550143266476,0.5107449856733525
E01015260,1544,809,735,0.5239637305699482,0.47603626943005184
E01015240,1463,662,801,0.4524948735475051,0.5475051264524948
E01015241,1479,699,780,0.4726166328600406,0.5273833671399595
E01015242,1238,589,649,0.47576736672051695,0.524232633279483
E01015243,1260,592,668,0.46984126984126984,0.5301587301587302
E01015214,1407,692,715,0.4918265813788202,0.5081734186211798
E01015215,1458,720,738,0.49382716049382713,0.5061728395061729
E01015216,1429,685,744,0.4793561931420574,0.5206438068579426
E01015218,1453,688,765,0.47350309704060567,0.5264969029593943
E01015217,1528,773,755,0.5058900523560209,0.49410994764397903
E01015255,1619,890,729,0.5497220506485485,0.4502779493514515
E01015256,1793,971,822,0.5415504740658115,0.45844952593418853
E01015261,1957,966,991,0.4936126724578436,0.5063873275421563
E01015267,1527,777,750,0.5088408644400786,0.4911591355599214
E01015268,1570,788,782,0.5019108280254777,0.4980891719745223
E01015269,1631,784,847,0.48068669527896996,0.51931330472103
E01015270,1627,809,818,0.4972341733251383,0.5027658266748617
E01015271,1422,668,754,0.469760900140647,0.530239099859353
E01015224,1493,731,762,0.4896182183523108,0.5103817816476892
E01015225,1467,693,774,0.4723926380368098,0.5276073619631901
E01015226,1411,674,737,0.47767540751240256,0.5223245924875974
E01015227,1535,744,791,0.48469055374592834,0.5153094462540717
E01015228,1505,685,820,0.45514950166112955,0.5448504983388704
E01015230,1415,661,754,0.46713780918727915,0.5328621908127208
E01015202,1513,745,768,0.49239920687376076,0.5076007931262393
E01015203,1272,602,670,0.47327044025157233,0.5267295597484277
E01015204,1375,685,690,0.49818181818181817,0.5018181818181818
E01015205,1489,697,792,0.46809939556749497,0.5319006044325051
E01015206,1484,696,788,0.46900269541778977,0.5309973045822103
E01015190,1666,842,824,0.5054021608643458,0.49459783913565425
E01015191,1662,797,865,0.4795427196149218,0.5204572803850782
E01015192,1450,718,732,0.49517241379310345,0.5048275862068966
E01015193,1283,595,688,0.4637568199532346,0.5362431800467654
E01015194,1400,679,721,0.485,0.515
E01015195,1508,738,770,0.48938992042440316,0.5106100795755968
E01015196,1508,727,781,0.48209549071618035,0.5179045092838196
E01015229,1368,626,742,0.45760233918128657,0.5423976608187134
E01015231,1593,785,808,0.49278091650973005,0.5072190834902699
E01015232,1651,797,854,0.48273773470623865,0.5172622652937614
E01015233,1399,659,740,0.4710507505360972,0.5289492494639028
E01015234,1318,623,695,0.47268588770864944,0.5273141122913505
E01015235,1689,796,893,0.4712847838957963,0.5287152161042037
E01015219,1393,635,758,0.45585068198133527,0.5441493180186647
E01015220,1370,638,732,0.4656934306569343,0.5343065693430656
E01015221,1430,665,765,0.46503496503496505,0.534965034965035
E01015222,1413,656,757,0.46426043878273177,0.5357395612172682
E01015223,1304,648,656,0.49693251533742333,0.5030674846625767
E01015197,1439,683,756,0.47463516330785266,0.5253648366921473
E01015198,1567,736,831,0.4696873005743459,0.5303126994256541
E01015199,1299,624,675,0.48036951501154734,0.5196304849884527
E01015200,1016,483,533,0.47539370078740156,0.5246062992125984
E01015201,1336,655,681,0.4902694610778443,0.5097305389221557
E01015183,1320,638,682,0.48333333333333334,0.5166666666666667
E01015184,1311,620,691,0.47292143401983217,0.5270785659801678
E01015185,1325,637,688,0.4807547169811321,0.519245283018868
E01015186,1339,660,679,0.49290515309932786,0.5070948469006722
E01015187,1384,643,741,0.46459537572254334,0.5354046242774566
E01015188,1482,686,796,0.46288798920377866,0.5371120107962213
E01015189,1170,560,610,0.47863247863247865,0.5213675213675214
E01015244,1463,697,766,0.4764183185235817,0.5235816814764184
E01015245,1312,646,666,0.4923780487804878,0.5076219512195121
E01015246,1440,671,769,0.46597222222222223,0.5340277777777778
E01015247,1707,828,879,0.4850615114235501,0.5149384885764499
E01015248,1440,682,758,0.4736111111111111,0.5263888888888889
E01015207,1577,750,827,0.4755865567533291,0.5244134432466709
E01015208,1852,878,974,0.4740820734341253,0.5259179265658748
E01015209,1395,667,728,0.47813620071684587,0.5218637992831541
E01015210,1507,680,827,0.45122760451227606,0.5487723954877239
E01015211,1478,699,779,0.472936400541272,0.527063599458728
E01015212,1394,696,698,0.49928263988522237,0.5007173601147776
E01015213,1433,716,717,0.49965108164689465,0.5003489183531054
E01031841,1833,904,929,0.49318057828696127,0.5068194217130387
E01031868,1777,897,880,0.5047833427124367,0.4952166572875633
E01031873,1869,897,972,0.4799357945425361,0.5200642054574639
E01031874,1529,737,792,0.48201438848920863,0.5179856115107914
E01031884,1627,804,823,0.4941610325752919,0.505838967424708
E01031861,2409,1132,1277,0.46990452469904526,0.5300954753009548
E01031862,1554,747,807,0.4806949806949807,0.5193050193050193
E01031863,1171,550,621,0.46968403074295473,0.5303159692570453
E01031864,1329,639,690,0.48081264108352145,0.5191873589164786
E01031865,1932,971,961,0.5025879917184265,0.4974120082815735
E01031866,1567,777,790,0.4958519463943842,0.5041480536056159
E01031869,1859,868,991,0.4669176976869285,0.5330823023130715
E01031870,1775,865,910,0.48732394366197185,0.5126760563380282
E01031871,1659,796,863,0.4798071127185051,0.5201928872814949
E01031850,1894,896,998,0.4730728616684266,0.5269271383315733
E01031851,1518,738,780,0.48616600790513836,0.5138339920948617
E01031852,2041,984,1057,0.4821166095051445,0.5178833904948554
E01032688,1331,646,685,0.48534936138241924,0.5146506386175808
E01032689,1350,645,705,0.4777777777777778,0.5222222222222223
E01032692,1238,601,637,0.48546042003231016,0.5145395799676898
E01032693,1371,680,691,0.4959883296863603,0.5040116703136397
E01031853,1420,696,724,0.49014084507042255,0.5098591549295775
E01031854,1767,846,921,0.47877758913412566,0.5212224108658744
E01031855,1511,725,786,0.4798146922567836,0.5201853077432164
E01031856,1564,756,808,0.4833759590792839,0.5166240409207161
E01031845,1577,783,794,0.4965123652504756,0.5034876347495244
E01031846,1651,805,846,0.4875832828588734,0.5124167171411266
E01031848,2142,1241,901,0.5793650793650794,0.42063492063492064
E01031872,1622,775,847,0.47780517879161527,0.5221948212083847
E01031876,1502,716,786,0.4766977363515313,0.5233022636484687
E01031843,1782,862,920,0.4837261503928171,0.5162738496071829
E01031847,1772,868,904,0.4898419864559819,0.510158013544018
E01031849,1679,859,820,0.5116140559857058,0.48838594401429425
E01031877,1836,914,922,0.49782135076252726,0.5021786492374728
E01031844,1926,927,999,0.48130841121495327,0.5186915887850467
E01031857,1631,803,828,0.49233599019006746,0.5076640098099325
E01031858,2084,1036,1048,0.4971209213051823,0.5028790786948176
E01031883,1775,854,921,0.4811267605633803,0.5188732394366197
E01031842,1909,923,986,0.48349921424829756,0.5165007857517024
E01031867,1828,905,923,0.4950765864332604,0.5049234135667396
E01031882,2031,1004,1027,0.49433776464795665,0.5056622353520434
E01031859,1743,808,935,0.4635685599541021,0.5364314400458978
E01031860,1510,740,770,0.4900662251655629,0.5099337748344371
E01031878,2621,1551,1070,0.5917588706600534,0.4082411293399466
E01031879,2120,1263,857,0.595754716981132,0.4042452830188679
E01031880,3902,2842,1060,0.7283444387493593,0.2716555612506407
E01032697,1481,745,736,0.5030384875084403,0.49696151249155973
E01032698,1671,818,853,0.48952722920406944,0.5104727707959306
E01031887,1762,861,901,0.48864926220204313,0.5113507377979569
E01031934,1751,873,878,0.4985722444317533,0.5014277555682467
E01031935,1753,847,906,0.4831717056474615,0.5168282943525385
E01031936,1478,733,745,0.4959404600811908,0.5040595399188093
E01031885,1587,816,771,0.5141776937618148,0.48582230623818523
E01031947,1657,805,852,0.4858177429088715,0.5141822570911285
E01031948,2105,1059,1046,0.5030878859857483,0.4969121140142518
E01031949,1808,880,928,0.48672566371681414,0.5132743362831859
E01031954,1347,663,684,0.4922048997772829,0.5077951002227171
E01031955,1623,768,855,0.4731977818853974,0.5268022181146026
E01031956,1301,622,679,0.47809377401998465,0.5219062259800153
E01031962,1330,666,664,0.5007518796992482,0.4992481203007519
E01031886,1414,711,703,0.5028288543140028,0.4971711456859972
E01031892,1390,671,719,0.4827338129496403,0.5172661870503598
E01031893,1576,809,767,0.5133248730964467,0.4866751269035533
E01031894,1517,765,752,0.5042847725774555,0.4957152274225445
E01031957,1477,691,786,0.46784021665538256,0.5321597833446174
E01031958,1375,676,699,0.49163636363636365,0.5083636363636364
E01031959,1615,785,830,0.48606811145510836,0.5139318885448917
E01031960,1388,697,691,0.5021613832853026,0.4978386167146974
E01031963,1831,873,958,0.4767886400873839,0.523211359912616
E01031964,1687,851,836,0.5044457617071725,0.4955542382928275
E01031967,1908,924,984,0.48427672955974843,0.5157232704402516
E01031969,1438,734,704,0.5104311543810849,0.48956884561891517
E01031944,1064,527,537,0.49530075187969924,0.5046992481203008
E01031946,2090,1209,881,0.5784688995215311,0.4215311004784689
E01031961,1309,646,663,0.4935064935064935,0.5064935064935064
E01031965,1385,671,714,0.4844765342960289,0.5155234657039711
E01031966,1537,753,784,0.48991541964866625,0.5100845803513337
E01031968,1599,784,815,0.4903064415259537,0.5096935584740463
E01032699,2306,1139,1167,0.49392888117953165,0.5060711188204683
E01031939,2171,1053,1118,0.48502994011976047,0.5149700598802395
E01031940,2235,1109,1126,0.4961968680089485,0.5038031319910514
E01031950,1397,681,716,0.4874731567644954,0.5125268432355047
E01031951,1431,815,616,0.5695317959468903,0.4304682040531097
E01031907,2524,1239,1285,0.4908874801901743,0.5091125198098256
E01031910,1453,722,731,0.4969029593943565,0.5030970406056435
E01031914,1325,636,689,0.48,0.52
E01031915,1383,676,707,0.48879248011569054,0.5112075198843095
E01031919,1594,780,814,0.4893350062735257,0.5106649937264742
E01031920,1262,636,626,0.5039619651347068,0.4960380348652932
E01031905,1465,726,739,0.4955631399317406,0.5044368600682594
E01031906,1467,740,727,0.5044308111792775,0.49556918882072254
E01031908,1628,793,835,0.4871007371007371,0.5128992628992629
E01031909,1276,621,655,0.48667711598746083,0.5133228840125392
E01031925,1180,566,614,0.47966101694915253,0.5203389830508475
E01031926,1507,744,763,0.4936960849369608,0.5063039150630392
E01031927,1306,653,653,0.5,0.5
E01031911,1369,651,718,0.47552958363769177,0.5244704163623083
E01031912,1366,688,678,0.5036603221083455,0.49633967789165445
E01031913,1397,690,707,0.49391553328561205,0.506084466714388
E01031917,1416,704,712,0.4971751412429379,0.5028248587570622
E01031918,2460,1202,1258,0.4886178861788618,0.5113821138211382
E01031928,1345,635,710,0.4721189591078067,0.5278810408921933
E01031891,2301,1130,1171,0.49109083007388094,0.5089091699261191
E01031904,2154,1027,1127,0.4767873723305478,0.5232126276694522
E01031937,1131,558,573,0.493368700265252,0.506631299734748
E01031938,1416,707,709,0.4992937853107345,0.5007062146892656
E01031916,1299,638,661,0.4911470361816782,0.5088529638183218
E01031921,1468,747,721,0.5088555858310627,0.49114441416893734
E01031922,1273,667,606,0.5239591516103692,0.4760408483896308
E01031923,1374,695,679,0.5058224163027657,0.49417758369723436
E01031924,1663,813,850,0.4888755261575466,0.5111244738424534
E01031895,1594,794,800,0.4981179422835634,0.5018820577164367
E01031896,1184,516,668,0.4358108108108108,0.5641891891891891
E01031897,2209,1128,1081,0.5106382978723404,0.48936170212765956
E01031898,1808,735,1073,0.4065265486725664,0.5934734513274337
E01032690,1794,909,885,0.5066889632107023,0.49331103678929766
E01032691,1537,773,764,0.5029277813923227,0.4970722186076773
E01031900,2209,1048,1161,0.47442281575373474,0.5255771842462653
E01031901,1458,687,771,0.4711934156378601,0.5288065843621399
E01031902,1157,595,562,0.5142610198789974,0.4857389801210026
E01031903,2324,1142,1182,0.49139414802065406,0.5086058519793459
E01031888,1333,645,688,0.4838709677419355,0.5161290322580645
E01031889,1859,925,934,0.4975793437331899,0.5024206562668101
E01031890,1484,730,754,0.4919137466307278,0.5080862533692723
E01031929,1318,643,675,0.48786039453717756,0.5121396054628224
E01031930,1654,942,712,0.5695284159613059,0.43047158403869407
E01031931,1641,790,851,0.48141377209018893,0.5185862279098111
E01031932,1447,680,767,0.469937802349689,0.530062197650311
E01031933,1586,759,827,0.478562421185372,0.521437578814628
E01031941,1598,768,830,0.4806007509386733,0.5193992490613266
E01031942,1431,723,708,0.5052410901467506,0.4947589098532495
E01031952,2423,1137,1286,0.4692529921584812,0.5307470078415187
E01031953,2886,1391,1495,0.481981981981982,0.5180180180180181
E01031988,1588,800,788,0.5037783375314862,0.49622166246851385
E01031998,3024,1823,1201,0.6028439153439153,0.39715608465608465
E01032026,1601,796,805,0.4971892567145534,0.5028107432854466
E01032696,2980,1801,1179,0.6043624161073825,0.39563758389261744
E01031989,1562,800,762,0.5121638924455826,0.4878361075544174
E01031996,1397,679,718,0.4860415175375805,0.5139584824624195
E01031997,1434,720,714,0.502092050209205,0.497907949790795
E01031999,1524,751,773,0.4927821522309711,0.5072178477690289
E01031974,1264,616,648,0.4873417721518987,0.5126582278481012
E01031975,1260,592,668,0.46984126984126984,0.5301587301587302
E01031976,1420,709,711,0.4992957746478873,0.5007042253521127
E01031977,2944,1467,1477,0.4983016304347826,0.5016983695652174
E01031978,1753,855,898,0.4877353108956075,0.5122646891043925
E01031979,2083,1011,1072,0.485357657225156,0.514642342774844
E01032013,2099,1052,1047,0.5011910433539781,0.49880895664602193
E01032032,1601,775,826,0.4840724547158026,0.5159275452841974
E01032033,1424,714,710,0.5014044943820225,0.49859550561797755
E01032034,1402,670,732,0.47788873038516405,0.5221112696148359
E01032010,2090,1005,1085,0.48086124401913877,0.5191387559808612
E01032035,1535,748,787,0.48729641693811077,0.5127035830618892
E01032036,1465,723,742,0.49351535836177474,0.5064846416382253
E01032037,1470,709,761,0.482312925170068,0.5176870748299319
E01031984,1600,764,836,0.4775,0.5225
E01031985,1309,621,688,0.4744079449961803,0.5255920550038197
E01031986,1248,591,657,0.4735576923076923,0.5264423076923077
E01032017,1488,691,797,0.4643817204301075,0.5356182795698925
E01031980,1538,763,775,0.4960988296488947,0.5039011703511054
E01031981,1636,766,870,0.4682151589242054,0.5317848410757946
E01031982,1448,710,738,0.4903314917127072,0.5096685082872928
E01031983,1747,826,921,0.4728105323411563,0.5271894676588438
E01032018,1608,789,819,0.4906716417910448,0.5093283582089553
E01032019,1529,704,825,0.460431654676259,0.539568345323741
E01032020,1495,725,770,0.48494983277591974,0.5150501672240803
E01032025,1472,747,725,0.5074728260869565,0.49252717391304346
E01031990,1965,938,1027,0.47735368956743,0.5226463104325699
E01032004,2269,1105,1164,0.4869986778316439,0.5130013221683561
E01032027,1333,650,683,0.4876219054763691,0.5123780945236309
E01032038,1321,619,702,0.46858440575321725,0.5314155942467828
E01032039,1363,627,736,0.4600146735143067,0.5399853264856933
E01032040,1459,684,775,0.4688142563399589,0.5311857436600411
E01032001,1515,774,741,0.5108910891089109,0.4891089108910891
E01032002,1395,683,712,0.48960573476702507,0.5103942652329749
E01032003,1458,734,724,0.5034293552812071,0.49657064471879286
E01032024,2344,1152,1192,0.49146757679180886,0.5085324232081911
E01032014,1721,839,882,0.4875072632190587,0.5124927367809413
E01032015,1443,692,751,0.47955647955647956,0.5204435204435205
E01032016,1367,653,714,0.4776883686905633,0.5223116313094367
E01032021,1606,728,878,0.4533001245330012,0.5466998754669987
E01032000,2314,1095,1219,0.4732065687121867,0.5267934312878133
E01032011,2532,1201,1331,0.47432859399684046,0.5256714060031595
E01032012,1806,826,980,0.4573643410852713,0.5426356589147286
E01032008,1513,750,763,0.495703899537343,0.5042961004626569
E01032009,1819,863,956,0.47443650357339195,0.525563496426608
E01032022,1671,743,928,0.4446439257929384,0.5553560742070617
E01032005,1306,612,694,0.4686064318529862,0.5313935681470138
E01032006,1254,572,682,0.45614035087719296,0.543859649122807
E01032007,1348,655,693,0.48590504451038574,0.5140949554896143
E01032023,1804,835,969,0.46286031042128606,0.5371396895787139
E01031970,1575,722,853,0.45841269841269844,0.5415873015873016
E01031971,1182,556,626,0.4703891708967851,0.5296108291032149
E01031972,1504,745,759,0.4953457446808511,0.504654255319149
E01032041,1925,938,987,0.48727272727272725,0.5127272727272727
E01032042,1723,828,895,0.4805571677307023,0.5194428322692978
E01031991,2121,956,1165,0.4507307873644507,0.5492692126355493
E01032029,1373,650,723,0.47341587764020393,0.526584122359796
E01032030,1550,740,810,0.4774193548387097,0.5225806451612903
E01032031,1075,523,552,0.4865116279069767,0.5134883720930232
E01031973,1875,910,965,0.48533333333333334,0.5146666666666667
E01031992,1483,725,758,0.48887390424814564,0.5111260957518543
E01031993,1456,706,750,0.4848901098901099,0.5151098901098901
E01031994,1361,633,728,0.4650991917707568,0.5349008082292432
E01031995,1617,798,819,0.4935064935064935,0.5064935064935064
E01032063,1910,958,952,0.5015706806282723,0.49842931937172774
E01032064,1335,649,686,0.4861423220973783,0.5138576779026217
E01032065,1569,771,798,0.491395793499044,0.5086042065009561
E01032073,1422,712,710,0.5007032348804501,0.49929676511954996
E01032074,1108,535,573,0.48285198555956677,0.5171480144404332
E01032043,1321,574,747,0.4345193035579107,0.5654806964420893
E01032044,1374,662,712,0.48180494905385735,0.5181950509461426
E01032057,1193,590,603,0.4945515507124895,0.5054484492875104
E01032070,1510,769,741,0.509271523178808,0.49072847682119203
E01032071,2311,1168,1143,0.5054089138900909,0.49459108610990915
E01032072,2035,1010,1025,0.4963144963144963,0.5036855036855037
E01032062,1635,793,842,0.4850152905198777,0.5149847094801223
E01032066,1514,725,789,0.47886393659180976,0.5211360634081902
E01032067,1531,773,758,0.5048987589810582,0.4951012410189419
E01032068,1387,683,704,0.4924297043979812,0.5075702956020187
E01032069,1266,625,641,0.49368088467614535,0.5063191153238547
E01032058,1415,697,718,0.4925795053003534,0.5074204946996467
E01032059,1813,869,944,0.4793160507446222,0.5206839492553779
E01032060,1546,732,814,0.47347994825355755,0.5265200517464425
E01032061,1162,540,622,0.46471600688468157,0.5352839931153184
E01032045,1476,693,783,0.4695121951219512,0.5304878048780488
E01032046,1549,727,822,0.4693350548741123,0.5306649451258877
E01032047,1382,659,723,0.4768451519536903,0.5231548480463097
E01032048,1698,819,879,0.4823321554770318,0.5176678445229682
E01032049,1550,723,827,0.4664516129032258,0.5335483870967742
E01032050,1747,810,937,0.4636519748139668,0.5363480251860332
E01032077,1678,841,837,0.50119189511323,0.49880810488676997
E01032078,2872,1410,1462,0.4909470752089137,0.5090529247910863
E01032079,1496,741,755,0.49532085561497324,0.5046791443850267
E01032080,1719,825,894,0.4799301919720768,0.5200698080279232
E01032085,1652,794,858,0.48062953995157387,0.5193704600484261
E01032086,2401,1240,1161,0.5164514785506039,0.4835485214493961
E01032087,2113,1026,1087,0.4855655466161855,0.5144344533838144
E01032099,2959,1410,1549,0.4765123352483947,0.5234876647516052
E01032100,1507,731,776,0.48506967485069674,0.5149303251493033
E01032101,1670,827,843,0.49520958083832334,0.5047904191616767
E01032102,1563,750,813,0.4798464491362764,0.5201535508637236
E01032096,1876,892,984,0.47547974413646055,0.5245202558635395
E01032097,1857,898,959,0.48357565966612814,0.5164243403338719
E01032098,1748,862,886,0.4931350114416476,0.5068649885583524
E01032092,1402,691,711,0.492867332382311,0.507132667617689
E01032093,1860,882,978,0.47419354838709676,0.5258064516129032
E01032094,2329,1157,1172,0.4967797337913267,0.5032202662086732
E01032095,1698,848,850,0.4994110718492344,0.5005889281507656
E01032088,1524,732,792,0.48031496062992124,0.5196850393700787
E01032089,1478,758,720,0.5128552097428958,0.4871447902571042
E01032090,1435,688,747,0.4794425087108014,0.5205574912891986
E01032091,1232,609,623,0.4943181818181818,0.5056818181818182
E01032053,1424,709,715,0.4978932584269663,0.5021067415730337
E01032083,2274,1117,1157,0.49120492524186454,0.5087950747581355
E01032084,2569,1212,1357,0.47177890229661346,0.5282210977033865
E01032052,1274,630,644,0.4945054945054945,0.5054945054945055
E01032054,1285,627,658,0.48793774319066147,0.5120622568093385
E01032055,1235,601,634,0.48663967611336034,0.5133603238866397
E01032056,1357,664,693,0.48931466470154755,0.5106853352984525
E01032121,1565,769,796,0.4913738019169329,0.5086261980830671
E01032115,1749,852,897,0.48713550600343053,0.5128644939965694
E01032116,2582,1264,1318,0.4895429899302866,0.5104570100697134
E01032117,2657,1283,1374,0.4828754234098607,0.5171245765901392
E01032118,1551,739,812,0.4764667956157318,0.5235332043842682
E01032119,1866,890,976,0.4769560557341908,0.5230439442658092
E01032694,1648,792,856,0.48058252427184467,0.5194174757281553
E01032695,1437,692,745,0.4815588030619346,0.5184411969380655
E01032104,1349,690,659,0.5114899925871016,0.48851000741289846
E01032105,1458,696,762,0.4773662551440329,0.522633744855967
E01032107,1554,800,754,0.5148005148005148,0.4851994851994852
E01032108,1336,610,726,0.4565868263473054,0.5434131736526946
E01032110,1604,791,813,0.493142144638404,0.506857855361596
E01032111,1272,620,652,0.48742138364779874,0.5125786163522013
E01032112,1479,701,778,0.47396889790398916,0.5260311020960108
E01032113,1373,661,712,0.48142753095411506,0.5185724690458849
E01032103,1680,811,869,0.48273809523809524,0.5172619047619048
E01032106,1397,645,752,0.4617036506800286,0.5382963493199714
E01032109,1472,709,763,0.48165760869565216,0.5183423913043478
E01032114,1516,744,772,0.49076517150395776,0.5092348284960422
E01032051,1324,641,683,0.48413897280966767,0.5158610271903323
E01032075,1342,651,691,0.485096870342772,0.5149031296572281
E01032076,1221,577,644,0.4725634725634726,0.5274365274365275
E01032081,1226,574,652,0.46818923327895595,0.531810766721044
E01032082,1225,591,634,0.48244897959183675,0.5175510204081633
E01019902,2000,985,1015,0.4925,0.5075
E01019938,2201,1114,1087,0.506133575647433,0.493866424352567
E01019967,1291,638,653,0.4941905499612703,0.5058094500387297
E01019927,1234,566,668,0.4586709886547812,0.5413290113452188
E01019932,1612,758,854,0.47022332506203474,0.5297766749379652
E01019933,1208,575,633,0.4759933774834437,0.5240066225165563
E01019934,1865,874,991,0.46863270777479893,0.5313672922252011
E01019928,1450,684,766,0.47172413793103446,0.5282758620689655
E01019929,1445,687,758,0.4754325259515571,0.524567474048443
E01019930,1385,643,742,0.4642599277978339,0.535740072202166
E01019931,1284,614,670,0.4781931464174455,0.5218068535825545
E01019925,1288,647,641,0.5023291925465838,0.49767080745341613
E01019959,1152,569,583,0.4939236111111111,0.5060763888888888
E01019960,1362,671,691,0.49265785609397944,0.5073421439060205
E01019962,2380,1142,1238,0.47983193277310926,0.5201680672268908
E01032628,2049,996,1053,0.486090775988287,0.513909224011713
E01019886,2603,1272,1331,0.48866692278140605,0.5113330772185939
E01019887,1426,677,749,0.4747545582047686,0.5252454417952315
E01019888,1599,730,869,0.45653533458411505,0.5434646654158849
E01019889,1482,718,764,0.4844804318488529,0.5155195681511471
E01019966,1070,528,542,0.4934579439252336,0.5065420560747663
E01019891,1462,733,729,0.5013679890560876,0.49863201094391246
E01019892,1553,768,785,0.49452672247263363,0.5054732775273664
E01019893,1827,868,959,0.47509578544061304,0.524904214559387
E01019903,2041,991,1050,0.48554630083292505,0.514453699167075
E01019899,1335,620,715,0.46441947565543074,0.5355805243445693
E01019900,1830,871,959,0.47595628415300545,0.5240437158469945
E01019935,1237,589,648,0.4761519805982215,0.5238480194017785
E01019936,1121,548,573,0.4888492417484389,0.5111507582515611
E01019961,2521,1219,1302,0.48353827846092823,0.5164617215390718
E01019939,1484,705,779,0.4750673854447439,0.5249326145552561
E01019940,1577,742,835,0.4705136334812936,0.5294863665187064
E01019942,1783,867,916,0.48625911385305665,0.5137408861469434
E01019943,1574,767,807,0.4872935196950445,0.5127064803049556
E01019944,1541,721,820,0.46787800129785856,0.5321219987021415
E01019890,1824,896,928,0.49122807017543857,0.5087719298245614
E01019901,1328,651,677,0.49021084337349397,0.509789156626506
E01019951,2187,1012,1175,0.46273433927754914,0.5372656607224509
E01019946,1401,668,733,0.476802284082798,0.523197715917202
E01019947,1787,794,993,0.4443200895355344,0.5556799104644656
E01019948,1267,589,678,0.4648776637726914,0.5351223362273086
E01019949,1421,644,777,0.45320197044334976,0.5467980295566502
E01019950,1220,565,655,0.46311475409836067,0.5368852459016393
E01019952,1711,758,953,0.4430157802454705,0.5569842197545295
E01019953,1533,736,797,0.4801043705153294,0.5198956294846706
E01019954,1483,668,815,0.45043830074173974,0.5495616992582603
E01019955,1645,785,860,0.47720364741641336,0.5227963525835866
E01019956,1639,715,924,0.436241610738255,0.5637583892617449
E01019957,1727,763,964,0.4418066010422698,0.5581933989577301
E01019958,1812,844,968,0.46578366445916114,0.5342163355408388
E01019937,2095,997,1098,0.4758949880668258,0.5241050119331743
E01019945,2120,1047,1073,0.49386792452830186,0.5061320754716981
E01019963,1605,763,842,0.4753894080996885,0.5246105919003116
E01019898,2326,1169,1157,0.5025795356835769,0.49742046431642306
E01019964,1892,1347,545,0.7119450317124736,0.2880549682875264
E01019965,1763,855,908,0.48496880317640384,0.5150311968235961
E01019904,1359,623,736,0.45842531272994846,0.5415746872700515
E01019905,2020,995,1025,0.49257425742574257,0.5074257425742574
E01019906,1446,663,783,0.45850622406639,0.5414937759336099
E01019907,1495,727,768,0.4862876254180602,0.5137123745819397
E01019908,1751,830,921,0.47401484865790977,0.5259851513420902
E01019909,1790,852,938,0.4759776536312849,0.524022346368715
E01019910,1637,811,826,0.4954184483811851,0.5045815516188149
E01019911,1541,698,843,0.45295262816353016,0.5470473718364698
E01019894,1403,621,782,0.4426229508196721,0.5573770491803278
E01019895,1377,640,737,0.4647785039941903,0.5352214960058097
E01019896,1634,720,914,0.44063647490820074,0.5593635250917993
E01019897,1553,736,817,0.4739214423696072,0.5260785576303928
E01019920,1483,692,791,0.466621712744437,0.533378287255563
E01019921,1561,729,832,0.46700832799487507,0.5329916720051249
E01019922,1432,634,798,0.44273743016759776,0.5572625698324022
E01019923,1232,603,629,0.48944805194805197,0.510551948051948
E01019924,1515,711,804,0.4693069306930693,0.5306930693069307
E01019916,1891,924,967,0.48863035430988894,0.511369645690111
E01019917,1537,721,816,0.4690956408588159,0.5309043591411842
E01019918,1880,920,960,0.48936170212765956,0.5106382978723404
E01019919,1717,834,883,0.4857309260337799,0.5142690739662201
E01019912,1688,757,931,0.4484597156398104,0.5515402843601895
E01019913,1574,691,883,0.43900889453621345,0.5609911054637865
E01019914,2195,1051,1144,0.4788154897494305,0.5211845102505694
E01019915,1688,775,913,0.4591232227488152,0.5408767772511849
E01019998,1423,694,729,0.4877020379479972,0.5122979620520028
E01019999,1302,643,659,0.49385560675883255,0.5061443932411674
E01020001,1302,615,687,0.47235023041474655,0.5276497695852534
E01033233,4992,2433,2559,0.4873798076923077,0.5126201923076923
E01019990,1344,637,707,0.4739583333333333,0.5260416666666666
E01019991,1500,726,774,0.484,0.516
E01019993,1174,598,576,0.5093696763202725,0.4906303236797274
E01020000,1316,616,700,0.46808510638297873,0.5319148936170213
E01020007,1491,775,716,0.5197853789403085,0.4802146210596915
E01019992,1503,701,802,0.46640053226879574,0.5335994677312043
E01020002,1482,677,805,0.45681511470985153,0.5431848852901484
E01020003,1631,767,864,0.4702636419374617,0.5297363580625383
E01020004,1480,702,778,0.4743243243243243,0.5256756756756756
E01020005,1861,915,946,0.491671144545943,0.5083288554540569
E01019997,1530,748,782,0.4888888888888889,0.5111111111111111
E01020019,1783,757,1026,0.42456533931575996,0.5754346606842401
E01020020,1748,829,919,0.4742562929061785,0.5257437070938215
E01020021,1653,930,723,0.5626134301270418,0.43738656987295826
E01020022,1707,853,854,0.4997070884592853,0.5002929115407148
E01019980,1681,838,843,0.49851279000594884,0.5014872099940512
E01019982,1628,800,828,0.4914004914004914,0.5085995085995086
E01019983,1469,709,760,0.48264125255275697,0.517358747447243
E01019984,1363,693,670,0.5084372707263389,0.491562729273661
E01019985,1405,664,741,0.47259786476868326,0.5274021352313167
E01019987,1705,819,886,0.48035190615835777,0.5196480938416422
E01019989,1173,543,630,0.4629156010230179,0.5370843989769821
E01020006,2041,1036,1005,0.507594316511514,0.492405683488486
E01020008,1773,923,850,0.5205865764241399,0.47941342357586014
E01020009,1481,769,712,0.5192437542201216,0.48075624577987847
E01019986,1505,717,788,0.4764119601328904,0.5235880398671097
E01020036,1485,716,769,0.48215488215488217,0.5178451178451179
E01020037,1393,650,743,0.46661880832735103,0.533381191672649
E01020039,1868,891,977,0.47698072805139186,0.5230192719486081
E01020040,1306,633,673,0.48468606431852984,0.5153139356814701
E01019994,1532,755,777,0.49281984334203655,0.5071801566579635
E01019995,1417,722,695,0.5095271700776288,0.49047282992237123
E01020016,2147,1145,1002,0.5333022822543083,0.4666977177456917
E01020017,2488,1287,1201,0.5172829581993569,0.48271704180064307
E01020018,2000,993,1007,0.4965,0.5035
E01019996,1372,637,735,0.4642857142857143,0.5357142857142857
E01020023,2203,1047,1156,0.4752610077167499,0.5247389922832502
E01020024,1531,688,843,0.44937949052906595,0.550620509470934
E01020025,1481,699,782,0.47197839297771776,0.5280216070222823
E01019975,1369,670,699,0.48940832724616506,0.5105916727538349
E01020029,1601,810,791,0.5059337913803873,0.49406620861961276
E01020030,1812,866,946,0.47792494481236203,0.522075055187638
E01020031,1590,747,843,0.469811320754717,0.530188679245283
E01020032,1452,747,705,0.5144628099173554,0.4855371900826446
E01020026,1736,850,886,0.48963133640552997,0.5103686635944701
E01020027,1586,797,789,0.5025220680958385,0.4974779319041614
E01020035,1615,780,835,0.48297213622291024,0.5170278637770898
E01020038,1436,697,739,0.4853760445682451,0.5146239554317549
E01033232,1462,743,719,0.5082079343365253,0.49179206566347466
E01033234,1472,739,733,0.5020380434782609,0.49796195652173914
E01019973,1451,703,748,0.4844934527911785,0.5155065472088215
E01019974,1422,677,745,0.4760900140646976,0.5239099859353024
E01019976,1378,623,755,0.4521044992743106,0.5478955007256894
E01019977,1481,716,765,0.4834571235651587,0.5165428764348413
E01019981,1443,719,724,0.4982674982674983,0.5017325017325017
E01019988,1441,671,770,0.46564885496183206,0.5343511450381679
E01020010,1825,848,977,0.46465753424657535,0.5353424657534247
E01020013,1323,643,680,0.4860166288737717,0.5139833711262283
E01020014,1568,764,804,0.4872448979591837,0.5127551020408163
E01020015,1819,891,928,0.48982957669048927,0.5101704233095107
E01019968,1541,723,818,0.4691758598312784,0.5308241401687216
E01019969,1310,659,651,0.5030534351145038,0.49694656488549616
E01019970,1363,637,726,0.4673514306676449,0.532648569332355
E01019971,1616,827,789,0.5117574257425742,0.48824257425742573
E01019972,1401,675,726,0.4817987152034261,0.5182012847965739
E01020011,1219,592,627,0.4856439704675964,0.5143560295324036
E01020012,1468,668,800,0.4550408719346049,0.5449591280653951
E01020033,1655,769,886,0.4646525679758308,0.5353474320241692
E01033235,1232,517,715,0.41964285714285715,0.5803571428571429
E01033236,1017,453,564,0.44542772861356933,0.5545722713864307
E01020046,1571,781,790,0.49713558243157224,0.5028644175684277
E01020049,1307,662,645,0.5065034429992349,0.4934965570007651
E01020050,2105,998,1107,0.47410926365795725,0.5258907363420428
E01020077,1603,804,799,0.5015595757953837,0.4984404242046163
E01020047,2146,1014,1132,0.4725069897483691,0.527493010251631
E01020051,1800,861,939,0.47833333333333333,0.5216666666666666
E01020066,2835,1397,1438,0.4927689594356261,0.5072310405643738
E01020080,1266,623,643,0.4921011058451817,0.5078988941548184
E01020063,2448,1201,1247,0.49060457516339867,0.5093954248366013
E01020074,2137,1058,1079,0.49508656995788486,0.5049134300421151
E01020075,1902,935,967,0.49158780231335436,0.5084121976866456
E01020052,1787,858,929,0.4801343033016228,0.5198656966983771
E01020053,1463,699,764,0.47778537252221465,0.5222146274777854
E01020065,1978,994,984,0.5025278058645096,0.4974721941354904
E01020067,1972,944,1028,0.4787018255578093,0.5212981744421906
E01020048,2079,1049,1030,0.5045695045695046,0.49543049543049544
E01020078,1367,667,700,0.4879297732260424,0.5120702267739575
E01020079,1361,658,703,0.4834680382072006,0.5165319617927994
E01020081,1281,629,652,0.49102263856362216,0.5089773614363778
E01020045,1647,810,837,0.4918032786885246,0.5081967213114754
E01020059,2096,1045,1051,0.4985687022900763,0.5014312977099237
E01020062,1547,761,786,0.4919198448610213,0.5080801551389786
E01020064,1813,883,930,0.4870380584666299,0.5129619415333702
E01020054,2079,1032,1047,0.4963924963924964,0.5036075036075036
E01020055,1920,901,1019,0.46927083333333336,0.5307291666666667
E01020057,1716,821,895,0.4784382284382284,0.5215617715617715
E01020058,1928,962,966,0.49896265560165975,0.5010373443983402
E01020043,2041,975,1066,0.47770700636942676,0.5222929936305732
E01020044,1602,784,818,0.4893882646691635,0.5106117353308365
E01020056,2044,1012,1032,0.49510763209393344,0.5048923679060665
E01020071,1875,892,983,0.47573333333333334,0.5242666666666667
E01020072,1660,796,864,0.4795180722891566,0.5204819277108433
E01020073,1629,811,818,0.4978514426028238,0.5021485573971762
E01020076,1708,832,876,0.48711943793911006,0.5128805620608899
E01020082,1158,585,573,0.5051813471502591,0.4948186528497409
E01020068,1520,738,782,0.4855263157894737,0.5144736842105263
E01020069,1536,752,784,0.4895833333333333,0.5104166666666666
E01020070,1893,943,950,0.49815108293713684,0.5018489170628632
E01020083,2330,1192,1138,0.511587982832618,0.488412017167382
E01020041,2176,1083,1093,0.4977022058823529,0.5022977941176471
E01020042,1648,824,824,0.5,0.5
E01020060,1682,811,871,0.4821640903686088,0.5178359096313913
E01020061,2094,993,1101,0.47421203438395415,0.5257879656160458
E01020111,1451,663,788,0.4569262577532736,0.5430737422467264
E01020112,1622,824,798,0.5080147965474723,0.4919852034525277
E01020114,1232,612,620,0.4967532467532468,0.5032467532467533
E01020115,1212,598,614,0.4933993399339934,0.5066006600660066
E01020099,1380,669,711,0.48478260869565215,0.5152173913043478
E01020100,1095,545,550,0.4977168949771689,0.502283105022831
E01020101,1466,705,761,0.48090040927694405,0.5190995907230559
E01020126,1647,791,856,0.4802671523982999,0.5197328476017
E01020113,1455,711,744,0.488659793814433,0.511340206185567
E01020116,1651,816,835,0.4942459115687462,0.5057540884312538
E01020117,1498,714,784,0.4766355140186916,0.5233644859813084
E01020118,1388,659,729,0.47478386167146974,0.5252161383285303
E01020090,1723,856,867,0.4968078932095183,0.5031921067904818
E01020108,2308,1134,1174,0.4913344887348354,0.5086655112651647
E01020109,1440,697,743,0.4840277777777778,0.5159722222222223
E01020089,2276,1069,1207,0.46968365553602814,0.5303163444639719
E01020091,1296,645,651,0.4976851851851852,0.5023148148148148
E01020092,1421,682,739,0.47994370161857847,0.5200562983814215
E01020093,1412,670,742,0.4745042492917847,0.5254957507082153
E01020110,2673,1535,1138,0.5742611298166854,0.42573887018331463
E01020088,2117,1042,1075,0.49220595181861126,0.5077940481813887
E01020120,1904,909,995,0.47741596638655465,0.5225840336134454
E01020127,1879,934,945,0.4970729111229377,0.5029270888770623
E01020132,1805,853,952,0.47257617728531853,0.5274238227146815
E01020133,1472,712,760,0.483695652173913,0.5163043478260869
E01020134,1175,570,605,0.4851063829787234,0.5148936170212766
E01020139,1397,669,728,0.47888332140300643,0.5211166785969935
E01020094,1706,848,858,0.4970691676436108,0.5029308323563892
E01020095,1521,746,775,0.4904667981591059,0.5095332018408941
E01020140,1187,570,617,0.4802021903959562,0.5197978096040438
E01020141,1786,845,941,0.4731243001119821,0.526875699888018
E01020096,1683,829,854,0.49257278669043375,0.5074272133095663
E01020123,1449,679,770,0.46859903381642515,0.5314009661835749
E01020124,1364,671,693,0.49193548387096775,0.5080645161290323
E01020125,1286,611,675,0.4751166407465008,0.5248833592534993
E01020102,1681,807,874,0.48007138607971445,0.5199286139202856
E01020103,1497,722,775,0.48229792919171677,0.5177020708082832
E01020104,1413,668,745,0.4727530077848549,0.527246992215145
E01020128,1311,622,689,0.4744469870327994,0.5255530129672006
E01020129,1179,561,618,0.4758269720101781,0.5241730279898219
E01020130,1533,724,809,0.47227658186562294,0.5277234181343771
E01020105,1505,712,793,0.47308970099667774,0.5269102990033223
E01020106,1130,529,601,0.46814159292035395,0.531858407079646
E01020107,1675,779,896,0.46507462686567164,0.5349253731343283
E01020119,1501,740,761,0.49300466355762823,0.5069953364423717
E01020084,1502,707,795,0.47070572569906793,0.5292942743009321
E01020085,1549,742,807,0.4790187217559716,0.5209812782440284
E01020086,1514,735,779,0.4854689564068692,0.5145310435931307
E01020121,1951,945,1006,0.4843669912865197,0.5156330087134803
E01020122,1708,842,866,0.4929742388758782,0.5070257611241218
E01020097,2255,1098,1157,0.4869179600886918,0.5130820399113082
E01020131,2206,1128,1078,0.5113327289211242,0.4886672710788758
E01020135,1568,758,810,0.48341836734693877,0.5165816326530612
E01020136,1745,824,921,0.4722063037249284,0.5277936962750717
E01020137,1562,745,817,0.47695262483994877,0.5230473751600512
E01020087,1911,938,973,0.4908424908424908,0.5091575091575091
E01020098,2081,1015,1066,0.4877462758289284,0.5122537241710716
E01020138,2313,1134,1179,0.490272373540856,0.5097276264591439
E01020144,1538,768,770,0.49934980494148246,0.5006501950585176
E01020145,2001,1090,911,0.544727636181909,0.45527236381809094
E01020146,1184,571,613,0.4822635135135135,0.5177364864864865
E01020149,1202,592,610,0.4925124792013311,0.5074875207986689
E01020148,1119,538,581,0.48078641644325293,0.5192135835567471
E01020157,2321,1115,1206,0.4803963808703145,0.5196036191296854
E01020160,1884,929,955,0.49309978768577495,0.5069002123142251
E01020176,1150,524,626,0.45565217391304347,0.5443478260869565
E01020177,1409,658,751,0.46699787083037614,0.5330021291696239
E01020180,1872,837,1035,0.44711538461538464,0.5528846153846154
E01020181,1710,823,887,0.4812865497076023,0.5187134502923977
E01020182,1483,699,784,0.471341874578557,0.528658125421443
E01020183,1402,656,746,0.46790299572039945,0.5320970042796006
E01020184,1609,745,864,0.4630205096333126,0.5369794903666874
E01020153,1217,593,624,0.48726376335250615,0.5127362366474938
E01020156,1877,913,964,0.4864144912093767,0.5135855087906234
E01020170,2123,1046,1077,0.49269901083372586,0.5073009891662741
E01020188,1946,930,1016,0.4779033915724563,0.5220966084275437
E01020161,2477,1140,1337,0.4602341542188131,0.5397658457811869
E01020162,1655,789,866,0.47673716012084594,0.5232628398791541
E01020163,1807,891,916,0.4930824571112341,0.5069175428887659
E01020164,1548,762,786,0.49224806201550386,0.5077519379844961
E01020165,1535,756,779,0.49250814332247556,0.5074918566775244
E01020166,1443,710,733,0.49203049203049204,0.507969507969508
E01020167,1386,668,718,0.481962481962482,0.5180375180375181
E01020142,2265,1083,1182,0.4781456953642384,0.5218543046357615
E01020143,2217,1084,1133,0.4889490302210194,0.5110509697789806
E01020150,1753,821,932,0.46833998859098686,0.5316600114090131
E01020151,1584,764,820,0.4823232323232323,0.5176767676767676
E01020152,1424,680,744,0.47752808988764045,0.5224719101123596
E01020154,1559,885,674,0.5676715843489416,0.4323284156510584
E01020155,1038,520,518,0.5009633911368016,0.49903660886319845
E01020147,1951,944,1007,0.48385443362378266,0.5161455663762173
E01020158,1677,799,878,0.47644603458556944,0.5235539654144306
E01020159,1443,717,726,0.4968814968814969,0.5031185031185031
E01020190,2049,961,1088,0.4690092728160078,0.5309907271839922
E01020171,1814,894,920,0.4928335170893054,0.5071664829106945
E01020185,1315,632,683,0.4806083650190114,0.5193916349809886
E01020186,1425,677,748,0.4750877192982456,0.5249122807017544
E01020187,1715,816,899,0.47580174927113705,0.524198250728863
E01020168,2074,986,1088,0.47540983606557374,0.5245901639344263
E01020169,2307,1091,1216,0.4729085392284352,0.5270914607715648
E01020189,2042,947,1095,0.46376101860920665,0.5362389813907933
E01020174,1529,741,788,0.48463047743623283,0.5153695225637671
E01020175,1927,920,1007,0.4774260508562532,0.5225739491437468
E01020178,1895,905,990,0.47757255936675463,0.5224274406332454
E01020172,1800,850,950,0.4722222222222222,0.5277777777777778
E01020173,1553,745,808,0.47971667739858337,0.5202833226014166
E01020179,1886,911,975,0.48303287380699894,0.5169671261930011
E01020243,1193,562,631,0.471081307627829,0.528918692372171
E01020262,1243,592,651,0.4762670957361223,0.5237329042638778
E01020263,1472,728,744,0.4945652173913043,0.5054347826086957
E01020274,1285,636,649,0.49494163424124515,0.5050583657587548
E01020240,1544,728,816,0.47150259067357514,0.5284974093264249
E01020241,1744,868,876,0.49770642201834864,0.5022935779816514
E01020242,1425,681,744,0.47789473684210526,0.5221052631578947
E01020244,1412,673,739,0.476628895184136,0.523371104815864
E01020245,1634,804,830,0.4920440636474908,0.5079559363525091
E01020205,1447,698,749,0.4823773324118867,0.5176226675881134
E01020258,1703,829,874,0.4867880211391662,0.5132119788608338
E01020259,1103,530,573,0.48050770625566636,0.5194922937443336
E01020273,1383,680,703,0.49168474331164136,0.5083152566883586
E01020203,1651,785,866,0.47546941247728647,0.5245305875227135
E01020206,1528,744,784,0.4869109947643979,0.5130890052356021
E01020220,1367,671,696,0.4908558888076079,0.5091441111923921
E01020221,1766,886,880,0.5016987542468856,0.4983012457531144
E01020222,1245,599,646,0.4811244979919679,0.5188755020080321
E01020223,1747,876,871,0.5014310246136233,0.4985689753863766
E01020229,1667,859,808,0.5152969406118776,0.48470305938812236
E01020230,1687,785,902,0.46532305868405455,0.5346769413159455
E01020231,1469,682,787,0.46426140231449964,0.5357385976855004
E01020232,1627,764,863,0.4695759065765212,0.5304240934234788
E01020228,1753,819,934,0.4671990872789504,0.5328009127210497
E01020233,1726,821,905,0.4756662804171495,0.5243337195828505
E01020234,1459,700,759,0.47978067169294036,0.5202193283070596
E01020235,1773,801,972,0.4517766497461929,0.5482233502538071
E01020202,1540,728,812,0.4727272727272727,0.5272727272727272
E01020204,1555,772,783,0.4964630225080386,0.5035369774919615
E01020236,1289,641,648,0.4972847168347556,0.5027152831652444
E01020237,1573,737,836,0.46853146853146854,0.5314685314685315
E01020265,1698,806,892,0.4746760895170789,0.525323910482921
E01020266,1729,887,842,0.5130133024869867,0.4869866975130133
E01020267,1497,726,771,0.4849699398797595,0.5150300601202404
E01020268,1437,664,773,0.46207376478775225,0.5379262352122477
E01020270,1608,778,830,0.48383084577114427,0.5161691542288557
E01020250,1580,751,829,0.4753164556962025,0.5246835443037975
E01020252,1385,649,736,0.46859205776173285,0.5314079422382672
E01020253,1508,719,789,0.47679045092838196,0.523209549071618
E01020254,1316,670,646,0.5091185410334347,0.4908814589665654
E01020255,1302,627,675,0.4815668202764977,0.5184331797235023
E01020257,1215,582,633,0.47901234567901235,0.5209876543209877
E01020264,1515,675,840,0.44554455445544555,0.5544554455445545
E01020269,1854,845,1009,0.4557713052858684,0.5442286947141316
E01020271,1527,723,804,0.47347740667976423,0.5265225933202358
E01020272,1884,914,970,0.4851380042462845,0.5148619957537155
E01020200,1089,524,565,0.48117539026629935,0.5188246097337006
E01020201,1481,672,809,0.4537474679270763,0.5462525320729237
E01020251,1464,710,754,0.4849726775956284,0.5150273224043715
E01020260,1269,596,673,0.46966115051221435,0.5303388494877856
E01020261,1196,597,599,0.4991638795986622,0.5008361204013378
E01020208,1261,603,658,0.4781919111816019,0.5218080888183981
E01020209,1442,693,749,0.48058252427184467,0.5194174757281553
E01020210,1177,579,598,0.491928632115548,0.508071367884452
E01020219,2059,990,1069,0.48081593006313744,0.5191840699368625
E01020191,1674,1167,507,0.6971326164874552,0.30286738351254483
E01020194,1454,732,722,0.5034387895460798,0.4965612104539202
E01020207,1163,550,613,0.472914875322442,0.5270851246775581
E01020256,1377,643,734,0.46695715323166304,0.533042846768337
E01020211,1527,727,800,0.47609692206941717,0.5239030779305829
E01020217,1657,812,845,0.49004224502112254,0.5099577549788775
E01020218,1479,743,736,0.5023664638269101,0.4976335361730899
E01020224,1256,595,661,0.4737261146496815,0.5262738853503185
E01020216,1652,804,848,0.48668280871670705,0.513317191283293
E01020225,1264,615,649,0.4865506329113924,0.5134493670886076
E01020226,1266,609,657,0.48104265402843605,0.518957345971564
E01020227,1468,683,785,0.4652588555858311,0.534741144414169
E01020212,1216,597,619,0.4909539473684211,0.509046052631579
E01020213,1417,678,739,0.4784756527875794,0.5215243472124206
E01020214,1553,777,776,0.5003219575016098,0.4996780424983902
E01020215,1376,688,688,0.5,0.5
E01020195,1745,857,888,0.4911174785100286,0.5088825214899714
E01020196,1686,777,909,0.4608540925266904,0.5391459074733096
E01020197,1258,610,648,0.4848966613672496,0.5151033386327504
E01020198,1387,656,731,0.47296322999279017,0.5270367700072098
E01020199,1642,810,832,0.4933008526187576,0.5066991473812423
E01020246,1097,552,545,0.5031905195989061,0.4968094804010939
E01020247,1624,773,851,0.47598522167487683,0.5240147783251231
E01020248,1616,797,819,0.4931930693069307,0.5068069306930693
E01020249,1342,640,702,0.47690014903129657,0.5230998509687034
E01020192,1560,739,821,0.4737179487179487,0.5262820512820513
E01020193,1492,744,748,0.49865951742627346,0.5013404825737265
E01020238,1197,542,655,0.4527986633249791,0.5472013366750209
E01020239,1272,603,669,0.4740566037735849,0.5259433962264151
E01020275,1309,644,665,0.4919786096256685,0.5080213903743316
E01020276,1508,722,786,0.47877984084880637,0.5212201591511937
E01020297,1558,732,826,0.46983311938382544,0.5301668806161746
E01020299,1809,870,939,0.48092868988391374,0.5190713101160862
E01020298,2060,943,1117,0.4577669902912621,0.5422330097087379
E01020300,1706,797,909,0.4671746776084408,0.5328253223915592
E01020310,2112,1035,1077,0.4900568181818182,0.5099431818181818
E01020280,2174,1115,1059,0.5128794848206072,0.4871205151793928
E01020281,1922,966,956,0.5026014568158168,0.49739854318418314
E01020282,1621,760,861,0.4688463911165947,0.5311536088834053
E01020277,2021,969,1052,0.47946561108362196,0.520534388916378
E01020278,1664,825,839,0.4957932692307692,0.5042067307692307
E01020279,2305,1135,1170,0.4924078091106291,0.5075921908893709
E01020283,1387,678,709,0.48882480173035325,0.5111751982696467
E01020284,1962,961,1001,0.48980632008154945,0.5101936799184505
E01020285,2009,954,1055,0.47486311597809855,0.5251368840219014
E01020288,1627,823,804,0.505838967424708,0.4941610325752919
E01020292,1450,723,727,0.4986206896551724,0.5013793103448276
E01020295,1689,807,882,0.477797513321492,0.522202486678508
E01020296,1488,727,761,0.4885752688172043,0.5114247311827957
E01020304,1721,808,913,0.4694944799535154,0.5305055200464845
E01020305,1081,526,555,0.486586493987049,0.513413506012951
E01020306,1249,573,676,0.45876701361088873,0.5412329863891113
E01020307,1663,809,854,0.4864702345159351,0.5135297654840649
E01020287,1537,779,758,0.5068314899154196,0.49316851008458035
E01020303,1643,806,837,0.49056603773584906,0.5094339622641509
E01020308,1668,839,829,0.5029976019184652,0.4970023980815348
E01020311,2068,1027,1041,0.49661508704061896,0.503384912959381
E01020291,1569,796,773,0.5073295092415552,0.4926704907584449
E01020293,2211,1068,1143,0.4830393487109905,0.5169606512890095
E01020294,1736,818,918,0.47119815668202764,0.5288018433179723
E01020302,1734,880,854,0.5074971164936563,0.4925028835063437
E01020309,1679,852,827,0.5074449076831448,0.4925550923168553
E01020286,1650,809,841,0.4903030303030303,0.5096969696969696
E01020289,1534,758,776,0.4941329856584094,0.5058670143415906
E01020290,1716,836,880,0.48717948717948717,0.5128205128205128
E01020301,1999,997,1002,0.49874937468734365,0.5012506253126563
E01020320,1695,866,829,0.5109144542772861,0.48908554572271384
E01020321,2218,1078,1140,0.4860234445446348,0.5139765554553652
E01020322,2024,999,1025,0.4935770750988142,0.5064229249011858
E01020326,2026,1030,996,0.508390918065153,0.491609081934847
E01020327,1808,883,925,0.4883849557522124,0.5116150442477876
E01020328,2277,1096,1181,0.4813350900307422,0.5186649099692578
E01020329,1578,791,787,0.5012674271229405,0.4987325728770596
E01020330,1837,892,945,0.48557430593358736,0.5144256940664126
E01020318,1449,693,756,0.4782608695652174,0.5217391304347826
E01020319,1614,743,871,0.4603469640644362,0.5396530359355638
E01020323,2047,1231,816,0.6013678553981436,0.39863214460185636
E01020339,1683,819,864,0.48663101604278075,0.5133689839572193
E01020314,1610,799,811,0.4962732919254658,0.5037267080745341
E01020325,1617,805,812,0.49783549783549785,0.5021645021645021
E01020331,1622,772,850,0.4759556103575832,0.5240443896424167
E01020340,1680,832,848,0.49523809523809526,0.5047619047619047
E01020332,1786,875,911,0.4899216125419933,0.5100783874580067
E01020333,1928,966,962,0.5010373443983402,0.49896265560165975
E01020334,1927,877,1050,0.45511157239231964,0.5448884276076803
E01020335,1526,701,825,0.45937090432503275,0.5406290956749672
E01020336,1360,638,722,0.46911764705882353,0.5308823529411765
E01020337,1419,682,737,0.4806201550387597,0.5193798449612403
E01020338,2334,1086,1248,0.4652956298200514,0.5347043701799485
E01020317,1445,692,753,0.47889273356401385,0.5211072664359861
E01020324,1559,742,817,0.4759461193072482,0.5240538806927517
E01020341,1606,759,847,0.4726027397260274,0.5273972602739726
E01020342,1509,726,783,0.48111332007952284,0.5188866799204771
E01020312,1563,765,798,0.4894433781190019,0.510556621880998
E01020313,1426,701,725,0.49158485273492286,0.5084151472650772
E01020315,1539,720,819,0.4678362573099415,0.5321637426900585
E01020316,1841,864,977,0.4693101575230853,0.5306898424769148
E01020343,1505,735,770,0.4883720930232558,0.5116279069767442
E01020344,1460,718,742,0.4917808219178082,0.5082191780821917
E01020345,1212,560,652,0.46204620462046203,0.5379537953795379
E01020365,1596,793,803,0.4968671679197995,0.5031328320802005
E01020351,1309,649,660,0.4957983193277311,0.5042016806722689
E01020352,1359,632,727,0.4650478292862399,0.5349521707137601
E01020353,1698,816,882,0.48056537102473496,0.519434628975265
E01020359,1293,632,661,0.48878576952822894,0.5112142304717711
E01020366,2124,1062,1062,0.5,0.5
E01020349,1761,763,998,0.4332765474162408,0.5667234525837592
E01020350,1695,768,927,0.45309734513274336,0.5469026548672566
E01020357,2109,1030,1079,0.48838311996206735,0.5116168800379327
E01020358,1529,730,799,0.4774362328319163,0.5225637671680837
E01020369,1318,616,702,0.4673748103186646,0.5326251896813353
E01020370,1493,722,771,0.4835900870730074,0.5164099129269927
E01020371,1543,731,812,0.47375243033052494,0.5262475696694751
E01020372,1233,584,649,0.47364152473641524,0.5263584752635847
E01020346,1590,764,826,0.48050314465408805,0.519496855345912
E01020347,1612,800,812,0.49627791563275436,0.5037220843672456
E01020348,1673,858,815,0.5128511655708309,0.4871488344291692
E01020363,1202,586,616,0.4875207986688852,0.5124792013311148
E01020360,1551,748,803,0.48226950354609927,0.5177304964539007
E01020361,1626,808,818,0.4969249692496925,0.5030750307503075
E01020364,1599,725,874,0.4534083802376485,0.5465916197623515
E01020367,1851,869,982,0.46947595894111294,0.5305240410588871
E01020368,2383,1174,1209,0.492656315568611,0.507343684431389
E01020354,1483,694,789,0.4679703304113284,0.5320296695886716
E01020355,1905,895,1010,0.46981627296587924,0.5301837270341208
E01020356,1589,732,857,0.460667086217747,0.539332913782253
E01020362,1451,680,771,0.4686423156443832,0.5313576843556168
E01020373,1331,672,659,0.5048835462058603,0.49511645379413977
E01020374,1517,732,785,0.48253131179960446,0.5174686882003955
E01020389,2189,1097,1092,0.5011420740063957,0.4988579259936044
E01020397,1428,695,733,0.48669467787114845,0.5133053221288515
E01020416,1493,709,784,0.47488278633623576,0.5251172136637642
E01020417,1074,517,557,0.4813780260707635,0.5186219739292365
E01020418,1455,670,785,0.46048109965635736,0.5395189003436426
E01020419,1865,906,959,0.4857908847184987,0.5142091152815014
E01020420,1334,650,684,0.487256371814093,0.512743628185907
E01020411,1154,535,619,0.46360485268630847,0.5363951473136915
E01020412,1493,720,773,0.4822505023442733,0.5177494976557268
E01020413,1463,728,735,0.49760765550239233,0.5023923444976076
E01020414,1992,956,1036,0.4799196787148594,0.5200803212851406
E01020415,1529,782,747,0.5114453891432309,0.48855461085676916
E01020403,1560,765,795,0.49038461538461536,0.5096153846153846
E01020404,1567,748,819,0.4773452456924059,0.5226547543075941
E01020405,1461,718,743,0.4914442162902122,0.5085557837097878
E01020406,2271,1096,1175,0.4826067811536768,0.5173932188463232
E01020396,1063,529,534,0.49764816556914393,0.5023518344308561
E01020398,2286,1105,1181,0.48337707786526685,0.5166229221347332
E01020409,1271,629,642,0.4948859166011015,0.5051140833988985
E01020410,1311,675,636,0.5148741418764302,0.4851258581235698
E01020421,1391,661,730,0.47519769949676494,0.5248023005032351
E01020422,1653,744,909,0.4500907441016334,0.5499092558983666
E01020423,1453,689,764,0.4741913282863042,0.5258086717136958
E01020424,1392,670,722,0.4813218390804598,0.5186781609195402
E01020425,1672,799,873,0.47787081339712917,0.5221291866028708
E01020377,1634,810,824,0.49571603427172584,0.5042839657282742
E01020379,1458,717,741,0.49176954732510286,0.5082304526748971
E01020380,1084,534,550,0.492619926199262,0.507380073800738
E01020381,1217,595,622,0.48890714872637636,0.5110928512736237
E01020390,1363,625,738,0.458547322083639,0.541452677916361
E01020391,1433,696,737,0.4856943475226797,0.5143056524773203
E01020392,1544,685,859,0.44365284974093266,0.5563471502590673
E01020393,1571,754,817,0.47994907702100575,0.5200509229789942
E01020394,1732,851,881,0.4913394919168591,0.5086605080831409
E01020375,1370,626,744,0.4569343065693431,0.5430656934306569
E01020376,1087,531,556,0.48850045998160074,0.5114995400183993
E01020378,1534,744,790,0.485006518904824,0.5149934810951761
E01020407,1206,572,634,0.47429519071310117,0.5257048092868989
E01020408,1137,526,611,0.46262093227792433,0.5373790677220757
E01020426,1832,830,1002,0.45305676855895194,0.5469432314410481
E01020427,1623,773,850,0.4762784966112138,0.5237215033887862
E01020428,1894,851,1043,0.44931362196409713,0.5506863780359028
E01020429,1665,798,867,0.47927927927927927,0.5207207207207207
E01020395,1829,843,986,0.46090759978130125,0.5390924002186988
E01020399,2502,1230,1272,0.49160671462829736,0.5083932853717026
E01020400,1610,774,836,0.48074534161490684,0.5192546583850932
E01020401,1511,711,800,0.47054930509596293,0.5294506949040371
E01020402,1529,761,768,0.4977109221713538,0.5022890778286462
E01020382,1525,749,776,0.4911475409836066,0.5088524590163934
E01020383,1756,866,890,0.49316628701594534,0.5068337129840547
E01020384,1757,835,922,0.4752418895845191,0.5247581104154809
E01020385,1248,614,634,0.49198717948717946,0.5080128205128205
E01020386,1209,598,611,0.4946236559139785,0.5053763440860215
E01020387,1123,561,562,0.4995547640249332,0.5004452359750667
E01020388,1515,733,782,0.48382838283828383,0.5161716171617162
E01020443,2509,1246,1263,0.4966121960940614,0.5033878039059386
E01020447,1773,825,948,0.4653130287648054,0.5346869712351946
E01020463,1677,807,870,0.481216457960644,0.518783542039356
E01020464,1543,760,783,0.49254698639014904,0.507453013609851
E01020440,1905,941,964,0.49396325459317586,0.5060367454068242
E01020450,2297,1139,1158,0.4958641706573792,0.5041358293426208
E01020462,1786,851,935,0.4764837625979843,0.5235162374020157
E01033156,1742,881,861,0.5057405281285878,0.49425947187141217
E01033158,1474,731,743,0.49592944369063774,0.5040705563093623
E01020454,2121,1000,1121,0.47147571900047147,0.5285242809995285
E01020455,1905,893,1012,0.4687664041994751,0.531233595800525
E01020456,1780,887,893,0.498314606741573,0.501685393258427
E01020457,1508,708,800,0.46949602122015915,0.5305039787798409
E01020433,1775,881,894,0.49633802816901407,0.5036619718309859
E01020434,1799,873,926,0.48526959421901056,0.5147304057809894
E01020449,1998,967,1031,0.48398398398398396,0.516016016016016
E01020458,2179,1066,1113,0.48921523634694813,0.5107847636530518
E01020459,2578,1281,1297,0.49689681923972073,0.5031031807602793
E01020444,1774,833,941,0.4695603156708005,0.5304396843291995
E01020445,1519,733,786,0.4825543120473996,0.5174456879526004
E01020446,1525,757,768,0.4963934426229508,0.5036065573770492
E01020460,2277,1268,1009,0.556873078612209,0.443126921387791
E01020442,1993,984,1009,0.49372804816859006,0.5062719518314099
E01020452,2436,1250,1186,0.513136288998358,0.48686371100164205
E01020453,1711,831,880,0.4856808883693746,0.5143191116306254
E01033154,2205,1395,810,0.6326530612244898,0.3673469387755102
E01033159,1097,550,547,0.5013673655423884,0.4986326344576117
E01020435,1781,902,879,0.506457046603032,0.493542953396968
E01020436,2062,1050,1012,0.5092143549951503,0.49078564500484967
E01020437,1876,920,956,0.4904051172707889,0.509594882729211
E01020438,1993,975,1018,0.4892122428499749,0.5107877571500251
E01020439,2271,1135,1136,0.4997798326728313,0.5002201673271687
E01020430,1439,704,735,0.48922863099374564,0.5107713690062543
E01020431,1232,683,549,0.5543831168831169,0.44561688311688313
E01020432,1226,626,600,0.5106035889070146,0.4893964110929853
E01020441,1850,898,952,0.4854054054054054,0.5145945945945946
E01020448,1967,985,982,0.5007625826131165,0.4992374173868836
E01020465,1945,969,976,0.4982005141388175,0.5017994858611825
E01020469,1931,961,970,0.49766960124287934,0.5023303987571207
E01020470,1816,854,962,0.47026431718061673,0.5297356828193832
E01020471,1398,682,716,0.48783977110157367,0.5121602288984263
E01020472,1387,664,723,0.4787310742609949,0.5212689257390051
E01020473,1459,679,780,0.46538725154215216,0.5346127484578478
E01020474,1690,813,877,0.48106508875739645,0.5189349112426036
E01020475,2049,1014,1035,0.49487554904831627,0.5051244509516838
E01020476,1235,614,621,0.497165991902834,0.5028340080971659
E01020477,1539,783,756,0.5087719298245614,0.49122807017543857
E01020485,1442,666,776,0.4618585298196949,0.5381414701803051
E01020486,1306,590,716,0.45176110260336905,0.5482388973966309
E01020487,1287,613,674,0.4763014763014763,0.5236985236985237
E01020488,1461,694,767,0.4750171115674196,0.5249828884325805
E01020489,1464,757,707,0.5170765027322405,0.48292349726775957
E01020490,1618,809,809,0.5,0.5
E01020491,1571,771,800,0.4907702100572883,0.5092297899427116
E01020492,1153,541,612,0.4692107545533391,0.5307892454466608
E01020493,2586,1435,1151,0.5549110595514308,0.4450889404485692
E01020466,1780,876,904,0.49213483146067416,0.5078651685393258
E01020467,1764,884,880,0.5011337868480725,0.4988662131519274
E01020468,1491,738,753,0.4949698189134809,0.5050301810865191
E01020478,1091,525,566,0.48120989917506873,0.5187901008249313
E01020479,1202,563,639,0.4683860232945091,0.5316139767054908
E01020480,1478,705,773,0.4769959404600812,0.5230040595399188
E01020481,1513,764,749,0.5049570389953735,0.4950429610046266
E01020482,1618,767,851,0.47404202719406674,0.5259579728059333
E01020483,1274,631,643,0.49529042386185246,0.5047095761381476
E01020484,1425,666,759,0.4673684210526316,0.5326315789473685
E01020542,1304,602,702,0.4616564417177914,0.5383435582822086
E01020543,1452,682,770,0.4696969696969697,0.5303030303030303
E01020544,1666,719,947,0.43157262905162064,0.5684273709483794
E01020546,1818,946,872,0.5203520352035204,0.47964796479647964
E01020547,1117,520,597,0.4655326768128917,0.5344673231871083
E01032642,2166,1030,1136,0.4755309325946445,0.5244690674053555
E01020497,1914,913,1001,0.47701149425287354,0.5229885057471264
E01020508,2000,938,1062,0.469,0.531
E01020541,2011,1003,1008,0.4987568373943312,0.5012431626056688
E01020550,1564,755,809,0.4827365728900256,0.5172634271099744
E01020494,1150,571,579,0.4965217391304348,0.5034782608695653
E01020495,1387,646,741,0.4657534246575342,0.5342465753424658
E01020496,1570,737,833,0.4694267515923567,0.5305732484076433
E01020506,1736,865,871,0.49827188940092165,0.5017281105990783
E01020530,1848,938,910,0.5075757575757576,0.49242424242424243
E01020534,2081,1009,1072,0.4848630466122057,0.5151369533877943
E01020509,2799,1368,1431,0.4887459807073955,0.5112540192926045
E01020510,1969,924,1045,0.4692737430167598,0.5307262569832403
E01020529,2210,1090,1120,0.49321266968325794,0.5067873303167421
E01020539,1988,986,1002,0.4959758551307847,0.5040241448692153
E01020540,2437,1192,1245,0.48912597455888385,0.5108740254411162
E01020511,1697,810,887,0.47731290512669416,0.5226870948733058
E01020532,1614,737,877,0.4566294919454771,0.5433705080545229
E01020533,2057,906,1151,0.4404472532814779,0.5595527467185221
E01020535,1717,846,871,0.49271986022131625,0.5072801397786838
E01020498,2038,973,1065,0.4774288518155054,0.5225711481844946
E01020499,1394,671,723,0.4813486370157819,0.5186513629842181
E01020500,1625,780,845,0.48,0.52
E01020501,1403,665,738,0.47398431931575197,0.5260156806842481
E01020507,1897,914,983,0.48181338956246705,0.518186610437533
E01020517,1745,850,895,0.4871060171919771,0.5128939828080229
E01020531,1697,803,894,0.4731879787860931,0.5268120212139069
E01020536,2080,992,1088,0.47692307692307695,0.5230769230769231
E01020502,1657,781,876,0.4713337356668678,0.5286662643331321
E01020503,1762,790,972,0.44835414301929627,0.5516458569807038
E01020504,2256,1066,1190,0.4725177304964539,0.5274822695035462
E01020526,1368,656,712,0.47953216374269003,0.52046783625731
E01020527,1508,739,769,0.490053050397878,0.5099469496021221
E01020528,1958,984,974,0.5025536261491318,0.4974463738508682
E01032641,1607,765,842,0.4760423148724331,0.5239576851275669
E01032643,1683,900,783,0.5347593582887701,0.46524064171123
E01032644,1073,483,590,0.45013979496738116,0.5498602050326188
E01032645,1093,473,620,0.43275388838060386,0.5672461116193962
E01020518,1522,718,804,0.47174770039421815,0.5282522996057819
E01020519,1805,835,970,0.4626038781163435,0.5373961218836565
E01020520,1394,694,700,0.49784791965566716,0.5021520803443329
E01020523,1264,607,657,0.4802215189873418,0.5197784810126582
E01020524,1466,725,741,0.4945429740791269,0.5054570259208732
E01020525,1319,636,683,0.48218347232752085,0.5178165276724791
E01020505,1870,906,964,0.4844919786096257,0.5155080213903743
E01020537,1953,988,965,0.5058883768561188,0.4941116231438812
E01020538,1851,876,975,0.473257698541329,0.526742301458671
E01020549,2095,990,1105,0.47255369928400953,0.5274463007159904
E01020512,2094,1039,1055,0.4961795606494747,0.5038204393505253
E01020513,1543,759,784,0.49189889825016203,0.508101101749838
E01020514,1252,618,634,0.4936102236421725,0.5063897763578274
E01020515,1213,596,617,0.49134377576257215,0.5086562242374278
E01020516,1507,726,781,0.48175182481751827,0.5182481751824818
E01020551,1883,933,950,0.49548592671269254,0.5045140732873075
E01020552,1805,851,954,0.4714681440443213,0.5285318559556786
E01020570,1581,776,805,0.49082858950031627,0.5091714104996837
E01020571,2047,982,1065,0.47972642892037126,0.5202735710796287
E01020557,1527,723,804,0.47347740667976423,0.5265225933202358
E01020558,1720,848,872,0.4930232558139535,0.5069767441860465
E01020559,1583,762,821,0.4813644977890082,0.5186355022109918
E01020560,1923,942,981,0.48985959438377535,0.5101404056162246
E01020561,1888,852,1036,0.451271186440678,0.548728813559322
E01020574,1892,905,987,0.47832980972515854,0.5216701902748414
E01020575,1662,836,826,0.5030084235860409,0.4969915764139591
E01020576,1711,853,858,0.49853886616014026,0.5014611338398597
E01020579,1964,969,995,0.49338085539714865,0.5066191446028513
E01020580,1440,698,742,0.4847222222222222,0.5152777777777777
E01020553,1302,673,629,0.5168970814132104,0.48310291858678955
E01020554,1778,928,850,0.5219347581552306,0.4780652418447694
E01020555,1361,710,651,0.5216752387950037,0.47832476120499634
E01020556,1437,718,719,0.49965205288796105,0.500347947112039
E01020581,2019,1015,1004,0.5027241208519069,0.4972758791480931
E01020582,1573,764,809,0.48569612205975843,0.5143038779402416
E01020572,1961,985,976,0.5022947475777665,0.49770525242223357
E01020573,1822,892,930,0.48957189901207465,0.5104281009879253
E01020577,1600,803,797,0.501875,0.498125
E01020578,2082,952,1130,0.457252641690682,0.542747358309318
E01020583,1930,974,956,0.5046632124352332,0.49533678756476685
E01020584,1702,822,880,0.48296122209165687,0.5170387779083431
E01020585,1559,774,785,0.4964720974983964,0.5035279025016036
E01020586,1273,621,652,0.4878240377062058,0.5121759622937941
E01020587,1490,710,780,0.47651006711409394,0.5234899328859061
E01020588,1321,642,679,0.48599545798637395,0.514004542013626
E01020589,1487,722,765,0.4855413584398117,0.5144586415601883
E01020563,1630,1031,599,0.6325153374233129,0.3674846625766871
E01020569,1460,718,742,0.4917808219178082,0.5082191780821917
E01033200,2553,1536,1017,0.6016451233842538,0.3983548766157462
E01020562,2026,991,1035,0.4891411648568608,0.5108588351431392
E01020564,1621,781,840,0.48180135718692163,0.5181986428130784
E01020565,1464,714,750,0.48770491803278687,0.5122950819672131
E01020566,2090,1026,1064,0.4909090909090909,0.509090909090909
E01022163,1494,740,754,0.49531459170013387,0.5046854082998661
E01022164,1394,684,710,0.49067431850789095,0.509325681492109
E01022165,1492,754,738,0.5053619302949062,0.49463806970509383
E01022166,1320,652,668,0.49393939393939396,0.5060606060606061
E01022143,1462,694,768,0.4746922024623803,0.5253077975376197
E01022144,1125,534,591,0.4746666666666667,0.5253333333333333
E01022145,1219,579,640,0.4749794913863823,0.5250205086136177
E01022146,1359,624,735,0.45916114790286977,0.5408388520971302
E01022122,1371,624,747,0.4551422319474836,0.5448577680525164
E01022160,2102,965,1137,0.45908658420551857,0.5409134157944815
E01022161,1416,682,734,0.481638418079096,0.518361581920904
E01022162,1543,745,798,0.48282566429034346,0.5171743357096565
E01022139,1272,616,656,0.48427672955974843,0.5157232704402516
E01022151,1711,818,893,0.47808299240210406,0.5219170075978959
E01022152,1140,532,608,0.4666666666666667,0.5333333333333333
E01022153,1641,821,820,0.5003046922608165,0.4996953077391834
E01022154,1911,878,1033,0.4594453165881737,0.5405546834118262
E01022120,1551,809,742,0.521598968407479,0.47840103159252095
E01022121,1775,851,924,0.47943661971830986,0.5205633802816901
E01022147,1620,781,839,0.4820987654320988,0.5179012345679013
E01022157,1534,733,801,0.47783572359843546,0.5221642764015645
E01022159,1475,701,774,0.4752542372881356,0.5247457627118645
E01022131,1261,611,650,0.4845360824742268,0.5154639175257731
E01022132,1425,675,750,0.47368421052631576,0.5263157894736842
E01022133,1484,719,765,0.48450134770889486,0.5154986522911051
E01022134,1561,788,773,0.5048046124279308,0.4951953875720692
E01022148,1557,782,775,0.5022479126525369,0.49775208734746307
E01022149,1400,728,672,0.52,0.48
E01022150,1531,749,782,0.4892227302416721,0.5107772697583279
E01022155,1506,772,734,0.5126162018592297,0.48738379814077026
E01022156,1593,820,773,0.514752040175769,0.485247959824231
E01022158,2201,1170,1031,0.5315765561108587,0.4684234438891413
E01022100,1799,937,862,0.5208449138410228,0.47915508615897723
E01022101,1814,905,909,0.49889746416758546,0.5011025358324146
E01022102,1781,982,799,0.5513756316676025,0.44862436833239755
E01022140,1193,558,635,0.4677284157585918,0.5322715842414082
E01022141,1384,712,672,0.5144508670520231,0.48554913294797686
E01022142,1478,764,714,0.516914749661705,0.48308525033829497
E01022116,1524,829,695,0.5439632545931758,0.45603674540682415
E01022117,1709,935,774,0.5471035693387947,0.4528964306612054
E01022119,1305,625,680,0.4789272030651341,0.5210727969348659
E01022124,1231,621,610,0.50446791226645,0.49553208773354995
E01022125,1282,617,665,0.48127925117004683,0.5187207488299532
E01022126,1421,769,652,0.5411681914144968,0.45883180858550315
E01022127,1989,699,1290,0.3514328808446455,0.6485671191553545
E01022106,1758,868,890,0.4937428896473265,0.5062571103526735
E01022107,1527,758,769,0.49639816633922723,0.5036018336607727
E01022108,1786,875,911,0.4899216125419933,0.5100783874580067
E01022123,2205,1140,1065,0.5170068027210885,0.48299319727891155
E01022135,1718,824,894,0.479627473806752,0.5203725261932479
E01022136,1503,682,821,0.4537591483699268,0.5462408516300732
E01022137,1716,861,855,0.5017482517482518,0.4982517482517482
E01022138,1752,866,886,0.4942922374429224,0.5057077625570776
E01022174,1347,650,697,0.4825538233110616,0.5174461766889383
E01022103,2393,1191,1202,0.49770162975344756,0.5022983702465524
E01022104,1636,793,843,0.484718826405868,0.5152811735941321
E01022105,1431,689,742,0.48148148148148145,0.5185185185185185
E01022109,1476,720,756,0.4878048780487805,0.5121951219512195
E01022110,1388,656,732,0.47262247838616717,0.5273775216138329
E01022111,1466,689,777,0.46998635743519784,0.5300136425648022
E01022112,1298,579,719,0.4460708782742681,0.5539291217257319
E01022167,1223,595,628,0.48650858544562553,0.5134914145543745
E01022168,1104,530,574,0.48007246376811596,0.519927536231884
E01022169,1506,729,777,0.48406374501992033,0.5159362549800797
E01022170,1483,715,768,0.48213081591368845,0.5178691840863116
E01022171,1350,680,670,0.5037037037037037,0.4962962962962963
E01022172,1433,686,747,0.47871598046057223,0.5212840195394278
E01022173,1338,631,707,0.47159940209267565,0.5284005979073244
E01022113,1675,782,893,0.46686567164179105,0.533134328358209
E01022114,1552,704,848,0.4536082474226804,0.5463917525773195
E01022115,1624,791,833,0.4870689655172414,0.5129310344827587
E01022118,1413,694,719,0.49115357395612175,0.5088464260438783
E01022128,1606,775,831,0.4825653798256538,0.5174346201743462
E01022129,2091,1036,1055,0.4954567192730751,0.5045432807269249
E01022130,1578,739,839,0.46831432192648925,0.5316856780735107
E01022179,2041,993,1048,0.4865262126408623,0.5134737873591376
E01022182,1498,714,784,0.4766355140186916,0.5233644859813084
E01022183,1506,705,801,0.4681274900398406,0.5318725099601593
E01022184,1451,680,771,0.4686423156443832,0.5313576843556168
E01022185,1433,688,745,0.4801116538729937,0.5198883461270063
E01022177,2042,956,1086,0.4681684622918707,0.5318315377081293
E01022178,1323,646,677,0.48828420256991684,0.5117157974300831
E01022205,1794,858,936,0.4782608695652174,0.5217391304347826
E01022211,1845,847,998,0.45907859078590785,0.5409214092140922
E01022212,1648,789,859,0.4787621359223301,0.5212378640776699
E01022180,2088,996,1092,0.47701149425287354,0.5229885057471264
E01022181,1588,760,828,0.47858942065491183,0.5214105793450882
E01022214,2103,1029,1074,0.4893009985734665,0.5106990014265336
E01022222,1900,914,986,0.48105263157894734,0.5189473684210526
E01022186,1705,845,860,0.49560117302052786,0.5043988269794721
E01022187,1970,999,971,0.5071065989847716,0.49289340101522844
E01022201,1793,885,908,0.4935861684327942,0.5064138315672058
E01022216,1829,921,908,0.5035538545653363,0.49644614543466375
E01022175,1884,924,960,0.49044585987261147,0.5095541401273885
E01022207,1789,884,905,0.4941307993292342,0.5058692006707658
E01022213,1854,862,992,0.46494066882416396,0.535059331175836
E01022215,1766,873,893,0.4943374858437146,0.5056625141562854
E01022188,1352,665,687,0.4918639053254438,0.5081360946745562
E01022189,1341,681,660,0.5078299776286354,0.49217002237136465
E01022190,1379,693,686,0.5025380710659898,0.49746192893401014
E01022196,1750,834,916,0.4765714285714286,0.5234285714285715
E01022197,1864,901,963,0.4833690987124464,0.5166309012875536
E01022194,1658,752,906,0.45355850422195415,0.5464414957780458
E01022195,1638,770,868,0.4700854700854701,0.5299145299145299
E01022199,1739,846,893,0.4864864864864865,0.5135135135135135
E01022200,1270,606,664,0.47716535433070867,0.5228346456692914
E01022191,1376,646,730,0.4694767441860465,0.5305232558139535
E01022192,1320,638,682,0.48333333333333334,0.5166666666666667
E01022193,1083,527,556,0.4866112650046168,0.5133887349953832
E01022198,1306,657,649,0.503062787136294,0.49693721286370596
E01022225,1786,902,884,0.5050391937290034,0.49496080627099664
E01022202,1095,542,553,0.4949771689497717,0.5050228310502283
E01022203,1478,709,769,0.479702300405954,0.520297699594046
E01022204,1458,687,771,0.4711934156378601,0.5288065843621399
E01022208,1575,746,829,0.47365079365079366,0.5263492063492063
E01022209,1123,563,560,0.5013357079252003,0.4986642920747996
E01022210,1275,619,656,0.48549019607843136,0.5145098039215686
E01022221,1955,958,997,0.4900255754475703,0.5099744245524297
E01022223,2374,1157,1217,0.487363100252738,0.512636899747262
E01022224,1547,741,806,0.4789915966386555,0.5210084033613446
E01022176,1930,981,949,0.5082901554404146,0.4917098445595855
E01022206,1887,917,970,0.4859565447800742,0.5140434552199258
E01022217,1294,621,673,0.47990726429675423,0.5200927357032458
E01022218,1314,640,674,0.487062404870624,0.512937595129376
E01022219,1256,597,659,0.4753184713375796,0.5246815286624203
E01022220,1608,740,868,0.4601990049751244,0.5398009950248757
E01022233,1901,950,951,0.4997369805365597,0.5002630194634403
E01022235,1760,848,912,0.4818181818181818,0.5181818181818182
E01022247,2496,1192,1304,0.4775641025641026,0.5224358974358975
E01022270,1856,904,952,0.4870689655172414,0.5129310344827587
E01022271,1664,832,832,0.5,0.5
E01022261,1941,950,991,0.48943843379701185,0.5105615662029882
E01022262,1826,883,943,0.4835706462212486,0.5164293537787513
E01022267,1583,760,823,0.4801010739102969,0.5198989260897031
E01022251,1431,726,705,0.5073375262054507,0.49266247379454925
E01022252,1721,879,842,0.5107495642068565,0.48925043579314353
E01022258,1150,554,596,0.4817391304347826,0.5182608695652174
E01022259,1633,810,823,0.4960195958358849,0.5039804041641152
E01022260,1824,900,924,0.4934210526315789,0.506578947368421
E01022236,2050,1013,1037,0.49414634146341463,0.5058536585365854
E01022237,1495,738,757,0.4936454849498328,0.5063545150501673
E01022238,1276,600,676,0.4702194357366771,0.5297805642633229
E01022239,1629,814,815,0.49969306322897483,0.5003069367710252
E01022240,2044,1005,1039,0.4916829745596869,0.5083170254403131
E01022249,1976,1011,965,0.5116396761133604,0.4883603238866397
E01022250,1792,878,914,0.48995535714285715,0.5100446428571429
E01022228,1714,852,862,0.4970828471411902,0.5029171528588098
E01022230,1754,848,906,0.48346636259977194,0.5165336374002281
E01022265,1667,840,827,0.5038992201559688,0.49610077984403117
E01022266,1421,706,715,0.4968332160450387,0.5031667839549613
E01022234,1520,759,761,0.4993421052631579,0.5006578947368421
E01022253,1667,819,848,0.4913017396520696,0.5086982603479304
E01022263,1822,897,925,0.49231613611416025,0.5076838638858397
E01022229,1652,799,853,0.48365617433414043,0.5163438256658596
E01022241,1598,780,818,0.4881101376720901,0.5118898623279099
E01022242,1474,698,776,0.4735413839891452,0.5264586160108549
E01022243,1224,600,624,0.49019607843137253,0.5098039215686274
E01022244,1459,710,749,0.4866346812885538,0.5133653187114462
E01022245,1314,658,656,0.5007610350076104,0.4992389649923896
E01022246,1290,640,650,0.49612403100775193,0.5038759689922481
E01022231,1642,808,834,0.4920828258221681,0.5079171741778319
E01022232,1529,766,763,0.5009810333551341,0.49901896664486595
E01022264,1475,715,760,0.4847457627118644,0.5152542372881356
E01022268,1575,769,806,0.4882539682539683,0.5117460317460317
E01022269,1947,963,984,0.4946070878274268,0.5053929121725732
E01022226,1548,747,801,0.48255813953488375,0.5174418604651163
E01022227,1546,754,792,0.48771021992238034,0.5122897800776197
E01022254,1905,919,986,0.48241469816272964,0.5175853018372704
E01022255,1557,775,782,0.49775208734746307,0.5022479126525369
E01022256,1585,763,822,0.48138801261829656,0.5186119873817034
E01022257,1852,900,952,0.48596112311015116,0.5140388768898488
E01022248,1690,821,869,0.48579881656804735,0.5142011834319526
E01022272,1342,629,713,0.46870342771982115,0.5312965722801788
E01022273,1371,745,626,0.5433989788475565,0.4566010211524435
E01022274,1173,589,584,0.5021312872975278,0.4978687127024723
E01022275,1600,756,844,0.4725,0.5275
E01022313,1689,836,853,0.49496743635287155,0.5050325636471285
E01022315,1505,754,751,0.5009966777408638,0.49900332225913624
E01022316,1581,759,822,0.48007590132827327,0.5199240986717267
E01022317,1564,790,774,0.5051150895140665,0.4948849104859335
E01022318,1742,876,866,0.5028702640642939,0.4971297359357061
E01022309,1546,771,775,0.4987063389391979,0.5012936610608021
E01022310,1737,833,904,0.47956246401842256,0.5204375359815774
E01022311,1814,965,849,0.5319735391400221,0.46802646085997796
E01022312,2314,1163,1151,0.5025929127052723,0.49740708729472777
E01022314,1451,709,742,0.48862853204686424,0.5113714679531358
E01022295,1430,697,733,0.4874125874125874,0.5125874125874126
E01022296,1458,719,739,0.49314128943758573,0.5068587105624143
E01022297,1276,646,630,0.5062695924764891,0.493730407523511
E01022298,1612,752,860,0.4665012406947891,0.533498759305211
E01022332,1612,830,782,0.5148883374689827,0.4851116625310174
E01022347,1689,982,707,0.581409117821196,0.418590882178804
E01022348,2610,1316,1294,0.5042145593869731,0.4957854406130268
E01032932,1207,673,534,0.5575807787903894,0.4424192212096106
E01032937,1101,605,496,0.5495004541326067,0.45049954586739327
E01022288,1739,844,895,0.48533640023001723,0.5146635997699828
E01022289,1582,809,773,0.511378002528445,0.488621997471555
E01022290,1375,680,695,0.49454545454545457,0.5054545454545455
E01022291,1739,876,863,0.503737780333525,0.496262219666475
E01022292,1411,726,685,0.5145287030474841,0.48547129695251595
E01022283,1510,717,793,0.47483443708609274,0.5251655629139073
E01022303,1407,664,743,0.47192608386638235,0.5280739161336176
E01022304,1543,722,821,0.4679196370706416,0.5320803629293583
E01022305,1391,661,730,0.47519769949676494,0.5248023005032351
E01022308,1422,719,703,0.5056258790436006,0.49437412095639943
E01022278,1588,779,809,0.4905541561712846,0.5094458438287154
E01022279,1480,705,775,0.47635135135135137,0.5236486486486487
E01022282,2857,1397,1460,0.4889744487224361,0.5110255512775639
E01022284,1277,633,644,0.49569303054032887,0.5043069694596711
E01022285,1409,687,722,0.48757984386089426,0.5124201561391057
E01022286,1579,772,807,0.4889170360987967,0.5110829639012033
E01022287,1685,866,819,0.513946587537092,0.486053412462908
E01022293,1576,798,778,0.5063451776649747,0.4936548223350254
E01022294,1531,756,775,0.4937949052906597,0.5062050947093403
E01022323,1777,825,952,0.4642656162070906,0.5357343837929094
E01022328,1328,648,680,0.4879518072289157,0.5120481927710844
E01022329,1605,790,815,0.49221183800623053,0.5077881619937694
E01022326,1307,623,684,0.47666411629686306,0.523335883703137
E01022327,1596,792,804,0.49624060150375937,0.5037593984962406
E01022330,1443,728,715,0.5045045045045045,0.4954954954954955
E01022331,1362,682,680,0.5007342143906021,0.49926578560939794
E01022333,1393,669,724,0.48025843503230436,0.5197415649676956
E01022334,1601,790,811,0.4934415990006246,0.5065584009993754
E01022276,1627,801,826,0.49231714812538413,0.5076828518746158
E01022277,1489,729,760,0.4895903290799194,0.5104096709200806
E01022280,1541,763,778,0.49513303049967555,0.5048669695003245
E01022281,1770,864,906,0.488135593220339,0.511864406779661
E01022306,1404,691,713,0.49216524216524216,0.5078347578347578
E01022307,1659,818,841,0.49306811332127787,0.5069318866787221
E01022319,1419,688,731,0.48484848484848486,0.5151515151515151
E01022320,1501,782,719,0.5209860093271153,0.47901399067288475
E01022321,1510,737,773,0.4880794701986755,0.5119205298013245
E01022322,1290,614,676,0.475968992248062,0.524031007751938
E01022324,1446,701,745,0.4847856154910097,0.5152143845089903
E01022325,1334,661,673,0.4955022488755622,0.5044977511244377
E01022343,1377,651,726,0.47276688453159044,0.5272331154684096
E01022344,1522,751,771,0.49342969776609724,0.5065703022339028
E01022345,1470,715,755,0.48639455782312924,0.5136054421768708
E01022346,1520,715,805,0.47039473684210525,0.5296052631578947
E01022299,1392,662,730,0.4755747126436782,0.5244252873563219
E01022300,1355,662,693,0.4885608856088561,0.5114391143911439
E01022301,1544,757,787,0.49028497409326427,0.5097150259067358
E01022302,1548,761,787,0.49160206718346255,0.5083979328165374
E01022339,1720,829,891,0.4819767441860465,0.5180232558139535
E01022340,1459,704,755,0.48252227553118576,0.5174777244688142
E01022341,2211,1031,1180,0.4663048394391678,0.5336951605608322
E01022342,1708,855,853,0.5005854800936768,0.4994145199063232
E01022335,1500,716,784,0.47733333333333333,0.5226666666666666
E01022336,1167,569,598,0.4875749785775493,0.5124250214224507
E01022338,1348,653,695,0.4844213649851632,0.5155786350148368
E01032933,1506,752,754,0.49933598937583,0.50066401062417
E01032934,1444,733,711,0.5076177285318559,0.49238227146814406
E01032935,1586,809,777,0.5100882723833543,0.48991172761664564
E01032936,1870,896,974,0.47914438502673795,0.520855614973262
E01022378,1822,913,909,0.5010976948408342,0.4989023051591657
E01022379,1436,710,726,0.49442896935933145,0.5055710306406686
E01022380,1525,756,769,0.49573770491803276,0.5042622950819672
E01022412,2845,1383,1462,0.48611599297012303,0.513884007029877
E01022354,2142,1060,1082,0.49486461251167135,0.5051353874883286
E01022390,1202,567,635,0.4717138103161398,0.5282861896838602
E01022391,1425,677,748,0.4750877192982456,0.5249122807017544
E01022392,1531,739,792,0.48269105160026127,0.5173089483997387
E01022376,1794,872,922,0.48606465997770343,0.5139353400222966
E01022396,1711,856,855,0.5002922267679719,0.49970777323202803
E01022397,1913,935,978,0.4887611082070047,0.5112388917929953
E01022398,1136,582,554,0.5123239436619719,0.4876760563380282
E01022355,1675,847,828,0.5056716417910447,0.4943283582089552
E01022356,2274,1127,1147,0.49560246262093227,0.5043975373790677
E01022357,1771,871,900,0.49181253529079616,0.5081874647092038
E01022358,1596,776,820,0.48621553884711777,0.5137844611528822
E01022377,2166,1047,1119,0.48337950138504154,0.5166204986149584
E01022389,1747,858,889,0.4911276473955352,0.5088723526044648
E01022400,1817,900,917,0.4953219592735278,0.5046780407264722
E01022401,1410,700,710,0.49645390070921985,0.5035460992907801
E01022402,1579,763,816,0.4832172260924636,0.5167827739075365
E01022403,1377,676,701,0.49092229484386346,0.5090777051561365
E01022404,1542,808,734,0.5239948119325551,0.47600518806744485
E01022365,2150,1113,1037,0.5176744186046511,0.4823255813953488
E01022399,2141,1090,1051,0.5091078935077067,0.4908921064922933
E01022410,2150,1025,1125,0.47674418604651164,0.5232558139534884
E01022411,2215,1065,1150,0.48081264108352145,0.5191873589164786
E01022414,2437,1219,1218,0.5002051702913418,0.4997948297086582
E01022393,1464,709,755,0.4842896174863388,0.5157103825136612
E01022394,1555,784,771,0.5041800643086817,0.4958199356913183
E01022395,1524,749,775,0.4914698162729659,0.5085301837270341
E01022408,1071,557,514,0.5200746965452848,0.47992530345471524
E01022409,1256,640,616,0.5095541401273885,0.49044585987261147
E01022366,1784,873,911,0.48934977578475336,0.5106502242152466
E01022367,1655,804,851,0.48580060422960725,0.5141993957703928
E01022368,1396,694,702,0.497134670487106,0.502865329512894
E01022369,1674,822,852,0.4910394265232975,0.5089605734767025
E01022370,1240,613,627,0.49435483870967745,0.5056451612903226
E01022371,1059,524,535,0.4948064211520302,0.5051935788479698
E01022405,1424,672,752,0.47191011235955055,0.5280898876404494
E01022406,1209,617,592,0.5103391232423491,0.48966087675765096
E01022407,1327,654,673,0.49284099472494347,0.5071590052750565
E01022350,2116,1026,1090,0.4848771266540643,0.5151228733459358
E01022382,1611,738,873,0.4581005586592179,0.5418994413407822
E01022383,1325,637,688,0.4807547169811321,0.519245283018868
E01022384,1421,697,724,0.4904996481351161,0.5095003518648838
E01022359,1492,731,761,0.48994638069705093,0.510053619302949
E01022360,1394,706,688,0.5064562410329986,0.4935437589670014
E01022361,1248,615,633,0.49278846153846156,0.5072115384615384
E01022362,1159,568,591,0.4900776531492666,0.5099223468507333
E01022363,1755,879,876,0.5008547008547009,0.49914529914529915
E01022364,1114,536,578,0.48114901256732495,0.518850987432675
E01022351,1412,724,688,0.5127478753541076,0.48725212464589235
E01022352,1350,658,692,0.4874074074074074,0.5125925925925926
E01022353,1419,681,738,0.4799154334038055,0.5200845665961945
E01022413,1879,955,924,0.5082490686535391,0.49175093134646086
E01022385,1623,780,843,0.4805914972273567,0.5194085027726433
E01022386,1630,765,865,0.46932515337423314,0.5306748466257669
E01022387,1609,778,831,0.48353014294592916,0.5164698570540709
E01022388,1752,849,903,0.4845890410958904,0.5154109589041096
E01022372,1772,877,895,0.494920993227991,0.505079006772009
E01022373,1701,835,866,0.49088771310993534,0.5091122868900647
E01022374,1963,980,983,0.49923586347427407,0.5007641365257259
E01022375,1261,613,648,0.486122125297383,0.5138778747026169
E01022381,2096,1063,1033,0.5071564885496184,0.4928435114503817
E01022415,1621,782,839,0.4824182603331277,0.5175817396668723
E01022416,1453,732,721,0.503785271851342,0.49621472814865797
E01022417,1714,812,902,0.47374562427071176,0.5262543757292882
E01022418,1722,850,872,0.49361207897793263,0.5063879210220673
E01022450,2111,1080,1031,0.5116058739933681,0.4883941260066319
E01022451,1521,738,783,0.48520710059171596,0.514792899408284
E01022452,1448,751,697,0.518646408839779,0.481353591160221
E01022455,1969,1024,945,0.5200609446419502,0.47993905535804976
E01032938,1518,793,725,0.5223978919631094,0.4776021080368906
E01032939,1610,790,820,0.4906832298136646,0.5093167701863354
E01032940,1406,673,733,0.4786628733997155,0.5213371266002845
E01022456,1304,640,664,0.49079754601226994,0.50920245398773
E01022457,1377,663,714,0.48148148148148145,0.5185185185185185
E01022458,1413,690,723,0.4883227176220807,0.5116772823779193
E01022459,1453,732,721,0.503785271851342,0.49621472814865797
E01022460,1700,857,843,0.5041176470588236,0.4958823529411765
E01022461,1380,662,718,0.4797101449275362,0.5202898550724637
E01022462,1668,831,837,0.4982014388489209,0.5017985611510791
E01022449,1955,950,1005,0.4859335038363171,0.5140664961636828
E01022463,1468,705,763,0.48024523160762944,0.5197547683923706
E01022464,1580,759,821,0.48037974683544304,0.519620253164557
E01022465,1526,766,760,0.5019659239842726,0.4980340760157274
E01022466,1721,853,868,0.49564206856478793,0.5043579314352121
E01022434,2123,1032,1091,0.4861045690061234,0.5138954309938766
E01022441,1520,739,781,0.4861842105263158,0.5138157894736842
E01022445,1368,687,681,0.5021929824561403,0.49780701754385964
E01022453,1592,770,822,0.4836683417085427,0.5163316582914573
E01022432,2009,974,1035,0.4848183175709308,0.5151816824290691
E01022433,2081,993,1088,0.4771744353676117,0.5228255646323883
E01022435,2327,1102,1225,0.4735711216158143,0.5264288783841856
E01022436,1921,879,1042,0.45757418011452367,0.5424258198854763
E01022437,1448,686,762,0.47375690607734805,0.5262430939226519
E01022438,1352,637,715,0.47115384615384615,0.5288461538461539
E01022439,1555,757,798,0.4868167202572347,0.5131832797427652
E01022440,1527,779,748,0.510150622134905,0.48984937786509497
E01022442,1498,750,748,0.5006675567423231,0.4993324432576769
E01022443,1334,631,703,0.47301349325337333,0.5269865067466267
E01022444,1504,728,776,0.48404255319148937,0.5159574468085106
E01022425,1215,581,634,0.47818930041152263,0.5218106995884774
E01022426,1437,715,722,0.4975643702157272,0.5024356297842728
E01022427,1446,690,756,0.47717842323651455,0.5228215767634855
E01022428,1845,885,960,0.4796747967479675,0.5203252032520326
E01022429,1561,795,766,0.5092889173606663,0.4907110826393338
E01022430,1440,700,740,0.4861111111111111,0.5138888888888888
E01022431,2046,980,1066,0.4789833822091887,0.5210166177908113
E01022447,1530,845,685,0.5522875816993464,0.4477124183006536
E01022420,2124,1046,1078,0.4924670433145009,0.507532956685499
E01022448,1357,637,720,0.4694178334561533,0.5305821665438467
E01022454,1936,917,1019,0.47365702479338845,0.5263429752066116
E01022421,1755,813,942,0.46324786324786327,0.5367521367521367
E01022422,1639,826,813,0.5039658328248933,0.4960341671751068
E01022423,1915,907,1008,0.47362924281984337,0.5263707571801567
E01022424,1664,809,855,0.48617788461538464,0.5138221153846154
E01022446,1746,833,913,0.4770904925544101,0.52290950744559
E01029022,1341,644,697,0.4802386278896346,0.5197613721103654
E01029023,1193,603,590,0.5054484492875104,0.4945515507124895
E01029044,1333,662,671,0.4966241560390098,0.5033758439609902
E01029053,2275,1147,1128,0.5041758241758242,0.4958241758241758
E01029057,2041,1025,1016,0.5022048015678588,0.4977951984321411
E01029024,2062,1029,1033,0.49903006789524734,0.5009699321047527
E01029025,1314,659,655,0.5015220700152208,0.4984779299847793
E01029026,999,492,507,0.4924924924924925,0.5075075075075075
E01029068,1536,801,735,0.521484375,0.478515625
E01029069,1060,528,532,0.4981132075471698,0.5018867924528302
E01029030,1939,954,985,0.4920061887570913,0.5079938112429088
E01029031,1655,773,882,0.4670694864048338,0.5329305135951662
E01029032,1018,464,554,0.45579567779960706,0.5442043222003929
E01029033,1433,720,713,0.5024424284717376,0.4975575715282624
E01029034,1373,692,681,0.5040058266569556,0.4959941733430444
E01029036,1611,802,809,0.4978274363749224,0.5021725636250776
E01029041,2001,967,1034,0.4832583708145927,0.5167416291854073
E01029042,1548,745,803,0.481266149870801,0.5187338501291989
E01029043,1540,739,801,0.4798701298701299,0.5201298701298701
E01029045,1565,752,813,0.4805111821086262,0.5194888178913738
E01029052,2112,1054,1058,0.4990530303030303,0.5009469696969697
E01029060,1950,928,1022,0.4758974358974359,0.5241025641025641
E01029061,2236,1072,1164,0.47942754919499103,0.5205724508050089
E01029083,1367,643,724,0.4703730797366496,0.5296269202633505
E01029018,2363,1160,1203,0.49090139652983494,0.509098603470165
E01029056,2338,1148,1190,0.49101796407185627,0.5089820359281437
E01029064,1588,890,698,0.5604534005037783,0.43954659949622166
E01029084,1503,689,814,0.458416500332668,0.541583499667332
E01029029,1694,820,874,0.48406139315230223,0.5159386068476978
E01029035,1527,746,781,0.4885396201702685,0.5114603798297315
E01029037,1382,690,692,0.4992764109985528,0.5007235890014472
E01029038,1385,651,734,0.4700361010830325,0.5299638989169675
E01029039,1559,741,818,0.47530468248877483,0.5246953175112251
E01029040,1640,821,819,0.500609756097561,0.499390243902439
E01029078,1744,764,980,0.4380733944954128,0.5619266055045872
E01029079,1524,740,784,0.48556430446194226,0.5144356955380578
E01029080,1482,727,755,0.49055330634278005,0.50944669365722
E01029081,1571,712,859,0.4532145130490134,0.5467854869509866
E01029082,1345,607,738,0.4513011152416357,0.5486988847583643
E01029062,1415,741,674,0.5236749116607774,0.4763250883392226
E01029063,2490,1212,1278,0.4867469879518072,0.5132530120481927
E01029065,1664,822,842,0.49399038461538464,0.5060096153846154
E01029066,1756,871,885,0.4960136674259681,0.5039863325740319
E01029067,1456,697,759,0.47870879120879123,0.5212912087912088
E01029020,1487,745,742,0.5010087424344317,0.4989912575655683
E01029021,1238,606,632,0.4894991922455573,0.5105008077544426
E01029027,1195,575,620,0.4811715481171548,0.5188284518828452
E01029028,1139,548,591,0.4811237928007024,0.5188762071992976
E01029058,2299,1123,1176,0.4884732492387995,0.5115267507612006
E01029046,1411,692,719,0.49043231750531535,0.5095676824946846
E01029050,2220,1073,1147,0.48333333333333334,0.5166666666666667
E01029051,1555,765,790,0.4919614147909968,0.5080385852090032
E01032627,2248,1072,1176,0.47686832740213525,0.5231316725978647
E01029047,1498,715,783,0.4773030707610147,0.5226969292389854
E01029054,1541,760,781,0.49318624269954575,0.5068137573004543
E01029055,1236,628,608,0.5080906148867314,0.4919093851132686
E01029074,2122,1121,1001,0.5282752120640904,0.4717247879359095
E01029076,2059,1001,1058,0.4861583292860612,0.5138416707139388
E01029019,2357,1140,1217,0.48366567670767924,0.5163343232923208
E01029059,2078,1036,1042,0.4985563041385948,0.5014436958614052
E01029077,2044,1017,1027,0.49755381604696675,0.5024461839530333
E01029070,1825,904,921,0.49534246575342467,0.5046575342465753
E01029071,1528,737,791,0.48232984293193715,0.5176701570680629
E01029072,1639,746,893,0.45515558267236117,0.5448444173276388
E01029073,1249,590,659,0.4723779023218575,0.5276220976781425
E01029075,1383,649,734,0.4692697035430224,0.5307302964569776
E01029085,2057,986,1071,0.4793388429752066,0.5206611570247934
E01029126,1515,739,776,0.4877887788778878,0.5122112211221123
E01029127,1504,675,829,0.4488031914893617,0.5511968085106383
E01029128,1883,931,952,0.4944237918215613,0.5055762081784386
E01029129,1940,950,990,0.4896907216494845,0.5103092783505154
E01029089,2262,1105,1157,0.4885057471264368,0.5114942528735632
E01029113,1641,777,864,0.473491773308958,0.526508226691042
E01029115,1665,795,870,0.4774774774774775,0.5225225225225225
E01029140,2907,1401,1506,0.48194014447884415,0.5180598555211559
E01032633,2169,1094,1075,0.5043798985707699,0.4956201014292301
E01029086,2204,1102,1102,0.5,0.5
E01029147,1736,876,860,0.5046082949308756,0.49539170506912444
E01029148,1582,757,825,0.47850821744627053,0.5214917825537294
E01029149,1478,747,731,0.5054127198917456,0.4945872801082544
E01029114,1536,705,831,0.458984375,0.541015625
E01029116,1577,766,811,0.48573240329740014,0.5142675967025999
E01029117,1606,789,817,0.4912826899128269,0.5087173100871731
E01029119,1579,694,885,0.4395186827105763,0.5604813172894236
E01029120,1509,704,805,0.4665341285619616,0.5334658714380385
E01029118,1795,862,933,0.48022284122562675,0.5197771587743732
E01029131,2035,1026,1009,0.5041769041769042,0.4958230958230958
E01029132,1473,713,760,0.48404616429056346,0.5159538357094365
E01029133,1292,634,658,0.4907120743034056,0.5092879256965944
E01029134,1868,901,967,0.4823340471092077,0.5176659528907923
E01029135,1627,800,827,0.49170251997541486,0.5082974800245851
E01029136,1971,988,983,0.5012683916793506,0.4987316083206494
E01029145,1968,945,1023,0.4801829268292683,0.5198170731707317
E01029152,2115,992,1123,0.4690307328605201,0.5309692671394799
E01029121,1294,619,675,0.47836166924265844,0.5216383307573416
E01029122,1485,764,721,0.5144781144781144,0.4855218855218855
E01029123,1116,542,574,0.48566308243727596,0.514336917562724
E01029124,1725,810,915,0.46956521739130436,0.5304347826086957
E01029125,1371,685,686,0.49963530269876005,0.50036469730124
E01029093,1597,795,802,0.4978083907326237,0.5021916092673764
E01029096,1435,726,709,0.5059233449477352,0.49407665505226483
E01029106,1640,818,822,0.49878048780487805,0.501219512195122
E01029107,1502,729,773,0.48535286284953394,0.5146471371504661
E01029109,1405,693,712,0.49323843416370106,0.5067615658362989
E01029094,1617,803,814,0.4965986394557823,0.5034013605442177
E01029095,1581,817,764,0.5167615433270082,0.48323845667299176
E01029110,2151,1039,1112,0.48303114830311483,0.5169688516968852
E01029111,2520,1228,1292,0.4873015873015873,0.5126984126984127
E01029112,1876,1001,875,0.5335820895522388,0.4664179104477612
E01029090,1525,749,776,0.4911475409836066,0.5088524590163934
E01029091,1627,784,843,0.48186846957590657,0.5181315304240934
E01029092,1546,757,789,0.4896507115135834,0.5103492884864166
E01029108,2074,1027,1047,0.4951783992285439,0.5048216007714561
E01029102,1504,697,807,0.4634308510638298,0.5365691489361702
E01029103,1573,728,845,0.4628099173553719,0.5371900826446281
E01029104,1523,729,794,0.47866053841103084,0.5213394615889692
E01032631,1351,673,678,0.4981495188749075,0.5018504811250926
E01032632,1265,639,626,0.5051383399209486,0.49486166007905136
E01032634,1257,642,615,0.5107398568019093,0.4892601431980907
E01029130,2130,1073,1057,0.503755868544601,0.4962441314553991
E01029137,1557,779,778,0.5003211303789339,0.49967886962106617
E01029138,1425,700,725,0.49122807017543857,0.5087719298245614
E01029139,1482,733,749,0.49460188933873145,0.5053981106612686
E01029150,1291,622,669,0.4817970565453137,0.5182029434546863
E01029151,1262,615,647,0.4873217115689382,0.5126782884310618
E01029097,1430,689,741,0.4818181818181818,0.5181818181818182
E01029098,1393,721,672,0.5175879396984925,0.4824120603015075
E01029099,1348,654,694,0.48516320474777447,0.5148367952522255
E01029100,1362,683,679,0.5014684287812041,0.4985315712187959
E01029105,1496,724,772,0.4839572192513369,0.516042780748663
E01029101,1137,535,602,0.47053649956024624,0.5294635004397538
E01029142,1486,739,747,0.49730820995962316,0.5026917900403769
E01029143,1383,645,738,0.46637744034707157,0.5336225596529284
E01029144,1255,629,626,0.501195219123506,0.49880478087649405
E01032629,1501,763,738,0.508327781479014,0.491672218520986
E01032630,1596,796,800,0.49874686716791977,0.5012531328320802
E01029157,1356,697,659,0.5140117994100295,0.4859882005899705
E01029158,1551,780,771,0.5029013539651838,0.49709864603481624
E01029221,2442,1108,1334,0.4537264537264537,0.5462735462735463
E01029166,2270,1126,1144,0.4960352422907489,0.5039647577092511
E01029167,1620,749,871,0.4623456790123457,0.5376543209876543
E01029168,1612,761,851,0.47208436724565755,0.5279156327543424
E01029210,1629,791,838,0.48557397176181705,0.514426028238183
E01029211,1376,673,703,0.4890988372093023,0.5109011627906976
E01029224,1604,764,840,0.4763092269326683,0.5236907730673317
E01029225,2107,1024,1083,0.48599905078310396,0.5140009492168961
E01029226,1691,768,923,0.4541691306918983,0.5458308693081018
E01029200,1430,691,739,0.48321678321678324,0.5167832167832168
E01029201,1442,691,751,0.4791955617198336,0.5208044382801664
E01029222,1623,798,825,0.49168207024029575,0.5083179297597042
E01029223,1207,581,626,0.48135874067937034,0.5186412593206297
E01029155,1785,886,899,0.49635854341736696,0.503641456582633
E01029227,1638,795,843,0.48534798534798534,0.5146520146520146
E01029228,1642,777,865,0.47320341047503045,0.5267965895249695
E01029229,1992,987,1005,0.4954819277108434,0.5045180722891566
E01029164,1525,748,777,0.4904918032786885,0.5095081967213114
E01029165,1217,613,604,0.5036976170912079,0.49630238290879214
E01029198,1306,647,659,0.49540581929555894,0.5045941807044411
E01029199,3013,1898,1115,0.6299369399269831,0.3700630600730169
E01029187,1024,498,526,0.486328125,0.513671875
E01029188,1503,731,772,0.4863606121091151,0.5136393878908849
E01029196,1499,719,780,0.47965310206804534,0.5203468979319547
E01029197,1273,610,663,0.4791830322073841,0.5208169677926159
E01029154,1814,891,923,0.49117971334068355,0.5088202866593164
E01029156,1851,908,943,0.49054565099945974,0.5094543490005402
E01029206,1462,694,768,0.4746922024623803,0.5253077975376197
E01029207,1340,678,662,0.5059701492537313,0.49402985074626865
E01029202,1180,561,619,0.4754237288135593,0.5245762711864407
E01029203,1518,764,754,0.5032938076416338,0.49670619235836627
E01029204,1244,583,661,0.46864951768488744,0.5313504823151125
E01029205,1782,876,906,0.49158249158249157,0.5084175084175084
E01029163,2211,1074,1137,0.48575305291723203,0.514246947082768
E01029216,1448,694,754,0.47928176795580113,0.5207182320441989
E01029217,1514,723,791,0.4775429326287979,0.5224570673712021
E01029218,1904,891,1013,0.4679621848739496,0.5320378151260504
E01029238,1542,734,808,0.47600518806744485,0.5239948119325551
E01029252,1423,697,726,0.4898102600140548,0.5101897399859452
E01029253,1525,731,794,0.479344262295082,0.520655737704918
E01029254,1385,697,688,0.5032490974729242,0.4967509025270758
E01029160,2659,1383,1276,0.5201203459947349,0.4798796540052651
E01029248,1588,751,837,0.4729219143576826,0.5270780856423174
E01029250,1363,679,684,0.49816581071166544,0.5018341892883346
E01029251,1307,651,656,0.49808722264728383,0.5019127773527161
E01029161,1597,804,793,0.5034439574201628,0.4965560425798372
E01029162,1518,709,809,0.4670619235836627,0.5329380764163373
E01029247,1627,753,874,0.46281499692685923,0.5371850030731408
E01029255,1395,701,694,0.5025089605734767,0.4974910394265233
E01029231,1564,781,783,0.4993606138107417,0.5006393861892583
E01029233,1388,687,701,0.49495677233429397,0.5050432276657061
E01029235,1405,709,696,0.504626334519573,0.49537366548042705
E01029236,1519,733,786,0.4825543120473996,0.5174456879526004
E01029237,1481,712,769,0.48075624577987847,0.5192437542201216
E01029232,1527,756,771,0.4950884086444008,0.5049115913555993
E01029234,1832,955,877,0.5212882096069869,0.4787117903930131
E01029239,1483,729,754,0.4915711395819285,0.5084288604180714
E01029240,1550,794,756,0.512258064516129,0.48774193548387096
E01029241,1901,928,973,0.48816412414518673,0.5118358758548133
E01029245,2249,1091,1158,0.4851044908848377,0.5148955091151622
E01029246,1520,713,807,0.46907894736842104,0.530921052631579
E01029249,1351,623,728,0.46113989637305697,0.538860103626943
E01029189,1150,561,589,0.48782608695652174,0.5121739130434783
E01029190,1271,610,661,0.47993705743509046,0.5200629425649095
E01029191,1249,616,633,0.4931945556445156,0.5068054443554844
E01029192,1462,718,744,0.4911080711354309,0.5088919288645691
E01029212,1047,500,547,0.4775549188156638,0.5224450811843362
E01029213,1289,636,653,0.49340574088440653,0.5065942591155935
E01029214,1154,585,569,0.5069324090121318,0.4930675909878683
E01029215,1153,578,575,0.5013009540329575,0.4986990459670425
E01029159,1534,764,770,0.4980443285528031,0.5019556714471969
E01029242,1488,763,725,0.5127688172043011,0.48723118279569894
E01029243,1640,754,886,0.45975609756097563,0.5402439024390244
E01029244,1520,791,729,0.5203947368421052,0.47960526315789476
E01029193,1952,934,1018,0.47848360655737704,0.5215163934426229
E01029194,2510,1243,1267,0.4952191235059761,0.5047808764940239
E01029195,1555,712,843,0.45787781350482315,0.5421221864951768
E01029208,1130,548,582,0.4849557522123894,0.5150442477876106
E01029209,1298,640,658,0.4930662557781202,0.5069337442218799
E01029178,1470,728,742,0.49523809523809526,0.5047619047619047
E01029179,1115,538,577,0.48251121076233183,0.5174887892376682
E01029180,1404,687,717,0.4893162393162393,0.5106837606837606
E01029181,1321,660,661,0.4996214988644966,0.5003785011355034
E01029182,1463,709,754,0.48462064251537934,0.5153793574846206
E01029183,1467,701,766,0.4778459441036128,0.5221540558963872
E01029184,1773,847,926,0.47772137619853355,0.5222786238014664
E01029185,1654,799,855,0.4830713422007255,0.5169286577992744
E01029186,1469,692,777,0.471068754254595,0.5289312457454051
E01029169,1529,750,779,0.49051667756703726,0.5094833224329627
E01029172,1496,717,779,0.47927807486631013,0.5207219251336899
E01029173,1247,632,615,0.5068163592622293,0.49318364073777066
E01029176,1276,633,643,0.49608150470219436,0.5039184952978056
E01029177,1156,557,599,0.4818339100346021,0.5181660899653979
E01029170,1110,581,529,0.5234234234234234,0.4765765765765766
E01029171,2070,999,1071,0.4826086956521739,0.5173913043478261
E01029174,1088,527,561,0.484375,0.515625
E01029175,2102,1063,1039,0.505708848715509,0.49429115128449097
E01029153,2334,1147,1187,0.49143101970865466,0.5085689802913453
E01029219,1447,721,726,0.49827228749136143,0.5017277125086386
E01029220,1213,589,624,0.48557295960428687,0.5144270403957131
E01029230,2293,1127,1166,0.4914958569559529,0.5085041430440471
E01029258,1464,712,752,0.48633879781420764,0.5136612021857924
E01029259,1486,701,785,0.4717362045760431,0.528263795423957
E01029260,2309,1116,1193,0.4833261152013859,0.5166738847986141
E01029268,1570,747,823,0.47579617834394905,0.524203821656051
E01029276,1633,847,786,0.518677281077771,0.48132271892222905
E01029278,1333,637,696,0.4778694673668417,0.5221305326331583
E01029290,1415,698,717,0.49328621908127207,0.5067137809187279
E01029306,1570,744,826,0.47388535031847134,0.5261146496815287
E01029319,1517,747,770,0.4924192485168095,0.5075807514831905
E01029267,1702,829,873,0.4870740305522914,0.5129259694477086
E01029320,1588,757,831,0.47670025188916876,0.5232997481108312
E01029321,2312,1123,1189,0.4857266435986159,0.514273356401384
E01029297,1269,605,664,0.47675334909377465,0.5232466509062254
E01029298,1498,716,782,0.4779706275033378,0.5220293724966623
E01029304,1529,699,830,0.45716154349247873,0.5428384565075213
E01029305,1389,668,721,0.48092152627789775,0.5190784737221023
E01029307,1456,682,774,0.4684065934065934,0.5315934065934066
E01029271,1776,868,908,0.48873873873873874,0.5112612612612613
E01029273,1243,582,661,0.4682220434432824,0.5317779565567177
E01029274,1497,737,760,0.4923179692718771,0.5076820307281229
E01029275,1268,593,675,0.4676656151419558,0.5323343848580442
E01029279,1450,711,739,0.4903448275862069,0.5096551724137931
E01029282,1385,660,725,0.47653429602888087,0.5234657039711191
E01029291,1580,757,823,0.4791139240506329,0.5208860759493671
E01029294,1792,862,930,0.4810267857142857,0.5189732142857143
E01029317,1263,612,651,0.4845605700712589,0.5154394299287411
E01029318,1524,722,802,0.473753280839895,0.526246719160105
E01029285,2348,1180,1168,0.5025553662691652,0.49744463373083475
E01029287,1508,734,774,0.48673740053050396,0.513262599469496
E01029288,1535,721,814,0.46970684039087945,0.5302931596091205
E01029289,1863,885,978,0.4750402576489533,0.5249597423510467
E01029299,1501,736,765,0.49033977348434377,0.5096602265156562
E01029300,1550,759,791,0.4896774193548387,0.5103225806451613
E01029256,1446,672,774,0.46473029045643155,0.5352697095435685
E01029257,2174,1004,1170,0.46182152713891444,0.5381784728610856
E01029277,1038,485,553,0.46724470134874757,0.5327552986512524
E01032651,1886,1218,668,0.6458112407211029,0.35418875927889715
E01032652,1160,564,596,0.4862068965517241,0.5137931034482759
E01029280,1613,776,837,0.4810911345319281,0.5189088654680719
E01029281,1683,781,902,0.46405228758169936,0.5359477124183006
E01029283,1776,845,931,0.4757882882882883,0.5242117117117117
E01029292,1435,684,751,0.47665505226480837,0.5233449477351917
E01029293,1657,747,910,0.4508147254073627,0.5491852745926373
E01029266,1375,665,710,0.48363636363636364,0.5163636363636364
E01029284,1714,870,844,0.5075845974329055,0.49241540256709454
E01029286,1662,864,798,0.51985559566787,0.48014440433212996
E01029301,1919,894,1025,0.4658676393955185,0.5341323606044815
E01029303,1891,868,1023,0.45901639344262296,0.5409836065573771
E01029263,1404,672,732,0.47863247863247865,0.5213675213675214
E01029264,1294,609,685,0.4706336939721793,0.5293663060278208
E01029265,1390,670,720,0.48201438848920863,0.5179856115107914
E01029302,1695,797,898,0.4702064896755162,0.5297935103244837
E01029308,2072,996,1076,0.4806949806949807,0.5193050193050193
E01029309,1996,964,1032,0.48296593186372744,0.5170340681362725
E01029311,1484,704,780,0.4743935309973046,0.5256064690026954
E01029312,1420,690,730,0.4859154929577465,0.5140845070422535
E01029313,1355,678,677,0.5003690036900369,0.4996309963099631
E01029316,1637,762,875,0.4654856444715944,0.5345143555284056
E01029262,2337,1165,1172,0.4985023534445871,0.501497646555413
E01029269,2184,1054,1130,0.4826007326007326,0.5173992673992674
E01029310,1869,915,954,0.4895666131621188,0.5104333868378812
E01029314,2609,1271,1338,0.48715983135300883,0.5128401686469912
E01029315,1452,663,789,0.45661157024793386,0.5433884297520661
E01029261,2064,1024,1040,0.49612403100775193,0.5038759689922481
E01029270,2164,1044,1120,0.4824399260628466,0.5175600739371534
E01029295,1628,783,845,0.480958230958231,0.519041769041769
E01029296,1581,735,846,0.4648956356736243,0.5351043643263758
E01029324,1603,772,831,0.4815970056144729,0.5184029943855272
E01029329,1780,807,973,0.4533707865168539,0.5466292134831461
E01029330,2022,951,1071,0.47032640949554894,0.5296735905044511
E01032636,1922,883,1039,0.459417273673257,0.540582726326743
E01029322,2019,1025,994,0.5076770678553739,0.4923229321446261
E01029331,1458,652,806,0.44718792866941015,0.5528120713305898
E01029333,1177,545,632,0.46304163126593034,0.5369583687340697
E01029336,2074,982,1092,0.4734811957569913,0.5265188042430087
E01029326,1158,547,611,0.47236614853195164,0.5276338514680483
E01029334,1111,512,599,0.4608460846084608,0.5391539153915391
E01029339,1498,723,775,0.4826435246995995,0.5173564753004005
E01029341,1291,636,655,0.49264136328427577,0.5073586367157242
E01032635,2160,1046,1114,0.4842592592592593,0.5157407407407407
E01029327,2029,1016,1013,0.5007392804337112,0.4992607195662888
E01029335,1085,526,559,0.4847926267281106,0.5152073732718894
E01029337,2121,1042,1079,0.4912776991984913,0.5087223008015087
E01029342,1088,539,549,0.4954044117647059,0.5045955882352942
E01029343,1533,734,799,0.47879973907371165,0.5212002609262884
E01029325,1844,847,997,0.45932754880694143,0.5406724511930586
E01029328,1927,917,1010,0.47586922677737414,0.5241307732226258
E01029338,1775,873,902,0.49183098591549296,0.508169014084507
W01000003,2507,1235,1272,0.4926206621459912,0.5073793378540088
W01000004,1282,623,659,0.4859594383775351,0.5140405616224649
W01000018,1357,672,685,0.4952100221075903,0.5047899778924098
W01000028,1941,983,958,0.506439979392066,0.4935600206079341
W01000031,1545,775,770,0.5016181229773463,0.49838187702265374
W01000010,1869,893,976,0.4777956126270733,0.5222043873729267
W01000020,1315,647,668,0.4920152091254753,0.5079847908745247
W01000021,2264,1159,1105,0.5119257950530035,0.4880742049469965
W01000032,1064,506,558,0.4755639097744361,0.5244360902255639
W01000016,1203,627,576,0.5211970074812967,0.47880299251870323
W01000017,1525,754,771,0.4944262295081967,0.5055737704918033
W01000029,1493,717,776,0.48024112525117213,0.5197588747488279
W01000030,2286,1097,1189,0.4798775153105862,0.5201224846894138
W01000033,1504,756,748,0.5026595744680851,0.4973404255319149
W01000036,1088,541,547,0.49724264705882354,0.5027573529411765
W01000037,1178,627,551,0.532258064516129,0.46774193548387094
W01000022,1648,835,813,0.5066747572815534,0.4933252427184466
W01000034,1154,566,588,0.4904679376083189,0.5095320623916811
W01000039,1060,528,532,0.4981132075471698,0.5018867924528302
W01000040,1168,543,625,0.4648972602739726,0.5351027397260274
W01000043,1217,577,640,0.4741166803615448,0.5258833196384552
W01000044,1144,579,565,0.5061188811188811,0.4938811188811189
W01000005,1938,933,1005,0.48142414860681115,0.5185758513931888
W01000013,2254,1082,1172,0.4800354924578527,0.5199645075421473
W01000019,1513,742,771,0.4904163912756114,0.5095836087243887
W01000026,1229,579,650,0.47111472742066723,0.5288852725793328
W01000035,1869,914,955,0.48903156768325307,0.5109684323167469
W01000006,1534,776,758,0.5058670143415906,0.4941329856584094
W01000012,1484,684,800,0.4609164420485175,0.5390835579514824
W01000014,2049,987,1062,0.4816983894582723,0.5183016105417276
W01000041,1583,767,816,0.4845230574857865,0.5154769425142135
W01000001,1115,546,569,0.4896860986547085,0.5103139013452915
W01000002,1263,625,638,0.4948535233570863,0.5051464766429137
W01000009,1903,924,979,0.48554913294797686,0.5144508670520231
W01000023,1406,697,709,0.4957325746799431,0.5042674253200569
W01000024,1519,814,705,0.5358788676761027,0.4641211323238973
W01000008,1519,718,801,0.4726793943383805,0.5273206056616195
W01000011,1230,595,635,0.483739837398374,0.516260162601626
W01000015,1588,769,819,0.48425692695214106,0.5157430730478589
W01000042,2146,1056,1090,0.49207828518173347,0.5079217148182665
W01000007,1704,823,881,0.482981220657277,0.517018779342723
W01000025,2016,1011,1005,0.5014880952380952,0.49851190476190477
W01000027,1851,920,931,0.4970286331712588,0.5029713668287412
W01000038,2226,1072,1154,0.481581311769991,0.518418688230009
W01000062,1839,946,893,0.5144100054377378,0.4855899945622621
W01000076,1316,677,639,0.5144376899696048,0.48556231003039513
W01000077,1387,677,710,0.48810382119682766,0.5118961788031723
W01000091,1140,572,568,0.5017543859649123,0.4982456140350877
W01000092,4128,2021,2107,0.4895833333333333,0.5104166666666666
W01000064,1849,916,933,0.49540292049756623,0.5045970795024337
W01000072,1777,837,940,0.4710185706246483,0.5289814293753518
W01000075,1496,741,755,0.49532085561497324,0.5046791443850267
W01000090,1426,651,775,0.45652173913043476,0.5434782608695652
W01000102,1217,610,607,0.5012325390304027,0.4987674609695974
W01000050,1398,696,702,0.4978540772532189,0.5021459227467812
W01000071,2380,1192,1188,0.5008403361344538,0.4991596638655462
W01000096,1245,603,642,0.4843373493975904,0.5156626506024097
W01000097,1110,535,575,0.481981981981982,0.5180180180180181
W01000115,2218,1088,1130,0.4905320108205591,0.5094679891794409
W01000052,1171,574,597,0.4901793339026473,0.5098206660973527
W01000053,1219,622,597,0.5102543068088597,0.48974569319114025
W01000087,1916,925,991,0.482776617954071,0.517223382045929
W01000119,2284,1145,1139,0.5013134851138353,0.4986865148861646
W01000063,1909,931,978,0.48768988999476165,0.5123101100052383
W01000081,2026,998,1028,0.49259624876604147,0.5074037512339585
W01000099,1768,885,883,0.5005656108597285,0.4994343891402715
W01000103,1233,597,636,0.48418491484184917,0.5158150851581509
W01000059,2060,1025,1035,0.4975728155339806,0.5024271844660194
W01000093,2196,1047,1149,0.476775956284153,0.523224043715847
W01000098,2321,1129,1192,0.4864282636794485,0.5135717363205515
W01000110,1506,711,795,0.4721115537848606,0.5278884462151394
W01000054,1162,571,591,0.49139414802065406,0.5086058519793459
W01000088,1994,976,1018,0.48946840521564694,0.5105315947843531
W01000111,1532,759,773,0.4954308093994778,0.5045691906005222
W01000118,1676,823,853,0.49105011933174225,0.5089498806682577
W01000073,1695,840,855,0.49557522123893805,0.504424778761062
W01000086,2253,1105,1148,0.4904571682201509,0.509542831779849
W01000104,1793,839,954,0.467930842163971,0.532069157836029
W01000112,1930,951,979,0.4927461139896373,0.5072538860103627
W01000056,1878,956,922,0.5090521831735889,0.4909478168264111
W01000065,1126,542,584,0.48134991119005327,0.5186500888099467
W01000113,1871,899,972,0.4804917156600748,0.5195082843399251
W01000114,1604,795,809,0.4956359102244389,0.5043640897755611
W01000066,1219,611,608,0.5012305168170632,0.49876948318293685
W01000100,1054,521,533,0.49430740037950666,0.5056925996204934
W01000105,1775,888,887,0.5002816901408451,0.49971830985915494
W01000106,1732,844,888,0.48729792147806006,0.5127020785219399
W01000107,1257,598,659,0.47573587907716786,0.5242641209228321
W01000047,1354,647,707,0.4778434268833087,0.5221565731166913
W01000061,1753,823,930,0.4694808899030234,0.5305191100969766
W01000078,1683,840,843,0.49910873440285203,0.5008912655971479
W01000089,2080,1013,1067,0.48701923076923076,0.5129807692307692
W01000070,1275,652,623,0.5113725490196078,0.4886274509803922
W01000094,1229,602,627,0.4898291293734744,0.5101708706265257
W01000095,1373,670,703,0.4879825200291333,0.5120174799708667
W01000108,2190,1060,1130,0.4840182648401826,0.5159817351598174
W01000109,1886,964,922,0.5111346765641569,0.48886532343584305
W01000069,1540,742,798,0.4818181818181818,0.5181818181818182
W01000074,1997,991,1006,0.49624436654982473,0.5037556334501753
W01000079,1098,541,557,0.49271402550091076,0.5072859744990893
W01000101,1533,756,777,0.4931506849315068,0.5068493150684932
W01000080,1785,875,910,0.49019607843137253,0.5098039215686274
W01000084,1206,604,602,0.5008291873963516,0.49917081260364843
W01001932,2931,1478,1453,0.5042647560559536,0.4957352439440464
W01000051,1974,952,1022,0.48226950354609927,0.5177304964539007
W01000060,1345,675,670,0.5018587360594795,0.49814126394052044
W01000082,1095,554,541,0.5059360730593607,0.4940639269406393
W01000083,1293,668,625,0.5166279969064191,0.4833720030935808
W01000048,1380,650,730,0.47101449275362317,0.5289855072463768
W01000049,1142,587,555,0.5140105078809106,0.4859894921190893
W01000057,1444,751,693,0.5200831024930748,0.47991689750692523
W01000067,1204,606,598,0.5033222591362126,0.49667774086378735
W01000068,1484,684,800,0.4609164420485175,0.5390835579514824
W01000085,2007,1030,977,0.5132037867463877,0.48679621325361233
W01000116,1685,777,908,0.4611275964391691,0.5388724035608309
W01000117,1579,732,847,0.4635845471817606,0.5364154528182394
W01001933,2243,1113,1130,0.49621043245653146,0.5037895675434686
W01000132,1537,729,808,0.47430058555627846,0.5256994144437215
W01000146,2254,1145,1109,0.5079858030168589,0.4920141969831411
W01000147,1493,693,800,0.46416610850636303,0.535833891493637
W01000169,1855,925,930,0.49865229110512127,0.5013477088948787
W01000186,1711,805,906,0.47048509643483344,0.5295149035651666
W01000133,1887,870,1017,0.4610492845786963,0.5389507154213037
W01000168,1784,825,959,0.4624439461883408,0.5375560538116592
W01000187,1561,715,846,0.45803971812940425,0.5419602818705958
W01000188,1736,823,913,0.4740783410138249,0.5259216589861752
W01000154,1475,662,813,0.4488135593220339,0.5511864406779661
W01000173,1549,807,742,0.5209812782440284,0.4790187217559716
W01000174,1702,806,896,0.4735605170387779,0.5264394829612221
W01000175,1632,765,867,0.46875,0.53125
W01000155,1549,678,871,0.43770174306003873,0.5622982569399613
W01000156,1517,686,831,0.45220830586684246,0.5477916941331575
W01000157,1465,692,773,0.47235494880546075,0.5276450511945392
W01000158,1587,725,862,0.45683679899180846,0.5431632010081916
W01000149,1490,720,770,0.48322147651006714,0.5167785234899329
W01000150,1509,756,753,0.5009940357852882,0.4990059642147117
W01000151,1589,765,824,0.4814348646947766,0.5185651353052234
W01000152,1492,697,795,0.4671581769436997,0.5328418230563002
W01000184,2380,1120,1260,0.47058823529411764,0.5294117647058824
W01000135,2081,952,1129,0.45747236905333977,0.5425276309466602
W01000136,1855,923,932,0.49757412398921835,0.5024258760107817
W01000165,1930,959,971,0.4968911917098446,0.5031088082901555
W01000166,1949,896,1053,0.45972293483837867,0.5402770651616213
W01000139,1721,864,857,0.5020337013364323,0.4979662986635677
W01000143,1543,785,758,0.508749189889825,0.49125081011017496
W01000144,1516,805,711,0.5310026385224275,0.46899736147757254
W01000182,1918,925,993,0.48227320125130346,0.5177267987486965
W01000138,1826,868,958,0.47535596933187296,0.524644030668127
W01000145,1281,603,678,0.4707259953161593,0.5292740046838408
W01000180,1682,842,840,0.5005945303210464,0.4994054696789536
W01000181,1556,766,790,0.4922879177377892,0.5077120822622108
W01000183,1485,751,734,0.5057239057239057,0.49427609427609426
W01000126,1716,879,837,0.5122377622377622,0.48776223776223776
W01000127,1367,667,700,0.4879297732260424,0.5120702267739575
W01000128,1483,709,774,0.47808496291301417,0.5219150370869858
W01000153,1542,766,776,0.496757457846952,0.503242542153048
W01000163,1337,640,697,0.4786836200448766,0.5213163799551234
W01000164,1406,676,730,0.48079658605974396,0.519203413940256
W01000140,1466,706,760,0.4815825375170532,0.5184174624829468
W01000141,1542,703,839,0.45590142671854733,0.5440985732814526
W01000142,1603,772,831,0.4815970056144729,0.5184029943855272
W01000178,1901,882,1019,0.46396633350867966,0.5360336664913203
W01000179,1604,741,863,0.4619700748129676,0.5380299251870324
W01001927,1331,626,705,0.47032306536438767,0.5296769346356123
W01001928,1130,594,536,0.5256637168141592,0.4743362831858407
W01000167,1923,943,980,0.4903796151846074,0.5096203848153926
W01000176,1606,786,820,0.48941469489414696,0.5105853051058531
W01000177,1237,596,641,0.48181083265966046,0.5181891673403395
W01001926,2196,1059,1137,0.4822404371584699,0.51775956284153
W01000124,2007,970,1037,0.4833084205281515,0.5166915794718485
W01000129,1064,509,555,0.4783834586466165,0.5216165413533834
W01000130,1537,764,773,0.4970722186076773,0.5029277813923227
W01000131,1464,696,768,0.47540983606557374,0.5245901639344263
W01000123,1815,913,902,0.503030303030303,0.49696969696969695
W01000125,1485,719,766,0.4841750841750842,0.5158249158249159
W01000170,1822,890,932,0.4884742041712404,0.5115257958287596
W01000171,1582,768,814,0.4854614412136536,0.5145385587863464
W01000172,1286,610,676,0.47433903576982894,0.5256609642301711
W01000122,2122,1047,1075,0.4934024505183789,0.5065975494816211
W01000159,1435,721,714,0.5024390243902439,0.4975609756097561
W01000162,1925,1015,910,0.5272727272727272,0.4727272727272727
W01000190,1399,684,715,0.4889206576125804,0.5110793423874196
W01000121,1244,637,607,0.5120578778135049,0.4879421221864952
W01000134,2118,1000,1118,0.4721435316336166,0.5278564683663833
W01000137,1537,767,770,0.4990240728692258,0.5009759271307742
W01000148,1205,563,642,0.46721991701244814,0.5327800829875519
W01000185,1229,619,610,0.5036615134255492,0.4963384865744508
W01000189,1465,764,701,0.5215017064846417,0.4784982935153584
W01000218,1546,737,809,0.47671410090556277,0.5232858990944372
W01000219,2566,1237,1329,0.4820732657833203,0.5179267342166797
W01000220,1604,772,832,0.48129675810473815,0.5187032418952618
W01000213,1343,628,715,0.4676098287416232,0.5323901712583767
W01000214,1171,563,608,0.4807856532877882,0.5192143467122118
W01000215,1435,688,747,0.4794425087108014,0.5205574912891986
W01000216,1409,677,732,0.4804826117814053,0.5195173882185947
W01000212,2189,1052,1137,0.48058474189127454,0.5194152581087255
W01000221,1348,647,701,0.47997032640949555,0.5200296735905044
W01000222,1660,771,889,0.4644578313253012,0.5355421686746988
W01000226,1515,753,762,0.497029702970297,0.502970297029703
W01000227,1556,741,815,0.4762210796915167,0.5237789203084833
W01000228,1146,576,570,0.5026178010471204,0.4973821989528796
W01000239,1781,952,829,0.5345311622683886,0.46546883773161146
W01000240,1316,755,561,0.5737082066869301,0.42629179331306993
W01000241,1289,630,659,0.4887509697439876,0.5112490302560124
W01000236,1875,897,978,0.4784,0.5216
W01000237,1806,868,938,0.4806201550387597,0.5193798449612403
W01000238,1702,826,876,0.48531139835487663,0.5146886016451234
W01000200,1283,628,655,0.48947778643803586,0.5105222135619641
W01000201,1498,723,775,0.4826435246995995,0.5173564753004005
W01000217,2066,1010,1056,0.4888673765730881,0.5111326234269119
W01000248,1649,819,830,0.4966646452395391,0.5033353547604609
W01000191,2147,1051,1096,0.4895202608290638,0.5104797391709361
W01000223,1325,633,692,0.47773584905660377,0.5222641509433962
W01000224,1402,672,730,0.4793152639087018,0.5206847360912982
W01000225,1528,738,790,0.4829842931937173,0.5170157068062827
W01000245,1674,826,848,0.4934289127837515,0.5065710872162486
W01000246,1681,795,886,0.4729327781082689,0.5270672218917312
W01000247,1970,953,1017,0.48375634517766497,0.516243654822335
W01000194,2122,1050,1072,0.4948162111215834,0.5051837888784166
W01000198,1475,760,715,0.5152542372881356,0.4847457627118644
W01000199,1690,854,836,0.5053254437869823,0.49467455621301776
W01000195,1379,655,724,0.4749818709209572,0.5250181290790428
W01000196,1506,744,762,0.4940239043824701,0.5059760956175299
W01000197,1676,832,844,0.4964200477326969,0.5035799522673031
W01000211,1856,930,926,0.5010775862068966,0.4989224137931034
W01000203,2456,1242,1214,0.505700325732899,0.494299674267101
W01000204,1421,720,701,0.5066854327938072,0.4933145672061928
W01000206,2156,1074,1082,0.49814471243042674,0.5018552875695733
W01000242,1906,924,982,0.48478488982161594,0.5152151101783841
W01000243,1823,892,931,0.48930334613274823,0.5106966538672518
W01000244,1732,845,887,0.48787528868360275,0.5121247113163973
W01000193,1314,677,637,0.515220700152207,0.484779299847793
W01000202,1686,826,860,0.48991696322657174,0.5100830367734283
W01000207,2227,1124,1103,0.5047148630444545,0.4952851369555456
W01000192,1011,513,498,0.5074183976261127,0.49258160237388726
W01000205,1122,582,540,0.5187165775401069,0.48128342245989303
W01000208,1229,650,579,0.5288852725793328,0.47111472742066723
W01000209,1496,731,765,0.48863636363636365,0.5113636363636364
W01000210,1354,639,715,0.47193500738552435,0.5280649926144756
W01000229,1606,767,839,0.4775840597758406,0.5224159402241594
W01000230,1963,946,1017,0.4819154355578197,0.5180845644421803
W01000231,1432,676,756,0.4720670391061452,0.5279329608938548
W01000232,1605,777,828,0.48411214953271026,0.5158878504672897
W01000233,1276,616,660,0.4827586206896552,0.5172413793103449
W01000234,1405,665,740,0.47330960854092524,0.5266903914590747
W01000235,1330,658,672,0.49473684210526314,0.5052631578947369
W01000287,1808,885,923,0.4894911504424779,0.5105088495575221
W01000298,1527,762,765,0.49901768172888017,0.5009823182711198
W01000338,1838,888,950,0.48313384113166485,0.5168661588683352
W01000306,2399,1211,1188,0.5047936640266778,0.4952063359733222
W01000320,1844,902,942,0.4891540130151844,0.5108459869848156
W01000340,2322,1186,1136,0.5107665805340224,0.4892334194659776
W01000253,1941,964,977,0.4966512107161257,0.5033487892838743
W01000254,2224,1094,1130,0.4919064748201439,0.5080935251798561
W01000296,1506,748,758,0.49667994687915007,0.5033200531208499
W01000297,1235,592,643,0.47935222672064776,0.5206477732793522
W01000304,1988,966,1022,0.4859154929577465,0.5140845070422535
W01000305,1758,874,884,0.49715585893060293,0.502844141069397
W01000288,2264,1073,1191,0.4739399293286219,0.526060070671378
W01000290,1269,622,647,0.49014972419227737,0.5098502758077226
W01000292,1483,706,777,0.476062036412677,0.523937963587323
W01000293,1568,825,743,0.5261479591836735,0.47385204081632654
W01000289,1358,683,675,0.5029455081001473,0.49705449189985274
W01000291,1401,665,736,0.47466095645967166,0.5253390435403283
W01000294,1937,992,945,0.5121321631388746,0.48786783686112545
W01000295,1673,801,872,0.47878063359234907,0.5212193664076509
W01000258,2153,1081,1072,0.5020901068276823,0.4979098931723177
W01000270,1286,654,632,0.5085536547433903,0.49144634525660963
W01000271,1283,630,653,0.49103663289166016,0.5089633671083398
W01000272,1874,921,953,0.49146211312700105,0.508537886872999
W01000301,1785,889,896,0.4980392156862745,0.5019607843137255
W01000273,1585,764,821,0.48201892744479496,0.5179810725552051
W01000274,1771,892,879,0.5036702428006776,0.49632975719932243
W01000275,1253,646,607,0.515562649640862,0.48443735035913804
W01000278,1495,723,772,0.4836120401337793,0.5163879598662208
W01000276,1393,709,684,0.5089734386216799,0.4910265613783202
W01000277,1363,636,727,0.46661775495231106,0.5333822450476889
W01000279,1264,604,660,0.4778481012658228,0.5221518987341772
W01000281,1222,611,611,0.5,0.5
W01000283,2259,1120,1139,0.4957945993802568,0.5042054006197433
W01000332,1568,792,776,0.5051020408163265,0.49489795918367346
W01000333,1428,700,728,0.49019607843137253,0.5098039215686274
W01000334,1958,994,964,0.5076608784473953,0.4923391215526047
W01000335,1111,526,585,0.4734473447344735,0.5265526552655265
W01000336,1465,712,753,0.48600682593856653,0.5139931740614334
W01000337,2129,1080,1049,0.5072804133395961,0.49271958666040394
W01000252,1631,807,824,0.49478847332924586,0.5052115266707541
W01000280,1426,713,713,0.5,0.5
W01000282,1743,885,858,0.5077452667814114,0.49225473321858865
W01000325,1530,745,785,0.4869281045751634,0.5130718954248366
W01000311,1782,901,881,0.5056116722783389,0.4943883277216611
W01000312,1714,851,863,0.49649941656942825,0.5035005834305718
W01000328,2109,1106,1003,0.5244191559981034,0.47558084400189665
W01000264,1701,844,857,0.49617871840094063,0.5038212815990594
W01000265,1312,639,673,0.4870426829268293,0.5129573170731707
W01000323,1545,760,785,0.4919093851132686,0.5080906148867314
W01000324,1504,716,788,0.47606382978723405,0.523936170212766
W01000251,1486,716,770,0.48183041722745623,0.5181695827725438
W01000268,1767,885,882,0.5008488964346349,0.499151103565365
W01000284,1708,845,863,0.49473067915690866,0.5052693208430913
W01000285,1473,715,758,0.48540393754243044,0.5145960624575696
W01000286,2239,1115,1124,0.497990174184904,0.502009825815096
W01000302,1887,889,998,0.47111817700052994,0.5288818229994701
W01000249,1258,597,661,0.47456279809220986,0.5254372019077902
W01000250,1578,796,782,0.5044359949302915,0.4955640050697085
W01000261,1549,761,788,0.49128469980632666,0.5087153001936734
W01000321,1659,808,851,0.487040385774563,0.512959614225437
W01000322,1342,642,700,0.4783904619970194,0.5216095380029806
W01000255,2292,1137,1155,0.49607329842931935,0.5039267015706806
W01000256,1561,763,798,0.48878923766816146,0.5112107623318386
W01000257,2121,1091,1030,0.5143800094295143,0.4856199905704856
W01000329,1373,674,699,0.49089584850691914,0.5091041514930809
W01000330,2150,1068,1082,0.4967441860465116,0.5032558139534884
W01000331,1609,799,810,0.49658172778123055,0.5034182722187694
W01000313,1566,729,837,0.46551724137931033,0.5344827586206896
W01000314,1129,548,581,0.4853852967227635,0.5146147032772365
W01000315,2006,963,1043,0.48005982053838486,0.5199401794616152
W01000316,1323,620,703,0.46863189720332576,0.5313681027966742
W01000317,1393,708,685,0.5082555635319455,0.49174443646805455
W01000318,1172,579,593,0.49402730375426623,0.5059726962457338
W01000319,1469,733,736,0.4989788972089857,0.5010211027910143
W01000259,1636,788,848,0.48166259168704156,0.5183374083129584
W01000260,1809,880,929,0.48645660585959094,0.5135433941404091
W01000262,1490,722,768,0.48456375838926175,0.5154362416107383
W01000263,1488,745,743,0.5006720430107527,0.4993279569892473
W01000266,1320,654,666,0.4954545454545455,0.5045454545454545
W01000267,1593,787,806,0.49403640929064657,0.5059635907093534
W01000303,1697,816,881,0.48084855627578077,0.5191514437242192
W01000326,1677,814,863,0.4853905784138342,0.5146094215861657
W01000327,2197,1111,1086,0.5056895766954939,0.49431042330450614
W01000299,1942,955,987,0.4917610710607621,0.5082389289392379
W01000300,1726,846,880,0.4901506373117034,0.5098493626882966
W01000309,2135,1064,1071,0.49836065573770494,0.5016393442622951
W01000339,1627,800,827,0.49170251997541486,0.5082974800245851
W01000269,1619,791,828,0.48857319332921556,0.5114268066707844
W01000307,1363,670,693,0.491562729273661,0.5084372707263389
W01000308,1242,616,626,0.49597423510466987,0.5040257648953301
W01000310,1850,917,933,0.49567567567567566,0.5043243243243243
W01000374,1386,675,711,0.487012987012987,0.512987012987013
W01000375,1997,977,1020,0.48923385077616427,0.5107661492238358
W01000376,1390,706,684,0.5079136690647482,0.4920863309352518
W01000391,1425,714,711,0.5010526315789474,0.49894736842105264
W01000392,1720,831,889,0.4831395348837209,0.516860465116279
W01000377,1540,771,769,0.5006493506493507,0.4993506493506494
W01000378,1324,621,703,0.4690332326283988,0.5309667673716012
W01000379,1598,801,797,0.5012515644555695,0.49874843554443055
W01000380,1442,718,724,0.49791955617198336,0.5020804438280166
W01000351,2175,1066,1109,0.4901149425287356,0.5098850574712643
W01000373,1831,904,927,0.4937192790824686,0.5062807209175314
W01000400,1657,814,843,0.4912492456246228,0.5087507543753772
W01000401,1791,879,912,0.490787269681742,0.509212730318258
W01000347,2524,1272,1252,0.5039619651347068,0.4960380348652932
W01000348,1457,713,744,0.48936170212765956,0.5106382978723404
W01000362,1529,746,783,0.48790058862001306,0.5120994113799869
W01000363,1524,740,784,0.48556430446194226,0.5144356955380578
W01000364,1649,853,796,0.5172832019405701,0.48271679805942996
W01000343,1054,510,544,0.4838709677419355,0.5161290322580645
W01000344,1305,630,675,0.4827586206896552,0.5172413793103449
W01000415,1484,730,754,0.4919137466307278,0.5080862533692723
W01000416,1266,638,628,0.5039494470774092,0.4960505529225908
W01000368,2036,1004,1032,0.4931237721021611,0.5068762278978389
W01000371,1204,617,587,0.5124584717607974,0.48754152823920266
W01000372,1486,762,724,0.5127860026917901,0.48721399730820997
W01000387,1257,606,651,0.4821002386634845,0.5178997613365155
W01000388,1065,515,550,0.4835680751173709,0.5164319248826291
W01000422,2114,1044,1070,0.4938505203405866,0.5061494796594135
W01000341,1582,749,833,0.47345132743362833,0.5265486725663717
W01000342,1583,745,838,0.4706253948199621,0.5293746051800379
W01000393,1950,955,995,0.4897435897435897,0.5102564102564102
W01000352,1007,502,505,0.4985104270109235,0.5014895729890765
W01000353,1386,682,704,0.49206349206349204,0.5079365079365079
W01000413,1422,683,739,0.480309423347398,0.519690576652602
W01000414,1263,627,636,0.49643705463182897,0.503562945368171
W01000425,2323,1150,1173,0.49504950495049505,0.504950495049505
W01000349,1853,934,919,0.5040474905558554,0.49595250944414465
W01000350,1595,870,725,0.5454545454545454,0.45454545454545453
W01000365,2200,1125,1075,0.5113636363636364,0.48863636363636365
W01000402,2648,1422,1226,0.5370090634441088,0.46299093655589124
W01000381,1130,572,558,0.5061946902654867,0.49380530973451325
W01000382,1075,548,527,0.5097674418604651,0.49023255813953487
W01000423,2232,1102,1130,0.49372759856630827,0.5062724014336918
W01000424,1264,636,628,0.5031645569620253,0.49683544303797467
W01001929,1303,707,596,0.5425940138142747,0.45740598618572526
W01001931,1368,723,645,0.5285087719298246,0.47149122807017546
W01000398,1314,671,643,0.510654490106545,0.4893455098934551
W01000399,1158,584,574,0.5043177892918825,0.49568221070811747
W01000406,2205,1093,1112,0.49569160997732425,0.5043083900226757
W01000408,1184,587,597,0.49577702702702703,0.504222972972973
W01000366,1454,725,729,0.4986244841815681,0.5013755158184319
W01000367,1312,677,635,0.5160060975609756,0.4839939024390244
W01000385,1750,873,877,0.49885714285714283,0.5011428571428571
W01000410,1647,822,825,0.4990892531876138,0.5009107468123861
W01000386,1516,739,777,0.487467018469657,0.512532981530343
W01000405,2335,1114,1221,0.4770877944325482,0.5229122055674518
W01000411,1599,779,820,0.48717948717948717,0.5128205128205128
W01000412,1596,821,775,0.5144110275689223,0.4855889724310777
W01000394,1279,657,622,0.5136825645035183,0.48631743549648165
W01000395,1092,542,550,0.49633699633699635,0.5036630036630036
W01000407,1349,659,690,0.48851000741289846,0.5114899925871016
W01000419,1539,774,765,0.5029239766081871,0.49707602339181284
W01000420,1386,677,709,0.4884559884559885,0.5115440115440115
W01000354,1731,871,860,0.5031773541305604,0.49682264586943964
W01000355,1614,821,793,0.5086741016109045,0.4913258983890954
W01000356,1729,861,868,0.4979757085020243,0.5020242914979757
W01000389,2059,1028,1031,0.49927149101505586,0.5007285089849441
W01000409,1977,958,1019,0.4845725847243298,0.5154274152756702
W01000345,1583,783,800,0.49463044851547694,0.505369551484523
W01000346,1596,786,810,0.4924812030075188,0.5075187969924813
W01000403,1327,668,659,0.5033911077618689,0.49660889223813115
W01000404,1988,984,1004,0.4949698189134809,0.5050301810865191
W01000359,1177,562,615,0.47748513169073914,0.5225148683092609
W01000360,1255,615,640,0.4900398406374502,0.5099601593625498
W01000361,2036,978,1058,0.48035363457760316,0.5196463654223968
W01001930,2179,1115,1064,0.5117026158788435,0.4882973841211565
W01000369,1270,602,668,0.47401574803149604,0.525984251968504
W01000370,1460,692,768,0.473972602739726,0.5260273972602739
W01000383,2441,1228,1213,0.5030725112658746,0.49692748873412534
W01000384,1113,528,585,0.4743935309973046,0.5256064690026954
W01000390,1669,832,837,0.49850209706411025,0.5014979029358898
W01000396,1235,607,628,0.491497975708502,0.5085020242914979
W01000397,1045,520,525,0.49760765550239233,0.5023923444976076
W01000417,1568,783,785,0.49936224489795916,0.5006377551020408
W01000418,1663,847,816,0.5093205051112447,0.4906794948887553
W01000461,1532,806,726,0.5261096605744126,0.47389033942558745
W01000470,1880,914,966,0.48617021276595745,0.5138297872340426
W01000475,2371,1178,1193,0.4968367777309152,0.5031632222690847
W01001906,1916,974,942,0.5083507306889353,0.49164926931106473
W01001907,1415,721,694,0.5095406360424029,0.49045936395759715
W01000444,2319,1129,1190,0.48684777921517897,0.513152220784821
W01000457,2191,1090,1101,0.49748973071656777,0.5025102692834322
W01000458,1789,888,901,0.49636668529904976,0.5036333147009503
W01000498,1538,746,792,0.4850455136540962,0.5149544863459038
W01000499,1290,626,664,0.48527131782945737,0.5147286821705427
W01000500,1536,767,769,0.4993489583333333,0.5006510416666666
W01000501,2300,1134,1166,0.4930434782608696,0.5069565217391304
W01000442,2040,1009,1031,0.4946078431372549,0.5053921568627451
W01000452,1931,1001,930,0.5183842568617296,0.4816157431382703
W01000473,2235,1074,1161,0.48053691275167787,0.5194630872483221
W01000428,1334,683,651,0.5119940029985007,0.48800599700149927
W01000441,1426,702,724,0.49228611500701264,0.5077138849929874
W01000476,1295,616,679,0.4756756756756757,0.5243243243243243
W01000497,1430,715,715,0.5,0.5
W01000433,2316,1163,1153,0.5021588946459413,0.49784110535405873
W01000460,1810,891,919,0.4922651933701657,0.5077348066298343
W01000488,2180,1128,1052,0.5174311926605505,0.48256880733944957
W01000434,1691,845,846,0.4997043169722058,0.5002956830277943
W01000439,1972,977,995,0.49543610547667344,0.5045638945233266
W01000447,2057,1036,1021,0.5036460865337871,0.49635391346621294
W01000480,2069,1023,1046,0.4944417593040116,0.5055582406959884
W01000481,2267,1102,1165,0.48610498456109397,0.513895015438906
W01000482,1844,937,907,0.5081344902386117,0.49186550976138826
W01000478,1755,862,893,0.4911680911680912,0.5088319088319089
W01000479,1523,722,801,0.47406434668417596,0.525935653315824
W01000483,1899,914,985,0.4813059505002633,0.5186940494997367
W01000429,2294,1182,1112,0.5152571926765476,0.4847428073234525
W01000453,1405,712,693,0.5067615658362989,0.49323843416370106
W01000466,1425,664,761,0.46596491228070175,0.5340350877192982
W01000467,1504,779,725,0.5179521276595744,0.4820478723404255
W01000427,1411,715,696,0.5067328136073707,0.49326718639262934
W01000448,1406,676,730,0.48079658605974396,0.519203413940256
W01000449,1601,816,785,0.509681449094316,0.49031855090568394
W01000464,1255,629,626,0.501195219123506,0.49880478087649405
W01000484,1562,803,759,0.5140845070422535,0.4859154929577465
W01000485,1547,732,815,0.4731738849385908,0.5268261150614092
W01000486,1163,587,576,0.5047291487532244,0.49527085124677556
W01000438,1239,613,626,0.4947538337368846,0.5052461662631155
W01000451,1129,550,579,0.4871567759078831,0.5128432240921169
W01000472,1141,568,573,0.49780893952673094,0.5021910604732691
W01000477,1465,740,725,0.5051194539249146,0.4948805460750853
W01000487,2088,997,1091,0.4774904214559387,0.5225095785440613
W01000454,1227,622,605,0.5069274653626732,0.4930725346373268
W01000455,2059,1001,1058,0.4861583292860612,0.5138416707139388
W01000456,2023,964,1059,0.47652001977261493,0.5234799802273851
W01000431,1335,671,664,0.5026217228464419,0.49737827715355803
W01000432,1233,579,654,0.46958637469586373,0.5304136253041363
W01000450,1386,687,699,0.49567099567099565,0.5043290043290043
W01000459,1206,598,608,0.49585406301824214,0.5041459369817579
W01000471,1875,949,926,0.5061333333333333,0.4938666666666667
W01000430,1282,632,650,0.49297971918876754,0.5070202808112324
W01000443,2299,1131,1168,0.4919530230535015,0.5080469769464985
W01000445,1527,775,752,0.5075311067452521,0.49246889325474785
W01000446,1598,769,829,0.4812265331664581,0.518773466833542
W01000494,1724,849,875,0.49245939675174016,0.5075406032482599
W01000489,1797,877,920,0.48803561491374514,0.5119643850862549
W01000492,1591,782,809,0.491514770584538,0.5084852294154619
W01000493,1520,778,742,0.5118421052631579,0.4881578947368421
W01001901,1930,880,1050,0.45595854922279794,0.5440414507772021
W01001902,1412,649,763,0.45963172804532576,0.5403682719546742
W01000465,1036,506,530,0.48841698841698844,0.5115830115830116
W01001903,2063,990,1073,0.47988366456616577,0.5201163354338342
W01001904,1737,857,880,0.4933793897524468,0.5066206102475532
W01001905,2106,1047,1059,0.49715099715099714,0.5028490028490028
W01000440,1350,664,686,0.4918518518518519,0.5081481481481481
W01000474,1703,851,852,0.4997064004697592,0.5002935995302408
W01000503,1038,509,529,0.4903660886319846,0.5096339113680154
W01001897,1923,957,966,0.49765990639625585,0.5023400936037441
W01000426,1424,701,723,0.4922752808988764,0.5077247191011236
W01000496,2118,1057,1061,0.4990557129367328,0.5009442870632672
W01000502,2071,992,1079,0.47899565427329793,0.5210043457267021
W01000504,1161,587,574,0.5055986218776917,0.49440137812230833
W01000505,1383,660,723,0.4772234273318872,0.5227765726681128
W01001899,2053,976,1077,0.4754018509498295,0.5245981490501704
W01000523,1910,972,938,0.5089005235602094,0.49109947643979057
W01000548,1901,911,990,0.4792214623882167,0.5207785376117833
W01000549,1771,902,869,0.5093167701863354,0.4906832298136646
W01001937,2078,1009,1069,0.485563041385948,0.5144369586140519
W01000512,2075,1105,970,0.5325301204819277,0.4674698795180723
W01000513,2471,1328,1143,0.5374342371509511,0.462565762849049
W01000517,1472,807,665,0.548233695652174,0.4517663043478261
W01001934,3980,2026,1954,0.5090452261306533,0.4909547738693467
W01000515,1446,727,719,0.5027662517289073,0.4972337482710927
W01000516,1676,836,840,0.4988066825775656,0.5011933174224343
W01000518,1259,629,630,0.4996028594122319,0.5003971405877681
W01001935,1095,551,544,0.5031963470319635,0.4968036529680365
W01001936,2285,1139,1146,0.4984682713347921,0.5015317286652079
W01000506,1422,673,749,0.4732770745428973,0.5267229254571026
W01000524,1974,986,988,0.49949341438703143,0.5005065856129686
W01000538,1562,773,789,0.49487836107554417,0.5051216389244558
W01000539,1222,628,594,0.513911620294599,0.486088379705401
W01000540,1164,559,605,0.4802405498281787,0.5197594501718213
W01000529,1616,826,790,0.5111386138613861,0.48886138613861385
W01000532,1979,979,1000,0.4946942900454775,0.5053057099545225
W01000544,1082,526,556,0.48613678373382624,0.5138632162661737
W01000545,2045,1016,1029,0.4968215158924205,0.5031784841075795
W01000527,1510,807,703,0.5344370860927152,0.46556291390728477
W01000528,1460,700,760,0.4794520547945205,0.5205479452054794
W01000535,2037,1025,1012,0.5031909671084929,0.49680903289150713
W01000537,1484,736,748,0.49595687331536387,0.5040431266846361
W01000541,1854,893,961,0.4816612729234088,0.5183387270765911
W01000507,1196,582,614,0.4866220735785953,0.5133779264214047
W01000508,1178,591,587,0.50169779286927,0.49830220713073003
W01000509,1784,833,951,0.4669282511210762,0.5330717488789237
W01000510,1226,595,631,0.48531810766721045,0.5146818923327896
W01000511,1174,595,579,0.5068143100511073,0.49318568994889267
W01000546,1128,562,566,0.49822695035460995,0.50177304964539
W01000547,1180,558,622,0.4728813559322034,0.5271186440677966
W01000519,1627,800,827,0.49170251997541486,0.5082974800245851
W01000522,1293,655,638,0.5065738592420727,0.4934261407579273
W01000531,1835,879,956,0.4790190735694823,0.5209809264305177
W01000533,1439,691,748,0.48019457956914524,0.5198054204308548
W01000551,1310,639,671,0.48778625954198473,0.5122137404580153
W01000525,1206,556,650,0.46102819237147596,0.538971807628524
W01000534,1541,756,785,0.49059052563270605,0.509409474367294
W01000536,1459,715,744,0.4900616860863605,0.5099383139136395
W01000542,2209,1085,1124,0.49117247623358984,0.5088275237664102
W01000543,2020,999,1021,0.49455445544554455,0.5054455445544555
W01000550,1213,595,618,0.4905193734542457,0.5094806265457543
W01000552,2074,1038,1036,0.5004821600771456,0.49951783992285437
W01000558,2058,1002,1056,0.4868804664723032,0.5131195335276968
W01000559,1451,746,705,0.5141281874569262,0.48587181254307377
W01000560,1207,630,577,0.5219552609776305,0.4780447390223695
W01000561,1256,629,627,0.5007961783439491,0.49920382165605093
W01000613,2218,1091,1127,0.49188458070333635,0.5081154192966637
W01000562,1696,837,859,0.49351415094339623,0.5064858490566038
W01000565,1873,881,992,0.4703683929524827,0.5296316070475173
W01000566,1546,742,804,0.4799482535575679,0.5200517464424321
W01000567,1988,997,991,0.5015090543259557,0.4984909456740443
W01000597,1161,520,641,0.4478897502153316,0.5521102497846684
W01000617,1487,745,742,0.5010087424344317,0.4989912575655683
W01000579,2352,1154,1198,0.4906462585034014,0.5093537414965986
W01000581,1464,732,732,0.5,0.5
W01000612,1841,914,927,0.4964693101575231,0.503530689842477
W01000618,1877,1046,831,0.5572722429408631,0.4427277570591369
W01000582,1659,808,851,0.487040385774563,0.512959614225437
W01000583,1445,701,744,0.485121107266436,0.514878892733564
W01000611,1664,812,852,0.4879807692307692,0.5120192307692307
W01000623,1973,970,1003,0.49163710086163204,0.508362899138368
W01000568,2301,1168,1133,0.5076053889613211,0.4923946110386788
W01000569,1327,642,685,0.48379804069329313,0.5162019593067069
W01000570,1474,691,783,0.4687924016282225,0.5312075983717774
W01000572,1850,873,977,0.4718918918918919,0.5281081081081082
W01000571,2260,1068,1192,0.4725663716814159,0.5274336283185841
W01000573,2496,1164,1332,0.46634615384615385,0.5336538461538461
W01000586,2202,1059,1143,0.48092643051771117,0.5190735694822888
W01000577,1598,774,824,0.48435544430538174,0.5156445556946183
W01000585,1408,702,706,0.49857954545454547,0.5014204545454546
W01000595,1923,894,1029,0.46489859594383776,0.5351014040561622
W01000596,1509,723,786,0.47912524850894633,0.5208747514910537
W01000555,1416,726,690,0.5127118644067796,0.4872881355932203
W01000556,1149,552,597,0.4804177545691906,0.5195822454308094
W01000575,2517,1177,1340,0.4676201827572507,0.5323798172427493
W01000614,1405,688,717,0.4896797153024911,0.5103202846975089
W01000622,1536,751,785,0.4889322916666667,0.5110677083333334
W01000554,1826,880,946,0.4819277108433735,0.5180722891566265
W01000580,2336,1137,1199,0.4867294520547945,0.5132705479452054
W01000598,2219,1055,1164,0.4754393871113114,0.5245606128886886
W01000599,2150,1042,1108,0.4846511627906977,0.5153488372093024
W01000587,2003,1003,1000,0.5007488766849726,0.49925112331502747
W01000588,2157,1044,1113,0.48400556328233657,0.5159944367176634
W01000593,2763,1355,1408,0.4904089757509953,0.5095910242490047
W01000553,1232,609,623,0.4943181818181818,0.5056818181818182
W01000563,1207,597,610,0.49461474730737365,0.5053852526926264
W01000564,1211,598,613,0.49380677126341865,0.5061932287365813
W01000576,2262,1116,1146,0.493368700265252,0.506631299734748
W01000615,1535,763,772,0.4970684039087948,0.5029315960912052
W01000616,1093,536,557,0.49039341262580055,0.5096065873741995
W01000589,1152,557,595,0.4835069444444444,0.5164930555555556
W01000590,1087,510,577,0.46918123275068996,0.53081876724931
W01000591,1187,555,632,0.4675652906486942,0.5324347093513058
W01000592,1304,636,668,0.48773006134969327,0.5122699386503068
W01000594,2254,1142,1112,0.5066548358473825,0.4933451641526176
W01000600,1658,851,807,0.5132689987937273,0.4867310012062726
W01000601,1544,720,824,0.46632124352331605,0.533678756476684
W01000602,1306,641,665,0.4908116385911179,0.5091883614088821
W01000603,1897,949,948,0.5002635740643121,0.49973642593568796
W01000604,1514,757,757,0.5,0.5
W01000605,1834,923,911,0.5032715376226826,0.4967284623773173
W01000557,1532,748,784,0.48825065274151436,0.5117493472584856
W01000578,1671,830,841,0.4967085577498504,0.5032914422501497
W01000584,2083,1024,1059,0.49159865578492556,0.5084013442150744
W01000609,2408,1144,1264,0.4750830564784053,0.5249169435215947
W01000574,1877,938,939,0.49973361747469364,0.5002663825253063
W01000606,1650,770,880,0.4666666666666667,0.5333333333333333
W01000607,2060,1006,1054,0.4883495145631068,0.5116504854368932
W01000608,1434,724,710,0.504881450488145,0.49511854951185497
W01000610,1710,814,896,0.4760233918128655,0.5239766081871345
W01000619,2112,979,1133,0.4635416666666667,0.5364583333333334
W01000620,1030,529,501,0.5135922330097087,0.48640776699029126
W01000621,1554,732,822,0.47104247104247104,0.528957528957529
W01000685,1589,801,788,0.5040906230333543,0.49590937696664567
W01000686,1262,630,632,0.49920760697305866,0.5007923930269413
W01000701,1589,777,812,0.4889867841409692,0.5110132158590308
W01000702,1218,604,614,0.49589490968801314,0.5041050903119869
W01000647,1518,743,775,0.4894598155467721,0.5105401844532279
W01000650,1613,824,789,0.5108493490390577,0.48915065096094235
W01000678,1421,702,719,0.494018296973962,0.505981703026038
W01000679,1268,629,639,0.4960567823343849,0.5039432176656151
W01000646,2214,1072,1142,0.48419150858175247,0.5158084914182475
W01000688,1808,900,908,0.497787610619469,0.5022123893805309
W01000689,1619,778,841,0.48054354539839406,0.5194564546016059
W01000728,2072,1072,1000,0.5173745173745173,0.4826254826254826
W01000676,1532,757,775,0.4941253263707572,0.5058746736292428
W01000677,1439,667,772,0.46351633078526755,0.5364836692147325
W01000687,1929,971,958,0.5033696215655781,0.496630378434422
W01000709,2248,1118,1130,0.4973309608540925,0.5026690391459074
W01000624,2315,1153,1162,0.4980561555075594,0.5019438444924406
W01000682,1381,655,726,0.47429398986241855,0.5257060101375814
W01000683,1059,542,517,0.5118035882908404,0.48819641170915956
W01000684,1851,921,930,0.49756888168557534,0.5024311183144247
W01000643,1689,773,916,0.4576672587329781,0.5423327412670219
W01000644,1857,820,1037,0.44157242864835755,0.5584275713516424
W01000645,1697,770,927,0.45374189746611665,0.5462581025338833
W01000648,1480,754,726,0.5094594594594595,0.4905405405405405
W01000649,1538,762,776,0.49544863459037713,0.5045513654096229
W01000637,1427,681,746,0.4772249474421864,0.5227750525578136
W01000638,1193,586,607,0.4911986588432523,0.5088013411567477
W01000639,1361,661,700,0.4856722997795738,0.5143277002204262
W01000640,1161,565,596,0.48664944013781225,0.5133505598621878
W01000641,2075,1038,1037,0.5002409638554217,0.49975903614457834
W01000642,1725,805,920,0.4666666666666667,0.5333333333333333
W01000693,1079,490,589,0.4541241890639481,0.5458758109360519
W01000694,1302,649,653,0.49846390168970817,0.5015360983102919
W01000656,2139,1032,1107,0.48246844319775595,0.517531556802244
W01000657,1078,511,567,0.474025974025974,0.525974025974026
W01000658,1269,639,630,0.5035460992907801,0.49645390070921985
W01000718,1424,700,724,0.49157303370786515,0.5084269662921348
W01000719,1497,741,756,0.49498997995991983,0.5050100200400801
W01000680,2011,975,1036,0.48483341621084036,0.5151665837891596
W01000681,1983,986,997,0.497226424609178,0.502773575390822
W01000724,1912,920,992,0.4811715481171548,0.5188284518828452
W01000725,2199,1053,1146,0.47885402455661663,0.5211459754433834
W01000675,1963,960,1003,0.489047376464595,0.5109526235354049
W01000695,1534,769,765,0.5013037809647979,0.49869621903520206
W01000696,1568,790,778,0.5038265306122449,0.4961734693877551
W01000722,1304,646,658,0.495398773006135,0.504601226993865
W01000723,1370,681,689,0.49708029197080295,0.502919708029197
W01000625,1200,575,625,0.4791666666666667,0.5208333333333334
W01000626,1462,717,745,0.4904240766073871,0.5095759233926128
W01000627,2175,1063,1112,0.48873563218390803,0.511264367816092
W01000714,1452,712,740,0.4903581267217631,0.509641873278237
W01000715,1297,640,657,0.49344641480339246,0.5065535851966075
W01000697,1834,909,925,0.4956379498364231,0.5043620501635769
W01000698,1906,906,1000,0.4753410283315845,0.5246589716684156
W01000699,1530,773,757,0.5052287581699346,0.4947712418300654
W01000712,1496,752,744,0.5026737967914439,0.49732620320855614
W01000713,1393,704,689,0.5053840631730079,0.4946159368269921
W01000662,2155,1060,1095,0.4918793503480278,0.5081206496519721
W01000663,2261,1062,1199,0.46970367094206106,0.530296329057939
W01000664,1805,887,918,0.49141274238227145,0.5085872576177285
W01000716,1337,659,678,0.49289454001495886,0.5071054599850411
W01000717,1431,705,726,0.49266247379454925,0.5073375262054507
W01000665,1780,883,897,0.4960674157303371,0.5039325842696629
W01000666,1446,707,739,0.48893499308437066,0.5110650069156293
W01000731,2438,1231,1207,0.5049220672682526,0.4950779327317473
W01000670,1619,779,840,0.4811612106238419,0.5188387893761581
W01000671,1904,911,993,0.47846638655462187,0.5215336134453782
W01000729,1265,590,675,0.466403162055336,0.5335968379446641
W01000730,1276,636,640,0.49843260188087773,0.5015673981191222
W01000690,1755,875,880,0.4985754985754986,0.5014245014245015
W01000691,1591,772,819,0.4852294154619736,0.5147705845380264
W01000692,1618,809,809,0.5,0.5
W01000726,1526,758,768,0.4967234600262123,0.5032765399737876
W01000727,1010,480,530,0.4752475247524752,0.5247524752475248
W01000651,1588,767,821,0.48299748110831237,0.5170025188916877
W01000652,2009,951,1058,0.47336983573917374,0.5266301642608263
W01000655,2054,970,1084,0.47224926971762415,0.5277507302823758
W01000632,1457,718,739,0.49279341111873715,0.5072065888812629
W01000633,1412,692,720,0.49008498583569404,0.509915014164306
W01000634,1377,667,710,0.4843863471314452,0.5156136528685549
W01000710,2271,1119,1152,0.49273447820343463,0.5072655217965654
W01000711,2030,968,1062,0.4768472906403941,0.5231527093596059
W01000703,1863,896,967,0.4809447128287708,0.5190552871712292
W01000704,1640,785,855,0.47865853658536583,0.5213414634146342
W01000705,1954,937,1017,0.4795291709314227,0.5204708290685772
W01000653,1465,691,774,0.47167235494880544,0.5283276450511946
W01000654,1738,878,860,0.5051783659378596,0.4948216340621404
W01000667,1412,675,737,0.4780453257790368,0.5219546742209632
W01001925,2333,1146,1187,0.491213030432919,0.508786969567081
W01000628,1593,782,811,0.4908976773383553,0.5091023226616447
W01000629,1731,834,897,0.48180242634315423,0.5181975736568457
W01000630,1661,819,842,0.49307645996387717,0.5069235400361228
W01000631,1776,874,902,0.49211711711711714,0.5078828828828829
W01000635,2265,1103,1162,0.4869757174392936,0.5130242825607064
W01000636,1942,925,1017,0.476313079299691,0.523686920700309
W01000706,1649,811,838,0.49181322013341416,0.5081867798665858
W01000707,1473,702,771,0.47657841140529533,0.5234215885947047
W01000708,1384,693,691,0.5007225433526011,0.49927745664739887
W01000659,1542,729,813,0.4727626459143969,0.5272373540856031
W01000660,1539,739,800,0.4801819363222872,0.5198180636777128
W01000732,1390,690,700,0.49640287769784175,0.5035971223021583
W01000733,1256,626,630,0.4984076433121019,0.5015923566878981
W01000734,1433,745,688,0.5198883461270063,0.4801116538729937
W01001923,1254,630,624,0.5023923444976076,0.49760765550239233
W01001924,1333,645,688,0.4838709677419355,0.5161290322580645
W01000672,1629,799,830,0.4904849600982198,0.5095150399017803
W01000673,1222,598,624,0.48936170212765956,0.5106382978723404
W01000674,2087,1080,1007,0.5174892189746046,0.4825107810253953
W01000700,2006,969,1037,0.4830508474576271,0.5169491525423728
W01000720,1632,802,830,0.49142156862745096,0.508578431372549
W01000721,1363,639,724,0.46881878209831257,0.5311812179016875
W01000735,2272,1115,1157,0.4907570422535211,0.5092429577464789
W01000845,2048,972,1076,0.474609375,0.525390625
W01000846,1730,847,883,0.48959537572254336,0.5104046242774567
W01000847,1306,665,641,0.5091883614088821,0.4908116385911179
W01000848,1197,568,629,0.47451963241436923,0.5254803675856308
W01000750,1552,727,825,0.4684278350515464,0.5315721649484536
W01000751,1422,691,731,0.4859353023909986,0.5140646976090014
W01000752,1518,727,791,0.47891963109354413,0.5210803689064558
W01000753,1420,666,754,0.46901408450704224,0.5309859154929577
W01000754,1591,778,813,0.48900062853551224,0.5109993714644877
W01000803,1850,954,896,0.5156756756756756,0.4843243243243243
W01000806,1515,730,785,0.48184818481848185,0.5181518151815182
W01000807,1421,714,707,0.5024630541871922,0.4975369458128079
W01000808,1465,701,764,0.4784982935153584,0.5215017064846417
W01000810,1376,644,732,0.4680232558139535,0.5319767441860465
W01000815,1599,790,809,0.49405878674171355,0.5059412132582864
W01000816,1735,852,883,0.4910662824207493,0.5089337175792508
W01000791,1504,736,768,0.48936170212765956,0.5106382978723404
W01000792,1645,795,850,0.48328267477203646,0.5167173252279635
W01000793,1890,930,960,0.49206349206349204,0.5079365079365079
W01000837,1624,797,827,0.4907635467980296,0.5092364532019704
W01000838,1244,589,655,0.4734726688102894,0.5265273311897106
W01000773,2663,1312,1351,0.49267743146826887,0.5073225685317311
W01000774,1638,810,828,0.4945054945054945,0.5054945054945055
W01000841,1479,732,747,0.4949290060851927,0.5050709939148073
W01000842,1424,686,738,0.48174157303370785,0.5182584269662921
W01000843,1379,673,706,0.4880348078317622,0.5119651921682379
W01000844,1241,619,622,0.49879129734085415,0.5012087026591459
W01000795,1621,806,815,0.4972239358420728,0.5027760641579272
W01000796,2723,1358,1365,0.4987146529562982,0.5012853470437018
W01000800,1500,709,791,0.4726666666666667,0.5273333333333333
W01000801,1548,747,801,0.48255813953488375,0.5174418604651163
W01000784,1317,617,700,0.46848899012908124,0.5315110098709187
W01000785,1316,664,652,0.5045592705167173,0.49544072948328266
W01000786,1375,662,713,0.48145454545454547,0.5185454545454545
W01000802,2355,1148,1207,0.48747346072186837,0.5125265392781316
W01000877,1548,771,777,0.49806201550387597,0.501937984496124
W01000878,1223,587,636,0.47996729354047424,0.5200327064595257
W01000809,1604,770,834,0.4800498753117207,0.5199501246882793
W01000811,1590,808,782,0.5081761006289308,0.4918238993710692
W01000812,1434,711,723,0.49581589958158995,0.50418410041841
W01000813,1624,803,821,0.4944581280788177,0.5055418719211823
W01000814,1565,777,788,0.4964856230031949,0.5035143769968051
W01000817,1769,836,933,0.47258338044092707,0.5274166195590729
W01000818,1536,725,811,0.4720052083333333,0.5279947916666666
W01000819,1437,711,726,0.49478079331941544,0.5052192066805845
W01000820,1395,691,704,0.4953405017921147,0.5046594982078854
W01000821,1494,721,773,0.4825970548862115,0.5174029451137885
W01000822,1241,616,625,0.49637389202256244,0.5036261079774376
W01000794,2176,1078,1098,0.4954044117647059,0.5045955882352942
W01000797,1514,736,778,0.4861294583883752,0.5138705416116248
W01000798,1416,681,735,0.4809322033898305,0.5190677966101694
W01000799,1935,933,1002,0.4821705426356589,0.517829457364341
W01000830,1693,794,899,0.4689899586532782,0.5310100413467218
W01000832,1604,820,784,0.5112219451371571,0.48877805486284287
W01000833,1750,847,903,0.484,0.516
W01000834,1545,709,836,0.4588996763754045,0.5411003236245955
W01000836,2274,1080,1194,0.47493403693931396,0.525065963060686
W01000759,1566,753,813,0.48084291187739464,0.5191570881226054
W01000777,1782,844,938,0.47362514029180697,0.5263748597081931
W01000778,1890,915,975,0.48412698412698413,0.5158730158730159
W01000779,1540,759,781,0.4928571428571429,0.5071428571428571
W01000760,1670,820,850,0.49101796407185627,0.5089820359281437
W01000761,1569,784,785,0.4996813256851498,0.5003186743148502
W01000762,1594,797,797,0.5,0.5
W01000831,1806,850,956,0.4706533776301218,0.5293466223698782
W01000835,1447,649,798,0.4485141672425708,0.5514858327574291
W01000738,1768,851,917,0.4813348416289593,0.5186651583710408
W01000739,1840,921,919,0.5005434782608695,0.4994565217391304
W01000740,1658,773,885,0.4662243667068758,0.5337756332931243
W01000741,1591,748,843,0.470144563167819,0.5298554368321811
W01000763,1524,723,801,0.4744094488188976,0.5255905511811023
W01000764,1649,836,813,0.5069739235900546,0.49302607640994545
W01000765,1660,839,821,0.505421686746988,0.49457831325301205
W01000766,1585,740,845,0.4668769716088328,0.5331230283911672
W01000767,1554,763,791,0.49099099099099097,0.509009009009009
W01000742,1581,827,754,0.5230866540164453,0.4769133459835547
W01000744,1492,763,729,0.5113941018766756,0.4886058981233244
W01000787,1551,790,761,0.5093488072211476,0.49065119277885233
W01000788,1456,722,734,0.4958791208791209,0.5041208791208791
W01000789,1423,685,738,0.4813773717498243,0.5186226282501757
W01000790,1738,883,855,0.5080552359033371,0.4919447640966628
W01000755,1957,950,1007,0.4854368932038835,0.5145631067961165
W01000756,1597,777,820,0.4865372573575454,0.5134627426424546
W01000757,1492,685,807,0.45911528150134046,0.5408847184986595
W01000758,1917,962,955,0.5018257694314032,0.4981742305685968
W01000772,1583,742,841,0.46873025900189513,0.5312697409981049
W01000828,1722,851,871,0.49419279907084784,0.5058072009291521
W01000829,1913,920,993,0.48092002090956615,0.5190799790904339
W01000862,1599,748,851,0.46779237023139464,0.5322076297686054
W01000863,1586,773,813,0.48738965952080704,0.512610340479193
W01000864,1651,794,857,0.4809206541490006,0.5190793458509994
W01000865,1352,623,729,0.46079881656804733,0.5392011834319527
W01000866,1209,558,651,0.46153846153846156,0.5384615384615384
W01000867,1299,589,710,0.4534257120862202,0.5465742879137798
W01000768,1395,691,704,0.4953405017921147,0.5046594982078854
W01000769,1412,666,746,0.471671388101983,0.5283286118980169
W01000770,1576,786,790,0.4987309644670051,0.501269035532995
W01000771,1331,659,672,0.49511645379413977,0.5048835462058603
W01000849,1872,911,961,0.48664529914529914,0.5133547008547008
W01000850,2260,1217,1043,0.5384955752212389,0.4615044247787611
W01000851,1544,752,792,0.48704663212435234,0.5129533678756477
W01000852,1511,737,774,0.4877564526803441,0.5122435473196558
W01000853,1470,737,733,0.501360544217687,0.49863945578231295
W01000854,1418,705,713,0.49717912552891397,0.502820874471086
W01000855,1517,733,784,0.4831905075807515,0.5168094924192486
W01000856,1765,864,901,0.48951841359773374,0.5104815864022663
W01000857,1785,836,949,0.46834733893557423,0.5316526610644258
W01000781,1701,814,887,0.47854203409758966,0.5214579659024103
W01000782,1080,514,566,0.4759259259259259,0.524074074074074
W01001956,2921,1492,1429,0.5107839780896953,0.48921602191030467
W01000747,1944,1135,809,0.5838477366255144,0.4161522633744856
W01000868,1348,652,696,0.4836795252225519,0.516320474777448
W01000869,1590,840,750,0.5283018867924528,0.4716981132075472
W01000870,1611,834,777,0.5176908752327747,0.4823091247672253
W01000872,1384,668,716,0.48265895953757226,0.5173410404624278
W01000874,2085,1094,991,0.5247002398081535,0.4752997601918465
W01000745,2259,1329,930,0.5883134130146083,0.4116865869853918
W01000746,1705,923,782,0.5413489736070382,0.4586510263929619
W01001938,1169,716,453,0.6124893071000855,0.38751069289991447
W01001955,1555,942,613,0.6057877813504823,0.39421221864951767
W01001957,1036,669,367,0.6457528957528957,0.35424710424710426
W01001958,1282,750,532,0.5850234009360374,0.41497659906396256
W01000749,1860,944,916,0.5075268817204301,0.4924731182795699
W01000871,1765,991,774,0.5614730878186969,0.43852691218130313
W01000873,1809,985,824,0.5444997236042012,0.45550027639579876
W01000875,2023,1131,892,0.5590706870983687,0.44092931290163123
W01000876,2050,1106,944,0.5395121951219513,0.4604878048780488
W01000858,1629,808,821,0.4960098219766728,0.5039901780233272
W01000859,1415,667,748,0.4713780918727915,0.5286219081272084
W01000860,1489,718,771,0.4822028206850235,0.5177971793149765
W01000861,1813,867,946,0.47821290678433537,0.5217870932156646
W01000736,1715,822,893,0.4793002915451895,0.5206997084548105
W01000737,1536,719,817,0.4680989583333333,0.5319010416666666
W01000804,1483,700,783,0.4720161834120027,0.5279838165879973
W01000805,1193,573,620,0.48030176026823135,0.5196982397317687
W01000879,1758,839,919,0.47724687144482364,0.5227531285551763
W01000880,1579,764,815,0.4838505383153895,0.5161494616846105
W01000881,1382,661,721,0.47829232995658466,0.5217076700434153
W01000882,1729,795,934,0.45980335454019666,0.5401966454598034
W01000775,1843,905,938,0.49104720564297344,0.5089527943570266
W01000776,1853,925,928,0.4991905018888289,0.500809498111171
W01000839,1011,497,514,0.49159248269040556,0.5084075173095944
W01000840,1677,829,848,0.49433512224209897,0.505664877757901
W01000823,1728,802,926,0.46412037037037035,0.5358796296296297
W01000824,1588,748,840,0.47103274559193953,0.5289672544080605
W01000825,1437,683,754,0.47529575504523314,0.5247042449547669
W01000826,1365,649,716,0.47545787545787543,0.5245421245421246
W01000827,1358,665,693,0.4896907216494845,0.5103092783505154
W01000918,1910,925,985,0.48429319371727747,0.5157068062827225
W01000944,1194,601,593,0.5033500837520938,0.4966499162479062
W01000965,2123,1052,1071,0.4955252001884126,0.5044747998115874
W01000893,1989,978,1011,0.4917043740573152,0.5082956259426847
W01000925,1571,773,798,0.49204328453214513,0.5079567154678549
W01000926,1859,921,938,0.4954276492738031,0.5045723507261969
W01000888,2327,1151,1176,0.49462827675118176,0.5053717232488182
W01000946,1604,778,826,0.4850374064837905,0.5149625935162094
W01000947,2033,984,1049,0.4840137727496311,0.5159862272503689
W01000948,1784,911,873,0.5106502242152466,0.48934977578475336
W01000955,1262,619,643,0.49049128367670364,0.5095087163232963
W01000956,1180,574,606,0.4864406779661017,0.5135593220338983
W01000971,1411,683,728,0.48405386250885896,0.515946137491141
W01000887,2400,1182,1218,0.4925,0.5075
W01000953,1720,855,865,0.49709302325581395,0.502906976744186
W01000954,1415,697,718,0.4925795053003534,0.5074204946996467
W01000970,1239,592,647,0.4778046811945117,0.5221953188054883
W01000902,1060,503,557,0.47452830188679246,0.5254716981132076
W01000903,1116,528,588,0.4731182795698925,0.5268817204301075
W01000904,1529,753,776,0.4924787442773054,0.5075212557226946
W01000905,1563,754,809,0.48240563019833654,0.5175943698016635
W01000908,1684,835,849,0.49584323040380046,0.5041567695961995
W01000906,1047,503,544,0.4804202483285578,0.5195797516714422
W01000907,1752,840,912,0.4794520547945205,0.5205479452054794
W01000922,1690,826,864,0.4887573964497041,0.5112426035502958
W01000923,1472,734,738,0.4986413043478261,0.501358695652174
W01000934,1263,627,636,0.49643705463182897,0.503562945368171
W01000935,1580,810,770,0.5126582278481012,0.4873417721518987
W01000938,1396,660,736,0.47277936962750716,0.5272206303724928
W01000939,1262,642,620,0.508716323296355,0.49128367670364503
W01000940,1284,608,676,0.4735202492211838,0.5264797507788161
W01000909,1216,556,660,0.45723684210526316,0.5427631578947368
W01000910,1470,712,758,0.48435374149659866,0.5156462585034014
W01000911,1254,623,631,0.49681020733652315,0.5031897926634769
W01000969,1260,620,640,0.49206349206349204,0.5079365079365079
W01000912,1229,566,663,0.46053702196908053,0.5394629780309195
W01000913,1162,562,600,0.4836488812392427,0.5163511187607573
W01000914,1599,759,840,0.474671669793621,0.525328330206379
W01000915,1205,589,616,0.4887966804979253,0.5112033195020746
W01000916,1206,620,586,0.5140961857379768,0.4859038142620232
W01000917,2652,1308,1344,0.49321266968325794,0.5067873303167421
W01000920,1256,644,612,0.5127388535031847,0.4872611464968153
W01000921,1569,763,806,0.4862970044614404,0.5137029955385596
W01000924,1096,548,548,0.5,0.5
W01000930,1362,671,691,0.49265785609397944,0.5073421439060205
W01000936,1518,743,775,0.4894598155467721,0.5105401844532279
W01000941,1541,756,785,0.49059052563270605,0.509409474367294
W01000942,1887,925,962,0.49019607843137253,0.5098039215686274
W01000943,1547,772,775,0.49903038138332256,0.5009696186166774
W01000894,1370,653,717,0.47664233576642334,0.5233576642335767
W01000895,1539,772,767,0.5016244314489928,0.4983755685510071
W01000896,1686,781,905,0.46322657176749704,0.536773428232503
W01000897,1316,643,673,0.4886018237082067,0.5113981762917933
W01000937,2040,1033,1007,0.5063725490196078,0.4936274509803922
W01000898,1470,738,732,0.5020408163265306,0.49795918367346936
W01000899,1679,811,868,0.48302561048243003,0.51697438951757
W01000900,1709,835,874,0.4885898186073727,0.5114101813926273
W01000901,1680,802,878,0.4773809523809524,0.5226190476190476
W01000945,1152,577,575,0.5008680555555556,0.4991319444444444
W01000889,1789,874,915,0.48854108440469535,0.5114589155953047
W01000890,1656,806,850,0.4867149758454106,0.5132850241545893
W01000891,1515,724,791,0.4778877887788779,0.5221122112211221
W01000892,1859,901,958,0.4846691769768693,0.5153308230231307
W01000883,1404,706,698,0.5028490028490028,0.49715099715099714
W01000958,1679,777,902,0.46277546158427635,0.5372245384157236
W01000961,1611,781,830,0.48479205462445685,0.5152079453755432
W01000962,1577,757,820,0.4800253646163602,0.5199746353836399
W01000963,1792,821,971,0.45814732142857145,0.5418526785714286
W01000964,1745,832,913,0.47679083094555874,0.5232091690544413
W01000884,1244,639,605,0.5136655948553055,0.48633440514469456
W01000885,1325,629,696,0.47471698113207544,0.5252830188679245
W01000886,1479,754,725,0.5098039215686274,0.49019607843137253
W01000957,1676,777,899,0.4636038186157518,0.5363961813842482
W01000959,1818,913,905,0.5022002200220022,0.4977997799779978
W01000960,1722,839,883,0.48722415795586527,0.5127758420441347
W01000949,1337,670,667,0.5011219147344802,0.4988780852655198
W01000950,1550,772,778,0.49806451612903224,0.5019354838709678
W01000951,1583,804,779,0.5078963992419456,0.4921036007580543
W01000952,1171,555,616,0.4739538855678907,0.5260461144321094
W01000966,1432,738,694,0.5153631284916201,0.48463687150837986
W01000932,1043,526,517,0.5043144774688398,0.4956855225311601
W01000933,1974,953,1021,0.4827760891590679,0.5172239108409321
W01000967,1470,713,757,0.4850340136054422,0.5149659863945578
W01000968,1897,925,972,0.48761201897733264,0.5123879810226674
W01000919,1172,579,593,0.49402730375426623,0.5059726962457338
W01000927,1644,785,859,0.4774939172749392,0.5225060827250608
W01000928,1603,784,819,0.4890829694323144,0.5109170305676856
W01000929,1307,671,636,0.513389441469013,0.486610558530987
W01000931,1330,663,667,0.49849624060150377,0.5015037593984962
W01000973,1480,731,749,0.4939189189189189,0.5060810810810811
W01001900,1539,770,769,0.5003248862897985,0.4996751137102014
W01000991,1131,556,575,0.4916003536693192,0.5083996463306808
W01000992,1505,736,769,0.48903654485049836,0.5109634551495017
W01000993,1525,764,761,0.5009836065573771,0.49901639344262294
W01000994,1398,698,700,0.49928469241773965,0.5007153075822603
W01000995,1436,685,751,0.47701949860724235,0.5229805013927576
W01001014,1640,801,839,0.48841463414634145,0.5115853658536585
W01001015,1475,699,776,0.4738983050847458,0.5261016949152543
W01001017,1477,707,770,0.4786729857819905,0.5213270142180095
W01001018,1387,696,691,0.501802451333814,0.498197548666186
W01001020,1436,715,721,0.4979108635097493,0.5020891364902507
W01000976,1105,526,579,0.4760180995475113,0.5239819004524887
W01000977,1388,694,694,0.5,0.5
W01001024,1144,568,576,0.4965034965034965,0.5034965034965035
W01001025,1200,568,632,0.47333333333333333,0.5266666666666666
W01001033,1738,837,901,0.4815880322209436,0.5184119677790564
W01001034,1379,679,700,0.49238578680203043,0.5076142131979695
W01000975,2253,1096,1157,0.486462494451842,0.513537505548158
W01000978,1789,888,901,0.49636668529904976,0.5036333147009503
W01001009,1243,642,601,0.5164923572003218,0.4835076427996782
W01001042,1338,676,662,0.5052316890881914,0.4947683109118087
W01001043,1161,567,594,0.4883720930232558,0.5116279069767442
W01001012,1563,791,772,0.5060780550223928,0.49392194497760716
W01001013,1469,709,760,0.48264125255275697,0.517358747447243
W01001016,1658,817,841,0.4927623642943305,0.5072376357056695
W01001019,1512,751,761,0.4966931216931217,0.5033068783068783
W01000974,2039,1022,1017,0.5012260912211869,0.49877390877881317
W01001057,1435,703,732,0.48989547038327524,0.5101045296167247
W01001058,1932,929,1003,0.4808488612836439,0.5191511387163561
W01000986,1319,639,680,0.4844579226686884,0.5155420773313116
W01000987,2252,1102,1150,0.48934280639431615,0.5106571936056838
W01001055,1225,609,616,0.49714285714285716,0.5028571428571429
W01001056,1218,609,609,0.5,0.5
W01000996,1481,713,768,0.4814314652261985,0.5185685347738015
W01001048,1401,700,701,0.49964311206281226,0.5003568879371877
W01001049,1315,640,675,0.4866920152091255,0.5133079847908745
W01001050,1539,759,780,0.49317738791423,0.50682261208577
W01001051,1796,920,876,0.512249443207127,0.48775055679287305
W01001052,1354,646,708,0.4771048744460857,0.5228951255539144
W01001004,1086,552,534,0.5082872928176796,0.49171270718232046
W01001005,1688,834,854,0.4940758293838863,0.5059241706161137
W01001006,2377,1179,1198,0.4960033655868742,0.5039966344131258
W01001007,1748,885,863,0.5062929061784897,0.4937070938215103
W01001039,1664,841,823,0.5054086538461539,0.49459134615384615
W01001040,1491,759,732,0.5090543259557344,0.4909456740442656
W01000999,1385,653,732,0.4714801444043321,0.5285198555956678
W01001000,1776,854,922,0.48085585585585583,0.5191441441441441
W01001001,1449,696,753,0.4803312629399586,0.5196687370600414
W01001002,2449,1209,1240,0.4936708860759494,0.5063291139240507
W01000998,2593,1963,630,0.7570381797146163,0.2429618202853837
W01001008,2147,1056,1091,0.4918490917559385,0.5081509082440615
W01001038,2221,1047,1174,0.4714092751013057,0.5285907248986943
W01000997,1537,743,794,0.483409238776838,0.516590761223162
W01001010,1219,577,642,0.47333880229696473,0.5266611977030353
W01001011,1384,694,690,0.5014450867052023,0.4985549132947977
W01001026,1995,977,1018,0.48972431077694234,0.5102756892230577
W01000989,1413,681,732,0.4819532908704883,0.5180467091295117
W01001037,1593,764,829,0.4795982423101067,0.5204017576898933
W01001041,2447,1210,1237,0.4944830404577033,0.5055169595422967
W01001021,1603,810,793,0.5053025577043044,0.49469744229569557
W01001022,1393,683,710,0.49030868628858576,0.5096913137114142
W01001023,1696,851,845,0.5017688679245284,0.4982311320754717
W01001028,1855,904,951,0.48733153638814014,0.5126684636118598
W01001035,1622,835,787,0.5147965474722564,0.48520345252774355
W01000979,1702,829,873,0.4870740305522914,0.5129259694477086
W01000983,1539,776,763,0.5042235217673814,0.49577647823261856
W01000985,1399,684,715,0.4889206576125804,0.5110793423874196
W01001003,1365,635,730,0.4652014652014652,0.5347985347985348
W01000980,1383,699,684,0.5054229934924078,0.4945770065075922
W01000981,1186,537,649,0.4527824620573356,0.5472175379426644
W01000982,1500,731,769,0.48733333333333334,0.5126666666666667
W01000984,2157,1076,1081,0.49884098284654615,0.5011590171534539
W01000990,1519,735,784,0.4838709677419355,0.5161290322580645
W01001027,1571,733,838,0.46658179503500957,0.5334182049649905
W01001036,1584,759,825,0.4791666666666667,0.5208333333333334
W01001918,1593,793,800,0.4978028876333961,0.5021971123666039
W01001919,1405,687,718,0.4889679715302491,0.5110320284697509
W01001920,1206,607,599,0.5033167495854063,0.4966832504145937
W01001921,1577,764,813,0.4844641724793913,0.5155358275206088
W01001031,1524,695,829,0.45603674540682415,0.5439632545931758
W01001032,1769,831,938,0.4697569248162804,0.5302430751837196
W01001046,1775,848,927,0.47774647887323946,0.5222535211267606
W01001047,1674,816,858,0.4874551971326165,0.5125448028673835
W01001053,1010,499,511,0.49405940594059405,0.505940594059406
W01001054,1257,572,685,0.45505171042163883,0.5449482895783612
W01001029,1799,872,927,0.4847137298499166,0.5152862701500833
W01001030,1809,860,949,0.4754007739082366,0.5245992260917635
W01001044,1663,811,852,0.48767288033674083,0.5123271196632592
W01001045,1725,826,899,0.47884057971014493,0.5211594202898551
W01001105,2643,1313,1330,0.4967839576239122,0.5032160423760877
W01001127,1199,586,613,0.48874061718098416,0.5112593828190158
W01001128,1439,714,725,0.4961779013203614,0.5038220986796387
W01001082,1500,715,785,0.4766666666666667,0.5233333333333333
W01001083,1611,796,815,0.4941030415890751,0.5058969584109249
W01001084,1563,728,835,0.4657709532949456,0.5342290467050543
W01001085,1506,765,741,0.5079681274900398,0.49203187250996017
W01001113,2289,1147,1142,0.5010921799912625,0.49890782000873746
W01001119,1731,848,883,0.4898902368573079,0.5101097631426921
W01001135,1494,721,773,0.4825970548862115,0.5174029451137885
W01001136,1165,556,609,0.47725321888412015,0.5227467811158798
W01001075,1197,557,640,0.4653299916457811,0.5346700083542189
W01001076,1461,696,765,0.47638603696098564,0.5236139630390144
W01001077,1432,664,768,0.46368715083798884,0.5363128491620112
W01001078,1263,605,658,0.47901821060965954,0.5209817893903405
W01001104,1977,968,1009,0.48963075366717246,0.5103692463328275
W01001129,1384,671,713,0.4848265895953757,0.5151734104046243
W01001116,2101,969,1132,0.4612089481199429,0.5387910518800572
W01001123,1633,798,835,0.488671157379057,0.511328842620943
W01001124,1463,745,718,0.5092276144907724,0.49077238550922764
W01001125,1471,720,751,0.4894629503738953,0.5105370496261047
W01001126,1911,1009,902,0.5279958137100994,0.4720041862899006
W01001130,1279,627,652,0.490226739640344,0.509773260359656
W01001086,1491,726,765,0.4869215291750503,0.5130784708249497
W01001087,1543,746,797,0.48347375243033053,0.5165262475696695
W01001088,1827,848,979,0.4641488779419814,0.5358511220580187
W01001089,1468,694,774,0.47275204359673023,0.5272479564032697
W01001090,1470,708,762,0.4816326530612245,0.5183673469387755
W01001081,1552,715,837,0.46069587628865977,0.5393041237113402
W01001092,1706,813,893,0.4765533411488863,0.5234466588511137
W01001094,1333,592,741,0.4441110277569392,0.5558889722430608
W01001095,1509,696,813,0.46123260437375746,0.5387673956262425
W01001096,1374,667,707,0.48544395924308587,0.5145560407569141
W01001097,1679,801,878,0.47706968433591423,0.5229303156640858
W01001114,1565,762,803,0.48690095846645365,0.5130990415335464
W01001115,2170,1023,1147,0.4714285714285714,0.5285714285714286
W01001131,1753,814,939,0.4643468339988591,0.5356531660011409
W01001132,1370,650,720,0.4744525547445255,0.5255474452554745
W01001133,2029,1014,1015,0.49975357318876296,0.5002464268112371
W01001134,1144,536,608,0.46853146853146854,0.5314685314685315
W01001067,1380,633,747,0.45869565217391306,0.5413043478260869
W01001068,1767,833,934,0.47142048670062253,0.5285795132993775
W01001070,1143,600,543,0.5249343832020997,0.47506561679790027
W01001071,1577,787,790,0.4990488268864933,0.5009511731135067
W01001072,2676,1358,1318,0.507473841554559,0.49252615844544095
W01001091,1662,820,842,0.49338146811071,0.50661853188929
W01001098,1071,501,570,0.4677871148459384,0.5322128851540616
W01001100,1500,722,778,0.48133333333333334,0.5186666666666667
W01001103,1244,580,664,0.4662379421221865,0.5337620578778135
W01001106,1423,693,730,0.4869992972593113,0.5130007027406887
W01001107,1547,728,819,0.47058823529411764,0.5294117647058824
W01001109,1473,701,772,0.47589952477936187,0.5241004752206382
W01001110,1570,743,827,0.4732484076433121,0.5267515923566879
W01001111,1482,695,787,0.4689608636977058,0.5310391363022942
W01001112,1441,705,736,0.4892435808466343,0.5107564191533657
W01001063,1742,863,879,0.4954075774971297,0.5045924225028703
W01001065,1595,767,828,0.4808777429467085,0.5191222570532915
W01001069,1459,733,726,0.5023989033584647,0.4976010966415353
W01001079,1615,745,870,0.4613003095975232,0.5386996904024768
W01001080,1581,763,818,0.48260594560404807,0.5173940543959519
W01001910,1656,842,814,0.5084541062801933,0.4915458937198068
W01001911,1195,591,604,0.49456066945606697,0.5054393305439331
W01001062,1381,669,712,0.4844315713251267,0.5155684286748733
W01001064,1445,658,787,0.45536332179930794,0.5446366782006921
W01001093,1798,850,948,0.4727474972191324,0.5272525027808677
W01001099,1341,644,697,0.4802386278896346,0.5197613721103654
W01001101,1500,763,737,0.5086666666666667,0.49133333333333334
W01001102,1545,725,820,0.4692556634304207,0.5307443365695793
W01001108,1685,866,819,0.513946587537092,0.486053412462908
W01001117,1416,699,717,0.4936440677966102,0.5063559322033898
W01001118,2380,1167,1213,0.4903361344537815,0.5096638655462185
W01001120,1380,677,703,0.4905797101449275,0.5094202898550725
W01001121,1545,781,764,0.5055016181229773,0.49449838187702266
W01001122,2950,1793,1157,0.6077966101694915,0.39220338983050845
W01001059,1320,659,661,0.49924242424242427,0.5007575757575757
W01001060,1436,668,768,0.46518105849582175,0.5348189415041783
W01001061,2144,1025,1119,0.4780783582089552,0.5219216417910447
W01001066,1575,751,824,0.4768253968253968,0.5231746031746032
W01001073,2001,1001,1000,0.5002498750624688,0.49975012493753124
W01001777,1496,738,758,0.49331550802139035,0.5066844919786097
W01001778,1873,930,943,0.4965296316070475,0.5034703683929524
W01001794,1420,653,767,0.45985915492957746,0.5401408450704225
W01001799,1279,604,675,0.472243940578577,0.527756059421423
W01001793,1427,694,733,0.4863349684653118,0.5136650315346881
W01001795,1547,746,801,0.48222365869424694,0.5177763413057531
W01001796,1491,708,783,0.47484909456740443,0.5251509054325956
W01001798,1481,697,784,0.4706279540850776,0.5293720459149224
W01001841,2025,969,1056,0.4785185185185185,0.5214814814814814
W01001842,1748,853,895,0.4879862700228833,0.5120137299771167
W01001843,2167,1070,1097,0.49377018920166127,0.5062298107983387
W01001844,2028,946,1082,0.46646942800788954,0.5335305719921104
W01001849,1558,737,821,0.4730423620025674,0.5269576379974326
W01001852,1817,848,969,0.46670335718216843,0.5332966428178316
W01001853,1562,734,828,0.469910371318822,0.5300896286811779
W01001854,1572,711,861,0.45229007633587787,0.5477099236641222
W01001791,1625,774,851,0.4763076923076923,0.5236923076923077
W01001792,1701,837,864,0.49206349206349204,0.5079365079365079
W01001797,1439,705,734,0.48992355802640725,0.5100764419735928
W01001800,1565,735,830,0.4696485623003195,0.5303514376996805
W01001949,1281,609,672,0.47540983606557374,0.5245901639344263
W01001953,1499,731,768,0.4876584389593062,0.5123415610406938
W01001820,1196,598,598,0.5,0.5
W01001846,1727,851,876,0.49276201505500866,0.5072379849449913
W01001847,1535,759,776,0.4944625407166124,0.5055374592833877
W01001948,1618,782,836,0.48331273176761436,0.5166872682323856
W01001954,1537,750,787,0.48796356538711777,0.5120364346128823
W01001802,1588,746,842,0.46977329974811083,0.5302267002518891
W01001807,1567,708,859,0.4518187619655393,0.5481812380344607
W01001808,1634,739,895,0.45226438188494494,0.5477356181150551
W01001840,1752,870,882,0.4965753424657534,0.5034246575342466
W01001730,1489,707,782,0.4748153122901276,0.5251846877098724
W01001731,1446,699,747,0.483402489626556,0.516597510373444
W01001736,1395,656,739,0.47025089605734766,0.5297491039426523
W01001815,1353,643,710,0.475240206947524,0.524759793052476
W01001811,1503,706,797,0.4697272122421823,0.5302727877578177
W01001816,2625,1227,1398,0.4674285714285714,0.5325714285714286
W01001817,1406,665,741,0.47297297297297297,0.527027027027027
W01001818,1528,740,788,0.48429319371727747,0.5157068062827225
W01001888,1686,824,862,0.4887307236061684,0.5112692763938316
W01001893,1871,880,991,0.47033671833244256,0.5296632816675575
W01001894,1589,767,822,0.48269351793580867,0.5173064820641913
W01001895,1634,838,796,0.5128518971848225,0.48714810281517745
W01001877,1710,839,871,0.49064327485380116,0.5093567251461988
W01001878,1574,710,864,0.45108005082592123,0.5489199491740788
W01001882,1824,893,931,0.4895833333333333,0.5104166666666666
W01001885,2017,938,1079,0.46504709965294994,0.5349529003470501
W01001773,2524,1234,1290,0.4889064976228209,0.5110935023771791
W01001848,1447,704,743,0.4865238424326192,0.5134761575673807
W01001850,1931,930,1001,0.4816157431382703,0.5183842568617296
W01001851,1482,727,755,0.49055330634278005,0.50944669365722
W01001879,1904,876,1028,0.46008403361344535,0.5399159663865546
W01001880,1554,691,863,0.4446589446589447,0.5553410553410554
W01001881,1438,668,770,0.46453407510431155,0.5354659248956884
W01001884,1374,592,782,0.43085880640465796,0.5691411935953421
W01001727,1140,539,601,0.4728070175438597,0.5271929824561403
W01001728,1478,739,739,0.5,0.5
W01001729,2203,1058,1145,0.4802541988197912,0.5197458011802089
W01001819,2287,1095,1192,0.47879317883690425,0.5212068211630958
W01001803,1573,734,839,0.46662428480610296,0.533375715193897
W01001804,1566,786,780,0.5019157088122606,0.49808429118773945
W01001805,1490,726,764,0.487248322147651,0.512751677852349
W01001806,1642,808,834,0.4920828258221681,0.5079171741778319
W01001866,1510,701,809,0.4642384105960265,0.5357615894039736
W01001867,1429,662,767,0.4632610216934919,0.5367389783065081
W01001883,1600,754,846,0.47125,0.52875
W01001886,1199,572,627,0.47706422018348627,0.5229357798165137
W01001809,1309,641,668,0.48968678380443087,0.5103132161955691
W01001810,1678,807,871,0.48092967818831944,0.5190703218116806
W01001812,1292,608,684,0.47058823529411764,0.5294117647058824
W01001813,1519,741,778,0.4878209348255431,0.5121790651744569
W01001814,1421,683,738,0.48064743138634763,0.5193525686136523
W01001769,1602,798,804,0.49812734082397003,0.50187265917603
W01001770,1107,554,553,0.5004516711833785,0.4995483288166215
W01001771,1645,819,826,0.4978723404255319,0.502127659574468
W01001774,1399,693,706,0.49535382416011436,0.5046461758398856
W01001732,1591,774,817,0.4864864864864865,0.5135135135135135
W01001733,2077,1073,1004,0.516610495907559,0.483389504092441
W01001734,1526,736,790,0.48230668414154654,0.5176933158584535
W01001735,1624,749,875,0.46120689655172414,0.5387931034482759
W01001887,1573,779,794,0.49523204068658616,0.5047679593134139
W01001889,1546,760,786,0.49159120310478654,0.5084087968952135
W01001891,1659,763,896,0.459915611814346,0.540084388185654
W01001892,1437,681,756,0.47390396659707723,0.5260960334029228
W01001896,1533,722,811,0.4709719504240052,0.5290280495759948
W01001772,1413,667,746,0.4720452937013447,0.5279547062986554
W01001775,1592,779,813,0.48932160804020103,0.510678391959799
W01001776,1347,648,699,0.48106904231625836,0.5189309576837416
W01001890,1610,758,852,0.47080745341614905,0.529192546583851
W01001863,1564,760,804,0.4859335038363171,0.5140664961636828
W01001864,1505,723,782,0.48039867109634554,0.5196013289036545
W01001865,1321,636,685,0.4814534443603331,0.5185465556396669
W01001868,1498,680,818,0.4539385847797063,0.5460614152202937
W01001785,1183,524,659,0.4429416737109045,0.5570583262890956
W01001786,1555,755,800,0.4855305466237942,0.5144694533762058
W01001787,1461,728,733,0.49828884325804246,0.5017111567419575
W01001788,1431,726,705,0.5073375262054507,0.49266247379454925
W01001789,1527,729,798,0.4774066797642436,0.5225933202357563
W01001790,1187,539,648,0.45408593091828137,0.5459140690817186
W01001821,1837,818,1019,0.44529123571039736,0.5547087642896026
W01001826,1353,635,718,0.4693274205469327,0.5306725794530672
W01001827,1610,745,865,0.46273291925465837,0.5372670807453416
W01001828,1535,747,788,0.4866449511400652,0.5133550488599349
W01001755,1432,734,698,0.5125698324022346,0.48743016759776536
W01001756,3809,1678,2131,0.4405355736413757,0.5594644263586243
W01001757,1493,730,763,0.48894842598794375,0.5110515740120563
W01001758,2056,916,1140,0.4455252918287938,0.5544747081712063
W01001779,1445,703,742,0.4865051903114187,0.5134948096885813
W01001780,1750,790,960,0.4514285714285714,0.5485714285714286
W01001781,1736,849,887,0.4890552995391705,0.5109447004608295
W01001782,1437,706,731,0.4913013221990257,0.5086986778009742
W01001783,1268,603,665,0.4755520504731861,0.5244479495268138
W01001784,1361,658,703,0.4834680382072006,0.5165319617927994
W01001747,1624,771,853,0.4747536945812808,0.5252463054187192
W01001748,1569,750,819,0.4780114722753346,0.5219885277246654
W01001749,1488,727,761,0.4885752688172043,0.5114247311827957
W01001751,1661,811,850,0.48826008428657436,0.5117399157134257
W01001718,1680,887,793,0.5279761904761905,0.4720238095238095
W01001719,2064,1001,1063,0.48498062015503873,0.5150193798449613
W01001720,1892,922,970,0.48731501057082455,0.5126849894291755
W01001722,1571,766,805,0.4875875238701464,0.5124124761298536
W01001726,1715,840,875,0.4897959183673469,0.5102040816326531
W01001822,1647,757,890,0.4596235579842137,0.5403764420157863
W01001823,1334,648,686,0.48575712143928035,0.5142428785607196
W01001824,1566,796,770,0.508301404853129,0.49169859514687103
W01001825,1775,883,892,0.49746478873239436,0.5025352112676056
W01001831,1565,782,783,0.4996805111821086,0.5003194888178913
W01001836,1599,843,756,0.5272045028142589,0.4727954971857411
W01001837,1524,827,697,0.5426509186351706,0.4573490813648294
W01001838,1782,908,874,0.5095398428731762,0.4904601571268238
W01001839,1609,787,822,0.4891236793039155,0.5108763206960846
W01001750,1650,776,874,0.4703030303030303,0.5296969696969697
W01001752,1625,804,821,0.4947692307692308,0.5052307692307693
W01001753,1653,756,897,0.4573502722323049,0.542649727767695
W01001754,1711,811,900,0.4739918176504968,0.5260081823495032
W01001721,2906,1336,1570,0.45973847212663455,0.5402615278733655
W01001724,1984,909,1075,0.4581653225806452,0.5418346774193549
W01001725,2214,1141,1073,0.5153568202348691,0.484643179765131
W01001922,1976,1108,868,0.5607287449392713,0.4392712550607287
W01001939,1020,641,379,0.6284313725490196,0.3715686274509804
W01001941,1099,679,420,0.6178343949044586,0.3821656050955414
W01001829,1807,1006,801,0.5567238516878804,0.44327614831211953
W01001830,1638,918,720,0.5604395604395604,0.43956043956043955
W01001832,1787,1072,715,0.599888080581981,0.40011191941801905
W01001833,1626,857,769,0.527060270602706,0.47293972939729395
W01001834,1607,817,790,0.5084007467330429,0.4915992532669571
W01001835,1622,901,721,0.5554870530209618,0.4445129469790382
W01001858,1694,825,869,0.487012987012987,0.512987012987013
W01001859,1421,716,705,0.5038705137227305,0.49612948627726955
W01001860,1707,850,857,0.4979496192149971,0.502050380785003
W01001861,1709,874,835,0.5114101813926273,0.4885898186073727
W01001714,1522,726,796,0.47700394218134035,0.5229960578186597
W01001715,1571,799,772,0.5085932527052832,0.49140674729471673
W01001716,1274,623,651,0.489010989010989,0.510989010989011
W01001717,1580,745,835,0.47151898734177217,0.5284810126582279
W01001694,1961,1055,906,0.537990821009689,0.4620091789903111
W01001695,3243,1868,1375,0.5760098674067222,0.42399013259327784
W01001696,1553,778,775,0.5009658725048294,0.4990341274951706
W01001697,1646,818,828,0.49696233292831105,0.503037667071689
W01001698,1968,1073,895,0.5452235772357723,0.45477642276422764
W01001870,1377,685,692,0.4974582425562818,0.5025417574437182
W01001871,1594,741,853,0.46486825595984943,0.5351317440401505
W01001875,2695,1307,1388,0.4849721706864564,0.5150278293135436
W01001876,1547,756,791,0.48868778280542985,0.5113122171945701
W01001869,1395,666,729,0.4774193548387097,0.5225806451612903
W01001872,1525,769,756,0.5042622950819672,0.49573770491803276
W01001873,1699,840,859,0.49440847557386697,0.505591524426133
W01001874,1429,697,732,0.48775367389783064,0.5122463261021694
W01001737,1585,741,844,0.46750788643533125,0.5324921135646687
W01001738,1421,665,756,0.46798029556650245,0.5320197044334976
W01001739,1361,649,712,0.47685525349008084,0.5231447465099192
W01001740,1521,715,806,0.4700854700854701,0.5299145299145299
W01001741,1619,714,905,0.4410129709697344,0.5589870290302656
W01001709,1898,939,959,0.4947312961011591,0.5052687038988409
W01001710,1597,818,779,0.5122103944896681,0.48778960551033185
W01001711,1632,780,852,0.47794117647058826,0.5220588235294118
W01001712,1506,684,822,0.4541832669322709,0.545816733067729
W01001713,1724,893,831,0.5179814385150812,0.4820185614849188
W01001704,1552,685,867,0.4413659793814433,0.5586340206185567
W01001706,1244,594,650,0.477491961414791,0.522508038585209
W01001707,2068,990,1078,0.4787234042553192,0.5212765957446809
W01001746,1542,708,834,0.4591439688715953,0.5408560311284046
W01001855,1799,923,876,0.5130628126737076,0.4869371873262924
W01001856,1852,1073,779,0.5793736501079914,0.42062634989200864
W01001857,1856,978,878,0.5269396551724138,0.4730603448275862
W01001862,1733,976,757,0.5631852279284478,0.4368147720715522
W01001742,1515,675,840,0.44554455445544555,0.5544554455445545
W01001743,1424,694,730,0.48735955056179775,0.5126404494382022
W01001744,1592,753,839,0.4729899497487437,0.5270100502512562
W01001745,1355,656,699,0.4841328413284133,0.5158671586715867
W01001764,1993,1039,954,0.5213246362267938,0.47867536377320624
W01001765,1418,747,671,0.5267983074753173,0.47320169252468264
W01001766,1663,846,817,0.5087191822008419,0.49128081779915816
W01001767,1658,859,799,0.5180940892641737,0.4819059107358263
W01001768,1691,876,815,0.5180366646954465,0.48196333530455354
W01001702,1850,879,971,0.4751351351351351,0.5248648648648648
W01001703,1266,622,644,0.4913112164296998,0.5086887835703001
W01001705,1776,841,935,0.47353603603603606,0.526463963963964
W01001708,1562,764,798,0.48911651728553135,0.5108834827144686
W01001759,1588,794,794,0.5,0.5
W01001760,1693,807,886,0.47666863555818073,0.5233313644418193
W01001761,1790,943,847,0.5268156424581005,0.4731843575418994
W01001762,1745,865,880,0.49570200573065903,0.504297994269341
W01001940,1111,643,468,0.5787578757875788,0.42124212421242124
W01001943,1098,608,490,0.5537340619307832,0.44626593806921677
W01001944,1027,580,447,0.5647517039922103,0.4352482960077897
W01001945,1303,760,543,0.5832693783576363,0.4167306216423638
W01001947,1504,751,753,0.49933510638297873,0.5006648936170213
W01001699,2198,1168,1030,0.5313921747042766,0.46860782529572337
W01001942,1355,711,644,0.5247232472324723,0.4752767527675277
W01001946,1339,702,637,0.5242718446601942,0.47572815533980584
W01001950,1082,605,477,0.5591497227356746,0.4408502772643253
W01001951,1016,582,434,0.5728346456692913,0.4271653543307087
W01001952,1238,644,594,0.5201938610662359,0.4798061389337641
W01001186,1753,859,894,0.4900171135196805,0.5099828864803194
W01001187,1393,719,674,0.5161521895190236,0.4838478104809763
W01001188,1038,498,540,0.4797687861271676,0.5202312138728323
W01001221,1467,672,795,0.45807770961145194,0.5419222903885481
W01001222,1596,751,845,0.4705513784461153,0.5294486215538847
W01001233,1700,845,855,0.4970588235294118,0.5029411764705882
W01001148,1662,810,852,0.48736462093862815,0.5126353790613718
W01001152,1584,779,805,0.4917929292929293,0.5082070707070707
W01001153,1499,732,767,0.4883255503669113,0.5116744496330887
W01001155,1534,718,816,0.4680573663624511,0.5319426336375489
W01001149,1428,692,736,0.484593837535014,0.5154061624649859
W01001150,1670,780,890,0.46706586826347307,0.5329341317365269
W01001151,1679,820,859,0.48838594401429425,0.5116140559857058
W01001154,1405,676,729,0.4811387900355872,0.5188612099644128
W01001156,1546,772,774,0.49935316946959896,0.500646830530401
W01001147,1801,852,949,0.47307051637978903,0.526929483620211
W01001168,1457,668,789,0.45847632120796156,0.5415236787920384
W01001169,1726,896,830,0.5191193511008111,0.48088064889918886
W01001170,1218,581,637,0.47701149425287354,0.5229885057471264
W01001137,2389,1152,1237,0.4822101297614064,0.5177898702385936
W01001138,1362,656,706,0.48164464023494863,0.5183553597650514
W01001139,1473,738,735,0.5010183299389002,0.4989816700610998
W01001140,1432,714,718,0.49860335195530725,0.5013966480446927
W01001141,1617,791,826,0.48917748917748916,0.5108225108225108
W01001142,1592,794,798,0.49874371859296485,0.5012562814070352
W01001204,1321,624,697,0.4723694171082513,0.5276305828917487
W01001205,1588,773,815,0.48677581863979846,0.5132241813602015
W01001206,1482,691,791,0.46626180836707154,0.5337381916329285
W01001207,1387,672,715,0.4844989185291997,0.5155010814708003
W01001208,1596,750,846,0.4699248120300752,0.5300751879699248
W01001265,1535,732,803,0.47687296416938113,0.5231270358306189
W01001266,1343,651,692,0.4847356664184661,0.5152643335815339
W01001267,1423,708,715,0.49754040758959944,0.5024595924104006
W01001268,1426,710,716,0.49789621318373073,0.5021037868162693
W01001209,1403,696,707,0.49607982893799,0.5039201710620099
W01001210,1449,700,749,0.4830917874396135,0.5169082125603864
W01001211,1595,768,827,0.48150470219435737,0.5184952978056426
W01001212,1342,645,697,0.48062593144560356,0.5193740685543964
W01001175,1439,684,755,0.47533009034051427,0.5246699096594858
W01001177,1279,634,645,0.49569976544175137,0.5043002345582487
W01001202,1780,899,881,0.505056179775281,0.4949438202247191
W01001203,1380,660,720,0.4782608695652174,0.5217391304347826
W01001269,1416,681,735,0.4809322033898305,0.5190677966101694
W01001270,1445,702,743,0.48581314878892734,0.5141868512110727
W01001271,1620,815,805,0.5030864197530864,0.49691358024691357
W01001272,1545,752,793,0.4867313915857605,0.5132686084142395
W01001273,1668,802,866,0.48081534772182255,0.5191846522781774
W01001213,1361,634,727,0.46583394562821456,0.5341660543717854
W01001214,1299,634,665,0.4880677444187837,0.5119322555812164
W01001215,1037,514,523,0.4956605593056895,0.5043394406943105
W01001216,1535,747,788,0.4866449511400652,0.5133550488599349
W01001143,1600,789,811,0.493125,0.506875
W01001144,1606,781,825,0.4863013698630137,0.5136986301369864
W01001145,1765,883,882,0.5002832861189802,0.49971671388101985
W01001146,1419,693,726,0.4883720930232558,0.5116279069767442
W01001176,1460,715,745,0.4897260273972603,0.5102739726027398
W01001274,1344,652,692,0.4851190476190476,0.5148809523809523
W01001275,1807,891,916,0.4930824571112341,0.5069175428887659
W01001276,1395,684,711,0.49032258064516127,0.5096774193548387
W01001200,1009,479,530,0.47472745292368684,0.5252725470763132
W01001201,1238,613,625,0.49515347334410337,0.5048465266558966
W01001260,1091,514,577,0.4711274060494959,0.5288725939505041
W01001285,1451,689,762,0.47484493452791177,0.5251550654720882
W01001286,1535,755,780,0.49185667752442996,0.50814332247557
W01001287,1456,731,725,0.5020604395604396,0.49793956043956045
W01001288,1412,697,715,0.4936260623229462,0.5063739376770539
W01001180,1463,699,764,0.47778537252221465,0.5222146274777854
W01001181,1396,690,706,0.49426934097421205,0.505730659025788
W01001282,2000,975,1025,0.4875,0.5125
W01001283,1503,715,788,0.47571523619427813,0.5242847638057219
W01001284,1161,592,569,0.5099052540913006,0.4900947459086994
W01001166,1321,662,659,0.5011355034065103,0.4988644965934898
W01001167,1478,704,774,0.476319350473613,0.523680649526387
W01001247,1696,830,866,0.4893867924528302,0.5106132075471698
W01001248,2054,1060,994,0.5160662122687439,0.48393378773125606
W01001171,1260,605,655,0.4801587301587302,0.5198412698412699
W01001229,1433,749,684,0.5226796929518492,0.47732030704815076
W01001230,1603,788,815,0.49157829070492826,0.5084217092950717
W01001231,1540,746,794,0.4844155844155844,0.5155844155844156
W01001280,1631,796,835,0.4880441446965052,0.5119558553034947
W01001281,1689,823,866,0.4872705743043221,0.5127294256956779
W01001217,1202,601,601,0.5,0.5
W01001218,1541,761,780,0.4938351719662557,0.5061648280337443
W01001219,1332,662,670,0.496996996996997,0.503003003003003
W01001220,1479,725,754,0.49019607843137253,0.5098039215686274
W01001259,1691,818,873,0.48373743347131876,0.5162625665286813
W01001261,1258,632,626,0.5023847376788553,0.49761526232114467
W01001164,1551,763,788,0.49194068343004516,0.5080593165699548
W01001165,1304,615,689,0.47162576687116564,0.5283742331288344
W01001256,1222,596,626,0.4877250409165303,0.5122749590834698
W01001257,1267,618,649,0.4877663772691397,0.5122336227308603
W01001258,1265,613,652,0.48458498023715413,0.5154150197628459
W01001172,1492,722,770,0.4839142091152815,0.5160857908847185
W01001173,1368,686,682,0.5014619883040936,0.49853801169590645
W01001174,1385,649,736,0.46859205776173285,0.5314079422382672
W01001232,1394,690,704,0.4949784791965567,0.5050215208034433
W01001182,1479,734,745,0.49628127112914133,0.5037187288708587
W01001183,1011,525,486,0.5192878338278932,0.4807121661721068
W01001227,1334,656,678,0.4917541229385307,0.5082458770614693
W01001228,1502,751,751,0.5,0.5
W01001234,1456,706,750,0.4848901098901099,0.5151098901098901
W01001235,1685,792,893,0.47002967359050446,0.5299703264094956
W01001236,1516,715,801,0.4716358839050132,0.5283641160949868
W01001185,1625,798,827,0.4910769230769231,0.5089230769230769
W01001237,1467,682,785,0.4648943421949557,0.5351056578050443
W01001238,1673,774,899,0.46264196054991036,0.5373580394500896
W01001262,1356,724,632,0.5339233038348082,0.46607669616519176
W01001263,1711,932,779,0.5447106954997077,0.4552893045002922
W01001264,2083,1204,879,0.5780124819971195,0.4219875180028805
W01001178,1709,829,880,0.48507899356348744,0.5149210064365126
W01001179,1727,830,897,0.4806022003474233,0.5193977996525767
W01001253,1428,682,746,0.47759103641456585,0.5224089635854342
W01001255,1598,771,827,0.48247809762202754,0.5175219023779725
W01001914,1841,929,912,0.5046170559478544,0.49538294405214556
W01001917,1507,751,756,0.49834107498341074,0.5016589250165893
W01001249,1389,682,707,0.49100071994240463,0.5089992800575954
W01001250,1458,699,759,0.4794238683127572,0.5205761316872428
W01001251,1557,742,815,0.4765574823378292,0.5234425176621709
W01001252,1523,747,776,0.49047931713722914,0.5095206828627709
W01001162,1718,844,874,0.4912689173457509,0.5087310826542492
W01001244,1364,642,722,0.4706744868035191,0.5293255131964809
W01001245,1303,640,663,0.4911742133537989,0.508825786646201
W01001246,1381,664,717,0.48081100651701664,0.5191889934829833
W01001184,1963,961,1002,0.48955680081507896,0.5104431991849211
W01001239,1365,673,692,0.49304029304029307,0.5069597069597069
W01001240,1945,949,996,0.4879177377892031,0.5120822622107969
W01001241,1727,841,886,0.48697162709901565,0.5130283729009844
W01001196,1575,787,788,0.4996825396825397,0.5003174603174603
W01001197,1258,629,629,0.5,0.5
W01001198,1556,761,795,0.4890745501285347,0.5109254498714653
W01001199,1710,820,890,0.47953216374269003,0.52046783625731
W01001915,1774,872,902,0.4915445321307779,0.5084554678692221
W01001916,1529,745,784,0.48724656638325703,0.512753433616743
W01001157,1386,662,724,0.47763347763347763,0.5223665223665224
W01001158,1491,746,745,0.500335345405768,0.49966465459423204
W01001159,1279,621,658,0.48553557466770914,0.5144644253322909
W01001277,1211,591,620,0.4880264244426094,0.5119735755573905
W01001278,1154,588,566,0.5095320623916811,0.4904679376083189
W01001279,1182,548,634,0.46362098138747887,0.5363790186125211
W01001160,1594,797,797,0.5,0.5
W01001161,2224,1083,1141,0.4869604316546763,0.5130395683453237
W01001189,1663,804,859,0.4834636199639206,0.5165363800360794
W01001190,2531,1250,1281,0.4938759383642829,0.5061240616357171
W01001193,1213,593,620,0.4888705688375927,0.5111294311624073
W01001194,2165,1067,1098,0.4928406466512702,0.5071593533487297
W01001195,1498,741,757,0.4946595460614152,0.5053404539385847
W01001242,1357,675,682,0.4974207811348563,0.5025792188651437
W01001243,1377,652,725,0.4734931009440813,0.5265068990559186
W01001191,2494,1234,1260,0.49478748997594224,0.5052125100240578
W01001192,1491,726,765,0.4869215291750503,0.5130784708249497
W01001223,1593,780,813,0.4896421845574388,0.5103578154425612
W01001224,2129,1033,1096,0.4852043212775951,0.5147956787224048
W01001225,1574,767,807,0.4872935196950445,0.5127064803049556
W01001226,1719,800,919,0.4653868528214078,0.5346131471785922
W01001295,1574,754,820,0.47903430749682335,0.5209656925031766
W01001296,1677,822,855,0.49016100178890876,0.5098389982110912
W01001297,1890,958,932,0.5068783068783069,0.4931216931216931
W01001298,1785,865,920,0.484593837535014,0.5154061624649859
W01001310,1630,798,832,0.48957055214723927,0.5104294478527608
W01001311,1192,608,584,0.5100671140939598,0.4899328859060403
W01001291,1845,906,939,0.49105691056910566,0.5089430894308943
W01001294,1644,818,826,0.4975669099756691,0.5024330900243309
W01001305,1292,617,675,0.4775541795665635,0.5224458204334366
W01001306,1549,758,791,0.4893479664299548,0.5106520335700452
W01001324,2033,984,1049,0.4840137727496311,0.5159862272503689
W01001292,1730,820,910,0.47398843930635837,0.5260115606936416
W01001293,1650,792,858,0.48,0.52
W01001307,1485,734,751,0.49427609427609426,0.5057239057239057
W01001315,1709,895,814,0.5236980690462258,0.47630193095377416
W01001314,2179,1078,1101,0.49472234970169804,0.505277650298302
W01001316,2862,1420,1442,0.49615653389238296,0.5038434661076171
W01001317,1599,772,827,0.482801751094434,0.517198248905566
W01001318,1501,769,732,0.5123251165889408,0.4876748834110593
W01001289,1392,683,709,0.4906609195402299,0.5093390804597702
W01001302,1124,580,544,0.5160142348754448,0.48398576512455516
W01001303,1200,583,617,0.48583333333333334,0.5141666666666667
W01001304,1507,758,749,0.5029860650298607,0.49701393497013935
W01001312,1557,738,819,0.47398843930635837,0.5260115606936416
W01001313,1560,752,808,0.48205128205128206,0.517948717948718
W01001290,1885,944,941,0.5007957559681697,0.4992042440318302
W01001319,1646,820,826,0.49817739975698666,0.5018226002430134
W01001320,1546,769,777,0.4974126778783959,0.5025873221216042
W01001321,1572,750,822,0.4770992366412214,0.5229007633587787
W01001322,1592,780,812,0.4899497487437186,0.5100502512562815
W01001299,1616,750,866,0.46410891089108913,0.5358910891089109
W01001300,1753,825,928,0.47062179121505987,0.5293782087849401
W01001301,1911,913,998,0.47776033490319203,0.522239665096808
W01001308,1320,626,694,0.47424242424242424,0.5257575757575758
W01001309,1277,604,673,0.4729835552075176,0.5270164447924823
W01001898,1518,748,770,0.4927536231884058,0.5072463768115942
W01001374,1462,722,740,0.493844049247606,0.506155950752394
W01001375,1475,710,765,0.48135593220338985,0.5186440677966102
W01001376,1530,736,794,0.48104575163398694,0.5189542483660131
W01001406,1924,957,967,0.4974012474012474,0.5025987525987526
W01001428,1297,628,669,0.48419429452582885,0.5158057054741712
W01001429,1157,561,596,0.4848746758859118,0.5151253241140882
W01001360,1357,666,691,0.49078850405305824,0.5092114959469418
W01001361,1250,611,639,0.4888,0.5112
W01001384,1647,826,821,0.5015179113539769,0.49848208864602306
W01001385,1576,766,810,0.4860406091370558,0.5139593908629442
W01001386,1743,877,866,0.5031554790590935,0.4968445209409065
W01001325,1540,770,770,0.5,0.5
W01001326,2102,1045,1057,0.4971455756422455,0.5028544243577545
W01001362,2062,1002,1060,0.4859359844810863,0.5140640155189137
W01001336,1437,735,702,0.511482254697286,0.48851774530271397
W01001337,1558,774,784,0.496790757381258,0.503209242618742
W01001338,1744,887,857,0.5086009174311926,0.4913990825688073
W01001339,1457,668,789,0.45847632120796156,0.5415236787920384
W01001334,1495,732,763,0.48963210702341137,0.5103678929765886
W01001335,1274,638,636,0.5007849293563579,0.49921507064364207
W01001347,1442,699,743,0.48474341192787795,0.515256588072122
W01001351,1504,754,750,0.5013297872340425,0.49867021276595747
W01001356,1259,627,632,0.4980142970611596,0.5019857029388404
W01001357,1600,805,795,0.503125,0.496875
W01001358,1540,756,784,0.4909090909090909,0.509090909090909
W01001359,1548,772,776,0.49870801033591733,0.5012919896640827
W01001390,1843,917,926,0.49755832881172,0.50244167118828
W01001391,1639,796,843,0.4856619890176937,0.5143380109823062
W01001352,1845,890,955,0.4823848238482385,0.5176151761517616
W01001353,1595,787,808,0.4934169278996865,0.5065830721003135
W01001387,1285,636,649,0.49494163424124515,0.5050583657587548
W01001388,1855,872,983,0.47008086253369274,0.5299191374663073
W01001389,1162,581,581,0.5,0.5
W01001414,1600,779,821,0.486875,0.513125
W01001415,1807,889,918,0.49197565024903156,0.5080243497509684
W01001416,1462,711,751,0.48632010943912446,0.5136798905608755
W01001417,1490,746,744,0.5006711409395973,0.4993288590604027
W01001418,1458,705,753,0.4835390946502058,0.5164609053497943
W01001348,1812,834,978,0.4602649006622517,0.5397350993377483
W01001349,1971,985,986,0.49974632166412986,0.5002536783358701
W01001350,1767,877,890,0.49632144878324846,0.5036785512167515
W01001392,1769,861,908,0.48671565856416055,0.5132843414358395
W01001380,1815,902,913,0.49696969696969695,0.503030303030303
W01001381,1535,759,776,0.4944625407166124,0.5055374592833877
W01001382,1653,808,845,0.48880822746521474,0.5111917725347852
W01001383,1506,732,774,0.4860557768924303,0.5139442231075697
W01001401,1943,957,986,0.4925373134328358,0.5074626865671642
W01001402,1699,835,864,0.4914655679811654,0.5085344320188346
W01001403,1621,803,818,0.49537322640345466,0.5046267735965454
W01001404,1412,715,697,0.5063739376770539,0.4936260623229462
W01001405,1877,920,957,0.49014384656366544,0.5098561534363346
W01001363,1493,731,762,0.4896182183523108,0.5103817816476892
W01001364,1930,945,985,0.4896373056994819,0.5103626943005182
W01001365,2125,1031,1094,0.4851764705882353,0.5148235294117647
W01001369,2242,1111,1131,0.49553969669937553,0.5044603033006244
W01001377,1543,741,802,0.48023331173039535,0.5197666882696047
W01001378,1592,744,848,0.46733668341708545,0.5326633165829145
W01001379,1512,778,734,0.5145502645502645,0.48544973544973546
W01001432,2210,1082,1128,0.48959276018099546,0.5104072398190045
W01001433,1413,665,748,0.4706298655343241,0.5293701344656758
W01001434,1420,702,718,0.4943661971830986,0.5056338028169014
W01001327,2169,1087,1082,0.5011526048870447,0.4988473951129553
W01001328,1606,812,794,0.5056039850560399,0.4943960149439601
W01001329,1577,761,816,0.4825618262523779,0.517438173747622
W01001354,1646,816,830,0.4957472660996355,0.5042527339003645
W01001355,1619,814,805,0.5027794935145151,0.4972205064854849
W01001430,2367,1142,1225,0.4824672581326574,0.5175327418673427
W01001431,1581,775,806,0.49019607843137253,0.5098039215686274
W01001407,1416,702,714,0.4957627118644068,0.5042372881355932
W01001408,1515,724,791,0.4778877887788779,0.5221122112211221
W01001409,1677,800,877,0.4770423375074538,0.5229576624925462
W01001410,1856,941,915,0.5070043103448276,0.49299568965517243
W01001411,1709,815,894,0.47688706846108836,0.5231129315389117
W01001412,1693,838,855,0.4949793266391022,0.5050206733608978
W01001413,1827,868,959,0.47509578544061304,0.524904214559387
W01001330,1473,741,732,0.5030549898167006,0.4969450101832994
W01001331,1785,884,901,0.49523809523809526,0.5047619047619047
W01001332,1926,982,944,0.509865005192108,0.490134994807892
W01001333,1615,770,845,0.47678018575851394,0.5232198142414861
W01001366,1692,836,856,0.4940898345153664,0.5059101654846335
W01001367,1516,767,749,0.5059366754617414,0.4940633245382586
W01001368,1553,757,796,0.4874436574372183,0.5125563425627817
W01001393,1345,672,673,0.4996282527881041,0.5003717472118959
W01001397,1732,860,872,0.49653579676674364,0.5034642032332564
W01001400,1454,685,769,0.47111416781292986,0.5288858321870702
W01001340,1809,915,894,0.5058043117744611,0.494195688225539
W01001341,1807,850,957,0.4703929164360819,0.5296070835639181
W01001344,1708,836,872,0.4894613583138173,0.5105386416861827
W01001346,1535,742,793,0.48338762214983716,0.5166123778501629
W01001342,1168,567,601,0.4854452054794521,0.514554794520548
W01001343,1194,591,603,0.4949748743718593,0.5050251256281407
W01001345,1537,738,799,0.4801561483409239,0.5198438516590761
W01001419,1556,800,756,0.5141388174807198,0.48586118251928023
W01001371,1450,685,765,0.4724137931034483,0.5275862068965518
W01001372,1943,910,1033,0.4683479155944416,0.5316520844055584
W01001373,1692,839,853,0.4958628841607565,0.5041371158392435
W01001420,1305,629,676,0.481992337164751,0.518007662835249
W01001421,1543,729,814,0.47245625405055086,0.5275437459494491
W01001422,1572,766,806,0.4872773536895674,0.5127226463104325
W01001370,1686,818,868,0.4851720047449585,0.5148279952550415
W01001394,1377,705,672,0.5119825708061002,0.4880174291938998
W01001395,1455,692,763,0.4756013745704467,0.5243986254295533
W01001396,1666,796,870,0.4777911164465786,0.5222088835534213
W01001399,1316,652,664,0.49544072948328266,0.5045592705167173
W01001398,2507,1265,1242,0.5045871559633027,0.4954128440366973
W01001423,1417,690,727,0.48694424841213835,0.5130557515878617
W01001424,1497,693,804,0.46292585170340683,0.5370741482965932
W01001425,1620,792,828,0.4888888888888889,0.5111111111111111
W01001426,1381,698,683,0.5054308472121651,0.4945691527878349
W01001427,1835,903,932,0.49209809264305177,0.5079019073569482
W01001440,1380,668,712,0.48405797101449277,0.5159420289855072
W01001441,1248,611,637,0.4895833333333333,0.5104166666666666
W01001442,1238,614,624,0.49596122778675283,0.5040387722132472
W01001470,1482,734,748,0.49527665317139,0.50472334682861
W01001471,1752,856,896,0.4885844748858447,0.5114155251141552
W01001446,1273,603,670,0.47368421052631576,0.5263157894736842
W01001447,1570,767,803,0.48853503184713376,0.5114649681528662
W01001448,1238,648,590,0.5234248788368336,0.4765751211631664
W01001449,1449,723,726,0.4989648033126294,0.5010351966873706
W01001472,1473,742,731,0.5037338764426341,0.49626612355736593
W01001473,1399,646,753,0.46175839885632597,0.538241601143674
W01001474,1549,784,765,0.5061329890251776,0.49386701097482244
W01001475,1209,584,625,0.48304383788254757,0.5169561621174524
W01001480,1495,713,782,0.47692307692307695,0.5230769230769231
W01001438,1425,675,750,0.47368421052631576,0.5263157894736842
W01001439,1685,843,842,0.5002967359050445,0.49970326409495547
W01001456,1321,627,694,0.47464042392127176,0.5253595760787282
W01001457,1709,784,925,0.4587478057343476,0.5412521942656524
W01001458,1531,760,771,0.496407576747224,0.503592423252776
W01001443,1369,714,655,0.5215485756026297,0.4784514243973703
W01001444,1933,939,994,0.4857734092084842,0.5142265907915158
W01001445,1506,742,764,0.49269588313413015,0.5073041168658698
W01001467,1946,937,1009,0.48150051387461457,0.5184994861253854
W01001468,1378,677,701,0.49129172714078373,0.5087082728592163
W01001469,1311,668,643,0.509534706331045,0.49046529366895497
W01001462,1518,720,798,0.4743083003952569,0.525691699604743
W01001463,1892,906,986,0.4788583509513742,0.5211416490486258
W01001478,1471,714,757,0.48538409245411285,0.5146159075458872
W01001479,1511,710,801,0.4698874917273329,0.5301125082726671
W01001481,1586,798,788,0.5031525851197982,0.4968474148802018
W01001450,1310,644,666,0.4916030534351145,0.5083969465648855
W01001451,1429,712,717,0.4982505248425472,0.5017494751574527
W01001452,1556,798,758,0.512853470437018,0.487146529562982
W01001459,1111,529,582,0.47614761476147616,0.5238523852385238
W01001460,1743,875,868,0.5020080321285141,0.4979919678714859
W01001461,1420,705,715,0.4964788732394366,0.5035211267605634
W01001435,1442,725,717,0.5027739251040222,0.4972260748959778
W01001436,1413,708,705,0.5010615711252654,0.4989384288747346
W01001437,1561,765,796,0.49007046764894296,0.509929532351057
W01001453,1563,773,790,0.4945617402431222,0.5054382597568778
W01001454,1404,671,733,0.4779202279202279,0.5220797720797721
W01001455,1736,843,893,0.48559907834101385,0.5144009216589862
W01001464,1544,788,756,0.5103626943005182,0.4896373056994819
W01001465,1566,769,797,0.49106002554278416,0.5089399744572158
W01001466,1687,892,795,0.5287492590397155,0.4712507409602845
W01001476,1039,504,535,0.4850818094321463,0.5149181905678537
W01001477,1443,717,726,0.4968814968814969,0.5031185031185031
W01001487,1550,791,759,0.5103225806451613,0.4896774193548387
W01001488,1592,774,818,0.4861809045226131,0.5138190954773869
W01001489,1616,783,833,0.484529702970297,0.5154702970297029
W01001490,1297,630,667,0.48573631457208943,0.5142636854279106
W01001482,1213,607,606,0.5004122011541632,0.49958779884583676
W01001483,1378,643,735,0.46661828737300437,0.5333817126269956
W01001484,1740,845,895,0.48563218390804597,0.514367816091954
W01001485,1211,568,643,0.4690338563170933,0.5309661436829067
W01001486,1522,762,760,0.5006570302233903,0.49934296977660975
W01001525,1541,763,778,0.49513303049967555,0.5048669695003245
W01001529,2063,1034,1029,0.5012118274357732,0.49878817256422686
W01001530,1844,865,979,0.4690889370932755,0.5309110629067245
W01001531,1762,883,879,0.5011350737797957,0.4988649262202043
W01001491,1808,873,935,0.48285398230088494,0.5171460176991151
W01001496,1438,691,747,0.480528511821975,0.519471488178025
W01001523,1492,726,766,0.4865951742627346,0.5134048257372654
W01001524,1836,934,902,0.5087145969498911,0.4912854030501089
W01001540,1272,632,640,0.4968553459119497,0.5031446540880503
W01001541,1162,550,612,0.47332185886402756,0.5266781411359724
W01001510,1522,714,808,0.469119579500657,0.5308804204993429
W01001511,1604,771,833,0.48067331670822944,0.5193266832917706
W01001512,1357,680,677,0.501105379513633,0.498894620486367
W01001513,1503,753,750,0.500998003992016,0.499001996007984
W01001514,1180,576,604,0.488135593220339,0.511864406779661
W01001515,1512,732,780,0.48412698412698413,0.5158730158730159
W01001516,1434,706,728,0.49232914923291493,0.5076708507670851
W01001517,1984,997,987,0.5025201612903226,0.49747983870967744
W01001518,1107,559,548,0.5049683830171635,0.4950316169828365
W01001519,1351,683,668,0.5055514433752776,0.4944485566247224
W01001520,1801,866,935,0.4808439755691283,0.5191560244308717
W01001521,1452,729,723,0.5020661157024794,0.49793388429752067
W01001522,1701,822,879,0.48324514991181655,0.5167548500881834
W01001537,1200,604,596,0.5033333333333333,0.49666666666666665
W01001493,1941,942,999,0.4853168469860896,0.5146831530139103
W01001494,1509,732,777,0.4850894632206759,0.5149105367793241
W01001495,1796,829,967,0.4615812917594655,0.5384187082405345
W01001507,2013,945,1068,0.46944858420268254,0.5305514157973175
W01001501,1344,665,679,0.4947916666666667,0.5052083333333334
W01001503,1395,665,730,0.4767025089605735,0.5232974910394266
W01001536,1229,578,651,0.47030105777054515,0.5296989422294548
W01001538,1327,624,703,0.4702336096458176,0.5297663903541824
W01001539,1472,690,782,0.46875,0.53125
W01001506,1401,715,686,0.510349750178444,0.489650249821556
W01001526,1341,634,707,0.4727815063385533,0.5272184936614467
W01001527,1206,581,625,0.48175787728026537,0.5182421227197347
W01001528,1118,540,578,0.48300536672629696,0.516994633273703
W01001532,1756,833,923,0.474373576309795,0.525626423690205
W01001497,1527,720,807,0.4715127701375246,0.5284872298624754
W01001498,1176,561,615,0.4770408163265306,0.5229591836734694
W01001499,1203,604,599,0.5020781379883624,0.4979218620116376
W01001500,1323,638,685,0.48223733938019653,0.5177626606198035
W01001502,1329,645,684,0.4853273137697517,0.5146726862302483
W01001492,2335,1142,1193,0.48907922912205565,0.5109207708779443
W01001533,1637,827,810,0.5051924251679902,0.49480757483200977
W01001534,1484,746,738,0.5026954177897575,0.4973045822102426
W01001535,1335,667,668,0.49962546816479403,0.500374531835206
W01001504,2045,983,1062,0.4806845965770171,0.5193154034229829
W01001505,2080,1018,1062,0.4894230769230769,0.510576923076923
W01001508,1226,587,639,0.47879282218597063,0.5212071778140294
W01001509,1482,725,757,0.4892037786774629,0.5107962213225371
W01001545,1458,673,785,0.4615912208504801,0.5384087791495199
W01001548,2121,1048,1073,0.4941065535124941,0.5058934464875059
W01001557,1853,868,985,0.46842957366432814,0.5315704263356719
W01001571,1255,634,621,0.5051792828685259,0.49482071713147413
W01001579,1461,670,791,0.458590006844627,0.5414099931553731
W01001546,1537,753,784,0.48991541964866625,0.5100845803513337
W01001558,1527,733,794,0.48002619515389655,0.5199738048461034
W01001580,1791,866,925,0.4835287548855388,0.5164712451144612
W01001909,2651,1281,1370,0.48321388155413053,0.5167861184458695
W01001561,1480,722,758,0.48783783783783785,0.5121621621621621
W01001562,1406,703,703,0.5,0.5
W01001563,1013,481,532,0.47482724580454094,0.5251727541954591
W01001564,2319,1125,1194,0.4851228978007762,0.5148771021992238
W01001569,1447,704,743,0.4865238424326192,0.5134761575673807
W01001552,1564,774,790,0.4948849104859335,0.5051150895140665
W01001553,2746,1342,1404,0.48871085214857973,0.5112891478514202
W01001554,1691,844,847,0.4991129509166174,0.5008870490833827
W01001576,1088,529,559,0.48621323529411764,0.5137867647058824
W01001577,1300,587,713,0.45153846153846156,0.5484615384615384
W01001599,2119,1024,1095,0.4832468145351581,0.516753185464842
W01001566,1268,659,609,0.5197160883280757,0.4802839116719243
W01001567,1016,481,535,0.4734251968503937,0.5265748031496063
W01001568,1755,849,906,0.48376068376068376,0.5162393162393163
W01001575,1253,656,597,0.5235434956105347,0.4764565043894653
W01001581,1928,929,999,0.48184647302904565,0.5181535269709544
W01001555,1189,559,630,0.4701429772918419,0.5298570227081582
W01001556,1204,580,624,0.48172757475083056,0.5182724252491694
W01001560,1299,663,636,0.5103926096997691,0.4896073903002309
W01001565,1861,944,917,0.5072541644277271,0.49274583557227297
W01001596,1332,817,515,0.6133633633633634,0.3866366366366366
W01001597,1502,746,756,0.4966711051930759,0.5033288948069241
W01001549,1480,755,725,0.5101351351351351,0.48986486486486486
W01001583,1618,804,814,0.4969097651421508,0.5030902348578492
W01001585,1299,610,689,0.4695919938414165,0.5304080061585835
W01001586,2517,1213,1304,0.4819229241160111,0.5180770758839889
W01001594,1435,715,720,0.49825783972125437,0.5017421602787456
W01001595,1324,664,660,0.5015105740181269,0.4984894259818731
W01001559,1356,656,700,0.4837758112094395,0.5162241887905604
W01001584,1891,931,960,0.4923320994182972,0.5076679005817029
W01001587,1847,905,942,0.4899837574445046,0.5100162425554954
W01001592,1713,811,902,0.47343841214244015,0.5265615878575598
W01001593,1727,824,903,0.47712796757382747,0.5228720324261725
W01001542,1791,905,886,0.5053042992741485,0.4946957007258515
W01001543,1440,710,730,0.4930555555555556,0.5069444444444444
W01001578,2133,1089,1044,0.510548523206751,0.48945147679324896
W01001590,2201,1120,1081,0.5088596092685143,0.4911403907314857
W01001551,1179,578,601,0.4902459711620017,0.5097540288379983
W01001588,1712,833,879,0.48656542056074764,0.5134345794392523
W01001589,1467,734,733,0.5003408316291752,0.4996591683708248
W01001598,1665,838,827,0.5033033033033033,0.4966966966966967
W01001908,2141,1041,1100,0.48622139187295654,0.5137786081270435
W01001572,1583,772,811,0.48768161718256475,0.5123183828174352
W01001573,1503,763,740,0.5076513639387891,0.49234863606121093
W01001574,1487,749,738,0.503698722259583,0.49630127774041694
W01001582,1813,882,931,0.4864864864864865,0.5135135135135135
W01001591,1567,776,791,0.4952137843012125,0.5047862156987875
W01001623,1491,703,788,0.47149564050972503,0.528504359490275
W01001624,1275,597,678,0.4682352941176471,0.5317647058823529
W01001625,1279,635,644,0.49648162627052383,0.5035183737294762
W01001626,1394,712,682,0.5107604017216643,0.48923959827833574
W01001627,1553,769,784,0.4951706374758532,0.5048293625241468
W01001628,1069,498,571,0.46585594013096354,0.5341440598690365
W01001651,1525,746,779,0.48918032786885246,0.5108196721311475
W01001652,1773,825,948,0.4653130287648054,0.5346869712351946
W01001653,1449,703,746,0.48516218081435475,0.5148378191856453
W01001654,1629,790,839,0.4849600982197667,0.5150399017802333
W01001655,1621,786,835,0.4848858729179519,0.5151141270820481
W01001617,1289,626,663,0.4856477889837083,0.5143522110162917
W01001618,1123,549,574,0.4888691006233304,0.5111308993766697
W01001619,1386,671,715,0.48412698412698413,0.5158730158730159
W01001620,1166,540,626,0.4631217838765009,0.5368782161234992
W01001621,1368,645,723,0.47149122807017546,0.5285087719298246
W01001622,1274,613,661,0.4811616954474097,0.5188383045525903
W01001639,1911,920,991,0.48142333856619574,0.5185766614338043
W01001640,1146,557,589,0.4860383944153578,0.5139616055846422
W01001641,1368,682,686,0.49853801169590645,0.5014619883040936
W01001649,1472,747,725,0.5074728260869565,0.49252717391304346
W01001650,1489,724,765,0.4862323707186031,0.513767629281397
W01001614,1496,707,789,0.47259358288770054,0.5274064171122995
W01001615,1531,738,793,0.48203788373612017,0.5179621162638798
W01001616,1436,706,730,0.49164345403899723,0.5083565459610028
W01001678,1609,829,780,0.5152268489745183,0.4847731510254817
W01001601,1463,731,732,0.49965823650034175,0.5003417634996582
W01001681,1315,642,673,0.488212927756654,0.511787072243346
W01001682,1307,601,706,0.45983167559296095,0.540168324407039
W01001683,1104,533,571,0.48278985507246375,0.5172101449275363
W01001684,1409,696,713,0.49396735273243436,0.5060326472675657
W01001675,1550,779,771,0.5025806451612903,0.4974193548387097
W01001676,1653,843,810,0.5099818511796733,0.4900181488203267
W01001677,1461,710,751,0.485968514715948,0.5140314852840521
W01001679,1155,566,589,0.49004329004329006,0.5099567099567099
W01001680,1247,616,631,0.49398556535685645,0.5060144346431436
W01001606,1277,602,675,0.47141738449490994,0.52858261550509
W01001608,1544,768,776,0.49740932642487046,0.5025906735751295
W01001663,1500,675,825,0.45,0.55
W01001665,1661,782,879,0.4708007224563516,0.5291992775436484
W01001669,1350,678,672,0.5022222222222222,0.49777777777777776
W01001670,2385,1202,1183,0.5039832285115304,0.4960167714884696
W01001672,1761,837,924,0.4752981260647359,0.524701873935264
W01001673,1449,725,724,0.5003450655624568,0.4996549344375431
W01001674,1489,717,772,0.48153122901276024,0.5184687709872398
W01001664,1425,699,726,0.4905263157894737,0.5094736842105263
W01001666,1477,683,794,0.46242383209207855,0.5375761679079215
W01001667,1347,635,712,0.47141796585003715,0.5285820341499629
W01001668,1140,576,564,0.5052631578947369,0.49473684210526314
W01001611,1319,628,691,0.4761182714177407,0.5238817285822593
W01001612,1559,799,760,0.5125080179602309,0.48749198203976907
W01001613,1554,755,799,0.48584298584298585,0.5141570141570142
W01001691,1479,737,742,0.4983096686950642,0.5016903313049358
W01001692,1988,1058,930,0.5321931589537223,0.4678068410462777
W01001600,1584,776,808,0.4898989898989899,0.51010101010101
W01001602,1513,718,795,0.47455386649041637,0.5254461335095836
W01001603,1388,700,688,0.5043227665706052,0.4956772334293948
W01001604,1466,717,749,0.48908594815825374,0.5109140518417462
W01001642,1691,810,881,0.47900650502661146,0.5209934949733885
W01001643,1486,716,770,0.48183041722745623,0.5181695827725438
W01001644,2681,1348,1333,0.5027974636329727,0.4972025363670272
W01001690,2216,1100,1116,0.4963898916967509,0.5036101083032491
W01001693,1781,1012,769,0.5682201010668164,0.4317798989331836
W01001605,1368,726,642,0.5307017543859649,0.4692982456140351
W01001685,1652,862,790,0.5217917675544794,0.4782082324455206
W01001686,1392,671,721,0.48204022988505746,0.5179597701149425
W01001687,1729,945,784,0.5465587044534413,0.4534412955465587
W01001607,1423,662,761,0.4652143359100492,0.5347856640899508
W01001609,1467,659,808,0.4492160872528971,0.5507839127471029
W01001610,1301,662,639,0.5088393543428132,0.49116064565718676
W01001645,1363,659,704,0.483492296404989,0.516507703595011
W01001646,2120,1032,1088,0.4867924528301887,0.5132075471698113
W01001647,1483,717,766,0.48347943358057993,0.5165205664194201
W01001648,1529,730,799,0.4774362328319163,0.5225637671680837
W01001635,1348,650,698,0.4821958456973294,0.5178041543026706
W01001637,1724,837,887,0.48549883990719256,0.5145011600928074
W01001638,1190,584,606,0.4907563025210084,0.5092436974789916
W01001671,1724,823,901,0.47737819025522044,0.5226218097447796
W01001629,1395,664,731,0.4759856630824373,0.5240143369175627
W01001630,1462,714,748,0.4883720930232558,0.5116279069767442
W01001631,1423,678,745,0.4764581869290232,0.5235418130709768
W01001632,1377,659,718,0.4785766158315178,0.5214233841684822
W01001659,1803,934,869,0.5180255130338325,0.4819744869661675
W01001660,1569,769,800,0.49012109623964306,0.5098789037603569
W01001661,2599,1329,1270,0.5113505194305502,0.4886494805694498
W01001662,1347,659,688,0.4892353377876763,0.5107646622123236
W01001633,1535,735,800,0.4788273615635179,0.5211726384364821
W01001634,1529,706,823,0.4617396991497711,0.5382603008502289
W01001688,2648,1277,1371,0.48225075528700906,0.5177492447129909
W01001689,1773,801,972,0.4517766497461929,0.5482233502538071
W01001636,1897,944,953,0.4976278334211914,0.5023721665788087
W01001657,1465,721,744,0.49215017064846417,0.5078498293515359
W01001658,1885,891,994,0.4726790450928382,0.5273209549071618
W01001912,1480,739,741,0.49932432432432433,0.5006756756756757
W01001913,1440,753,687,0.5229166666666667,0.47708333333333336
